Map Name,Team 1 Name,Team 2 Name,Team 1 Score,Team 2 Score,Team 1 Attacking Wins,Team 1 Attacking Losses,Team 2 Attacking Wins,Team 2 Attacking Losses,Team 1 Agents,Team 2 Agents
Ascent,sou proplayer lixo?,Team Leveling,14,12,5,8,4,9,"Sova,Killjoy,Omen,Jett,KAY/O","Sova,Killjoy,Omen,Jett,KAY/O"
Haven,sou proplayer lixo?,Team Leveling,13,6,6,1,5,7,"Breach,Sova,Killjoy,Omen,Neon","Breach,Cypher,Sova,Omen,Neon"
Icebox,sou proplayer lixo?,Team Leveling,13,10,6,5,5,7,"Sova,Killjoy,Viper,Jett,Iso","Sova,Killjoy,Viper,Jett,Iso"
Ascent,Reckoning Esports,Mogo eSports,11,13,9,3,10,2,"Cypher,Sova,Omen,Jett,KAY/O","Cypher,Sova,Omen,Jett,Iso"
Bind,Reckoning Esports,Mogo eSports,6,13,5,7,6,1,"Raze,Cypher,Brimstone,Skye,Gekko","Raze,Cypher,Viper,Brimstone,Gekko"
Lotus,Orangutan,Niory Esports,13,7,5,3,4,8,"Cypher,Sage,Omen,Fade,Deadlock","Breach,Sova,Killjoy,Omen,Neon"
Icebox,Orangutan,Niory Esports,13,11,6,6,5,7,"Sova,Killjoy,Viper,Jett,Gekko","Sova,Killjoy,Viper,Jett,Iso"
Haven,Xipto Esports,ZETA DIVISION GC,13,5,10,2,3,3,"Killjoy,Viper,Omen,Jett,Skye","Breach,Cypher,Sova,Omen,Neon"
Icebox,Xipto Esports,ZETA DIVISION GC,13,2,3,0,2,10,"Killjoy,Viper,Jett,KAY/O,Gekko","Sova,Killjoy,Viper,Jett,KAY/O"
Sunset,Xipto Esports,ZETA DIVISION GC,13,8,6,6,2,7,"Cypher,Sova,Omen,KAY/O,Neon","Breach,Raze,Cypher,Sova,Omen"
Haven,Shopify Rebellion,oomfies,13,10,8,4,6,5,"Breach,Cypher,Sova,Omen,Neon","Cypher,Sova,Viper,Phoenix,Harbor"
Ascent,Shopify Rebellion,oomfies,13,6,6,1,5,7,"Cypher,Sova,Omen,Yoru,Deadlock","Cypher,Sova,Jett,Deadlock,Clove"
Sunset,Skout Esports,Cobweb eSports,13,7,7,1,6,6,"Cypher,Sova,Reyna,Omen,Jett","Breach,Cypher,Sova,Omen,Neon"
Lotus,oomfies,Teddy Tactics,13,5,6,0,5,7,"Raze,Cypher,Fade,Deadlock,Clove","Breach,Raze,Killjoy,Astra,Fade"
Icebox,Shopify Rebellion,Refrag,13,2,3,0,2,10,"Killjoy,Viper,Reyna,KAY/O,Gekko","Sova,Killjoy,Viper,Jett,Clove"
Lotus,Skout Esports,Cobweb eSports,2,13,2,10,3,0,"Breach,Raze,Killjoy,Omen,Neon","Breach,Killjoy,Viper,Omen,Neon"
Bind,Shopify Rebellion,Refrag,13,4,3,2,2,10,"Raze,Cypher,Viper,Brimstone,Skye","Raze,Viper,Brimstone,Gekko,Iso"
Haven,oomfies,Teddy Tactics,13,10,6,5,5,7,"Cypher,Sova,Viper,Phoenix,Harbor","Breach,Cypher,Sova,Jett,Astra"
Ascent,Skout Esports,Cobweb eSports,13,11,9,3,8,4,"Cypher,Sova,Phoenix,Omen,Jett","Sova,Killjoy,Omen,Jett,KAY/O"
Bind,Vila das Flores,Team Leveling,4,13,2,3,10,2,"Raze,Cypher,Brimstone,Skye,Deadlock","Raze,Viper,Brimstone,Skye,Gekko"
Haven,Vila das Flores,Team Leveling,14,16,6,9,7,8,"Breach,Cypher,Sova,Omen,Neon","Breach,Cypher,Sova,Omen,Neon"
Icebox,REVOADA,sou proplayer lixo?,8,13,5,4,9,3,"Sova,Killjoy,Viper,Jett,Gekko","Sova,Killjoy,Viper,Jett,Iso"
Split,Essence,Avoid Esports,9,13,3,7,6,6,"Raze,Viper,Jett,Skye,Astra","Raze,Cypher,Omen,Jett,Skye"
Haven,Tani Amaterasu,SC (Spain),13,1,2,0,1,11,"Breach,Sova,Killjoy,Omen,Jett","Breach,Brimstone,Sage,Jett,Chamber"
Bind,1000rr club,TzManiacs,14,12,4,9,3,10,"Raze,Cypher,Brimstone,Reyna,Fade","Raze,Viper,Omen,Skye,Fade"
Ascent,Golden Monkeys,Waist EC,13,15,5,9,6,8,"Sova,Killjoy,Omen,Jett,KAY/O","Sova,Killjoy,Omen,Jett,KAY/O"
Haven,God eSports,AMBYS Team,1,13,0,2,11,1,"Breach,Cypher,Omen,Neon,Gekko","Cypher,Skye,Neon,Iso,Clove"
Ascent,REVOADA,sou proplayer lixo?,5,13,5,7,6,0,"Sova,Killjoy,Omen,Jett,KAY/O","Sova,Killjoy,Omen,Jett,KAY/O"
Abyss,Zenturions,Tani Susano,5,13,3,9,4,2,"Cypher,Sova,Jett,Astra,KAY/O","Cypher,Sova,Jett,Astra,KAY/O"
Abyss,CDC Valorant,Guinea Pink Silkie,13,5,4,2,3,9,"Cypher,Sova,Jett,Astra,Gekko","Breach,Cypher,Jett,Astra,Gekko"
Bind,Mighty Meerkats,SPH WASHED,9,13,7,5,8,2,"Raze,Viper,Brimstone,Skye,Gekko","Breach,Raze,Cypher,Reyna,Clove"
Ascent,NGS ,Nick Hers,13,9,8,2,7,5,"Sova,Killjoy,Omen,Jett,KAY/O","Sova,Killjoy,Omen,Jett,KAY/O"
Sunset,Universae,vortex esports,13,5,5,1,4,8,"Breach,Raze,Cypher,Omen,Gekko","Breach,Cypher,Sova,Omen,Neon"
Ascent,Visions eSports,ADCeuta esports,5,13,5,7,6,0,"Cypher,Sova,Omen,Jett,Deadlock","Sova,Killjoy,Omen,Jett,KAY/O"
Haven,5GY eSports,El Barco Esports,8,13,5,7,6,3,"Breach,Cypher,Sova,Omen,Neon","Breach,Sova,Killjoy,Astra,Neon"
Sunset,TEAM VELAXIS,Melilla Titans Aura,13,9,7,5,4,6,"Breach,Raze,Cypher,Omen,KAY/O","Breach,Cypher,Sova,Omen,Neon"
Pearl,Mirror Never SURRENDER,Cerox Esports,13,5,7,5,0,6,"Killjoy,Jett,Yoru,Astra,Gekko","Killjoy,Jett,KAY/O,Harbor,Gekko"
Ascent,Team Orion,Velaxis Academy,13,6,4,3,3,9,"Sova,Killjoy,Omen,Jett,KAY/O","Sova,Killjoy,Omen,Jett,KAY/O"
Ascent,Odyssey Gaming,XTEC Esports,13,4,4,1,3,9,"Cypher,Sova,Omen,Jett,KAY/O","Sova,Killjoy,Omen,Jett,KAY/O"
Sunset,EREUS,Burrote Seco,5,13,3,9,4,2,"Breach,Raze,Cypher,Phoenix,Omen","Breach,Cypher,Omen,Neon,Gekko"
Ascent,El Pueblo,MaskapalosAutenticoGuachupino,13,11,4,8,3,9,"Cypher,Sova,Omen,Jett,Deadlock","Sova,Killjoy,Phoenix,Omen,Jett"
Haven,La Banda del Patio,Linares eSports,5,13,2,4,9,3,"Breach,Sova,Killjoy,Omen,Jett","Breach,Cypher,Sova,Omen,Neon"
Lotus,Medal Esports,Asterisk (IN),5,13,2,4,9,3,"Breach,Cypher,Omen,Neon,Fade","Raze,Killjoy,Viper,Omen,Fade"
Haven,LOS CHAMBALES,Peluqueria Mariloli,3,13,1,3,10,2,"Sova,Killjoy,Reyna,Jett,Astra","Breach,Sova,Killjoy,Omen,Neon"
Haven,TLS eSports,KHORE GAMING,13,11,5,7,4,8,"Breach,Cypher,Omen,Jett,Fade","Sova,Viper,Yoru,Astra,Deadlock"
Sunset,Nexum EC,Locked Esports,3,13,1,3,10,2,"Cypher,Sova,Omen,KAY/O,Neon","Breach,Raze,Cypher,Omen,Gekko"
Ascent,Arctic Ninjas,Zenn Club,0,13,0,12,1,0,"Sova,Omen,Jett,KAY/O,Deadlock","Cypher,Sova,Phoenix,Omen,Jett"
Abyss,Medal Esports,Asterisk (IN),6,13,4,8,5,2,"Cypher,Sova,Jett,Astra,Gekko","Breach,Raze,Cypher,Astra,Gekko"
Icebox,True Rippers,Dupg Esports,7,13,1,11,2,6,"Sova,Killjoy,Viper,Jett,KAY/O","Sova,Killjoy,Viper,Jett,KAY/O"
Ascent,True Rippers,Dupg Esports,11,13,4,8,5,7,"Sova,Killjoy,Omen,Jett","Cypher,Sova,Omen,Yoru,Deadlock"
Haven,True Rippers,Dupg Esports,13,11,5,7,4,8,"Breach,Cypher,Sova,Omen,Neon","Breach,Cypher,Sova,Omen,Neon"
Lotus,Mir Gaming GC,ZETA DIVISION GC,7,13,4,4,9,3,"Killjoy,Viper,Omen,Neon,Fade","Breach,Cypher,Omen,Neon,Fade"
Ascent,Mir Gaming GC,ZETA DIVISION GC,5,13,1,5,8,4,"Cypher,Sova,Omen,Jett,Deadlock","Sova,Killjoy,Omen,Jett,KAY/O"
Bind,Mir Gaming GC,ZETA DIVISION GC,13,10,5,7,3,8,"Raze,Viper,Brimstone,Skye,Gekko","Raze,Cypher,Viper,Brimstone,Skye"
Bind,Xipto Esports,sisu,13,6,9,3,3,4,"Raze,Viper,Brimstone,Fade,Gekko","Raze,Omen,Fade,Clove"
Sunset,Xipto Esports,sisu,13,8,6,6,2,7,"Cypher,Sova,Omen,KAY/O,Neon","Breach,Cypher,Sova,Omen,Neon"
Abyss,Xipto Esports,sisu,15,17,6,10,7,9,"Sova,Omen,Jett,Astra,KAY/O","Cypher,Sova,Jett,Astra,Gekko"
Sunset,SaD FROST,Teddy Tactics,6,13,6,6,7,0,"Breach,Raze,Cypher,Omen,Gekko","Breach,Raze,Cypher,Sova,Astra"
Abyss,SaD FROST,Teddy Tactics,13,10,6,5,5,7,"Cypher,Sova,Jett,Astra,Gekko","Sova,Killjoy,Viper,Jett,Astra"
Ascent,oomfies,Elation Vortex,13,5,7,5,0,6,"Cypher,Sova,Jett,Deadlock,Clove","Cypher,Sova,Omen,Jett"
Ascent,SaD FROST,Teddy Tactics,10,13,6,5,8,4,"Sova,Killjoy,Omen,Jett,KAY/O","Breach,Cypher,Sova,Jett,Astra"
Lotus,Refrag,Give Wingman 2 Nuclear Devices,13,5,4,2,3,9,"Cypher,Omen,Neon,Gekko,Iso","Raze,Cypher,Omen,Gekko,Clove"
Abyss,Shopify Rebellion,HyperSpeed Red,13,3,2,2,1,11,"Cypher,Sova,Yoru,Astra","Cypher,Sova,Jett,Astra,KAY/O"
Abyss,oomfies,Elation Vortex,12,14,6,7,7,6,"Sova,Jett,Yoru,Astra","Sova,Viper,Jett,Yoru,Astra"
Bind,Refrag,Give Wingman 2 Nuclear Devices,13,3,4,0,3,9,"Raze,Viper,Brimstone,Gekko,Iso","Raze,Skye,Astra,Chamber,Deadlock"
Ascent,Shopify Rebellion,HyperSpeed Red,13,3,3,1,2,10,"Cypher,Sova,Omen,Yoru,Deadlock","Sova,Killjoy,Omen,Jett,KAY/O"
Lotus,Teddy Tactics,Day By Day,14,12,6,7,5,8,"Breach,Raze,Killjoy,Astra,Fade","Raze,Cypher,Viper,Fade,Clove"
Sunset,oomfies,Elation Vortex,13,4,3,2,2,10,"Cypher,Sova,Neon,Deadlock,Clove","Breach,Cypher,Sova,Omen,Neon"
Bind,mesos millionaires,Give Wingman 2 Nuclear Devices,10,13,3,8,5,7,"Raze,Fade,Gekko,Deadlock,Clove","Raze,Skye,Astra,Chamber,Deadlock"
Icebox,Tenax GC,HyperSpeed Red,8,13,2,7,6,6,"Sova,Viper,Sage,Reyna,Chamber","Sova,Killjoy,Viper,Jett,Yoru"
Haven,Teddy Tactics,Day By Day,13,10,6,5,5,7,"Breach,Cypher,Sova,Jett,Astra","Breach,Cypher,Sova,Jett,Astra"
Bind,Refrag,Students of the Game,13,6,8,4,2,5,"Raze,Viper,Brimstone,Yoru,Gekko","Raze,Cypher,Reyna,Skye,Clove"
Abyss,SaD FROST, RITUAL RËAL,13,6,7,5,1,6,"Cypher,Sova,Jett,Astra,Gekko","Cypher,Sova,Jett,Astra,KAY/O"
Haven,oomfies,YDZ Black,13,7,5,3,4,8,"Cypher,Sova,Viper,Phoenix,Harbor","Breach,Sova,Killjoy,Omen,Jett"
Ascent,Tani Tsukuyomi,rustoria mondays,11,13,5,7,6,6,"Cypher,Sova,Omen,Jett,KAY/O","Sova,Killjoy,Omen,Jett,KAY/O"
Abyss,Elation Vortex,meowtastic,13,5,9,3,2,4,"Sova,Viper,Jett,Yoru,Astra","Breach,Cypher,Sova,Jett,Astra"
Icebox,Shopify Rebellion,Ominous Minions,13,3,4,0,3,9,"Killjoy,Viper,Reyna,KAY/O,Gekko","Sova,Killjoy,Viper,Reyna,Jett"
Bind,CryZen,Peluqueria Mariloli,13,11,8,4,7,5,"Raze,Omen,Skye,KAY/O,Clove","Raze,Sova,Brimstone,Skye,Chamber"
Icebox,mesos millionaires,Give Wingman 2 Nuclear Devices,6,13,5,7,6,1,"Sova,Killjoy,Viper,Jett,Gekko","Sova,Viper,Sage,Reyna,Chamber"
Sunset,oomfies,YDZ Black,13,4,9,3,1,4,"Sova,Reyna,Yoru,Chamber,Clove","Breach,Raze,Cypher,Omen,Gekko"
Ascent,Teddy Tactics,Day By Day,6,13,2,5,8,4,"Breach,Cypher,Sova,Jett,Astra","Cypher,Sova,Omen,Jett,Deadlock"
Icebox,Elation Vortex,meowtastic,13,2,10,2,0,3,"Sova,Killjoy,Viper,Jett,Harbor","Sova,Killjoy,Viper,Jett,KAY/O"
Sunset,SaD FROST, RITUAL RËAL,13,7,7,1,6,6,"Breach,Raze,Cypher,Omen,Gekko","Raze,Cypher,Omen,KAY/O,Gekko"
Lotus,Refrag,Students of the Game,13,6,6,1,5,7,"Raze,Cypher,Omen,Neon,Gekko","Raze,Killjoy,Viper,Omen,Fade"
Lotus,Tenax GC,HyperSpeed Red,10,13,6,6,7,4,"Breach,Killjoy,Omen,Neon,Fade","Breach,Killjoy,Omen,Neon,Fade"
Sunset,Shopify Rebellion,Ominous Minions,13,3,9,3,0,4,"Breach,Cypher,Sova,Omen,Neon","Breach,Raze,Cypher,Omen,Fade"
Abyss,CDC Valorant,Tani Tsukuyomi,12,14,7,6,8,5,"Cypher,Sova,Jett,Astra,Gekko","Breach,Cypher,Omen,Chamber,Gekko"
Haven,Universae,CryZen,11,13,6,6,7,5,"Killjoy,Viper,Omen,Jett,Skye","Breach,Sova,Killjoy,Omen,Jett"
Ascent,El Barco Esports,rustoria mondays,7,13,1,7,6,6,"Breach,Sova,Killjoy,Jett,Astra","Sova,Killjoy,Omen,Jett,KAY/O"
Sunset,Linares eSports,Peluqueria Mariloli,11,13,3,9,4,8,"Breach,Cypher,Sova,Omen,Neon","Breach,Cypher,Sova,Omen,Neon"
Ascent,rustoria mondays,Avoid Esports,13,3,4,0,3,9,"Sova,Killjoy,Omen,Jett,KAY/O","Sova,Killjoy,Omen,Jett,KAY/O"
Bind,Tani Tsukuyomi,Mighty Meerkats,13,7,7,5,2,6,"Omen,Skye,Yoru,Fade,Clove","Raze,Viper,Brimstone,Skye,Gekko"
Bind,CryZen,Las Palmas Unity,13,10,4,7,3,9,"Raze,Omen,Skye,KAY/O,Clove","Breach,Viper,Brimstone,Yoru,Fade"
Haven,vortex esports,El Barco Esports,9,13,5,5,8,4,"Breach,Sova,Killjoy,Omen,Neon","Breach,Sova,Killjoy,Astra,Neon"
Abyss,CDC Valorant,Monta Club Ace,14,12,9,4,8,5,"Cypher,Sova,Jett,Astra,Gekko","Breach,Cypher,Sova,Omen,Jett"
Bind,Peluqueria Mariloli,Tani Susano,13,4,3,2,2,10,"Raze,Sova,Brimstone,Skye,Chamber","Raze,Viper,Brimstone,Skye,Gekko"
Haven,Universae,Fractious Esports,13,11,7,5,6,6,"Killjoy,Viper,Omen,Jett,Skye","Breach,Cypher,Sova,Omen,Jett"
Split,Linares eSports,MaskapalosAutenticoGuachupino,19,17,8,10,7,11,"Breach,Raze,Cypher,Omen,Skye","Breach,Raze,Cypher,Omen,Jett"
Haven,AMBYS Team,rustoria mondays,8,13,5,4,9,3,"Breach,Cypher,Sova,Astra,Neon","Sova,Reyna,Omen,Jett,Chamber"
Sunset,RAVEN EXODUS,Las Palmas Unity,10,13,2,10,3,8,"Breach,Cypher,Sova,Omen,Neon","Cypher,Omen,KAY/O,Neon,Gekko"
Sunset,Locked Esports,vortex esports,9,13,4,6,7,5,"Breach,Raze,Cypher,Omen,Gekko","Breach,Cypher,Sova,Omen,Neon"
Sunset,Monta Club Ace,Zenn Club,13,8,6,3,5,7,"Breach,Cypher,Omen,Neon,Gekko","Breach,Cypher,Sova,Omen,Neon"
Bind,Avoid Esports,ADCeuta esports,13,10,6,5,5,7,"Raze,Brimstone,Reyna,Skye,Harbor","Raze,Cypher,Brimstone,Skye,Gekko"
Ascent,Tani Tsukuyomi,TLS eSports,13,11,6,6,5,7,"Cypher,Sova,Omen,Jett,KAY/O","Killjoy,Viper,Omen,Jett,Skye"
Ascent,Visions eSports,El Barco Esports,5,13,4,8,5,1,"Cypher,Sova,Omen,Jett,Deadlock","Breach,Sova,Killjoy,Jett,Astra"
Bind,Arctic Ninjas,Tani Susano,2,13,2,10,3,0,"Raze,Viper,Skye,Astra,Chamber","Raze,Viper,Brimstone,Skye,Gekko"
Ascent,Cierzo Esports,CryZen,2,13,0,3,10,2,"Viper,Phoenix,Omen,Skye,Gekko","Breach,Omen,Neon,Fade,Deadlock"
Ascent,Peluqueria Mariloli,Guinea Pink Silkie,13,6,7,0,6,6,"Sova,KAY/O,Chamber,Iso,Clove","Sova,Killjoy,Omen,Jett,Gekko"
Haven,La Banda del Patio,MaskapalosAutenticoGuachupino,4,13,0,5,8,4,"Breach,Sova,Killjoy,Omen,Jett","Sova,Killjoy,Omen,Jett,Iso"
Haven,CDC Valorant,Velaxis Academy,13,7,4,4,3,9,"Breach,Cypher,Sova,Astra,Neon","Breach,Sova,Killjoy,Omen,Jett"
Sunset,KHORE GAMING,Universae,10,13,5,6,7,5,"Breach,Cypher,Sova,Omen,Neon","Breach,Raze,Cypher,Omen,Gekko"
Abyss,Fractious Esports,Tani Amaterasu,13,8,8,1,7,5,"Cypher,Sova,Jett,Astra,KAY/O","Cypher,Sova,Omen,KAY/O,Neon"
Sunset,Peluqueria Mariloli,SZK Academy,13,6,4,3,3,9,"Breach,Cypher,Sova,Omen,Neon","Breach,Cypher,Sova,Omen,Neon"
Sunset,XTirpeTeam,EREUS,13,7,5,3,4,8,"Breach,Cypher,Sova,Omen,Neon","Breach,Cypher,Sova,Omen,Neon"
Haven,eLionking Academy,rustoria mondays,2,13,1,11,2,1,"Breach,Sova,Killjoy,Jett,Astra","Breach,Killjoy,Reyna,Jett,Clove"
Ascent,Waist EC,El Barco Esports,2,13,2,10,3,0,"Sova,Killjoy,Omen,Jett,KAY/O","Breach,Sova,Killjoy,Jett,Astra"
Haven,TEAM VELAXIS,Locked Esports,8,13,3,9,4,5,"Breach,Sova,Killjoy,Omen,Jett","Breach,Cypher,Sova,Astra,Neon"
Haven,AMBYS Team,5GY eSports,13,11,2,10,1,11,"Breach,Cypher,Sova,Astra,Neon","Breach,Cypher,Sova,Omen,Neon"
Haven,Monta Club Ace,Nexum EC,14,12,6,7,5,8,"Breach,Cypher,Sova,Omen,Neon","Breach,Sova,Killjoy,Astra,Neon"
Haven,RAVEN EXODUS,VOID (EU),15,13,9,5,8,6,"Breach,Cypher,Sova,Omen,Neon","Breach,Sova,Killjoy,Omen,Neon"
Bind,Stray Wolves,Avoid Esports,10,13,6,6,7,4,"Raze,Brimstone,Omen,Gekko,Deadlock","Raze,Brimstone,Reyna,Skye,Harbor"
Sunset,Linares eSports,Genesis eSports,13,6,6,1,5,7,"Breach,Cypher,Sova,Omen,Neon","Breach,Cypher,Sova,Omen,Neon"
Ascent,KBT Gaming,TLS eSports,6,13,0,7,6,6,"Cypher,Sova,Omen,Jett,KAY/O","Killjoy,Viper,Omen,Jett,Skye"
Ascent,UnderDogs SYN,Tani Tsukuyomi,12,14,2,11,3,10,"Sova,Killjoy,Omen,Jett,KAY/O","Cypher,Sova,Omen,Jett,KAY/O"
Ascent,Team Ogmios,CryZen,7,13,3,9,4,4,"Cypher,Sova,Omen,Jett,Gekko","Breach,Omen,Neon,Fade,Deadlock"
Haven,MaskapalosAutenticoGuachupino,Arco de Jason Staham,13,7,8,0,7,5,"Sova,Killjoy,Omen,Jett,Iso","Breach,Sova,Killjoy,Omen,Jett"
Split,LINX Academy,La Banda del Patio,4,13,3,2,11,1,"Breach,Raze,Cypher,Omen,Fade","Breach,Raze,Cypher,Sage,Omen"
Bind,ADCeuta esports,Future Radiants ,13,6,5,2,4,8,"Raze,Cypher,Brimstone,Skye,Gekko","Raze,Viper,Brimstone,Reyna,Fade"
Haven,KHORE GAMING,El Pueblo,13,2,10,2,0,3,"Sova,Viper,Yoru,Astra,Deadlock","Breach,Cypher,Sova,Omen,Jett"
Haven,Divine eSports,vortex esports,2,13,1,11,2,1,"Breach,Cypher,Sova,Omen,Jett","Breach,Sova,Killjoy,Omen,Neon"
Pearl,Las Palmas Unity,Osprey Jade,13,3,10,2,1,3,"Viper,Jett,Astra,KAY/O,Fade","Cypher,Viper,Jett,Astra,KAY/O"
Sunset,Velaxis Academy,Guinea Pink Baldwin,13,7,4,4,3,9,"Breach,Cypher,Sova,Omen,Neon","Breach,Cypher,Sova,Omen,Neon"
Haven,SLEIK Esports,Fractious Esports,3,13,1,3,10,2,"Breach,Cypher,Sova,Omen,Jett","Breach,Cypher,Sova,Omen,Jett"
Bind,CDC Valorant,Dranwork,13,4,4,1,3,9,"Raze,Viper,Brimstone,Skye,Gekko","Raze,Cypher,Brimstone,Skye,Gekko"
Bind,Nick Hers,Tani Susano,3,13,0,4,9,3,"Breach,Cypher,Omen,Neon,Deadlock","Raze,Viper,Brimstone,Skye,Gekko"
Bind,Karasu Eaters,Universae,0,13,0,12,1,0,"Raze,Viper,Brimstone,Skye,Gekko","Viper,Omen,Skye,Neon,Fade"
Ascent,Nyx (SP),Cierzo Esports,6,13,6,6,7,0,"Cypher,Sova,Jett,KAY/O,Clove","Viper,Phoenix,Omen,Skye,Gekko"
Ascent,W2WG,Visions eSports,5,13,0,6,7,5,"Sova,Killjoy,Reyna,Omen,Jett","Cypher,Sova,Omen,Jett,Deadlock"
Haven,Zenn Club,Cerox Esports,13,6,7,5,1,6,"Breach,Sova,Killjoy,Omen,Jett","Breach,Sova,Killjoy,Omen,Neon"
Lotus,ZETA DIVISION GC,BOBA,13,11,6,6,5,7,"Breach,Cypher,Omen,Neon,Fade","Killjoy,Viper,Omen,Neon,Fade"
Sunset,ZETA DIVISION GC,BOBA,15,13,8,6,7,7,"Breach,Raze,Cypher,Sova,Omen","Breach,Cypher,Sova,Omen,Neon"
Lotus,sisu,swaglord9000,13,7,6,2,5,7,"Omen,Chamber,Neon,Fade","Raze,Cypher,Omen,Fade,Deadlock"
Bind,sisu,swaglord9000,13,1,11,1,0,2,"Raze,Omen,Fade,Clove","Raze,Cypher,Viper,Brimstone,Skye"
Ascent,sisu,swaglord9000,8,13,4,5,8,4,"Sova,Killjoy,Omen,Jett,KAY/O","Cypher,Sova,Omen,Yoru,Deadlock"
Ascent,sou proplayer lixo?,PS5Patas,13,2,3,0,2,10,"Sova,Killjoy,Omen,Jett,KAY/O","Sova,Killjoy,Omen,Jett,KAY/O"
Bind,REVOADA,ygrenys,13,8,8,4,4,5,"Raze,Viper,Skye,Deadlock,Clove","Raze,Viper,Brimstone,Skye,Gekko"
Icebox,sou proplayer lixo?,PS5Patas,13,3,4,0,3,9,"Sova,Killjoy,Viper,Sage,Jett","Sova,Killjoy,Viper,Jett,Iso"
Lotus,BOBA,FENNEL GC,13,7,4,4,3,9,"Killjoy,Viper,Omen,Neon,Fade","Breach,Raze,Cypher,Omen,Fade"
Ascent,BOBA,FENNEL GC,13,10,5,6,4,8,"Cypher,Sova,Omen,Jett,Deadlock","Sova,Killjoy,Omen,Jett,KAY/O"
Icebox,Purr-fectionists,swaglord9000,12,14,8,5,9,4,"Sova,Killjoy,Viper,Jett,Gekko","Sova,Killjoy,Viper,Sage,Jett"
Bind,Purr-fectionists,swaglord9000,13,9,9,3,6,4,"Raze,Viper,Brimstone,Skye,Gekko","Raze,Cypher,Viper,Brimstone,Skye"
Ascent,Purr-fectionists,swaglord9000,3,13,3,9,4,0,"Sova,Killjoy,Reyna,Omen,Jett","Cypher,Sova,Omen,Yoru,Deadlock"
Bind,ZETA DIVISION GC,Xipto Esports,6,13,3,4,9,3,"Raze,Cypher,Viper,Brimstone,Skye","Raze,Viper,Brimstone,Fade,Gekko"
Ascent,ZETA DIVISION GC,Xipto Esports,5,13,5,7,6,0,"Sova,Killjoy,Omen,Jett,KAY/O","Cypher,Sova,Omen,Jett,KAY/O"
Haven,YDZ Black,Skyline Dreamers GC,13,5,5,1,4,8,"Breach,Sova,Killjoy,Omen,Jett","Cypher,Sova,Omen,Yoru,Iso"
Ascent, RITUAL RËAL,Passionless Project,13,1,11,1,0,2,"Cypher,Sova,Omen,Jett,KAY/O","Sova,Killjoy,Omen,Jett,KAY/O"
Sunset,YDZ Black,Skyline Dreamers GC,13,11,7,5,6,6,"Breach,Raze,Cypher,Omen,Gekko","Breach,Raze,Cypher,Omen,Gekko"
Lotus, RITUAL RËAL,Passionless Project,6,13,1,6,7,5,"Raze,Cypher,Omen,Fade,Deadlock","Breach,Raze,Cypher,Omen,Gekko"
Haven,Day By Day,Nori X,13,6,4,3,3,9,"Cypher,Sova,Yoru,Astra,Iso","Breach,Cypher,Sova,Omen,Jett"
Icebox,HyperSpeed Red,Elite Dynasty GC,13,4,5,0,4,8,"Sova,Killjoy,Viper,Jett,Yoru","Sova,Killjoy,Viper,Jett,Harbor"
Sunset,Give Wingman 2 Nuclear Devices,SHU GC,14,12,9,4,8,5,"Breach,Sova,Omen,Chamber,Neon","Raze,Cypher,Astra,Fade,Gekko"
Bind,Ominous Minions,AURA Eclipse,13,8,7,5,3,6,"Raze,Viper,Brimstone,Fade,Gekko","Raze,Cypher,Viper,Brimstone,Skye"
Ascent,meowtastic,Erinite GC,13,8,7,5,3,6,"Sova,Killjoy,Omen,Jett,KAY/O","Sova,Killjoy,Omen,Jett,KAY/O"
Lotus,Day By Day,Nori X,13,2,11,1,1,2,"Cypher,Omen,Skye,Neon,Clove","Breach,Raze,Omen,Chamber,Gekko"
Lotus,YDZ Black,Skyline Dreamers GC,10,13,3,9,4,7,"Breach,Raze,Cypher,Omen,Fade","Breach,Killjoy,Neon,Gekko,Clove"
Bind,Give Wingman 2 Nuclear Devices,SHU GC,13,6,7,5,1,6,"Raze,Skye,Astra,Chamber,Deadlock","Raze,Viper,Brimstone,Fade,Gekko"
Lotus,HyperSpeed Red,Elite Dynasty GC,13,7,7,5,2,6,"Breach,Killjoy,Omen,Neon,Fade","Breach,Cypher,Sova,Omen,Neon"
Abyss, RITUAL RËAL,Passionless Project,13,10,4,7,3,9,"Cypher,Sova,Jett,Astra,KAY/O","Breach,Cypher,Sova,Jett,Astra"
Sunset,Ominous Minions,AURA Eclipse,13,4,4,1,3,9,"Breach,Raze,Cypher,Omen,Fade","Breach,Cypher,Sova,Omen,Neon"
Haven,meowtastic,Erinite GC,13,3,4,0,3,9,"Breach,Sova,Killjoy,Omen,Jett","Breach,Sova,Omen,Chamber,Neon"
Haven,Mir Gaming GC,sisu,14,12,6,7,5,8,"Breach,Sova,Killjoy,Omen,Jett","Breach,Sova,Killjoy,Astra,Neon"
Lotus,Mir Gaming GC,sisu,13,15,8,6,9,5,"Killjoy,Viper,Omen,Neon,Fade","Omen,Chamber,Neon,Fade"
Icebox,Mir Gaming GC,sisu,13,6,4,3,3,9,"Sova,Killjoy,Viper,Jett,Gekko","Sova,Killjoy,Viper,Jett,Harbor"
Haven,Xipto Esports,FENNEL GC,13,3,9,3,0,4,"Killjoy,Viper,Omen,Jett,Skye","Breach,Sova,Killjoy,Omen,Jett"
Sunset,Xipto Esports,FENNEL GC,13,9,5,5,4,8,"Cypher,Sova,Omen,KAY/O,Neon","Breach,Raze,Cypher,Omen,Fade"
Ascent,ZETA DIVISION GC,BOBA,13,11,10,2,9,3,"Sova,Killjoy,Omen,Jett,KAY/O","Cypher,Sova,Omen,Jett,Deadlock"
Abyss,ZETA DIVISION GC,BOBA,7,13,3,9,4,4,"Cypher,Sova,Jett,Astra,KAY/O","Cypher,Sova,Omen,Jett,KAY/O"
Haven,ZETA DIVISION GC,BOBA,13,10,8,3,7,5,"Breach,Cypher,Sova,Omen,Neon","Breach,Sova,Killjoy,Omen,Neon"
Abyss,Tenax GC,meowtastic,14,12,5,8,4,9,"Breach,Sova,Omen,Jett,Astra","Breach,Cypher,Sova,Jett,Astra"
Lotus,oomfies,Ominous Minions,13,4,3,2,2,10,"Sova,Sage,Reyna,Yoru,Clove","Sova,Reyna,Neon,Iso,Clove"
Ascent,oomfies,Ominous Minions,13,5,5,1,4,8,"Cypher,Sova,Yoru,Deadlock,Clove","Sova,Killjoy,Omen,Jett,KAY/O"
Icebox,Tenax GC,meowtastic,16,14,9,6,8,7,"Sova,Viper,Sage,Reyna,Chamber","Sova,Killjoy,Viper,Jett,KAY/O"
Abyss,Akave Esports Black,FUSION X,10,13,7,5,8,3,"Sova,Killjoy,Viper,Yoru,Astra","Cypher,Sova,Jett,Astra,Gekko"
Sunset,Shopify Rebellion,YDZ Black,13,0,12,0,0,1,"Breach,Cypher,Sova,Omen,Neon","Breach,Raze,Cypher,Omen,Gekko"
Haven,SaD FROST,Day By Day,13,10,7,4,6,6,"Breach,Cypher,Sova,Omen,Jett","Breach,Cypher,Sova,Omen,Jett"
Ascent,Tenax GC,meowtastic,6,13,3,4,9,3,"Sova,Killjoy,Omen,Yoru,Iso","Sova,Killjoy,Omen,Jett,KAY/O"
Bind,SHU GC,Purpose Gaming Sirens,13,6,7,0,6,6,"Raze,Viper,Brimstone,Fade,Gekko","Raze,Viper,Brimstone,Skye,Gekko"
Lotus,Refrag,Give Wingman 2 Nuclear Devices,13,3,3,1,2,10,"Breach,Raze,Cypher,Fade,Clove","Breach,Raze,Killjoy,Reyna,Omen"
Ascent,mesos millionaires, RITUAL RËAL,13,7,9,3,4,4,"Sova,Killjoy,Jett,Astra,KAY/O","Cypher,Sova,Omen,Jett,KAY/O"
Bind,Ominous Minions,AURA Eclipse,13,9,6,4,5,7,"Raze,Viper,Brimstone,Fade,Gekko","Raze,Cypher,Viper,Brimstone,Skye"
Icebox,Shopify Rebellion,YDZ Black,13,4,9,3,1,4,"Killjoy,Viper,Reyna,KAY/O,Gekko","Sova,Killjoy,Viper,KAY/O,Clove"
Ascent,Teddy Tactics,HyperSpeed Red,13,10,7,4,6,6,"Breach,Cypher,Sova,Jett,Astra","Sova,Killjoy,Omen,Jett,KAY/O"
Ascent,SaD FROST,Day By Day,13,8,6,3,5,7,"Sova,Killjoy,Omen,Jett,KAY/O","Cypher,Sova,Omen,Jett,KAY/O"
Lotus,BBB,Nori X,3,13,0,4,9,3,"Raze,Killjoy,Omen,Fade,Gekko","Breach,Raze,Omen,Chamber,Gekko"
Lotus,Akave Esports Black,FUSION X,13,1,11,1,0,2,"Raze,Killjoy,Viper,Omen,Fade","Breach,Raze,Cypher,Fade,Clove"
Lotus,Akave Esports Black,FUSION X,13,1,11,1,0,2,"Raze,Killjoy,Viper,Omen,Fade","Breach,Raze,Cypher,Fade,Clove"
Sunset,mesos millionaires, RITUAL RËAL,13,8,7,2,6,6,"Breach,Raze,Cypher,Sova,Clove","Raze,Cypher,Omen,KAY/O,Gekko"
Haven,SHU GC,Purpose Gaming Sirens,13,10,9,3,7,4,"Breach,Sova,Killjoy,Omen,Jett","Breach,Sova,Killjoy,Omen,Jett"
Icebox,Refrag,Give Wingman 2 Nuclear Devices,13,9,6,6,3,7,"Sova,Killjoy,Viper,Jett,Gekko","Sova,Viper,Sage,Reyna,Chamber"
Ascent,Erinite GC,meowtastic,6,13,2,10,3,4,"Sova,Killjoy,Omen,Jett,KAY/O","Sova,Killjoy,Omen,Jett,KAY/O"
Haven,Teddy Tactics,HyperSpeed Red,13,7,7,5,2,6,"Breach,Cypher,Sova,Jett,Astra","Breach,Sova,Killjoy,Omen,Neon"
Lotus,Ominous Minions,AURA Eclipse,12,14,4,9,5,8,"Breach,Raze,Omen,Fade,Clove","Breach,Neon,Deadlock,Clove"
Lotus,YDZ Black,Skyline Dreamers GC,13,6,5,2,4,8,"Breach,Raze,Cypher,Omen,Fade","Breach,Killjoy,Neon,Gekko,Clove"
Haven,Day By Day,Nori X,13,9,7,5,4,6,"Breach,Cypher,Sova,Omen,Jett","Breach,Cypher,Sova,Omen,Jett"
Lotus,Refrag,SHU GC,13,8,3,6,2,10,"Raze,Omen,Fade,Deadlock","Breach,Cypher,Omen,Neon,Fade"
Sunset,SaD FROST,BBB,13,2,10,2,0,3,"Breach,Raze,Cypher,Omen,Gekko","Breach,Raze,Cypher,Omen,Gekko"
Bind,Akave Esports Black,FUSION X,13,6,6,6,0,7,"Raze,Viper,Skye,Astra,Iso","Raze,Cypher,Brimstone,Skye,Gekko"
Haven,Erinite GC,meowtastic,13,5,7,5,0,6,"Breach,Sova,Omen,Chamber,Neon","Breach,Sova,Killjoy,Omen,Jett"
Lotus, RITUAL RËAL,Passionless Project,13,8,5,4,4,8,"Raze,Cypher,Omen,Fade,Deadlock","Breach,Raze,Cypher,Omen,Gekko"
Bind,Give Wingman 2 Nuclear Devices,Purpose Gaming Sirens,13,1,11,1,0,2,"Raze,Skye,Astra,Chamber,Deadlock","Raze,Viper,Brimstone,Skye,Gekko"
Lotus,HyperSpeed Red,Elite Dynasty GC,13,6,10,2,4,3,"Breach,Killjoy,Omen,Neon,Fade","Breach,Cypher,Sova,Omen,Neon"
Bind,Day By Day,Nori X,13,5,9,3,2,4,"Raze,Cypher,Viper,Brimstone,Skye","Raze,Viper,Brimstone,Chamber,Gekko"
Bind,Refrag,SHU GC,13,7,4,4,3,9,"Raze,Viper,Brimstone,Yoru,Gekko","Raze,Viper,Brimstone,Fade,Gekko"
Sunset,Ominous Minions,AURA Eclipse,13,9,9,3,6,4,"Breach,Raze,Cypher,Omen,Fade","Breach,Cypher,Sova,Omen,Neon"
Sunset,YDZ Black,Skyline Dreamers GC,13,8,10,2,6,3,"Breach,Raze,Cypher,Omen,Gekko","Breach,Raze,Cypher,Omen,Gekko"
Bind,SaD FROST,BBB,13,3,2,2,1,11,"Raze,Viper,Brimstone,Skye,Chamber","Raze,Brimstone,Jett,Skye,Gekko"
Haven,HyperSpeed Red,Elite Dynasty GC,13,2,10,2,0,3,"Breach,Sova,Killjoy,Omen,Neon","Breach,Cypher,Sova,Omen,Neon"
Haven, RITUAL RËAL,Passionless Project,13,2,3,0,2,10,"Breach,Cypher,Sova,Omen,Jett","Breach,Cypher,Sova,Omen,Neon"
Sunset,Give Wingman 2 Nuclear Devices,Purpose Gaming Sirens,13,3,11,1,2,2,"Breach,Cypher,Sova,Omen,Neon","Breach,Raze,Cypher,Omen,Gekko"
Icebox,Erinite GC,meowtastic,3,13,1,11,2,2,"Sova,Killjoy,Jett,Harbor,Clove","Sova,Killjoy,Viper,Jett,KAY/O"
Sunset,Möyhentäjät,wade,3,13,3,9,4,0,"Breach,Raze,Cypher,Sova,Brimstone","Breach,Cypher,Sova,Neon,Clove"
Lotus,Ahlman ,VIRMA,1,13,0,2,11,1,"Raze,Cypher,Omen,Gekko,Clove","Breach,Raze,Omen,Chamber,Deadlock"
Ascent,Möyhentäjät,wade,2,13,2,1,12,0,"Sova,Killjoy,Phoenix,Omen,Jett","Sova,Killjoy,Jett,KAY/O,Clove"
Ascent,Ahlman ,VIRMA,1,13,1,11,2,0,"Cypher,Omen,Jett,Yoru,KAY/O","Sova,Omen,Jett,KAY/O,Deadlock"
Lotus,SSalama,KAMK.GG,13,2,3,0,2,10,"Breach,Raze,Omen,Gekko","Viper,Chamber,Neon,Gekko,Clove"
Haven,SSalama,KAMK.GG,13,8,7,5,3,6,"Breach,Sova,Omen,Jett","Breach,Sova,Killjoy,Omen,Jett"
Sunset,Dupg Esports,Alternate Realities,13,2,11,1,1,2,"Breach,Cypher,Sova,Omen,Neon","Raze,Cypher,Omen,KAY/O,Gekko"
Bind,Dupg Esports,Alternate Realities,13,9,7,5,4,6,"Breach,Raze,Brimstone,Skye,Chamber","Raze,Viper,Brimstone,Fade,Gekko"
Ascent,Alternate Realities,Asterisk (IN),8,13,6,3,10,2,"Sova,Killjoy,Omen,Jett,KAY/O","Sova,Killjoy,Omen,Jett,KAY/O"
Icebox,Alternate Realities,Asterisk (IN),8,13,4,5,8,4,"Sova,Killjoy,Viper,Jett,Clove","Sova,Killjoy,Viper,Neon,Gekko"
Icebox,sisu,swaglord9000,13,10,7,4,6,6,"Sova,Killjoy,Viper,Jett,Harbor","Sova,Killjoy,Viper,Sage,Jett"
Haven,sisu,swaglord9000,13,4,5,0,4,8,"Breach,Sova,Killjoy,Astra,Neon","Cypher,Sova,Omen,Jett,Yoru"
Icebox,Mir Gaming GC,Purr-fectionists,13,11,7,5,6,6,"Sova,Killjoy,Viper,Jett,Gekko","Sova,Killjoy,Viper,Jett,Gekko"
Haven,Mir Gaming GC,Purr-fectionists,7,13,4,4,9,3,"Breach,Sova,Killjoy,Omen,Jett","Breach,Sova,Killjoy,Omen,Jett"
Lotus,Mir Gaming GC,Purr-fectionists,13,9,7,3,6,6,"Killjoy,Viper,Omen,Neon,Fade","Raze,Killjoy,Viper,Omen,Fade"
Sunset,KRÜ BLAZE,9z Team GC,13,9,7,5,4,6,"Breach,Cypher,Sova,Omen,Neon","Breach,Omen,Neon,Gekko,Deadlock"
Lotus,KRÜ BLAZE,9z Team GC,13,5,8,4,1,5,"Raze,Killjoy,Viper,Omen,Fade","Breach,Omen,Neon,Fade,Clove"
Bind,KRÜ BLAZE,9z Team GC,13,6,7,5,1,6,"Viper,Brimstone,Neon,Fade,Gekko","Astra,Neon,Fade,Gekko,Deadlock"
Lotus,Defient Esports,The Cult,13,6,3,4,2,10,"Breach,Raze,Cypher,Omen,Fade","Breach,Killjoy,Omen,Jett,Fade"
Sunset,Defient Esports,The Cult,13,4,4,1,3,9,"Breach,Cypher,Sova,Omen,Neon","Breach,Raze,Cypher,Gekko,Clove"
Lotus,KineTiX eSports X1,Blue Moon eSports,8,13,6,6,7,2,"Breach,Raze,Cypher,Omen,Fade","Breach,Raze,Killjoy,Omen,Fade"
Bind,KineTiX eSports X1,Blue Moon eSports,2,13,0,3,10,2,"Raze,Viper,Brimstone,Skye,Fade","Breach,Raze,Cypher,Brimstone,Fade"
Ascent,Dupg Esports,Niory Esports,10,13,4,7,6,6,"Cypher,Sova,Omen,Yoru,Deadlock","Sova,Killjoy,Omen,Jett,KAY/O"
Sunset,Dupg Esports,Niory Esports,9,13,6,6,7,3,"Breach,Cypher,Sova,Omen,Neon","Breach,Cypher,Sova,Omen,Neon"
Ascent,TBS GC,Vila das Flores,13,9,7,5,4,6,"Sova,Killjoy,Omen,Jett,KAY/O","Cypher,Sova,Omen,Jett,Yoru"
Abyss,TBS GC,Vila das Flores,13,9,9,3,6,4,"Cypher,Sova,Omen,Jett,KAY/O","Cypher,Sova,Omen,Jett,Harbor"
Bind,LOUD GC,REVOADA,13,3,11,1,2,2,"Raze,Cypher,Brimstone,Skye,Deadlock","Raze,Viper,Brimstone,Skye,Gekko"
Sunset,LOUD GC,REVOADA,13,6,7,5,1,6,"Raze,Cypher,Omen,KAY/O,Gekko","Breach,Cypher,Sova,Omen,Neon"
Lotus,LOUD GC,REVOADA,4,13,4,8,5,0,"Cypher,Omen,KAY/O,Neon,Fade","Raze,Killjoy,Viper,Omen,Fade"
Ascent,Imperium Gaming,Lotus Knights,6,13,3,9,4,3,"Sova,Killjoy,Reyna,Omen,Jett","Cypher,Sova,Omen,Jett,Deadlock"
Haven,Tap Tap Boom eSports,The Easy Crew,10,13,8,4,9,2,"Breach,Cypher,Sova,Omen,Jett","Breach,Cypher,Sova,Omen,Neon"
Haven,SZK Esports,LONETEAM,11,13,4,8,5,7,"Breach,Sova,Killjoy,Omen,Jett","Breach,Cypher,Sova,Omen,Jett"
Ascent,Tap Tap Boom eSports,The Easy Crew,15,13,5,9,4,10,"Sova,Killjoy,Omen,Jett,KAY/O","Cypher,Sova,Omen,Jett,KAY/O"
Haven,TwentyStars,Dimonis,10,13,4,7,6,6,"Breach,Sova,Killjoy,Omen,Jett","Breach,Sova,Killjoy,Omen,Neon"
Abyss,Dark Horse Templars,Union Atta I,3,13,1,3,10,2,"Breach,Cypher,Sova,Astra,Neon","Sova,Omen,Neon,Gekko"
Sunset,Melilla Titans,SLTitans Esports,13,5,10,2,3,3,"Cypher,Sova,Omen,KAY/O,Neon","Cypher,Sova,Omen,KAY/O,Neon"
Ascent,Dark Horse Templars,Union Atta I,7,13,6,6,7,1,"Sova,Killjoy,Omen,Jett,KAY/O","Killjoy,Reyna,Omen,KAY/O"
Haven,Leça FC Esports,RTZN,13,8,5,4,4,8,"Cypher,Sova,Omen,Yoru,Iso","Breach,Cypher,Sova,Omen,Jett"
Abyss,ZINGERS,NoMercy,13,3,10,2,1,3,"Breach,Astra,Chamber,Neon,Harbor","Cypher,Sova,Omen,Jett,KAY/O"
Ascent,GMBLERS Esports,Team Galaga,13,6,4,3,3,9,"Sova,Killjoy,Omen,Jett,KAY/O","Sova,Killjoy,Omen,Jett,KAY/O"
Sunset,ZINGERS,NoMercy,13,8,5,7,1,8,"Breach,Cypher,Omen,Neon,Gekko","Breach,Cypher,Omen,Neon,Gekko"
Sunset,Las Cabras (EU),NewD,11,13,5,7,6,6,"Breach,Cypher,Sova,Omen,Neon","Breach,Cypher,Neon,Harbor,Gekko"
Bind,Sin Prisa Gaming,BOOM Esports,17,15,10,6,9,7,"Cypher,Brimstone,Skye,Neon,Deadlock","Raze,Cypher,Viper,Brimstone,Skye"
Haven,Las Cabras (EU),NewD,9,13,4,6,7,5,"Breach,Cypher,Sova,Omen,Neon","Breach,Cypher,Omen,Jett,Deadlock"
Haven,Sin Prisa Gaming,BOOM Esports,10,13,9,3,10,1,"Breach,Cypher,Sova,Omen,Neon","Cypher,Viper,Omen,Skye,Neon"
Haven,Pegasus Esports,TEAM BLINDSPOT,2,13,0,3,10,2,"Breach,Cypher,Sova,Omen,Neon","Breach,Cypher,Sova,Omen,Neon"
Lotus,Sin Prisa Gaming,BOOM Esports,12,14,6,7,7,6,"Cypher,Viper,Omen,Neon,Fade","Raze,Cypher,Viper,Omen,Fade"
Bind,Pegasus Esports,TEAM BLINDSPOT,3,13,3,9,4,0,"Raze,Viper,Fade,Harbor,Gekko","Raze,Viper,Brimstone,Skye,Gekko"
Icebox,Sin Prisa Gaming,BOOM Esports,13,10,3,9,1,10,"Sova,Killjoy,Viper,Jett,Harbor","Sova,Killjoy,Viper,Jett,Harbor"
Sunset,Sin Prisa Gaming,BOOM Esports,13,6,9,3,3,4,"Breach,Cypher,Neon,Fade,Clove","Breach,Raze,Cypher,Omen,Gekko"
Haven,FUSION X,MYVRA,13,7,7,1,6,6,"Cypher,Sova,Astra,Gekko,Iso","Breach,Raze,Cypher,Astra,Fade"
Abyss,FUSION X,MYVRA,6,13,1,6,7,5,"Cypher,Sova,Jett,Astra,Gekko","Breach,Raze,Cypher,Sova,Astra"
Lotus,FUSION X,MYVRA,13,6,3,4,2,10,"Breach,Raze,Cypher,Fade,Clove","Breach,Raze,Cypher,Omen,Deadlock"
Ascent,FUSION X,MYVRA,13,8,4,5,3,9,"Raze,Sova,KAY/O,Iso,Clove","Sova,Killjoy,Jett,KAY/O,Clove"
Lotus,LOUD GC,Team Liquid Brazil,9,13,5,7,6,4,"Cypher,Omen,KAY/O,Neon,Fade","Raze,Brimstone,Omen,Fade,Deadlock"
Bind,FUSION X,MYVRA,2,13,0,3,10,2,"Raze,Viper,Astra,Fade,Gekko","Raze,Brimstone,Fade,Deadlock"
Abyss,LOUD GC,Team Liquid Brazil,10,13,6,6,7,4,"Cypher,Sova,Omen,Jett,KAY/O","Cypher,Sova,Omen,Jett,KAY/O"
Bind,MIBR GC,TBS GC,13,7,5,3,4,8,"Raze,Viper,Brimstone,Fade,Gekko","Raze,Viper,Brimstone,Skye,Gekko"
Sunset,MIBR GC,TBS GC,13,4,10,2,2,3,"Breach,Raze,Cypher,Omen,Gekko","Cypher,Sova,Omen,KAY/O,Neon"
Icebox,Team Galaga,LONETEAM,7,13,4,4,9,3,"Sova,Killjoy,Viper,Sage,Jett","Sova,Killjoy,Viper,Jett,Gekko"
Abyss,The giornalisti,EX0TIK GAMING,5,13,2,10,3,3,"Cypher,Sova,Omen,Jett,KAY/O","Cypher,Sova,Jett,Astra,KAY/O"
Abyss,Team GMask,Dimonis,8,13,5,7,6,3,"Cypher,Sova,Jett,Astra,KAY/O","Cypher,Sova,Jett,Astra,KAY/O"
Abyss,DSYRE Academy,Nexum EC,13,9,6,4,5,7,"Cypher,Sova,Yoru,Astra,Chamber","Omen,Jett,KAY/O,Fade,Deadlock"
Abyss,1000rr club,SLTitans Esports,13,11,8,4,7,5,"Cypher,Sova,Jett,Astra,Gekko","Cypher,Sova,Jett,Astra,KAY/O"
Ascent,Lotus Knights,RTZN,13,10,8,4,6,5,"Cypher,Sova,Omen,Jett,Deadlock","Cypher,Sova,Omen,Jett,KAY/O"
Lotus,Melilla Titans,SZK Esports,4,13,1,4,9,3,"Breach,Cypher,Sova,Omen,Neon","Breach,Raze,Cypher,Omen,Fade"
Abyss,DSYRE Academy,EX0TIK GAMING,13,11,6,6,5,7,"Cypher,Sova,Yoru,Astra,Chamber","Cypher,Sova,Jett,Astra,KAY/O"
Abyss,1000rr club,Alicante Titans,13,8,5,4,4,8,"Cypher,Sova,Jett,Yoru,Astra","Cypher,Sova,Omen,Jett,KAY/O"
Abyss,The giornalisti,Team GMask,2,13,0,3,10,2,"Cypher,Sova,Omen,Yoru,Gekko","Cypher,Sova,Jett,Astra,KAY/O"
Abyss,Nexum EC,SLTitans Esports,15,16,9,7,9,6,"Omen,Jett,KAY/O,Fade,Deadlock","Cypher,Sova,Jett,Astra,KAY/O"
Ascent,Velocity Gaming (EU),Blue Lock,8,13,5,7,6,3,"Sova,Killjoy,Omen,Jett,KAY/O","Sova,Killjoy,Omen,Jett,KAY/O"
Haven,Imperium Gaming,Dimonis,10,13,6,5,8,4,"Breach,Cypher,Sova,Omen,Jett","Breach,Sova,Killjoy,Omen,Neon"
Lotus,Velocity Gaming (EU),Blue Lock,9,13,4,6,7,5,"Breach,Killjoy,Omen,Neon,Fade","Breach,Raze,Killjoy,Viper,Omen"
Abyss,GMBLERS Esports,SLTitans Esports,13,5,8,4,1,5,"Raze,Cypher,Sova,Omen,Astra","Cypher,Sova,Omen,Jett,KAY/O"
Haven,TwentyStars,Leça FC Esports,13,2,10,2,0,3,"Breach,Sova,Killjoy,Omen,Jett","Cypher,Sova,Omen,Yoru,Iso"
Ascent,WASP Elektra,Dark Horse Knights,13,8,8,4,4,5,"Cypher,Sova,Phoenix,Omen,Jett","Cypher,Sova,Omen,Jett,KAY/O"
Lotus,WASP Elektra,Dark Horse Knights,13,2,10,2,0,3,"Breach,Raze,Cypher,Omen,Neon","Raze,Cypher,Viper,Omen,Fade"
Icebox,Alternate Realities,Mogo eSports,5,13,2,4,9,3,"Sova,Killjoy,Viper,Jett,KAY/O","Sova,Killjoy,Viper,Jett,Gekko"
Icebox,Lost Dynasty,PANDEMONIUM,9,13,5,7,6,4,"Sova,Killjoy,Viper,Reyna,KAY/O","Sova,Killjoy,Viper,Jett,Harbor"
Haven,Alternate Realities,Mogo eSports,13,11,7,5,6,6,"Breach,Cypher,Sova,Omen,Neon","Breach,Cypher,Sova,Omen,Jett"
Haven,Lost Dynasty,PANDEMONIUM,7,13,4,8,5,3,"Breach,Sova,Killjoy,Omen,Jett","Cypher,Sova,Omen,Yoru,Iso"
Bind,Alternate Realities,Mogo eSports,10,13,6,6,7,4,"Raze,Viper,Brimstone,Fade,Gekko","Raze,Cypher,Viper,Brimstone,Gekko"
Sunset,FULL SENSE,BOOM Esports,9,13,5,7,6,4,"Breach,Cypher,Sova,Omen,Neon","Breach,Raze,Cypher,Omen,Gekko"
Ascent,Orangutan,Dupg Esports,13,8,6,6,2,7,"Cypher,Sova,Omen,Yoru,Deadlock","Cypher,Sova,Omen,Yoru,Deadlock"
Lotus,FULL SENSE,BOOM Esports,14,12,8,5,7,6,"Breach,Killjoy,Omen,Astra,Neon","Raze,Killjoy,Viper,Omen,Fade"
Icebox,Orangutan,Dupg Esports,13,0,1,0,0,12,"Sova,Killjoy,Viper,Jett,Gekko","Sova,Killjoy,Viper,Jett,KAY/O"
Abyss,FULL SENSE,BOOM Esports,9,13,3,7,6,6,"Breach,Cypher,Omen,Jett,Gekko","Cypher,Sova,Omen,Yoru,Clove"
Ascent,FULL SENSE,BOOM Esports,7,13,3,9,4,4,"Sova,Killjoy,Omen,Jett,KAY/O","Sova,Killjoy,Omen,Jett,KAY/O"
Bind,9z Team GC,Leviatán GC,13,9,7,5,4,6,"Raze,Astra,Fade,Gekko,Deadlock","Raze,Cypher,Viper,Brimstone,Skye"
Abyss,Team Leveling,Vila das Flores,5,13,4,8,5,1,"Sova,Omen,Astra,KAY/O,Neon","Cypher,Sova,Omen,Jett,Harbor"
Ascent,9z Team GC,Leviatán GC,8,13,2,7,6,6,"Sova,Killjoy,Omen,Jett,KAY/O","Cypher,Sova,Omen,Jett,Deadlock"
Bind,Team Leveling,Vila das Flores,14,12,9,4,8,5,"Raze,Viper,Brimstone,Skye,Gekko","Viper,Brimstone,Yoru,Neon,Fade"
Lotus,9z Team GC,Leviatán GC,13,6,5,2,4,8,"Breach,Omen,Neon,Fade,Clove","Raze,Killjoy,Viper,Omen,Fade"
Abyss,9z Team GC,Leviatán GC,13,10,8,3,7,5,"Cypher,Sova,Jett,Astra,Harbor","Cypher,Sova,Omen,Jett,Yoru"
Haven,Team Leveling,Vila das Flores,12,14,3,10,4,9,"Breach,Cypher,Sova,Omen,Neon","Breach,Cypher,Sova,Omen,Neon"
Lotus,PS5Patas,REVOADA,7,13,2,6,7,5,"Killjoy,Viper,Omen,Neon,Fade","Raze,Killjoy,Viper,Omen,Fade"
Haven,PS5Patas,REVOADA,3,13,3,9,4,0,"Breach,Sova,Killjoy,Astra,Neon","Breach,Sova,Killjoy,Omen,Jett"
Ascent,TwentyStars,Imperium Gaming,14,12,8,5,7,6,"Breach,Sova,Killjoy,Omen,Jett","Sova,Killjoy,Omen,Jett,KAY/O"
Ascent,Melilla Titans,GMBLERS Esports,6,13,5,7,6,1,"Sova,Killjoy,Omen,Jett,KAY/O","Sova,Killjoy,Omen,Jett,KAY/O"
Sunset,RTZN,Dimonis,13,9,10,2,7,3,"Breach,Cypher,Sova,Omen,Neon","Cypher,Sova,Omen,KAY/O,Neon"
Sunset,LONETEAM,SLTitans Esports,9,13,7,5,8,2,"Breach,Cypher,Sova,Omen,Neon","Cypher,Sova,Omen,KAY/O,Neon"
Sunset,Leça FC Esports,Lotus Knights,3,13,2,2,11,1,"Cypher,Sova,Omen,KAY/O,Neon","Breach,Cypher,Sova,Omen,Neon"
Haven,Team Galaga,SZK Esports,13,9,6,6,3,7,"Breach,Sova,Killjoy,Omen,Jett","Breach,Cypher,Sova,Omen,Jett"
Lotus,Team Serenity,Niory Esports,8,13,6,6,7,2,"Breach,Omen,Neon,Gekko,Iso","Breach,Sova,Killjoy,Omen,Neon"
Lotus,Asterisk (IN),Perfectionists,13,6,5,2,4,8,"Raze,Killjoy,Viper,Omen,Fade","Breach,Raze,Omen,Chamber,Fade"
Abyss,Asterisk (IN),Perfectionists,13,4,5,0,4,8,"Breach,Raze,Cypher,Astra,Gekko","Sova,Omen,Jett,Astra,Gekko"
Haven,Team Serenity,Niory Esports,8,13,3,6,7,5,"Killjoy,Viper,Omen,Jett,Skye","Breach,Sova,Killjoy,Omen,Neon"
Abyss,RIDDLE ORDER,BOOM Esports,3,13,0,4,9,3,"Cypher,Sova,Omen,Jett,KAY/O","Cypher,Sova,Omen,Yoru,Clove"
Sunset,BLUE BEES.ESP,IGZIST,10,13,2,9,4,8,"Breach,Raze,Cypher,Omen,Gekko","Cypher,Sova,Omen,KAY/O,Neon"
Lotus,NOEZ FOXX,Delight,13,9,7,5,4,6,"Breach,Cypher,Omen,Neon,Fade","Breach,Cypher,Sova,Omen,Neon"
Lotus,RIDDLE ORDER,BOOM Esports,15,17,10,6,11,5,"Breach,Omen,Neon,Fade,Clove","Raze,Killjoy,Viper,Omen,Fade"
Lotus,BLUE BEES.ESP,IGZIST,9,13,4,8,5,5,"Breach,Omen,Neon,Fade,Clove","Raze,Cypher,Omen,Astra,Fade"
Lotus,Sumthin Dumplin,BC SWELL,8,13,2,7,6,6,"Raze,Phoenix,Omen,Chamber,Fade","Breach,Killjoy,Omen,Neon,Fade"
Haven,NOEZ FOXX,Delight,13,4,5,0,4,8,"Breach,Cypher,Sova,Omen,Neon","Breach,Cypher,Sova,Omen,Neon"
Lotus,Crest Gaming ZST,REVE RISE MAX,13,5,8,4,1,5,"Raze,Killjoy,Viper,Omen,Fade","Raze,Killjoy,Viper,Omen,Fade"
Abyss,Sumthin Dumplin,BC SWELL,9,13,6,6,7,3,"Cypher,Sova,Phoenix,Omen,Jett","Cypher,Sova,Jett,Astra,KAY/O"
Ascent,BLUE BEES.ESP,IGZIST,13,10,9,2,8,4,"Sova,Killjoy,Omen,Jett,KAY/O","Sova,Killjoy,Omen,Jett,KAY/O"
Sunset,NOEZ FOXX,Delight,8,13,5,4,9,3,"Breach,Cypher,Sova,Omen,Neon","Cypher,Sova,Omen,KAY/O,Neon"
Bind,Crest Gaming ZST,REVE RISE MAX,13,4,9,3,1,4,"Raze,Cypher,Brimstone,Jett,Skye","Raze,Cypher,Brimstone,Skye,Deadlock"
Haven,Sin Prisa Gaming,FULL SENSE,13,0,12,0,0,1,"Breach,Cypher,Sova,Omen,Neon","Breach,Sova,Killjoy,Omen,Neon"
Bind,Sin Prisa Gaming,FULL SENSE,13,6,9,3,3,4,"Cypher,Brimstone,Neon,Fade,Deadlock","Raze,Viper,Brimstone,Fade,Gekko"
Ascent,Team Liquid Brazil,Vila das Flores,13,4,9,3,1,4,"Sova,Killjoy,Omen,Jett,KAY/O","Cypher,Sova,Phoenix,Omen,Jett"
Lotus,Team Liquid Brazil,Vila das Flores,13,9,4,8,1,9,"Raze,Killjoy,Viper,Omen,Fade","Breach,Cypher,Omen,Neon,Fade"
Bind,LOUD GC,Team Leveling,13,1,11,1,0,2,"Raze,Cypher,Brimstone,Skye,Deadlock","Raze,Viper,Brimstone,Skye,Gekko"
Sunset,ALTERNATE aTTaX Ruby,SK Nebula,8,13,4,8,5,4,"Breach,Cypher,Sova,Omen,Neon","Cypher,Sova,Omen,KAY/O,Neon"
Ascent,LOUD GC,Team Leveling,7,13,6,6,7,1,"Cypher,Sova,Omen,Jett,KAY/O","Sova,Killjoy,Omen,Jett,KAY/O"
Lotus,ALTERNATE aTTaX Ruby,SK Nebula,13,5,4,2,3,9,"Breach,Raze,Cypher,Omen,Fade","Raze,Cypher,Viper,Omen,Fade"
Sunset,FOKUS Sakura,SSP Numina,13,5,9,3,2,4,"Breach,Cypher,Omen,Neon,Fade","Breach,Cypher,Sova,Omen,Neon"
Haven,ALTERNATE aTTaX Ruby,SK Nebula,3,13,0,4,9,3,"Breach,Cypher,Sova,Omen,Jett","Breach,Cypher,Sova,Jett,Astra"
Sunset,LONETEAM,GMBLERS Esports,4,13,3,9,4,1,"Breach,Cypher,Sova,Omen,Neon","Breach,Sova,Killjoy,Astra,Neon"
Abyss,LOUD GC,Team Leveling,13,11,9,3,8,4,"Cypher,Sova,Omen,Jett,KAY/O","Sova,Omen,Astra,KAY/O,Neon"
Ascent,Reveal Multigaming Jushimori,Veni eSports Venom,7,13,6,6,7,1,"Sova,Killjoy,Phoenix,Omen,Jett","Sova,Omen,Jett,KAY/O,Chamber"
Ascent,TOG Kitsune,Permitta Unicorns GC,11,13,5,7,6,6,"Sova,Killjoy,Omen,Jett,KAY/O","Sova,Killjoy,Omen,Jett,KAY/O"
Ascent,FOKUS Sakura,SSP Numina,16,14,11,4,10,5,"Sova,Killjoy,Omen,Jett,Iso","Sova,Killjoy,Omen,Jett,KAY/O"
Sunset,Dimonis,Leça FC Esports,13,9,8,2,7,5,"Cypher,Sova,Omen,KAY/O,Neon","Cypher,Sova,Omen,KAY/O,Neon"
Sunset,Dortmund eSports Dynasty,Entropy Azúcar,6,13,5,7,6,1,"Breach,Raze,Cypher,Omen,Fade","Raze,Cypher,Sage,Jett,Astra"
Ascent,NEON BLADE,teamhoppers,13,10,7,5,5,6,"Sova,Killjoy,Omen,Jett,KAY/O","Sova,Killjoy,Omen,Jett,KAY/O"
Sunset,ROA SYNC,LVENGERS,8,13,4,8,5,4,"Breach,Cypher,Sova,Neon,Clove","Breach,Raze,Cypher,Sova,Omen"
Haven,TOG Kitsune,Permitta Unicorns GC,13,3,4,0,3,9,"Breach,Cypher,Sova,Omen,Jett","Breach,Cypher,Sova,Jett,Astra"
Ascent,Scald eSport GC,RIZON Sugar,6,13,3,9,4,3,"Sova,Killjoy,Omen,Jett,Yoru","Sova,Killjoy,Omen,Jett,Neon"
Bind,Reveal Multigaming Jushimori,Veni eSports Venom,15,13,8,6,7,7,"Breach,Raze,Cypher,Brimstone,Fade","Raze,Brimstone,Chamber,Fade,Gekko"
Haven,Blindspot Kunai,Silly Seals,4,13,1,4,9,3,"Breach,Sova,Killjoy,Omen,Jett","Breach,Cypher,Sova,Omen,Neon"
Haven,Melilla Titans,Team Galaga,13,9,6,6,3,7,"Breach,Cypher,Sova,Omen,Jett","Breach,Sova,Killjoy,Omen,Jett"
Bind,ROA SYNC,LVENGERS,4,13,1,4,9,3,"Breach,Raze,Cypher,Brimstone,Skye","Breach,Raze,Cypher,Brimstone,Gekko"
Lotus,Blindspot Kunai,Silly Seals,1,13,0,2,11,1,"Breach,Killjoy,Omen,Jett,Gekko","Breach,Raze,Killjoy,Omen,Fade"
Abyss,NEON BLADE,teamhoppers,13,9,6,4,5,7,"Cypher,Sova,Omen,Jett,Gekko","Sova,Sage,Jett,Astra,KAY/O"
Sunset,Scald eSport GC,RIZON Sugar,8,13,3,9,4,5,"Breach,Cypher,Sova,Omen,Neon","Breach,Raze,Cypher,Sova,Omen"
Haven,Dortmund eSports Dynasty,Entropy Azúcar,10,13,7,5,8,3,"Breach,Sova,Killjoy,Omen,Jett","Breach,Sova,Killjoy,Omen,Jett"
Lotus,Reveal Multigaming Jushimori,Veni eSports Venom,5,13,3,9,4,2,"Breach,Raze,Killjoy,Omen,Fade","Breach,Omen,Chamber,Neon,Gekko"
Sunset,TOG Kitsune,Permitta Unicorns GC,7,13,1,7,6,6,"Breach,Cypher,Sova,Omen,Yoru","Breach,Raze,Cypher,Sova,Omen"
Sunset,TwentyStars,Lotus Knights,3,13,0,4,9,3,"Breach,Cypher,Sova,Omen,Neon","Breach,Cypher,Sova,Omen,Neon"
Ascent,SSalama,Valoja Päälle?,13,3,3,1,2,10,"Raze,Sova,Reyna,Clove","Brimstone,Omen,Fade,Gekko"
Bind,SZK Esports,SLTitans Esports,13,10,7,5,5,6,"Raze,Viper,Brimstone,Skye,Fade","Raze,Omen,Skye,Gekko,Deadlock"
Sunset,SSalama,Valoja Päälle?,13,0,12,0,0,1,"Breach,Sova,Omen,Jett","Cypher,Brimstone,Sage,KAY/O,Clove"
Lotus,RTZN,Imperium Gaming,6,13,5,7,6,1,"Breach,Raze,Cypher,Omen,Fade","Breach,Killjoy,Omen,Neon,Fade"
Bind,Delight,Team SEIBI,13,9,8,4,5,5,"Raze,Viper,Omen,Skye,Yoru","Raze,Viper,Brimstone,Skye,Gekko"
Haven,Delight,Team SEIBI,10,13,6,5,8,4,"Breach,Cypher,Sova,Omen,Neon","Breach,Cypher,Sova,Omen,Jett"
Sunset,BC SWELL,WICKED,13,8,7,5,3,6,"Cypher,Sova,Omen,KAY/O,Neon","Breach,Cypher,Sova,Omen,Neon"
Abyss,Striders,IGZIST,8,13,3,9,4,5,"Cypher,Sova,Omen,Jett,KAY/O","Cypher,Sova,Omen,Yoru,Astra"
Abyss,REVE RISE MAX,ConTeNt Soul Gaming,13,6,7,5,1,6,"Cypher,Sova,Jett,Astra,KAY/O","Breach,Cypher,Sova,Jett,Astra"
Haven,BC SWELL,WICKED,13,3,2,2,1,11,"Breach,Cypher,Sova,Omen,Neon","Breach,Sova,Killjoy,Omen,Jett"
Sunset,Striders,IGZIST,5,13,2,4,9,3,"Cypher,Sova,Omen,KAY/O,Neon","Cypher,Sova,Omen,KAY/O,Neon"
Haven,REVE RISE MAX,ConTeNt Soul Gaming,13,2,3,0,2,10,"Breach,Cypher,Sova,Omen,Neon","Killjoy,Sage,Omen,Jett,KAY/O"
Lotus,Delight,Team SEIBI,13,9,5,7,2,8,"Breach,Cypher,Sova,Omen,Neon","Raze,Killjoy,Viper,Omen,Fade"
Haven,SCARZ,Sumthin Dumplin,5,13,1,5,8,4,"Cypher,Sova,Omen,Yoru,Iso","Cypher,Sova,Phoenix,Omen,Jett"
Bind,Perfectionists,Team Ruthless,13,8,6,6,2,7,"Raze,Viper,Brimstone,Fade,Gekko","Raze,Viper,Brimstone,Fade,Gekko"
Haven,Asterisk (IN),AIRAVATA ESPORTS,14,12,8,5,7,6,"Breach,Sova,Killjoy,Omen,Jett","Breach,Cypher,Phoenix,Omen,Yoru"
Haven,NOEZ FOXX,ASNA,13,5,3,3,2,10,"Breach,Cypher,Sova,Omen,Neon","Breach,Sova,Killjoy,Jett,Astra"
Ascent,Crest Gaming ZST,SCARZ Youth,13,8,8,4,4,5,"Sova,Killjoy,Omen,Jett,KAY/O","Raze,Viper,Reyna,Skye,Clove"
Ascent,SCARZ,Sumthin Dumplin,14,12,7,6,6,7,"Cypher,Sova,Omen,Jett,Deadlock","Sova,Killjoy,Phoenix,Omen,Jett"
Haven,Perfectionists,Team Ruthless,13,9,11,1,8,2,"Breach,Cypher,Sova,Omen,Jett","Sova,Killjoy,Reyna,Omen,Jett"
Lotus,Asterisk (IN),AIRAVATA ESPORTS,13,5,4,2,3,9,"Raze,Killjoy,Viper,Omen,Fade","Raze,Omen,Yoru,Chamber,Fade"
Sunset,BLUE BEES.ESP,OECU esports,13,1,2,0,1,11,"Cypher,Sova,Jett,Iso,Clove","Breach,Raze,Cypher,Sova,Omen"
Bind,Crest Gaming ZST,SCARZ Youth,13,6,8,4,2,5,"Raze,Cypher,Brimstone,Jett,Skye","Raze,Viper,Reyna,Skye,Clove"
Ascent,NOEZ FOXX,ASNA,13,8,5,4,4,8,"Sova,Killjoy,Omen,Jett,KAY/O","Sova,Killjoy,Omen,Jett,KAY/O"
Haven,BLUE BEES.ESP,OECU esports,13,1,2,0,1,11,"Breach,Sova,Killjoy,Omen,Jett","Breach,Sova,Killjoy,Omen,Jett"
Abyss,SCARZ,Sumthin Dumplin,4,13,3,9,4,1,"Sova,Viper,Jett,Yoru,Astra","Cypher,Sova,Phoenix,Omen,Jett"
Sunset,Bon Bon Bum Contra GC,MYVRA,8,13,6,6,7,2,"Breach,Sova,Sage,Omen,Gekko","Cypher,Sova,Phoenix,Astra"
Ascent,Bon Bon Bum Contra GC,MYVRA,13,3,2,2,1,11,"Sova,Killjoy,Phoenix,Omen,Jett","Sova,Killjoy,Jett,KAY/O,Clove"
Lotus,Bon Bon Bum Contra GC,MYVRA,9,13,3,9,4,6,"Breach,Raze,Cypher,Omen,Neon","Breach,Raze,Cypher,Omen,Deadlock"
Haven,Bon Bon Bum Contra GC,MYVRA,8,13,5,4,9,3,"Breach,Cypher,Sova,Omen,Chamber","Breach,Raze,Cypher,Astra,Fade"
Sunset,TBS GC,REVOADA,13,7,3,5,2,10,"Cypher,Sova,Omen,KAY/O,Neon","Breach,Cypher,Sova,Omen,Neon"
Haven,TBS GC,REVOADA,13,2,3,0,2,10,"Cypher,Sova,Omen,Yoru,Iso","Breach,Sova,Killjoy,Omen,Jett"
Bind,MIBR GC,PS5Patas,13,2,10,2,0,3,"Raze,Viper,Brimstone,Fade,Gekko","Raze,Brimstone,Skye,Yoru,Chamber"
Ascent,MIBR GC,PS5Patas,13,4,3,2,2,10,"Sova,Killjoy,Omen,Jett,KAY/O","Sova,Killjoy,Omen,Jett,KAY/O"
Ascent,Leça FC Esports,Imperium Gaming,3,13,0,4,9,3,"Breach,Sova,Astra,Neon","Sova,Killjoy,Omen,Jett,KAY/O"
Bind,SZK Esports,GMBLERS Esports,13,7,7,5,2,6,"Raze,Viper,Brimstone,Skye,Fade","Raze,Viper,Brimstone,Fade,Gekko"
Sunset,Dimonis,Lotus Knights,2,13,0,3,10,2,"Cypher,Sova,Omen,KAY/O,Neon","Breach,Cypher,Sova,Omen,Neon"
Sunset,SLTitans Esports,Team Galaga,13,8,5,4,4,8,"Cypher,Sova,Omen,KAY/O,Neon","Raze,Cypher,Omen,KAY/O,Gekko"
Bind,Hampter,ISOSIMO,7,13,3,5,8,4,"Cypher,Phoenix,Reyna,Astra,Fade","Breach,Raze,Skye,Chamber,Clove"
Ascent,Hampter,ISOSIMO,5,13,3,9,4,2,"Sova,Killjoy,Phoenix,Reyna,Omen","Sova,Killjoy,Omen,Jett,KAY/O"
Sunset,Melilla Titans,LONETEAM,7,13,2,6,7,5,"Cypher,Sova,Omen,KAY/O,Neon","Breach,Cypher,Sova,Omen,Neon"
Lotus,Black Flag,Team Serenity,8,13,5,4,9,3,"Breach,Cypher,Omen,Neon,Fade","Breach,Neon,Gekko,Iso,Clove"
Lotus,Niory Esports,Team Accelerate,13,4,10,2,2,3,"Breach,Sova,Killjoy,Omen,Neon","Breach,Cypher,Omen,Neon,Fade"
Haven,Black Flag,Team Serenity,7,13,3,9,4,4,"Breach,Sova,Killjoy,Omen,Jett","Killjoy,Viper,Omen,Jett,Skye"
Ascent,Niory Esports,Team Accelerate,13,2,3,0,2,10,"Sova,Killjoy,Omen,Jett,KAY/O","Sova,Killjoy,Omen,Yoru,Harbor"
Haven,Alternate Realities,Perfectionists,13,6,7,5,1,6,"Breach,Cypher,Sova,Omen,Neon","Breach,Cypher,Sova,Omen,Jett"
Bind,Mogo eSports,Asterisk (IN),13,9,6,4,5,7,"Raze,Cypher,Viper,Brimstone,Gekko","Raze,Viper,Brimstone,Fade,Gekko"
Lotus,Alternate Realities,Perfectionists,6,13,1,6,7,5,"Raze,Killjoy,Viper,Omen,Fade","Breach,Raze,Omen,Chamber,Fade"
Sunset,Alternate Realities,Perfectionists,13,5,9,3,2,4,"Raze,Cypher,Omen,KAY/O,Gekko","Breach,Raze,Cypher,Omen,Gekko"
Haven,Mogo eSports,Asterisk (IN),13,10,5,6,4,8,"Breach,Cypher,Sova,Omen,Jett","Breach,Sova,Killjoy,Omen,Jett"
Lotus,SCARZ Youth,Chrysalis,14,12,6,7,5,8,"Raze,Viper,Reyna,Skye,Clove","Breach,Cypher,Sova,Omen,Neon"
Ascent,SCARZ Youth,Chrysalis,13,9,6,6,3,7,"Raze,Viper,Reyna,Skye,Clove","Cypher,Sova,Omen,Yoru,Deadlock"
Bind,FiRePOWER GC,Leviatán GC,8,13,4,8,5,4,"Raze,Viper,Brimstone,Skye,Gekko","Raze,Cypher,Viper,Brimstone,Skye"
Abyss,FiRePOWER GC,Leviatán GC,4,13,1,4,9,3,"Sova,Yoru,Astra,Chamber,Harbor","Cypher,Sova,Omen,Jett,Yoru"
Ascent,FiRePOWER GC,Leviatán GC,6,13,6,6,7,0,"Sova,Killjoy,Omen,Jett,KAY/O","Cypher,Sova,Omen,Jett,Deadlock"
Haven,TOG Kitsune,RIZON Sugar,9,13,7,5,8,2,"Breach,Cypher,Sova,Omen,Jett","Sova,Killjoy,Omen,Neon,Iso"
Sunset,ALTERNATE aTTaX Ruby,Scald eSport GC,13,9,9,1,8,4,"Breach,Cypher,Sova,Omen,Neon","Breach,Cypher,Omen,Neon,Gekko"
Sunset,TOG Kitsune,RIZON Sugar,8,13,3,6,7,5,"Breach,Cypher,Sova,Omen,Yoru","Breach,Raze,Cypher,Sova,Omen"
Ascent,FOKUS Sakura,SK Nebula,13,9,6,6,3,7,"Sova,Killjoy,Omen,Jett,Iso","Sova,Killjoy,Omen,Jett,KAY/O"
Lotus,ALTERNATE aTTaX Ruby,Scald eSport GC,13,4,8,4,0,5,"Breach,Raze,Cypher,Omen,Fade","Breach,Raze,Killjoy,Omen,Jett"
Lotus,Reveal Multigaming Jushimori,Silly Seals,6,13,2,10,3,4,"Breach,Raze,Killjoy,Omen,Fade","Breach,Raze,Killjoy,Omen,Fade"
Haven,SSP Numina,Permitta Unicorns GC,10,13,3,8,5,7,"Breach,Sova,Killjoy,Omen,Jett","Breach,Cypher,Sova,Jett,Astra"
Bind,NEON BLADE,Entropy Azúcar,13,3,10,2,1,3,"Raze,Viper,Brimstone,Reyna,Skye","Raze,Viper,Brimstone,Skye,Fade"
Haven,Reveal Multigaming Jushimori,Silly Seals,9,13,5,5,8,4,"Breach,Sova,Killjoy,Omen,Jett","Breach,Cypher,Sova,Omen,Neon"
Sunset,SSP Numina,Permitta Unicorns GC,3,13,0,4,9,3,"Breach,Cypher,Sova,Omen,Neon","Breach,Raze,Cypher,Sova,Omen"
Sunset,FOKUS Sakura,SK Nebula,2,13,2,10,3,0,"Breach,Cypher,Omen,Neon,Fade","Cypher,Sova,Omen,KAY/O,Neon"
Sunset,ROA SYNC,teamhoppers,11,13,5,7,6,6,"Breach,Cypher,Sova,Neon,Clove","Breach,Raze,Cypher,Sova,Astra"
Haven,NEON BLADE,Entropy Azúcar,13,8,6,6,2,7,"Breach,Sova,Killjoy,Omen,Jett","Breach,Sova,Killjoy,Omen,Jett"
Abyss,ROA SYNC,teamhoppers,4,13,1,4,9,3,"Breach,Cypher,Sova,Jett,Astra","Sova,Sage,Jett,Astra,KAY/O"
Lotus,FOKUS Sakura,SK Nebula,13,6,10,2,4,3,"Raze,Cypher,Omen,Neon,Fade","Raze,Cypher,Viper,Omen,Fade"
Ascent,SSP Numina,Permitta Unicorns GC,13,8,6,6,2,7,"Sova,Killjoy,Omen,Jett,KAY/O","Sova,Killjoy,Omen,Jett,KAY/O"
Bind,Reveal Multigaming Jushimori,Silly Seals,13,9,8,2,7,5,"Breach,Raze,Cypher,Brimstone,Fade","Raze,Viper,Astra,Fade,Gekko"
Abyss,wombat123,SKIPIDI,13,15,6,8,7,7,"Cypher,Sova,Jett,Astra,Gekko","Cypher,Sova,Omen,Jett,Gekko"
Haven,KAMK.GG,VIRMA,5,13,2,4,9,3,"Breach,Cypher,Sova,Omen,Jett","Breach,Cypher,Omen,Jett,Yoru"
Bind,KAMK.GG,VIRMA,3,13,1,3,10,2,"Raze,Viper,Brimstone,Reyna,Skye","Breach,Raze,Brimstone,Chamber,Deadlock"
Icebox,wombat123,SKIPIDI,13,9,8,2,7,5,"Sova,Killjoy,Viper,Jett,Iso","Sova,Killjoy,Viper,Jett,Chamber"
Ascent,Ahlman ,wade,4,13,1,11,2,3,"Cypher,Reyna,Omen,KAY/O,Chamber","Sova,Killjoy,Jett,KAY/O,Clove"
Bind,wombat123,SKIPIDI,6,13,5,7,6,1,"Raze,Viper,Gekko,Deadlock,Clove","Raze,Viper,Brimstone,Chamber,Fade"
Lotus,Ahlman ,wade,3,13,1,3,10,2,"Raze,Cypher,Omen,Gekko,Clove","Breach,Raze,Killjoy,Neon,Clove"
Haven,Black Flag,Dupg Esports,4,13,1,4,9,3,"Breach,Sova,Killjoy,Omen,Jett","Breach,Cypher,Sova,Omen,Neon"
Sunset,Orangutan,Niory Esports,13,10,6,5,5,7,"Breach,Cypher,Sova,Omen,Neon","Breach,Cypher,Sova,Omen,Neon"
Ascent,Orangutan,Niory Esports,13,1,11,1,0,2,"Cypher,Sova,Omen,Yoru,Deadlock","Sova,Killjoy,Omen,Jett,KAY/O"
Bind,BOOM Esports,Disguised,14,12,3,10,2,11,"Raze,Cypher,Viper,Brimstone,Skye","Raze,Viper,Omen,Yoru,Gekko"
Icebox,BOOM Esports,Disguised,6,13,4,3,10,2,"Killjoy,Viper,Jett,KAY/O,Gekko","Sova,Killjoy,Viper,Reyna,Jett"
Lotus,BOOM Esports,Disguised,14,12,4,9,3,10,"Raze,Killjoy,Viper,Omen,Fade","Raze,Cypher,Omen,Neon,Fade"
Haven,Justice For Tomorrow,RIDDLE ORDER,9,13,4,8,5,5,"Breach,Cypher,Sova,Omen,Neon","Killjoy,Viper,Omen,Jett,Skye"
Sunset,Justice For Tomorrow,RIDDLE ORDER,1,13,0,2,11,1,"Breach,Raze,Cypher,Omen,Neon","Cypher,Sova,Omen,KAY/O,Neon"
Lotus,FUSION X,Akave Esports Black,3,13,2,2,11,1,"Breach,Killjoy,Omen,Jett,Gekko","Raze,Killjoy,Viper,Omen,Fade"
Bind,FUSION X,Akave Esports Black,8,13,3,6,7,5,"Cypher,Brimstone,Jett,Skye,Gekko","Raze,Viper,Skye,Astra,Iso"
Ascent,FUSION X,Akave Esports Black,13,9,7,5,4,6,"Raze,Sova,KAY/O,Iso,Clove","Sova,Killjoy,Omen,Jett,KAY/O"
Haven,FUSION X,Akave Esports Black,8,13,4,5,8,4,"Cypher,Sova,Jett,Astra,Gekko","Breach,Cypher,Sova,Omen,Jett"
Sunset,Cobweb eSports,MouzKings eSports,9,13,4,6,7,5,"Breach,Cypher,Sova,Omen,Neon","Breach,Cypher,Sova,Omen,Neon"
Lotus,Cobweb eSports,MouzKings eSports,12,14,6,7,7,6,"Raze,Killjoy,Viper,Omen,Fade","Breach,Killjoy,Omen,Neon,Gekko"
Icebox,Blue Moon eSports,ZINGERS,9,13,6,4,9,3,"Raze,Sova,Killjoy,Viper,Iso","Sova,Killjoy,Viper,Omen,Gekko"
Abyss,Blue Moon eSports,ZINGERS,5,13,0,6,7,5,"Breach,Cypher,Sova,Jett,Astra","Breach,Astra,Chamber,Neon,Harbor"
Haven,LVENGERS,Veni eSports Venom,13,10,8,3,7,5,"Breach,Sova,Killjoy,Omen,Jett","Breach,Sova,Omen,Chamber,Neon"
Ascent,LVENGERS,Veni eSports Venom,13,4,3,2,2,10,"Cypher,Sova,Omen,Yoru,Deadlock","Sova,Omen,Jett,KAY/O,Chamber"
Bind,Union Atta I,KineTiX eSports X1,13,3,4,0,3,9,"Breach,Omen,Neon,Fade,Deadlock","Raze,Cypher,Viper,Brimstone,Skye"
Sunset,Union Atta I,KineTiX eSports X1,13,3,10,2,1,3,"Breach,Cypher,Sova,Omen,Neon","Breach,Raze,Cypher,Sova,Omen"
Bind,AIRAVATA ESPORTS,Perfectionists,13,15,6,8,7,7,"Raze,Cypher,Omen,Skye,Yoru","Raze,Viper,Brimstone,Fade,Gekko"
Lotus,AIRAVATA ESPORTS,Perfectionists,13,6,4,3,3,9,"Raze,Omen,Yoru,Chamber,Fade","Breach,Raze,Killjoy,Omen,Fade"
Ascent,Disguised,Revenant Esports,13,5,4,2,3,9,"Cypher,Sova,Omen,Jett,Iso","Cypher,Sova,Omen,Yoru,Deadlock"
Ascent,Asterisk (IN),Team Ruthless,13,4,8,4,0,5,"Sova,Killjoy,Omen,Jett,KAY/O","Sova,Killjoy,Omen,Jett,KAY/O"
Ascent,AIRAVATA ESPORTS,Perfectionists,10,13,3,8,5,7,"Breach,Sova,Killjoy,Omen,Jett","Sova,Killjoy,Omen,Jett,KAY/O"
Bind,Disguised,Revenant Esports,13,5,9,3,2,4,"Raze,Viper,Omen,Yoru,Gekko","Raze,Viper,Brimstone,Fade,Gekko"
Lotus,Asterisk (IN),Team Ruthless,13,2,3,0,2,10,"Raze,Killjoy,Viper,Omen,Fade","Killjoy,Omen,Neon,Fade,Gekko"
Sunset,Niory Esports,Team Serenity,13,10,6,6,4,7,"Breach,Cypher,Sova,Omen,Neon","Breach,Cypher,Sova,Omen,Neon"
Lotus,Disguised,Revenant Esports,13,15,6,8,7,7,"Raze,Cypher,Omen,Neon,Fade","Raze,Viper,Omen,Chamber,Fade"
Bind,Niory Esports,Team Serenity,13,5,10,2,3,3,"Raze,Cypher,Brimstone,Skye,Clove","Breach,Brimstone,Neon,Gekko,Deadlock"
Ascent,Dupg Esports,Team Accelerate,13,6,10,2,4,3,"Cypher,Sova,Omen,Yoru,Deadlock","Sova,Killjoy,Omen,Yoru,Harbor"
Ascent,RIDDLE ORDER,NAOS Esports,13,11,5,7,4,8,"Sova,Killjoy,Omen,Jett,KAY/O","Sova,Killjoy,Omen,Jett,KAY/O"
Haven,Niory Esports,Team Serenity,7,13,5,7,6,2,"Breach,Sova,Killjoy,Omen,Jett","Killjoy,Viper,Omen,Jett,Skye"
Bind,Dupg Esports,Team Accelerate,13,4,10,2,2,3,"Breach,Raze,Brimstone,Skye,Chamber","Raze,Viper,Brimstone,Skye,Yoru"
Lotus,RIDDLE ORDER,NAOS Esports,13,3,11,1,2,2,"Breach,Omen,Neon,Fade,Clove","Raze,Killjoy,Viper,Omen,Fade"
Haven,RIDDLE ORDER,NAOS Esports,15,17,7,9,8,8,"Killjoy,Viper,Omen,Jett,Skye","Cypher,Sova,Omen,Yoru,Iso"
Lotus,FULL SENSE,Justice For Tomorrow,13,9,6,4,5,7,"Breach,Killjoy,Omen,Astra,Neon","Breach,Omen,Neon,Fade,Clove"
Ascent,FULL SENSE,Justice For Tomorrow,13,8,5,7,1,8,"Sova,Killjoy,Omen,Jett,KAY/O","Cypher,Sova,Omen,Jett,Iso"
Haven,KRÜ BLAZE,9z Team GC,13,3,3,1,2,10,"Breach,Cypher,Sova,Omen,Neon","Breach,Cypher,Sova,Omen,Neon"
Ascent,KRÜ BLAZE,9z Team GC,9,13,4,6,7,5,"Sova,Killjoy,Omen,Jett,KAY/O","Sova,Killjoy,Omen,Jett,KAY/O"
Bind,KRÜ BLAZE,9z Team GC,13,4,4,1,3,9,"Viper,Brimstone,Neon,Fade,Gekko","Raze,Brimstone,Skye,Gekko,Deadlock"
Lotus,KRÜ BLAZE,9z Team GC,13,6,7,5,1,6,"Raze,Killjoy,Viper,Omen,Fade","Breach,Omen,Neon,Fade,Clove"
Icebox,KRÜ BLAZE,9z Team GC,11,13,5,7,6,6,"Sova,Killjoy,Harbor,Iso,Clove","Sova,Killjoy,Viper,Jett,Harbor"
Haven,The Easy Crew,Defient Esports,13,15,8,6,9,5,"Breach,Cypher,Sova,Astra,Neon","Breach,Cypher,Sova,Omen,Neon"
Sunset,2strong,Skout Esports,13,4,11,1,3,2,"Breach,Cypher,Sova,Omen,Neon","Raze,Cypher,Omen,Neon,Gekko"
Lotus,The Easy Crew,Defient Esports,4,13,2,10,3,2,"Raze,Killjoy,Viper,Omen,Fade","Breach,Raze,Cypher,Omen,Fade"
Bind,2strong,Skout Esports,11,13,4,8,5,7,"Breach,Raze,Cypher,Omen,Gekko","Breach,Raze,Cypher,Brimstone,Neon"
Haven,2strong,Skout Esports,13,3,3,1,2,10,"Breach,Sova,Killjoy,Omen,Neon","Cypher,Sova,Jett,Yoru,Astra"
Sunset,NoMercy,Dark Horse Templars,13,8,8,4,4,5,"Breach,Cypher,Omen,Neon,Gekko","Raze,Cypher,Omen,KAY/O,Gekko"
Ascent,NoMercy,Dark Horse Templars,13,8,6,3,5,7,"Sova,Killjoy,Omen,Jett,KAY/O","Sova,Killjoy,Omen,Jett,KAY/O"
Ascent,PANDEMONIUM,WASP Elektra,13,10,6,6,4,7,"Sova,Killjoy,Omen,Jett","Breach,Sova,Killjoy,Omen,Neon"
Haven,PANDEMONIUM,WASP Elektra,13,7,6,2,5,7,"Cypher,Sova,Omen,Yoru,Iso","Breach,Cypher,Sova,Omen,Neon"
Haven,NewD,Pegasus Esports,13,7,7,5,2,6,"Breach,Cypher,Omen,Jett,Deadlock","Breach,Sova,Killjoy,Omen,Jett"
Bind,NewD,Pegasus Esports,13,4,9,3,1,4,"Breach,Cypher,Viper,Brimstone,Yoru","Viper,Omen,Yoru,KAY/O,Gekko"
Icebox,Sin Prisa Gaming,BOOM Esports,13,9,9,3,6,4,"Sova,Killjoy,Viper,Jett,Harbor","Killjoy,Viper,Jett,KAY/O,Gekko"
Lotus,Sin Prisa Gaming,BOOM Esports,13,3,11,1,2,2,"Cypher,Viper,Omen,Neon,Fade","Raze,Killjoy,Viper,Omen,Fade"
Haven,Rapid Lofi,Revenant Esports,3,13,1,3,10,2,"Breach,Cypher,Phoenix,Omen,Neon","Cypher,Sova,Omen,Yoru,Iso"
Bind,Rapid Lofi,Revenant Esports,3,13,0,4,9,3,"Raze,Viper,Brimstone,Fade,Gekko","Raze,Viper,Brimstone,Fade,Gekko"
Lotus,NAOS Esports,Oblivion Force,13,7,4,4,3,9,"Raze,Killjoy,Viper,Omen,Fade","Raze,Cypher,Viper,Omen,Fade"
Icebox,NAOS Esports,Oblivion Force,13,10,5,6,4,8,"Sova,Killjoy,Viper,Jett,Harbor","Killjoy,Viper,Jett,KAY/O,Deadlock"
Bind,2Game Esports,M80,13,6,10,2,4,3,"Raze,Viper,Brimstone,Skye,Gekko","Raze,Viper,Brimstone,Skye,Gekko"
Haven,2Game Esports,M80,13,7,9,3,4,4,"Cypher,Sova,Omen,Yoru,Iso","Breach,Sova,Killjoy,Omen,Jett"
Abyss,2Game Esports,M80,8,13,7,5,8,1,"Cypher,Sova,Omen,Jett,KAY/O","Cypher,Sova,Omen,Jett,KAY/O"
Ascent,Veni eSports Venom,Silly Seals,13,7,9,3,4,4,"Sova,Killjoy,Omen,Jett,KAY/O","Sova,Killjoy,Omen,Jett,KAY/O"
Icebox,2Game Esports,M80,7,13,4,8,5,3,"Sova,Killjoy,Viper,Jett,KAY/O","Killjoy,Viper,Omen,KAY/O,Gekko"
Lotus,Veni eSports Venom,Silly Seals,14,12,7,6,6,7,"Breach,Omen,Chamber,Neon,Gekko","Breach,Raze,Killjoy,Omen,Fade"
Lotus,The giornalisti,DSYRE Academy,10,13,7,4,9,3,"Breach,Raze,Killjoy,Omen,Fade","Raze,Killjoy,Viper,Omen,Fade"
Lotus,Alicante Titans,GMBLERS Esports,9,13,5,7,6,4,"Breach,Omen,Neon,Fade,Clove","Breach,Raze,Cypher,Phoenix,Astra"
Lotus,Capacitanes,Team GMask,9,13,7,5,8,2,"Raze,Cypher,Omen,Fade,Gekko","Breach,Cypher,Omen,Neon,Gekko"
Lotus,RevenantVAL,bazinga esports,13,5,8,4,1,5,"Breach,Raze,Killjoy,Omen,Fade","Raze,Killjoy,Viper,Omen,Fade"
Lotus,Nexum EC,Poverineeh,13,4,4,1,3,9,"Breach,Killjoy,Omen,Neon,Fade","Killjoy,Omen,Jett,KAY/O,Gekko"
Lotus,Dimonis,EX0TIK GAMING,13,6,7,5,1,6,"Breach,Killjoy,Omen,Neon,Fade","Breach,Cypher,Omen,Neon,Fade"
Lotus,SLTitans Esports,IAPEsports,4,13,0,5,8,4,"Breach,Raze,Cypher,Omen,Iso","Breach,Omen,Neon,Fade,Clove"
Haven,Moon,Tap Tap Boom eSports,9,13,6,4,9,3,"Breach,Killjoy,Reyna,Omen,Jett","Breach,Cypher,Sova,Omen,Jett"
Sunset,2Game Esports,M80,13,5,5,1,4,8,"Breach,Cypher,Sova,Omen,Neon","Breach,Cypher,Omen,Yoru,Gekko"
Bind,Veni eSports Venom,Silly Seals,4,13,2,3,10,2,"Raze,Viper,Brimstone,Fade,Gekko","Raze,Viper,Astra,Fade,Gekko"
Lotus,Moon,Tap Tap Boom eSports,13,10,5,7,3,8,"Raze,Cypher,Viper,Omen,Fade","Breach,Omen,Neon,Fade,Clove"
Lotus,Nexum EC,The giornalisti,6,13,3,4,9,3,"Breach,Sova,Killjoy,Omen,Neon","Breach,Killjoy,Omen,Neon,Fade"
Lotus,Poverineeh,Melilla Titans Academy,15,13,4,10,3,11,"Raze,Killjoy,Viper,Omen,Fade","Breach,Raze,Cypher,Omen,Fade"
Lotus,SLTitans Esports,Dimonis,13,11,7,5,6,6,"Breach,Raze,Killjoy,Omen,Iso","Breach,Killjoy,Omen,Neon,Fade"
Lotus,EX0TIK GAMING,Team GMask,13,5,6,0,5,7,"Breach,Cypher,Omen,Neon,Fade","Breach,Cypher,Omen,Neon,Gekko"
Lotus,RevenantVAL,Alicante Titans,13,10,9,2,8,4,"Breach,Raze,Killjoy,Omen,Fade","Breach,Omen,Neon,Fade,Clove"
Lotus,bazinga esports,IAPEsports,14,16,7,8,8,7,"Raze,Killjoy,Viper,Omen,Fade","Breach,Omen,Neon,Fade,Clove"
Lotus,AMBYS Team,Capacitanes,7,13,0,8,5,7,"Breach,Raze,Omen,Fade,Clove","Raze,Cypher,Omen,Fade,Gekko"
Abyss,Velocity Gaming (EU),RYL | Royal Legion,7,13,4,8,5,3,"Cypher,Sova,Omen,Yoru,Astra","Cypher,Sova,Omen,Jett,Harbor"
Sunset,Velocity Gaming (EU),RYL | Royal Legion,11,13,8,4,9,3,"Breach,Cypher,Sova,Omen,Neon","Cypher,Sova,Omen,KAY/O,Neon"
Haven,Blue Lock,Lost Dynasty,18,16,9,8,8,9,"Breach,Sova,Killjoy,Omen,Jett","Breach,Sova,Killjoy,Omen,Jett"
Lotus,Blue Lock,Lost Dynasty,13,6,6,1,5,7,"Breach,Raze,Killjoy,Viper,Omen","Raze,Cypher,Omen,Fade,Deadlock"
Haven,Dark Horse Knights,TEAM BLINDSPOT,10,13,6,6,7,4,"Breach,Sova,Killjoy,Omen,Neon","Breach,Cypher,Sova,Omen,Neon"
Lotus,Dark Horse Knights,TEAM BLINDSPOT,5,13,1,5,8,4,"Raze,Killjoy,Viper,Omen,Fade","Omen,Chamber,Gekko,Clove"
Icebox,Disguised,FULL SENSE,12,14,8,5,9,4,"Sova,Killjoy,Viper,Reyna,Jett","Sova,Killjoy,Viper,Jett,Gekko"
Haven,Disguised,FULL SENSE,7,13,4,8,5,3,"Cypher,Sova,Omen,Jett,Neon","Breach,Sova,Killjoy,Omen,Neon"
Ascent,RIDDLE ORDER,Sin Prisa Gaming,9,13,4,6,7,5,"Sova,Killjoy,Omen,Jett,KAY/O","Brimstone,Yoru,Neon,Fade,Harbor"
Sunset,RIDDLE ORDER,Sin Prisa Gaming,12,14,7,6,8,5,"Cypher,Sova,Omen,KAY/O,Neon","Breach,Cypher,Neon,Fade,Clove"
Lotus,Justice For Tomorrow,Rapid Lofi,13,8,9,3,5,4,"Breach,Omen,Neon,Fade,Clove","Raze,Killjoy,Omen,Fade,Clove"
Abyss,Good Career,UFO MINIONS,13,10,4,8,2,9,"Sova,Omen,Jett,Yoru,Astra","Cypher,Sova,Jett,Yoru,Astra"
Haven,Painguins,Lionheart eSports,13,6,6,1,5,7,"Breach,Cypher,Sova,Omen,Neon","Breach,Cypher,Sova,Omen,Neon"
Sunset,English or Spanish,silly kittens,14,12,8,5,7,6,"Breach,Raze,Cypher,Sova,Omen","Breach,Cypher,Sova,Omen,Neon"
Lotus,Painguins,Lionheart eSports,13,2,10,2,0,3,"Breach,Killjoy,Omen,Neon,Gekko","Breach,Cypher,Omen,Neon,Gekko"
Icebox,Justice For Tomorrow,Rapid Lofi,13,3,9,3,0,4,"Sova,Killjoy,Viper,Jett,Iso","Sova,Killjoy,Viper,Sage,Jett"
Ascent,APX,Fractal Gaming,13,11,4,8,3,9,"Cypher,Sova,Omen,Jett,KAY/O","Sova,Killjoy,Omen,Jett,KAY/O"
Sunset,Good Career,UFO MINIONS,13,10,4,8,2,9,"Breach,Cypher,Sova,Omen,Neon","Raze,Cypher,Jett,Gekko,Clove"
Lotus,kellogs cereal,Void,13,7,7,5,2,6,"Breach,Raze,Cypher,Gekko,Clove","Raze,Cypher,Omen,Fade,Deadlock"
Lotus,Brimstone with a Fusion Bomb,Cyberia Esports,14,12,9,4,8,5,"Raze,Omen,Fade,Deadlock,Clove","Raze,Killjoy,Viper,Omen,Fade"
Sunset,Painguins,Lionheart eSports,3,13,0,4,9,3,"Breach,Cypher,Sova,Omen,Neon","Raze,Cypher,Sova,Omen,KAY/O"
Lotus,English or Spanish,silly kittens,13,11,5,7,4,8,"Breach,Raze,Omen,Chamber,Gekko","Raze,Cypher,Viper,Omen,Fade"
Haven,Cumberland Rising,Shifty505,11,13,6,6,7,5,"Breach,Cypher,Sova,Omen,Neon","Breach,Cypher,Sova,Omen,Jett"
Haven,Outlast Gaming,Dexterity Gaming,5,13,4,8,5,1,"Killjoy,Viper,Omen,Jett,Skye","Cypher,Sova,Sage,Omen,Jett"
Lotus,APX,Fractal Gaming,13,5,2,4,1,11,"Breach,Raze,Cypher,Omen,Gekko","Breach,Killjoy,Omen,Neon,Gekko"
Sunset,kellogs cereal,Void,13,5,9,3,2,4,"Breach,Raze,Cypher,Gekko,Clove","Cypher,Sova,Omen,KAY/O,Neon"
Ascent,Good Career,UFO MINIONS,9,13,1,9,4,8,"Sova,Killjoy,Omen,Jett,KAY/O","Cypher,Sova,Omen,Jett,Yoru"
Bind,Erinite Esports,Koala Pound,13,4,9,3,1,4,"Raze,Viper,Brimstone,Fade,Gekko","Raze,Viper,Brimstone,Skye,Fade"
Lotus,Siena Heights University,The Goon Goobers,13,4,9,3,1,4,"Breach,Omen,Neon,Fade,Clove","Breach,Raze,Killjoy,Omen,Gekko"
Sunset,Brimstone with a Fusion Bomb,Cyberia Esports,10,13,5,7,6,5,"Breach,Omen,KAY/O,Neon,Iso","Cypher,Sova,Omen,Neon,Gekko"
Haven,Elation Esports,Kiyoe's Fan Club,13,8,9,3,5,4,"Cypher,Sova,Omen,Yoru,Iso","Cypher,Sova,Reyna,Omen,Neon"
Haven,English or Spanish,silly kittens,7,13,6,6,7,1,"Breach,Cypher,Sova,Omen,Jett","Breach,Cypher,Sova,Omen,Jett"
Lotus,zZz,Antares Esports,13,10,6,5,5,7,"Breach,Cypher,Omen,Neon,Fade","Breach,Omen,Neon,Fade,Clove"
Lotus,Cumberland Rising,Shifty505,8,13,3,9,4,5,"Killjoy,Omen,Yoru,Neon,Fade","Raze,Killjoy,Viper,Omen,Fade"
Lotus,Berzerkers Moon,Seulgi Fanclub,13,9,8,2,7,5,"Omen,KAY/O,Neon,Fade,Clove","Viper,Brimstone,Omen,Harbor,Clove"
Ascent,Outlast Gaming,Dexterity Gaming,8,13,2,7,6,6,"Cypher,Sova,Omen,Yoru,Deadlock","Sova,Killjoy,Omen,Jett"
Abyss,Erinite Esports,Koala Pound,13,7,6,2,5,7,"Cypher,Sova,Omen,Jett,Gekko","Cypher,Sova,Reyna,Astra,Iso"
Haven,LazerrFreeks Mythic,Freak Nation,13,3,2,2,1,11,"Breach,Killjoy,Omen,Neon,Fade","Cypher,Sova,Omen,Skye,Neon"
Icebox,Big Hot Men,Lionheart eSports,6,13,1,6,7,5,"Sova,Killjoy,Viper,Jett,Yoru","Killjoy,Viper,KAY/O,Harbor,Gekko"
Lotus,Elation Esports,Kiyoe's Fan Club,13,6,10,2,4,3,"Breach,Cypher,Sova,Omen,Neon","Cypher,Omen,Jett,Neon,Fade"
Bind,Fractal Gaming,Globe's Mittens,14,12,8,5,7,6,"Raze,Cypher,Brimstone,Fade,Gekko","Raze,Cypher,Viper,Brimstone,Skye"
Ascent,Brimstone with a Fusion Bomb,Cyberia Esports,13,9,8,4,5,5,"Cypher,Sova,Omen,Jett,Yoru","Breach,Killjoy,Omen,Jett,KAY/O"
Ascent,Berzerkers Moon,Seulgi Fanclub,13,2,2,1,1,11,"Cypher,Sova,Reyna,Omen,Jett","Breach,Brimstone,Reyna,Jett,Neon"
Icebox,Siena Heights University,The Goon Goobers,13,8,7,2,6,6,"Sova,Killjoy,Viper,Reyna,Jett","Sova,Killjoy,Viper,Jett,Gekko"
Lotus,Nightblood Gaming,English or Spanish,13,8,5,4,4,8,"Breach,Cypher,Astra,Neon,Fade","Breach,Raze,Omen,Chamber,Gekko"
Haven,YDZ x Berzerkers,Good Career,13,11,4,8,3,9,"Breach,Cypher,Sova,Omen,Neon","Breach,Sova,Killjoy,Omen,Jett"
Icebox,Sexy Gang,Astane Anarchy,5,13,1,5,8,4,"Sova,Killjoy,Viper,Jett,KAY/O","Sova,Killjoy,Viper,Jett,KAY/O"
Icebox,zZz,Antares Esports,13,7,5,3,4,8,"Sova,Killjoy,Viper,Reyna,Jett","Sova,Killjoy,Viper,Neon,Gekko"
Bind,Rock Bottom,kellogs cereal,13,8,7,2,6,6,"Raze,Brimstone,Sage,Skye,Chamber","Raze,Cypher,Viper,Gekko,Clove"
Sunset,Berzerkers,Cumberland Rising,13,5,8,4,1,5,"Breach,Cypher,Sova,Omen,Neon","Breach,Cypher,Omen,Neon,Gekko"
Icebox,Lyrical's Daycare,Kryptic,16,14,6,9,5,10,"Sova,Viper,Sage,Chamber,Clove","Sova,Killjoy,Viper,Reyna,Jett"
Haven,Russian Mafia ,Shifty505,6,13,1,6,7,5,"Breach,Cypher,Sova,Omen,Neon","Breach,Cypher,Sova,Omen,Jett"
Haven,Big Hot Men,Lionheart eSports,13,5,6,0,5,7,"Cypher,Sova,Omen,Yoru,Iso","Breach,Cypher,Sova,Omen,Neon"
Abyss,SACKNUT,Outlast Gaming,13,4,10,2,2,3,"Sova,Omen,Jett,Yoru,Astra","Sova,Killjoy,Viper,Yoru,Astra"
Ascent,0-12 in parlays,UFO MINIONS,8,13,1,8,5,7,"Sova,Killjoy,Phoenix,Omen,Jett","Cypher,Sova,Omen,Jett,Yoru"
Bind,Siena Heights University,The Goon Goobers,4,13,4,8,5,0,"Raze,Cypher,Skye,Astra,Iso","Raze,Cypher,Omen,Fade,Gekko"
Ascent,glizzard wizards,Void,7,13,4,4,9,3,"Sova,Killjoy,Omen,Jett,KAY/O","Sova,Killjoy,Omen,Jett,KAY/O"
Bind,Kbull's Kittens,Dexterity Gaming,5,13,3,3,10,2,"Raze,Cypher,Skye,Clove","Viper,Brimstone,Skye,Yoru,Neon"
Lotus,LazerrFreeks Mythic,Freak Nation,13,11,4,8,3,9,"Killjoy,Viper,Omen,Neon,Fade","Raze,Cypher,Omen,Fade,Iso"
Sunset,silly kittens,The Barricade,13,5,6,0,5,7,"Breach,Cypher,Sova,Omen,Neon","Breach,Cypher,Astra,Neon,Gekko"
Sunset,Sexy Gang,Astane Anarchy,2,13,2,10,3,0,"Breach,Raze,Cypher,Sova,Clove","Breach,Raze,Cypher,Omen,Fade"
Abyss,FlyQuest RED,Erinite Esports,13,4,3,2,2,10,"Sova,Viper,Jett,Yoru,Astra","Cypher,Sova,Jett,Astra,Gekko"
Ascent,Nightblood Gaming,English or Spanish,13,6,7,5,1,6,"Sova,Killjoy,Omen,Jett,KAY/O","Sova,Killjoy,Omen,Jett,KAY/O"
Haven,Fractal Gaming,Globe's Mittens,13,10,8,3,7,5,"Breach,Sova,Killjoy,Omen,Jett","Breach,Cypher,Sova,Omen,Neon"
Sunset,SEN SHAHZAM,Kitten Shelter,13,6,9,3,3,4,"Cypher,Sova,Reyna,Omen,Jett","Breach,Cypher,Sova,Omen,Neon"
Ascent,mockings team,zZz,13,3,3,1,2,10,"Cypher,Sova,Omen,Jett,Clove","Cypher,Sova,Omen,Jett,Deadlock"
Lotus,Painguins,Cumberland Phoenix,13,15,4,10,5,9,"Breach,Killjoy,Omen,Neon,Gekko","Breach,Cypher,Omen,Neon,Fade"
Sunset,Team Image,Cyberia Esports,3,13,3,9,4,0,"Breach,Raze,Cypher,Sova,Omen","Cypher,Sova,Omen,Neon,Gekko"
Abyss,Gekko,Brimstone with a Fusion Bomb,13,6,8,4,2,5,"Sova,Viper,Yoru,Astra,Deadlock","Sova,Jett,Astra,Iso,Clove"
Icebox,Blue Otter,APX,13,1,2,0,1,11,"Sova,Killjoy,Viper,Jett,Gekko","Sova,Viper,Jett,Chamber,Harbor"
Haven,Antares Esports,HyperSpeed Violet,13,5,9,3,2,4,"Breach,Cypher,Sova,Omen,Jett","Breach,Cypher,Sova,Omen,Jett"
Haven,red,Elation Esports,13,10,6,5,5,7,"Cypher,Sova,Omen,Jett,Yoru","Cypher,Sova,Omen,Yoru,Iso"
Lotus,LOW9,Seulgi Fanclub,11,13,7,5,8,4,"Breach,Sova,Killjoy,Neon,Clove","Breach,Raze,Neon,Clove"
Lotus,Russian Mafia ,Shifty505,6,13,4,3,10,2,"Breach,Raze,Cypher,Omen,Fade","Raze,Killjoy,Viper,Omen,Fade"
Abyss,Rock Bottom,kellogs cereal,13,6,8,4,2,5,"Cypher,Sova,Yoru,Astra,Iso","Cypher,Sova,Jett,Astra,Deadlock"
Ascent,FLUFFY AIMERS,Berzerkers Moon,13,3,9,3,0,4,"Cypher,Sova,Omen,Yoru","Sova,Killjoy,Omen,Jett,KAY/O"
Abyss,Bentley Strike,Koala Pound,11,13,7,5,8,4,"Cypher,Sova,Yoru,Astra,Gekko","Sova,Yoru,Astra,Chamber,Neon"
Sunset,Big Hot Men,Lionheart eSports,5,13,3,9,4,2,"Breach,Cypher,Omen,KAY/O,Neon","Raze,Cypher,Sova,Omen,KAY/O"
Ascent,Lyrical's Daycare,Kryptic,13,8,8,4,4,5,"Cypher,Sova,Omen,Jett,Deadlock","Sova,Killjoy,Omen,Jett,KAY/O"
Ascent,SEN SHAHZAM,Kitten Shelter,13,1,11,1,0,2,"Sova,Killjoy,Reyna,Omen,Jett","Sova,Killjoy,Omen,Jett,KAY/O"
Haven,SACKNUT,Outlast Gaming,13,6,9,3,3,4,"Breach,Cypher,Sova,Omen,Neon","Killjoy,Viper,Omen,Jett,Skye"
Lotus,0-12 in parlays,UFO MINIONS,9,13,4,8,5,5,"Viper,Chamber,Neon,Gekko,Clove","Raze,Cypher,Omen,Jett,Gekko"
Haven,Berzerkers,Cumberland Rising,13,8,6,3,5,7,"Breach,Cypher,Sova,Omen,Neon","Breach,Cypher,Sova,Omen,Neon"
Lotus,YDZ x Berzerkers,Good Career,15,13,9,5,8,6,"Breach,Omen,Neon,Fade","Breach,Raze,Cypher,Omen,Gekko"
Sunset,Kbull's Kittens,Dexterity Gaming,8,13,6,3,10,2,"Breach,Cypher,Sova,Omen,Neon","Breach,Cypher,Sova,Omen,Neon"
Sunset,red,Elation Esports,13,1,2,0,1,11,"Cypher,Sova,Omen,Yoru,Neon","Breach,Raze,Cypher,Sova,Omen"
Sunset,MSU White,Astane Anarchy,3,13,3,9,4,0,"Breach,Cypher,Astra,KAY/O,Neon","Breach,Raze,Cypher,Omen,Fade"
Haven,Nightblood Gaming,English or Spanish,7,13,3,5,8,4,"Breach,Sova,Astra,Chamber,Neon","Breach,Cypher,Sova,Omen,Jett"
Sunset,glizzard wizards,Void,10,13,7,5,8,3,"Cypher,Sova,Omen,KAY/O,Neon","Cypher,Sova,Omen,KAY/O,Neon"
Sunset,KC and Friends,The Goon Goobers,7,13,4,8,5,3,"Breach,Cypher,Sova,Omen,Neon","Breach,Raze,Cypher,Sova,Omen"
Haven,Blue Otter,APX,13,4,3,2,2,10,"Breach,Cypher,Sova,Omen,Neon","Breach,Cypher,Sova,Jett,Astra"
Abyss,LOW9,Seulgi Fanclub,13,3,9,3,0,4,"Cypher,Sova,Jett,Yoru,Clove","Breach,Reyna,Yoru,Astra,Neon"
Lotus,Non-Verbal,LazerrFreeks Mythic,13,11,7,5,6,6,"Raze,Killjoy,Viper,Omen,Fade","Killjoy,Viper,Omen,Neon,Fade"
Haven,silly kittens,The Barricade,13,11,5,7,4,8,"Breach,Cypher,Sova,Omen,Jett","Breach,Cypher,Sova,Jett,Astra"
Lotus,Fractal Gaming,Globe's Mittens,11,13,6,6,7,5,"Breach,Killjoy,Omen,Neon,Gekko","Breach,Killjoy,Omen,KAY/O,Neon"
Ascent,Painguins,Cumberland Phoenix,10,13,5,6,7,5,"Cypher,Sova,Omen,Yoru,Chamber","Sova,Killjoy,Omen,Jett,KAY/O"
Bind,FlyQuest RED,Erinite Esports,13,11,6,6,5,7,"Raze,Viper,Skye,Astra,Gekko","Raze,Viper,Brimstone,Fade,Gekko"
Icebox,mockings team,zZz,15,13,5,9,4,10,"Killjoy,Viper,Jett,KAY/O,Gekko","Sova,Killjoy,Viper,Reyna,Jett"
Haven,Gekko,Brimstone with a Fusion Bomb,13,6,8,4,2,5,"Breach,Cypher,Sova,Omen,Jett","Cypher,Sova,Omen,Yoru,Iso"
Ascent,Team Image,Cyberia Esports,5,13,2,4,9,3,"Sova,Killjoy,Omen,Jett,KAY/O","Breach,Killjoy,Omen,Jett,KAY/O"
Haven,washed,Siena Heights University,13,4,9,3,1,4,"Breach,Cypher,Sova,Omen,Jett","Breach,Skye,Astra,Neon,Clove"
Sunset,Freak Nation,Missouri ST Gold,13,8,7,2,6,6,"Breach,Raze,Cypher,Sova,Omen","Breach,Cypher,Sova,Omen,Neon"
Lotus,Antares Esports,HyperSpeed Violet,13,10,4,7,3,9,"Breach,Omen,Neon,Fade,Clove","Raze,Killjoy,Omen,Fade,Gekko"
Bind,Sexy Gang,YDZ Esports,2,13,0,3,10,2,"Raze,Brimstone,Skye,Chamber,Fade","Raze,Viper,Brimstone,Fade,Gekko"
Haven,Bentley Strike,Koala Pound,5,13,1,5,8,4,"Sova,Killjoy,Viper,Omen,Yoru","Cypher,Sova,Omen,Yoru,Iso"
Icebox,Tempers,Kiyoe's Fan Club,8,13,4,8,5,4,"Sova,Killjoy,Viper,Reyna,Jett","Sova,Killjoy,Viper,Reyna,Jett"
Sunset,Shopify Rebellion,SEN SHAHZAM,13,9,7,5,4,6,"Breach,Cypher,Sova,Omen,Neon","Raze,Cypher,Reyna,Gekko,Clove"
Sunset,Avalon,Kryptic,8,13,4,8,5,4,"Breach,Cypher,Sova,Omen,Neon","Breach,Cypher,Sova,Omen,Neon"
Lotus,Screw's Angels,Kitten Shelter,5,13,2,4,9,3,"Raze,Killjoy,Omen,Fade,Gekko","Raze,Omen,Yoru,Chamber,Fade"
Sunset,Shifty505,Cumberland Rising,8,13,6,6,7,2,"Breach,Raze,Cypher,Sova,Omen","Breach,Cypher,Omen,Neon,Gekko"
Bind,KC and Friends,The Goon Goobers,6,13,1,6,7,5,"Raze,Cypher,Brimstone,Fade,Gekko","Raze,Cypher,Brimstone,Skye,Gekko"
Icebox,ROSE,Lyrical's Daycare,13,6,7,5,1,6,"Sova,Killjoy,Viper,Astra,Iso","Sova,Killjoy,Viper,Jett,Harbor"
Ascent,LOW9,Seulgi Fanclub,9,13,4,6,7,5,"Sova,Viper,Sage,Omen,Iso","Breach,Brimstone,Reyna,Jett,Neon"
Lotus,washed,Siena Heights University,13,2,10,2,0,3,"Raze,Cypher,Viper,Omen,Fade","Breach,Omen,Neon,Fade,Clove"
Lotus,FLUFFY AIMERS,Berzerkers Moon,14,12,5,8,4,9,"Raze,Cypher,Viper,Omen,Fade","Omen,KAY/O,Neon,Fade,Clove"
Haven,Dexterity Gaming,Outlast Gaming,9,13,3,9,4,6,"Breach,Cypher,Sova,Omen,Neon","Killjoy,Viper,Omen,Jett,Skye"
Haven,MSU White,Astane Anarchy,8,13,4,5,8,4,"Breach,Cypher,Sova,Jett,Astra","Breach,Cypher,Sova,Omen,Jett"
Haven,Sexy Gang,YDZ Esports,2,13,1,11,2,1,"Breach,Cypher,Sova,Jett,Astra","Breach,Cypher,Sova,Omen,Neon"
Haven,YDZ x Berzerkers,0-12 in parlays,13,7,6,2,5,7,"Breach,Cypher,Sova,Omen,Neon","Cypher,Sova,Omen,Yoru,Iso"
Sunset,Non-Verbal,LazerrFreeks Mythic,13,5,8,4,1,5,"Breach,Cypher,Sova,Omen,Neon","Breach,Cypher,Omen,Neon,Fade"
Lotus,Freak Nation,Missouri ST Gold,13,7,4,4,3,9,"Breach,Omen,Neon,Fade,Clove","Breach,Raze,Cypher,Omen,Fade"
Haven,Rock Bottom,glizzard wizards,13,2,3,0,2,10,"Breach,Sova,Killjoy,Omen,Jett","Breach,Cypher,Sova,Omen,Neon"
Sunset,Cumberland Phoenix,Lionheart eSports,13,6,6,6,0,7,"Breach,Cypher,Sova,Omen,Neon","Breach,Cypher,Sova,Omen,Neon"
Sunset,Nightblood Gaming,silly kittens,13,7,4,4,3,9,"Breach,Cypher,Sova,Omen,Neon","Breach,Cypher,Omen,KAY/O,Neon"
Abyss,APX,Globe's Mittens,13,7,4,4,3,9,"Sova,Jett,Astra,KAY/O","Cypher,Sova,Omen,Neon,Harbor"
Ascent,red,Elation Esports,16,18,7,10,8,9,"Raze,Sova,Killjoy,Omen,Yoru","Cypher,Sova,Omen,Jett,KAY/O"
Lotus,Team Image,Cyberia Esports,13,9,8,2,7,5,"Raze,Killjoy,Viper,Omen,Fade","Breach,Raze,Killjoy,Omen,Fade"
Haven,Void,kellogs cereal,11,13,3,9,4,8,"Breach,Cypher,Sova,Omen,Jett","Breach,Cypher,Sova,Omen,Jett"
Haven,Tempers,Kiyoe's Fan Club,6,13,3,9,4,3,"Cypher,Sova,Omen,Yoru,Iso","Cypher,Sova,Reyna,Omen,Neon"
Haven,Shopify Rebellion,SEN SHAHZAM,13,3,11,1,2,2,"Breach,Cypher,Sova,Omen,Neon","Breach,Sova,Killjoy,Jett,Astra"
Haven,Avalon,Kryptic,4,13,2,3,10,2,"Breach,Sova,Killjoy,Omen,Neon","Breach,Sova,Killjoy,Omen,Jett"
Lotus,ROSE,Lyrical's Daycare,13,2,10,2,0,3,"Raze,Killjoy,Viper,Omen,Fade","Raze,Cypher,Omen,Fade,Deadlock"
Lotus,Gekko,Brimstone with a Fusion Bomb,13,15,5,9,6,8,"Breach,Omen,Neon,Fade,Clove","Raze,Cypher,Omen,Fade,Clove"
Lotus,Erinite Esports,Koala Pound,13,9,9,3,6,4,"Breach,Raze,Cypher,Omen,Fade","Breach,Cypher,Omen,Neon,Gekko"
Sunset,Screw's Angels,Kitten Shelter,6,13,3,4,9,3,"Raze,Cypher,Sova,Omen,Gekko","Breach,Cypher,Sova,Omen,Neon"
Lotus,Good Career,UFO MINIONS,13,8,5,7,1,8,"Breach,Raze,Omen,Chamber,Gekko","Raze,Cypher,Omen,Jett,Gekko"
Icebox,HyperSpeed Violet,zZz,13,15,6,8,7,7,"Sova,Killjoy,Viper,Jett,Gekko","Sova,Killjoy,Viper,Reyna,Jett"
Haven,Shifty505,Cumberland Rising,7,13,5,7,6,2,"Breach,Sova,Killjoy,Omen,Jett","Breach,Cypher,Sova,Omen,Neon"
Bind,Rock Bottom,glizzard wizards,13,2,10,2,0,3,"Raze,Cypher,Viper,Brimstone,Skye","Raze,Viper,Brimstone,Skye,Gekko"
Haven,FLUFFY AIMERS,LOW9,13,4,4,1,3,9,"Cypher,Sova,Omen,Yoru,Iso","Cypher,Sova,Omen,Jett,Iso"
Sunset,Non-Verbal,Freak Nation,13,7,5,7,0,8,"Breach,Cypher,Sova,Omen,Neon","Breach,Cypher,Sova,Omen,Neon"
Lotus,YDZ Esports,Astane Anarchy,13,9,4,6,3,9,"Breach,Cypher,Neon,Gekko,Clove","Breach,Cypher,Omen,Neon,Fade"
Lotus,Dexterity Gaming,Outlast Gaming,10,13,5,6,7,5,"Raze,Killjoy,Viper,Omen,Fade","Raze,Killjoy,Viper,Omen,Fade"
Abyss,M80,All Knights,13,6,4,3,3,9,"Cypher,Sova,Omen,Jett,KAY/O","Cypher,Sova,Omen,Jett,KAY/O"
Abyss,Cumberland Phoenix,Lionheart eSports,13,6,8,4,2,5,"Sova,Jett,Astra,Deadlock","Cypher,Sova,Viper,Omen,Yoru"
Ascent,The Goon Goobers,Siena Heights University,11,13,4,8,5,7,"Sova,Killjoy,Omen,Jett,KAY/O","Sova,Killjoy,Omen,Jett,KAY/O"
Ascent,YDZ x Berzerkers,0-12 in parlays,11,13,2,10,3,9,"Sova,Killjoy,Omen,Jett,KAY/O","Sova,Killjoy,Reyna,Omen,Jett"
Ascent,Painguins,Big Hot Men,13,1,2,0,1,11,"Cypher,Sova,Omen,Yoru,Chamber","Sova,Killjoy,Omen,Jett,KAY/O"
Abyss,SACKNUT,Kbull's Kittens,2,13,2,10,3,0,"Breach,Sova,Jett,Astra,Deadlock","Sova,Omen,Jett,Yoru,Astra"
Ascent,Nightblood Gaming,silly kittens,13,7,4,4,3,9,"Sova,Killjoy,Omen,Jett,KAY/O","Cypher,Sova,Omen,Yoru,Deadlock"
Sunset,English or Spanish,The Barricade,13,10,6,5,5,7,"Breach,Raze,Cypher,Sova,Omen","Breach,Cypher,Astra,Neon,Gekko"
Lotus,mockings team,Antares Esports,13,5,8,4,1,5,"Sova,Killjoy,Omen,Jett,Clove","Breach,Omen,Neon,Fade,Clove"
Sunset,washed,KC and Friends,13,7,9,3,4,4,"Breach,Raze,Cypher,Omen,Gekko","Raze,Cypher,Sova,Omen,Gekko"
Haven,APX,Globe's Mittens,13,11,10,2,9,3,"Breach,Cypher,Sova,Omen,Jett","Breach,Cypher,Sova,Omen,Neon"
Abyss,FlyQuest RED,Bentley Strike,13,4,10,2,2,3,"Sova,Viper,Jett,Yoru,Astra","Cypher,Sova,Yoru,Astra,Gekko"
Ascent,Void,kellogs cereal,13,7,3,5,2,10,"Sova,Killjoy,Omen,Jett,KAY/O","Sova,Killjoy,Omen,Jett,KAY/O"
Sunset,Blue Otter,Fractal Gaming,13,2,10,2,0,3,"Breach,Cypher,Sova,Omen,Neon","Breach,Raze,Cypher,Omen,Gekko"
Lotus,Elation Esports,Kiyoe's Fan Club,13,11,4,8,3,9,"Breach,Cypher,Sova,Omen,Neon","Cypher,Reyna,Omen,Neon,Fade"
Icebox,Sexy Gang,MSU White,13,5,4,2,3,9,"Sova,Viper,Jett,KAY/O,Chamber","Sova,Killjoy,Viper,Jett,Harbor"
Sunset,ROSE,Avalon,13,2,3,0,2,10,"Raze,Cypher,Omen,Fade,Deadlock","Breach,Raze,Cypher,Sova,Omen"
Abyss,Gekko,Team Image,13,0,12,0,0,1,"Sova,Viper,Yoru,Deadlock,Clove","Cypher,Sova,Jett,Astra,KAY/O"
Abyss,Berzerkers,Russian Mafia ,13,4,8,4,0,5,"Cypher,Sova,Omen,Yoru,Deadlock","Cypher,Sova,Astra,Neon,Deadlock"
Ascent,Shopify Rebellion,Screw's Angels,13,4,9,3,1,4,"Cypher,Sova,Omen,Yoru,Deadlock","Sova,Killjoy,Omen,Jett,KAY/O"
Ascent,Lyrical's Daycare,Kryptic,13,3,2,2,1,11,"Cypher,Sova,Omen,Jett,Deadlock","Sova,Killjoy,Omen,Jett,KAY/O"
Lotus,red,Tempers,13,6,10,2,4,3,"Raze,Chamber,Gekko,Clove","Breach,Raze,Cypher,Omen,Fade"
Lotus,Berzerkers Moon,Seulgi Fanclub,13,3,12,0,3,1,"Omen,KAY/O,Neon,Fade,Clove","Raze,Cypher,Omen,Yoru,Fade"
Haven,Brimstone with a Fusion Bomb,Cyberia Esports,13,4,9,3,1,4,"Sova,Yoru,Astra,Chamber,Iso","Cypher,Sova,Reyna,Omen,Jett"
Bind,LazerrFreeks Mythic,Missouri ST Gold,13,5,8,4,1,5,"Raze,Viper,Brimstone,Fade,Gekko","Raze,Viper,Brimstone,Skye,Gekko"
Lotus,SEN SHAHZAM,Kitten Shelter,13,5,10,2,3,3,"Raze,Cypher,Astra,Fade,Deadlock","Raze,Cypher,Reyna,Astra,Gekko"
Sunset,SACKNUT,Kbull's Kittens,4,13,2,3,10,2,"Breach,Raze,Cypher,Omen,KAY/O","Breach,Cypher,Sova,Omen,Neon"
Sunset,Erinite Esports,Koala Pound,14,12,7,6,6,7,"Breach,Cypher,Sova,Omen,Yoru","Breach,Raze,Cypher,Omen,Gekko"
Sunset,Dexterity Gaming,Outlast Gaming,13,6,7,5,1,6,"Breach,Cypher,Sova,Omen,Neon","Breach,Raze,Cypher,Sova,Omen"
Lotus,YDZ x Berzerkers,0-12 in parlays,13,9,10,2,7,3,"Breach,Omen,Neon,Fade","Breach,Omen,Neon,Fade,Clove"
Icebox,mockings team,Antares Esports,13,3,4,0,3,9,"Sova,Killjoy,Reyna,Omen,Clove","Sova,Killjoy,Viper,Neon,Gekko"
Lotus,washed,KC and Friends,13,4,4,1,3,9,"Raze,Cypher,Viper,Omen,Fade","Breach,Raze,Cypher,Omen,Fade"
Lotus,Shifty505,Cumberland Rising,13,11,5,7,4,8,"Raze,Killjoy,Viper,Omen,Fade","Killjoy,Omen,Yoru,Neon,Fade"
Ascent,English or Spanish,The Barricade,13,2,3,0,2,10,"Sova,Killjoy,Omen,Jett,KAY/O","Cypher,Sova,Jett,Astra,Chamber"
Ascent,FLUFFY AIMERS,LOW9,13,5,10,2,3,3,"Cypher,Sova,Omen,Yoru","Cypher,Sova,Jett,Deadlock,Clove"
Sunset,Rock Bottom,glizzard wizards,9,13,7,5,8,2,"Breach,Cypher,Omen,Neon,Fade","Cypher,Sova,Omen,KAY/O,Neon"
Lotus,Berzerkers,Russian Mafia ,13,4,9,3,1,4,"Breach,Sova,Killjoy,Omen,Neon","Breach,Raze,Killjoy,Omen,Fade"
Haven,The Goon Goobers,Siena Heights University,7,13,2,6,7,5,"Breach,Cypher,Sova,Omen,Neon","Breach,Skye,Astra,Neon,Clove"
Abyss,ROSE,Avalon,13,2,10,2,0,3,"Sova,Jett,Yoru,Astra,Deadlock","Cypher,Sova,Omen,Jett"
Lotus,Gekko,Team Image,13,2,2,1,1,11,"Breach,Omen,Neon,Fade,Clove","Raze,Killjoy,Viper,Omen,Fade"
Sunset,Painguins,Big Hot Men,13,7,6,2,5,7,"Breach,Cypher,Sova,Omen,Neon","Breach,Cypher,Sova,Omen,Neon"
Icebox,Shopify Rebellion,Screw's Angels,13,0,12,0,0,1,"Killjoy,Viper,Reyna,KAY/O,Gekko","Sova,Killjoy,Viper,Reyna,Gekko"
Haven,Blue Otter,Fractal Gaming,13,4,5,0,4,8,"Breach,Cypher,Sova,Omen,Neon","Breach,Sova,Killjoy,Omen,Jett"
Haven,Cumberland Phoenix,Lionheart eSports,6,13,3,4,9,3,"Breach,Cypher,Sova,Omen,Jett","Breach,Cypher,Sova,Omen,Neon"
Ascent,Good Career,UFO MINIONS,14,12,4,9,3,10,"Sova,Killjoy,Omen,Jett,KAY/O","Sova,Omen,Jett,Yoru,Deadlock"
Ascent,red,Tempers,13,4,10,2,2,3,"Sova,Killjoy,Jett,Neon,Clove","Sova,Killjoy,Omen,Jett,KAY/O"
Lotus,APX,Globe's Mittens,9,13,2,8,5,7,"Raze,Cypher,Omen,Jett,Gekko","Breach,Killjoy,Omen,KAY/O,Neon"
Lotus,Non-Verbal,Freak Nation,15,13,4,10,3,11,"Raze,Killjoy,Viper,Omen,Fade","Breach,Raze,Cypher,Omen,Fade"
Sunset,Void,kellogs cereal,3,13,0,4,9,3,"Cypher,Sova,Omen,KAY/O,Neon","Breach,Raze,Cypher,Gekko,Clove"
Sunset,YDZ Esports,Astane Anarchy,13,11,2,10,1,11,"Breach,Cypher,Sova,Omen,Neon","Breach,Raze,Cypher,Omen,Fade"
Haven,FlyQuest RED,Bentley Strike,13,1,2,0,1,11,"Killjoy,Phoenix,Astra,Fade,Gekko","Sova,Killjoy,Viper,Omen,Yoru"
Sunset,Sexy Gang,MSU White,13,5,9,3,2,4,"Breach,Sova,Killjoy,Jett,Clove","Breach,Cypher,Astra,KAY/O,Neon"
Abyss,Berzerkers Moon,Seulgi Fanclub,13,3,9,3,0,4,"Cypher,Sova,Omen,Yoru,Astra","Cypher,Sova,Astra,Neon,Iso"
Lotus,Brimstone with a Fusion Bomb,Cyberia Esports,13,0,12,0,0,1,"Raze,Cypher,Omen,Fade,Clove","Breach,Raze,Killjoy,Omen,Fade"
Icebox,M80,All Knights,13,5,9,3,2,4,"Killjoy,Viper,Omen,KAY/O,Gekko","Sova,Killjoy,Viper,Gekko,Iso"
Haven,Nightblood Gaming,silly kittens,11,13,5,7,6,6,"Breach,Sova,Astra,Chamber,Neon","Breach,Cypher,Sova,Omen,Jett"
Sunset,LazerrFreeks Mythic,Missouri ST Gold,13,1,11,1,0,2,"Breach,Cypher,Omen,Neon,Fade","Breach,Cypher,Sova,Omen,Neon"
Lotus,Lyrical's Daycare,Kryptic,13,3,9,3,0,4,"Raze,Cypher,Omen,Fade,Deadlock","Raze,Killjoy,Viper,Omen,Fade"
Lotus,HyperSpeed Violet,zZz,15,17,9,7,10,6,"Raze,Killjoy,Omen,Fade,Gekko","Breach,Cypher,Omen,Neon,Fade"
Haven,Elation Esports,Kiyoe's Fan Club,13,5,9,3,2,4,"Cypher,Sova,Omen,Yoru,Iso","Breach,Cypher,Sova,Omen,Neon"
Haven,SEN SHAHZAM,Kitten Shelter,13,4,5,0,4,8,"Breach,Sova,Killjoy,Jett,Astra","Sova,Killjoy,Reyna,Omen,Jett"
Sunset,M80,All Knights,13,9,7,5,4,6,"Breach,Cypher,Omen,Yoru,Gekko","Breach,Cypher,Omen,Neon,Fade"
Lotus,M80,All Knights,4,13,3,9,4,1,"Cypher,Sage,Omen,Fade,Deadlock","Breach,Cypher,Omen,Neon,Fade"
Haven,M80,All Knights,3,13,0,4,9,3,"Breach,Sova,Killjoy,Omen,Jett","Breach,Cypher,Sova,Omen,Neon"
Lotus,NAOS Esports,BOOM Esports,7,13,3,5,8,4,"Raze,Killjoy,Viper,Omen,Fade","Raze,Killjoy,Viper,Omen,Fade"
Sunset,NAOS Esports,BOOM Esports,3,13,2,10,3,1,"Breach,Cypher,Sova,Omen,Neon","Breach,Raze,Cypher,Omen,Gekko"
Haven,FULL SENSE,Oblivion Force,13,3,4,0,3,9,"Breach,Sova,Killjoy,Omen,Neon","Breach,Cypher,Omen,Neon,Iso"
Sunset,FULL SENSE,Oblivion Force,13,6,3,4,2,10,"Breach,Cypher,Sova,Omen,Neon","Raze,Cypher,Omen,KAY/O,Gekko"
Icebox,Revenant Esports,Sin Prisa Gaming,5,13,0,6,7,5,"Sova,Killjoy,Viper,Yoru,Gekko","Sova,Killjoy,Viper,Jett,Harbor"
Bind,Revenant Esports,Sin Prisa Gaming,10,13,7,5,8,3,"Raze,Viper,Brimstone,Fade,Gekko","Cypher,Brimstone,Neon,Fade,Deadlock"
Ascent,M80,Galorys,14,12,4,9,3,10,"Cypher,Sova,Omen,Yoru,Deadlock","Cypher,Sova,Omen,Jett,Deadlock"
Sunset,M80,Galorys,13,9,8,4,5,5,"Breach,Cypher,Omen,Yoru,Gekko","Breach,Cypher,Sova,Omen,Neon"
Sunset,2Game Esports,All Knights,13,4,9,3,1,4,"Breach,Cypher,Sova,Omen,Neon","Breach,Cypher,Omen,Neon,Fade"
Lotus,Permitta Unicorns GC,RIZON Sugar,13,8,7,2,6,6,"Breach,Raze,Killjoy,Omen,Fade","Breach,Raze,Cypher,Omen,Fade"
Sunset,FOKUS Sakura,Scald eSport GC,13,5,9,3,2,4,"Breach,Cypher,Omen,Neon,Fade","Breach,Cypher,Omen,Neon,Gekko"
Lotus,2Game Esports,All Knights,12,14,5,8,6,7,"Breach,Cypher,Omen,Neon,Fade","Breach,Cypher,Omen,Neon,Fade"
Haven,Permitta Unicorns GC,RIZON Sugar,13,11,9,3,8,4,"Breach,Cypher,Sova,Omen,Jett","Cypher,Sova,Omen,Yoru,Iso"
Icebox,FOKUS Sakura,Scald eSport GC,13,7,6,2,5,7,"Sova,Killjoy,Viper,Reyna,Jett","Sova,Killjoy,Viper,Sage,Jett"
Lotus,Reveal Multigaming Jushimori,Dortmund eSports Dynasty,13,15,10,4,11,3,"Breach,Raze,Killjoy,Omen,Fade","Breach,Raze,Killjoy,Omen,Fade"
Abyss,2Game Esports,All Knights,13,9,7,3,6,6,"Cypher,Sova,Omen,Jett,KAY/O","Cypher,Sova,Omen,Jett,KAY/O"
Abyss,LVENGERS,teamhoppers,2,13,0,3,10,2,"Cypher,Sova,Omen,Jett,Harbor","Sova,Sage,Jett,Astra,KAY/O"
Ascent,ROA SYNC,Entropy Azúcar,13,8,6,6,2,7,"Cypher,Sova,Omen,Jett,KAY/O","Sova,Killjoy,Omen,Jett,KAY/O"
Sunset,Permitta Unicorns GC,RIZON Sugar,11,13,8,4,9,3,"Breach,Raze,Cypher,Sova,Omen","Breach,Raze,Cypher,Sova,Omen"
Bind,Reveal Multigaming Jushimori,Dortmund eSports Dynasty,13,10,9,3,7,4,"Breach,Raze,Cypher,Brimstone,Fade","Breach,Raze,Cypher,Brimstone,Fade"
Abyss,NEON BLADE,Blindspot Kunai,13,2,12,0,2,1,"Cypher,Sova,Omen,Jett,Gekko","Breach,Cypher,Jett,Astra,Gekko"
Ascent,SK Nebula,SSP Numina,13,3,10,2,1,3,"Sova,Killjoy,Omen,Jett,KAY/O","Sova,Killjoy,Omen,Jett,KAY/O"
Haven,TOG Kitsune,ALTERNATE aTTaX Ruby,8,13,6,6,7,2,"Breach,Cypher,Sova,Omen,Jett","Breach,Cypher,Sova,Omen,Jett"
Haven,LVENGERS,teamhoppers,7,13,6,6,7,1,"Breach,Sova,Killjoy,Omen,Jett","Raze,Killjoy,Viper,Skye,Astra"
Haven,NEON BLADE,Blindspot Kunai,13,3,10,2,1,3,"Breach,Sova,Killjoy,Omen,Jett","Breach,Sova,Killjoy,Omen,Jett"
Sunset,Reveal Multigaming Jushimori,Dortmund eSports Dynasty,5,13,1,5,8,4,"Breach,Raze,Cypher,Omen,Gekko","Breach,Raze,Cypher,Omen,Fade"
Lotus,ROA SYNC,Entropy Azúcar,13,10,7,4,6,6,"Breach,Raze,Killjoy,Gekko,Clove","Breach,Raze,Killjoy,Omen,Fade"
Haven,SK Nebula,SSP Numina,13,4,3,2,2,10,"Breach,Cypher,Sova,Jett,Astra","Breach,Sova,Killjoy,Omen,Jett"
Abyss,TOG Kitsune,ALTERNATE aTTaX Ruby,5,13,2,4,9,3,"Breach,Cypher,Sova,Jett,Astra","Sova,Sage,Jett,Astra,KAY/O"
Abyss,Team Serenity,Perfectionists,13,9,3,7,2,10,"Sova,Viper,Jett,Yoru,Astra","Sova,Jett,Astra,Harbor,Deadlock"
Sunset,Team Serenity,Perfectionists,13,7,7,5,2,6,"Breach,Cypher,Sova,Omen,Neon","Breach,Raze,Cypher,Omen,Gekko"
Haven,Team Serenity,Perfectionists,10,13,6,5,8,4,"Killjoy,Viper,Omen,Jett,Skye","Breach,Cypher,Sova,Omen,Jett"
Bind,All Knights,Galorys,14,12,10,3,9,4,"Raze,Cypher,Brimstone,Skye,Deadlock","Raze,Viper,Brimstone,Fade,Gekko"
Haven,All Knights,Galorys,13,9,8,2,7,5,"Breach,Cypher,Sova,Omen,Neon","Breach,Sova,Killjoy,Omen,Jett"
Icebox,M80,2Game Esports,7,13,4,8,5,3,"Killjoy,Viper,Omen,KAY/O,Gekko","Sova,Killjoy,Viper,Jett,KAY/O"
Sunset,M80,2Game Esports,8,13,5,4,9,3,"Breach,Cypher,Omen,Yoru,Gekko","Breach,Cypher,Sova,Omen,Neon"
Ascent,Reveal Multigaming Jushimori,NEON BLADE,6,13,6,6,7,0,"Breach,Sova,Killjoy,Omen,Jett","Sova,Killjoy,Omen,Jett,KAY/O"
Lotus,Reveal Multigaming Jushimori,NEON BLADE,11,13,7,5,8,4,"Breach,Raze,Killjoy,Omen,Fade","Breach,Raze,Killjoy,Omen,Fade"
Haven,FlyQuest RED,YFP X,10,13,8,4,9,2,"Killjoy,Phoenix,Astra,Fade,Gekko","Breach,Cypher,Sova,Omen,Jett"
Bind,FlyQuest RED,YFP X,10,13,6,6,7,4,"Raze,Viper,Skye,Astra,Gekko","Raze,Cypher,Omen,Skye,Yoru"
Sunset,FlyQuest RED,YFP X,13,2,3,0,2,10,"Raze,Cypher,Omen,Fade,Deadlock","Breach,Raze,Cypher,Sova,Omen"
Icebox,FlyQuest RED,Refrag,13,6,5,2,4,8,"Sova,Killjoy,Viper,Sage,Gekko","Sova,Killjoy,Viper,Reyna,Iso"
Haven,FlyQuest RED,Refrag,13,9,6,6,3,7,"Killjoy,Phoenix,Astra,Fade,Gekko","Cypher,Sova,Killjoy,Omen,Jett"
Lotus,FlyQuest RED,Refrag,6,13,4,8,5,2,"Raze,Omen,Fade,Deadlock,Clove","Raze,Omen,Fade,Deadlock"
Haven,Team Liquid Brazil,TBS GC,13,5,7,5,0,6,"Killjoy,Viper,Omen,Jett,Skye","Cypher,Sova,Omen,Yoru,Iso"
Abyss,Team Liquid Brazil,TBS GC,13,6,6,1,5,7,"Cypher,Sova,Omen,Jett,KAY/O","Sova,Reyna,Omen,Chamber,Iso"
Haven,YFP X,oomfies,13,8,7,5,3,6,"Breach,Cypher,Sova,Omen,Jett","Breach,Cypher,Sova,Omen,Jett"
Bind,Team Liquid Brazil,TBS GC,13,7,6,2,5,7,"Raze,Cypher,Viper,Brimstone,Skye","Raze,Viper,Brimstone,Skye,Gekko"
Sunset,YFP X,oomfies,13,7,4,4,3,9,"Breach,Raze,Cypher,Sova,Omen","Raze,Cypher,Sova,Omen,Iso"
Lotus,SSP Numina,RIZON Sugar,8,13,4,5,8,4,"Breach,Raze,Killjoy,Omen,Gekko","Breach,Raze,Cypher,Omen,Fade"
Lotus,Permitta Unicorns GC,ALTERNATE aTTaX Ruby,6,13,3,4,9,3,"Breach,Raze,Killjoy,Omen,Fade","Breach,Raze,Cypher,Omen,Fade"
Sunset,SSP Numina,RIZON Sugar,9,13,5,5,8,4,"Breach,Cypher,Sova,Omen,Neon","Breach,Raze,Cypher,Sova,Omen"
Sunset,Permitta Unicorns GC,ALTERNATE aTTaX Ruby,7,13,3,9,4,4,"Breach,Raze,Cypher,Sova,Omen","Breach,Raze,Cypher,Sova,Omen"
Haven,LVENGERS,Silly Seals,13,4,5,0,4,8,"Breach,Sova,Killjoy,Omen,Jett","Breach,Cypher,Sova,Omen,Neon"
Lotus,NASR Ignite,Karmine Corp GC,13,7,7,1,6,6,"Raze,Cypher,Omen,KAY/O,Deadlock","Breach,Cypher,Omen,Neon,Fade"
Ascent,FOKUS Sakura,TOG Kitsune,13,7,8,4,3,5,"Sova,Killjoy,Omen,Jett,Iso","Sova,Killjoy,Omen,Jett,KAY/O"
Bind,SK Nebula,Scald eSport GC,13,5,4,2,3,9,"Raze,Viper,Omen,Yoru,Fade","Breach,Raze,Cypher,Brimstone,Deadlock"
Lotus,teamhoppers,Entropy Azúcar,13,1,11,1,0,2,"Raze,Cypher,Omen,Fade,Deadlock","Breach,Raze,Killjoy,Omen,Fade"
Lotus,LVENGERS,Silly Seals,7,13,4,8,5,3,"Breach,Raze,Cypher,Omen,Fade","Breach,Raze,Killjoy,Omen,Fade"
Ascent,ROA SYNC,Blindspot Kunai,13,5,5,1,4,8,"Cypher,Sova,Omen,Jett,KAY/O","Sova,Killjoy,Omen,Jett,KAY/O"
Bind,NASR Ignite,Karmine Corp GC,13,9,6,6,3,7,"Raze,Cypher,Brimstone,Skye,Deadlock","Raze,Cypher,Brimstone,Omen,Skye"
Ascent,SK Nebula,Scald eSport GC,13,5,4,2,3,9,"Sova,Killjoy,Omen,Jett,KAY/O","Cypher,Sova,Omen,Jett,Yoru"
Sunset,FOKUS Sakura,TOG Kitsune,13,9,8,2,7,5,"Breach,Cypher,Omen,Neon,Fade","Breach,Cypher,Sova,Omen,Yoru"
Bind,LVENGERS,Silly Seals,13,3,2,2,1,11,"Breach,Raze,Brimstone,Harbor,Gekko","Raze,Viper,Astra,Fade,Gekko"
Haven,teamhoppers,Entropy Azúcar,13,8,8,1,7,5,"Raze,Killjoy,Viper,Skye,Astra","Breach,Sova,Killjoy,Omen,Jett"
Lotus,ROA SYNC,Blindspot Kunai,13,4,2,3,1,11,"Breach,Raze,Killjoy,Gekko,Clove","Breach,Killjoy,Omen,Jett,Gekko"
Lotus,The Rejects,Hampter,10,13,8,3,10,2,"Killjoy,Astra,Neon,Gekko","Raze,Reyna,Gekko,Deadlock,Clove"
Ascent,wade,KAMK.GG,18,16,8,9,7,10,"Cypher,Sova,Jett,KAY/O,Clove","Sova,Killjoy,Omen,Jett,KAY/O"
Lotus,VIRMA,Möyhentäjät,13,2,10,2,0,3,"Breach,Omen,Chamber,Neon,Gekko","Breach,Raze,Omen,Chamber,Harbor"
Ascent,GIANTX GC,Valiant GC,13,8,6,6,2,7,"Sova,Killjoy,Omen,Jett,KAY/O","Cypher,Sova,Omen,Jett,Deadlock"
Lotus,wade,KAMK.GG,13,2,3,0,2,10,"Breach,Raze,Killjoy,Neon,Clove","Breach,Reyna,Omen,Chamber,Neon"
Haven,SKIPIDI,Wintermint,4,13,3,9,4,1,"Sova,Killjoy,Reyna,Omen,Jett","Breach,Sova,Omen,Jett"
Haven,The Rejects,Hampter,9,13,7,5,8,2,"Raze,Cypher,Yoru,Astra,Gekko","Sage,Reyna,Skye,Deadlock,Clove"
Ascent,VIRMA,Möyhentäjät,13,0,12,0,0,1,"Cypher,Sova,Omen,Jett,KAY/O","Raze,Sova,Killjoy,Omen,Jett"
Lotus,Valoja Päälle?,Ahlman ,9,13,3,7,6,6,"Breach,Killjoy,Neon,Harbor,Clove","Raze,Cypher,Omen,Fade,Gekko"
Lotus,Pumppuhait,Monkey Momentum,2,13,0,3,10,2,"Raze,Cypher,Brimstone,Yoru,KAY/O","Breach,Killjoy,Omen,Jett,Gekko"
Lotus,SSalama,Rekka10,4,13,4,8,5,0,"Breach,Raze,Omen,Chamber,Fade","Raze,Cypher,Omen,Gekko,Deadlock"
Bind,wombat123,ISOSIMO,13,1,2,0,1,11,"Raze,Viper,Fade,Deadlock,Clove","Raze,Brimstone,Skye,Chamber,Fade"
Ascent,SKIPIDI,Wintermint,1,13,1,11,2,0,"Cypher,Sova,Omen,Jett,KAY/O","Sova,Killjoy,Omen,Jett,KAY/O"
Ascent,Pumppuhait,Monkey Momentum,4,13,2,3,10,2,"Killjoy,Phoenix,Brimstone,Reyna,KAY/O","Sova,Killjoy,Omen,Jett,KAY/O"
Haven,SSalama,Rekka10,2,13,1,11,2,1,"Breach,Cypher,Sova,Omen,Jett","Breach,Cypher,Sova,Omen,Jett"
Ascent,The Rejects,Hampter,13,10,8,4,6,5,"Cypher,Yoru,Astra,KAY/O,Neon","Sova,Killjoy,Phoenix,Omen,Jett"
Icebox,wombat123,ISOSIMO,13,4,8,4,0,5,"Sova,Killjoy,Viper,Reyna,Jett","Sova,Killjoy,Viper,Sage,Jett"
Lotus,GIANTX GC,Valiant GC,15,13,6,8,5,9,"Breach,Raze,Sova,Omen,Chamber","Breach,Killjoy,Omen,Neon,Fade"
Haven,Refrag,Teddy Tactics,13,7,3,5,2,10,"Breach,Cypher,Sova,Omen,Jett","Breach,Sova,Killjoy,Astra,Neon"
Bind,TBS GC,REVOADA,13,9,7,3,6,6,"Raze,Viper,Brimstone,Skye,Gekko","Raze,Cypher,Viper,Brimstone,Skye"
Haven,oomfies,mesos millionaires,13,4,9,3,1,4,"Cypher,Sova,Omen,Yoru,Iso","Breach,Sova,Killjoy,Omen,Neon"
Haven,FlyQuest RED,Give Wingman 2 Nuclear Devices,13,7,6,2,5,7,"Killjoy,Phoenix,Astra,Fade,Gekko","Breach,Cypher,Sova,Omen,Neon"
Lotus,Refrag,Teddy Tactics,13,1,11,1,0,2,"Raze,Cypher,Omen,Fade,Deadlock","Breach,Raze,Killjoy,Astra,Fade"
Haven,YFP X,Army National Guard,13,0,1,0,0,12,"Breach,Phoenix,Sage,KAY/O,Clove","Raze,Cypher,Phoenix,Omen,Gekko"
Bind,FlyQuest RED,Give Wingman 2 Nuclear Devices,13,4,8,4,0,5,"Raze,Viper,Skye,Astra,Gekko","Raze,Viper,Skye,Gekko,Clove"
Lotus,YFP X,Army National Guard,13,0,12,0,0,1,"Omen,Chamber,Neon,Gekko,Iso","Raze,Killjoy,Phoenix,Brimstone,Fade"
Bind,oomfies,mesos millionaires,13,7,6,2,5,7,"Raze,Viper,Brimstone,Fade,Gekko","Raze,Skye,Chamber,Deadlock,Clove"
Sunset,TBS GC,REVOADA,13,8,7,2,6,6,"Cypher,Sova,Omen,KAY/O,Neon","Breach,Raze,Cypher,Sova,Omen"
Ascent,Refrag,Teddy Tactics,6,13,2,5,8,4,"Sova,Killjoy,Omen,Jett,KAY/O","Breach,Sova,Killjoy,Jett,Astra"
Haven,TBS GC,REVOADA,10,13,5,7,6,5,"Cypher,Sova,Omen,Yoru,Iso","Breach,Sova,Killjoy,Omen,Jett"
Sunset,YFP X,Give Wingman 2 Nuclear Devices,13,6,9,3,3,4,"Breach,Raze,Cypher,Sova,Omen","Breach,Raze,Cypher,Omen,Gekko"
Ascent,Refrag,mesos millionaires,13,9,4,6,3,9,"Sova,Killjoy,Omen,Jett,KAY/O","Sova,Killjoy,Jett,Astra,KAY/O"
Icebox,FlyQuest RED,Teddy Tactics,13,3,9,3,0,4,"Sova,Killjoy,Viper,Sage,Gekko","Sova,Killjoy,Viper,Jett,Harbor"
Bind,oomfies,Army National Guard,13,1,11,1,0,2,"Raze,Cypher,Viper,Brimstone,Iso","Raze,Cypher,Phoenix,Brimstone,Gekko"
Bind,Give Wingman 2 Nuclear Devices,mesos millionaires,9,13,4,8,5,5,"Raze,Viper,Brimstone,Skye,Gekko","Raze,Skye,Chamber,Deadlock,Clove"
Haven,Refrag,YFP X,10,13,2,9,4,8,"Breach,Cypher,Sova,Omen,Jett","Breach,Cypher,Sova,Omen,Jett"
Haven,oomfies,FlyQuest RED,5,13,4,8,5,1,"Cypher,Sova,Omen,Yoru,Iso","Killjoy,Phoenix,Astra,Fade,Gekko"
Haven,Team Liquid Brazil,Vila das Flores,13,3,4,0,3,9,"Killjoy,Viper,Omen,Jett,Skye","Breach,Cypher,Sova,Omen,Neon"
Ascent,Teddy Tactics,Army National Guard,13,0,12,0,0,1,"Breach,Sova,Killjoy,Jett,Astra","Raze,Sova,Killjoy,Phoenix,Brimstone"
Haven,mesos millionaires,YFP X,7,13,4,8,5,3,"Breach,Sova,Killjoy,Omen,Neon","Breach,Cypher,Sova,Omen,Jett"
Lotus,Refrag,Give Wingman 2 Nuclear Devices,13,7,7,1,6,6,"Raze,Viper,Omen,Chamber,Fade","Killjoy,Viper,Omen,Neon,Gekko"
Haven,Army National Guard,FlyQuest RED,1,13,1,11,2,0,"Raze,Cypher,Phoenix,Omen,Gekko","Killjoy,Phoenix,Astra,Fade,Gekko"
Ascent,Team Liquid Brazil,Vila das Flores,13,7,5,3,4,8,"Sova,Killjoy,Omen,Jett,KAY/O","Cypher,Sova,Phoenix,Omen,Jett"
Bind,Veni eSports Venom,Dortmund eSports Dynasty,10,13,3,8,5,7,"Breach,Raze,Viper,Brimstone,Gekko","Breach,Raze,Cypher,Brimstone,Fade"
Bind,Valiant GC,BBL Queens,13,3,9,3,0,4,"Raze,Viper,Brimstone,Fade,Gekko","Breach,Raze,Cypher,Omen,Skye"
Haven,Veni eSports Venom,Dortmund eSports Dynasty,9,13,6,6,7,3,"Breach,Sova,Killjoy,Omen,Neon","Breach,Sova,Killjoy,Omen,Jett"
Lotus,Veni eSports Venom,Dortmund eSports Dynasty,13,9,8,2,7,5,"Breach,Omen,Chamber,Neon,Gekko","Breach,Raze,Killjoy,Omen,Fade"
Lotus,Valiant GC,BBL Queens,14,12,7,6,6,7,"Breach,Killjoy,Omen,Neon,Fade","Breach,Raze,Killjoy,Omen,Fade"
Bind,G2 Gozen,NASR Ignite,14,12,10,3,9,4,"Raze,Brimstone,Omen,Skye,Gekko","Raze,Cypher,Brimstone,Skye,Deadlock"
Haven,G2 Gozen,NASR Ignite,13,5,4,2,3,9,"Breach,Cypher,Sova,Omen,Neon","Breach,Cypher,Sova,Omen,Neon"
Sunset,All Knights,TSM,15,13,10,4,9,5,"Breach,Cypher,Sova,Omen,Neon","Breach,Cypher,Omen,Neon,Gekko"
Abyss,All Knights,TSM,13,6,9,3,3,4,"Cypher,Sova,Omen,Jett,KAY/O","Sova,Viper,Jett,Yoru,Astra"
Haven,All Knights,TSM,13,15,2,12,3,11,"Breach,Cypher,Sova,Omen,Neon","Breach,Cypher,Sova,Omen,Neon"
Sunset,Vila das Flores,Team Leveling,13,10,8,4,6,5,"Breach,Sova,Sage,Omen,Neon","Breach,Cypher,Sova,Omen,Neon"
Bind,Vila das Flores,Team Leveling,7,13,0,8,5,7,"Viper,Brimstone,Yoru,Neon,Fade","Raze,Viper,Brimstone,Skye,Gekko"
Sunset,2Game Esports,M80,14,16,5,10,6,9,"Breach,Cypher,Sova,Omen,Neon","Breach,Cypher,Omen,Yoru,Gekko"
Sunset,TBS GC,PS5Patas,13,2,10,2,0,3,"Cypher,Sova,Omen,KAY/O,Neon","Breach,Cypher,Sova,Omen,Neon"
Ascent,REVOADA,RocketggGC,13,2,10,2,0,3,"Sova,Killjoy,Omen,Jett,KAY/O","Sova,Killjoy,Omen,Jett,KAY/O"
Ascent,Team Liquid Brazil,PROCURADAS,13,1,2,0,1,11,"Sova,Killjoy,Omen,Jett,KAY/O","Sova,Killjoy,Omen,Jett,KAY/O"
Lotus,2Game Esports,M80,7,13,2,10,3,5,"Breach,Cypher,Omen,Neon,Fade","Breach,Cypher,Omen,Yoru,Fade"
Abyss,Vila das Flores,Team Leveling,13,11,7,5,6,6,"Cypher,Sova,Omen,Jett,Harbor","Sova,Omen,Astra,KAY/O,Neon"
Ascent,TBS GC,PS5Patas,13,8,7,2,6,6,"Sova,Killjoy,Omen,Jett,KAY/O","Sova,Killjoy,Omen,Jett,KAY/O"
Bind,REVOADA,RocketggGC,13,8,7,5,3,6,"Raze,Cypher,Viper,Brimstone,Skye","Raze,Cypher,Brimstone,Skye,Gekko"
Haven,Team Liquid Brazil,PROCURADAS,13,3,2,2,1,11,"Killjoy,Viper,Omen,Jett,Skye","Breach,Cypher,Sova,Omen,Jett"
Bind,RETA Esports,Galorys,4,13,3,9,4,1,"Raze,Viper,Brimstone,Skye,Gekko","Raze,Viper,Brimstone,Fade,Gekko"
Ascent,Apeks,PCIFIC Espor,13,4,8,4,0,5,"Cypher,Sova,Omen,Yoru,Deadlock","Cypher,Sova,Omen,Jett,KAY/O"
Sunset,Tap Tap Boom eSports,The Cult,4,13,2,10,3,2,"Raze,Viper,Omen,Chamber,Fade","Raze,Cypher,Skye,Gekko,Clove"
Lotus,Apeks,PCIFIC Espor,13,11,9,3,8,4,"Raze,Cypher,Omen,KAY/O,Deadlock","Breach,Cypher,Sova,Omen,Neon"
Ascent,RETA Esports,Galorys,11,13,4,8,5,7,"Sova,Killjoy,Omen,Jett,KAY/O","Cypher,Sova,Omen,Jett,Deadlock"
Lotus,TxT Gaming,COBWEB HYDRA,13,5,4,2,3,9,"Breach,Omen,Chamber,Neon,Fade","Breach,Cypher,Omen,Jett,Gekko"
Haven,Tap Tap Boom eSports,The Cult,14,12,7,6,6,7,"Breach,Cypher,Sova,Omen,Jett","Breach,Sova,Killjoy,Omen,Jett"
Bind,G2 Gozen,Odd 1 OUT,13,5,5,1,4,8,"Raze,Brimstone,Omen,Skye,Gekko","Raze,Viper,Brimstone,Fade,Gekko"
Haven,Apeks,PCIFIC Espor,11,13,9,3,10,2,"Breach,Sova,Killjoy,Omen,Jett","Breach,Sova,Killjoy,Omen,Jett"
Haven,TxT Gaming,COBWEB HYDRA,13,5,10,2,3,3,"Breach,Cypher,Sova,Omen,Neon","Breach,Sova,Killjoy,Omen,Neon"
Lotus,G2 Gozen,Odd 1 OUT,13,6,7,0,6,6,"Raze,Cypher,Omen,Fade,Deadlock","Breach,Cypher,Sova,Omen,Neon"
Ascent,Dark Horse Templars,ZINGERS,7,13,2,10,3,5,"Sova,Killjoy,Omen,Jett,KAY/O","Sova,Killjoy,Phoenix,Astra,Clove"
Abyss,Apeks,PCIFIC Espor,13,8,7,2,6,6,"Cypher,Sova,Omen,Yoru,Astra","Cypher,Sova,Omen,Jett,KAY/O"
Sunset,Top G,Linares eSports,9,13,5,5,8,4,"Breach,Cypher,Sova,Neon,Clove","Breach,Cypher,Sova,Omen,Neon"
Abyss,TxT Gaming,COBWEB HYDRA,11,13,8,4,9,3,"Cypher,Sova,Omen,Jett,Harbor","Cypher,Sova,Jett,Astra,Gekko"
Haven,Dark Horse Templars,ZINGERS,10,13,5,7,6,5,"Breach,Cypher,Sova,Omen,Neon","Breach,Killjoy,Omen,Jett,Iso"
Haven,Top G,Linares eSports,11,13,5,7,6,6,"Breach,Sova,Killjoy,Jett,Clove","Breach,Cypher,Sova,Omen,Jett"
Sunset,HEROIC Valkyries,GIANTX GC,13,5,8,4,1,5,"Breach,Raze,Cypher,Sova,Astra","Breach,Cypher,Sova,Omen,Neon"
Sunset,Apeks,PCIFIC Espor,6,13,3,9,4,3,"Cypher,Sova,Omen,KAY/O,Neon","Breach,Cypher,Sova,Omen,Neon"
Abyss,Top G,Linares eSports,13,8,6,3,5,7,"Cypher,Sova,Jett,Iso,Clove","Cypher,Sova,Jett,Astra,Gekko"
Lotus,Defient Esports,Moon,13,9,5,7,2,8,"Breach,Raze,Cypher,Omen,Fade","Breach,Raze,Killjoy,Skye,Clove"
Abyss,HEROIC Valkyries,GIANTX GC,13,11,7,5,6,6,"Breach,Cypher,Sova,Jett,Astra","Breach,Cypher,Jett,Astra,Gekko"
Icebox,Man I Love Fermin Trujin,Top G,5,13,3,3,10,2,"Sova,Killjoy,Viper,Sage,Jett","Sova,Killjoy,Viper,Reyna,Jett"
Haven,Linares eSports,meowmeowmeow,13,6,9,3,3,4,"Breach,Cypher,Sova,Omen,Jett","Breach,Cypher,Sova,Omen,Jett"
Abyss,Defient Esports,Moon,13,8,7,5,3,6,"Cypher,Sova,Jett,Astra,Gekko","Breach,Cypher,Omen,Jett,Deadlock"
Ascent,Man I Love Fermin Trujin,Top G,7,13,3,9,4,4,"Sova,Killjoy,Omen,Jett,KAY/O","Cypher,Sova,Reyna,Jett,Clove"
Bind,TEAM BLINDSPOT,PANDEMONIUM,5,13,3,3,10,2,"Raze,Viper,Brimstone,Fade,Gekko","Raze,Viper,Astra,Fade,Gekko"
Ascent,Linares eSports,meowmeowmeow,14,12,8,5,7,6,"Cypher,Sova,Omen,Jett,KAY/O","Sova,Killjoy,Phoenix,Omen,Jett"
Ascent,Team Accelerate,Team Ruthless,5,13,1,5,8,4,"Breach,Sova,Killjoy,Omen,Jett","Sova,Killjoy,Omen,Jett,KAY/O"
Sunset,TEAM BLINDSPOT,PANDEMONIUM,13,7,9,3,4,4,"Breach,Cypher,Omen,Neon,Gekko","Breach,Raze,Cypher,Omen,Gekko"
Haven,Team Accelerate,Team Ruthless,7,13,4,8,5,3,"Breach,Sova,Killjoy,Omen,Jett","Sova,Killjoy,Reyna,Omen,Jett"
Haven,Nexum EC,Linares eSports,4,13,0,5,8,4,"Breach,Viper,Omen,Neon","Breach,Cypher,Sova,Omen,Jett"
Abyss,Top G,Universae,14,12,7,6,6,7,"Cypher,Sova,Jett,Iso,Clove","Breach,Cypher,Sova,Jett,Astra"
Haven,meowmeowmeow,La Banda del Patio,13,4,3,2,2,10,"Breach,Cypher,Sova,Jett,Astra","Breach,Sova,Killjoy,Omen,Jett"
Ascent,VOID (EU),Man I Love Fermin Trujin,8,13,5,7,6,3,"Breach,Viper,Yoru,KAY/O,Clove","Sova,Killjoy,Omen,Jett,KAY/O"
Abyss,Las Cabras (EU),RYL | Royal Legion,12,14,5,8,6,7,"Cypher,Sova,Jett,Astra,Gekko","Cypher,Sova,Omen,Jett,Harbor"
Bind,Team Accelerate,Team Ruthless,13,9,6,4,5,7,"Raze,Viper,Brimstone,Skye,Yoru","Raze,Brimstone,Chamber,Fade,Gekko"
Ascent,kosomaks,Nexum EC,9,13,3,7,6,6,"Cypher,Sova,Omen,Jett,KAY/O","Breach,Omen,Neon,Fade,Deadlock"
Haven,Top G,Genesis eSports,13,3,2,2,1,11,"Breach,Sova,Killjoy,Omen,Jett","Breach,Sova,Killjoy,Omen,Jett"
Haven,La Banda del Patio,nox gaming,13,11,6,6,5,7,"Breach,Sova,Killjoy,Omen,Jett","Cypher,Sova,Omen,Yoru,Iso"
Haven,Las Cabras (EU),RYL | Royal Legion,9,13,3,7,6,6,"Breach,Cypher,Sova,Omen,Neon","Raze,Cypher,Omen,Yoru,Fade"
Haven,Linares eSports,MURCIA NO EXISTE,13,4,10,2,2,3,"Breach,Cypher,Sova,Omen,Jett","Breach,Cypher,Sova,Omen,Jett"
Haven,meowmeowmeow,KHORE GAMING,13,7,4,4,3,9,"Breach,Cypher,Sova,Jett,Clove","Breach,Cypher,Sova,Omen,Jett"
Haven,Universae,Locked Esports,13,5,4,2,3,9,"Breach,Sova,Killjoy,Omen,Jett","Cypher,Sova,Phoenix,Omen,Neon"
Icebox,UnderDogs Gaming,Man I Love Fermin Trujin,8,13,5,7,6,3,"Sova,Killjoy,Viper,Reyna,Jett","Sova,Killjoy,Viper,Sage,Jett"
Bind,Team B,VOID (EU),11,13,8,4,9,3,"Raze,Viper,Brimstone,Skye,Gekko","Raze,Viper,Brimstone,Fade,Gekko"
Abyss,AMBYS Team,kosomaks,3,13,2,2,11,1,"Sova,Viper,Jett,Yoru,Astra","Cypher,Sova,Omen,Jett,KAY/O"
Sunset,Linares eSports,Team Opio,13,1,2,0,1,11,"Breach,Cypher,Sova,Omen,Neon","Breach,Cypher,Sova,Omen,Neon"
Haven,Las Palmas Unity,Top G,8,13,4,8,5,4,"Breach,Cypher,Sova,Omen,Jett","Breach,Sova,Killjoy,Omen,Jett"
Sunset,Universae,napolitana,13,2,10,2,0,3,"Breach,Raze,Cypher,Omen,Gekko","Breach,Raze,Cypher,Sova,Omen"
Lotus,Monta Club Ace,KHORE GAMING,9,13,3,7,6,6,"Breach,Killjoy,Omen,Jett,Gekko","Breach,Raze,Killjoy,Omen,Gekko"
Ascent,Nexum EC,Divine eSports,13,2,3,0,2,10,"Breach,Omen,Neon,Fade,Deadlock","Sova,Killjoy,Omen,Jett,KAY/O"
Ascent,Sayonara eSports,Team B,2,13,2,10,3,0,"Sova,Killjoy,Omen,Jett,KAY/O","Cypher,Sova,Omen,Jett,KAY/O"
Ascent,SLEIK Esports,Man I Love Fermin Trujin,7,13,3,9,4,4,"Cypher,Sova,Omen,Jett,KAY/O","Sova,Killjoy,Omen,Jett,KAY/O"
Haven,Team GMask,meowmeowmeow,2,13,2,10,3,0,"Breach,Cypher,Sova,Jett,Astra","Breach,Cypher,Sova,Omen,Jett"
Sunset,Team Opio,GoodNights,13,4,8,4,0,5,"Breach,Cypher,Sova,Omen,Neon","Raze,Cypher,Sova,Omen,Gekko"
Icebox,Nyegit Aimers,Top G,6,13,2,5,8,4,"Sova,Killjoy,Viper,Reyna,Jett","Sova,Viper,Jett,Chamber,Iso"
Haven,VOID (EU),LyokFox,13,8,6,3,5,7,"Breach,Sova,Killjoy,Omen,Jett","Breach,Sova,Killjoy,Omen,Jett"
Haven,kosomaks,Team C,13,11,7,5,6,6,"Breach,Sova,Killjoy,Omen,Neon","Cypher,Sova,Omen,Jett,Yoru"
Lotus,Genesik Gaming,napolitana,8,13,2,7,6,6,"Breach,Raze,Killjoy,Omen,Fade","Breach,Raze,Killjoy,Omen,Fade"
Lotus,Cruasan,Man I Love Fermin Trujin,1,13,1,11,2,0,"Breach,Raze,Killjoy,Omen,Skye","Breach,Raze,Killjoy,Omen,Fade"
Haven,AUDIO PORFA,Team B,8,13,4,5,8,4,"Breach,Sova,Killjoy,Omen,Neon","Breach,Sova,Killjoy,Omen,Neon"
Bind,meowmeowmeow,Los Papus,13,1,2,0,1,11,"Reyna,Yoru,Chamber,Iso,Clove","Raze,Reyna,Omen,Skye,Deadlock"
Haven,M80,TSM,13,9,8,2,7,5,"Breach,Sova,Killjoy,Omen,Jett","Breach,Cypher,Sova,Omen,Neon"
Icebox,M80,TSM,13,6,5,2,4,8,"Killjoy,Viper,Omen,KAY/O,Gekko","Killjoy,Viper,Reyna,Omen,Gekko"
Sunset,M80,TSM,12,14,7,6,8,5,"Breach,Cypher,Omen,Yoru,Gekko","Breach,Cypher,Omen,Neon,Gekko"
Ascent,TBS GC,Fourth Wall,13,8,6,6,2,7,"Sova,Killjoy,Omen,Jett,KAY/O","Sova,Killjoy,Omen,Jett,KAY/O"
Haven,PS5Patas,TOTALE Talents,13,9,6,4,5,7,"Breach,Sova,Killjoy,Jett,Astra","Cypher,Sova,Omen,Yoru,Iso"
Bind,TBS GC,Fourth Wall,13,9,7,5,4,6,"Raze,Viper,Brimstone,Skye,Gekko","Raze,Cypher,Brimstone,Jett,Fade"
Icebox,2Game Esports,Galorys,4,13,4,8,5,0,"Sova,Killjoy,Viper,Jett,KAY/O","Sova,Killjoy,Viper,Sage,Jett"
Bind,Athena's e-Sports,RocketggGC,12,14,7,6,8,5,"Raze,Cypher,Brimstone,Skye,Gekko","Raze,Cypher,Brimstone,Skye,Gekko"
Abyss,PROCURADAS,Synergy BR,13,11,6,6,5,7,"Breach,Cypher,Omen,Jett,Gekko","Cypher,Sova,Omen,Jett,KAY/O"
Ascent,PS5Patas,TOTALE Talents,13,6,8,4,2,5,"Sova,Killjoy,Omen,Jett,KAY/O","Cypher,Sova,Omen,Jett,Deadlock"
Lotus,REVOADA,xurisco,13,3,3,1,2,10,"Raze,Killjoy,Viper,Omen,Fade","Raze,Killjoy,Omen,Chamber,Fade"
Sunset,Vila das Flores,indescritiveis,13,10,9,3,7,4,"Breach,Sova,Sage,Omen,Neon","Cypher,Omen,Neon,Gekko,Clove"
Icebox,TBS GC,Fourth Wall,9,13,5,7,6,4,"Sova,Killjoy,Viper,Jett,Gekko","Sova,Killjoy,Viper,Jett,Gekko"
Abyss,2Game Esports,Galorys,11,13,4,8,5,7,"Cypher,Sova,Omen,Jett,KAY/O","Cypher,Sova,Omen,Jett,Gekko"
Ascent,REVOADA,xurisco,13,3,3,1,2,10,"Sova,Killjoy,Omen,Jett,KAY/O","Sova,Killjoy,Omen,Jett,Chamber"
Icebox,PROCURADAS,Synergy BR,13,7,7,5,2,6,"Sova,Killjoy,Viper,Jett,Gekko","Sova,Killjoy,Viper,Jett,KAY/O"
Ascent,Vila das Flores,indescritiveis,13,0,1,0,0,12,"Cypher,Sova,Phoenix,Omen,Jett","Sova,Killjoy,Omen,Jett,KAY/O"
Sunset,Athena's e-Sports,RocketggGC,8,13,3,6,7,5,"Breach,Cypher,Omen,Neon,Gekko","Breach,Raze,Cypher,Omen,Gekko"
Icebox,PS5Patas,TOTALE Talents,10,13,2,9,4,8,"Killjoy,Viper,Jett,Gekko,Iso","Sova,Killjoy,Viper,Jett,Gekko"
Ascent,All Knights,RETA Esports,6,13,1,6,7,5,"Sova,Killjoy,Omen,Jett,KAY/O","Sova,Killjoy,Omen,Jett,KAY/O"
Sunset,Str1ve eSports,Cuban Raft Raiders,13,6,10,2,4,3,"Breach,Cypher,Sova,Omen,Neon","Breach,Cypher,Sova,Omen,Neon"
Sunset,AMBYS Team,The giornalisti,4,13,2,3,10,2,"Cypher,Sova,Omen,KAY/O,Neon","Raze,Cypher,Omen,Gekko,Iso"
Sunset,Poverineeh,Alicante Titans,9,13,4,8,5,5,"Breach,Cypher,Sova,Omen,Neon","Breach,Cypher,Sova,Omen,Jett"
Sunset,bazinga esports,KHORE GAMING,13,10,8,3,7,5,"Breach,Cypher,Sova,Omen","Cypher,Omen,Yoru,KAY/O,Neon"
Sunset,Team Galaga,Team GMask,13,2,3,0,2,10,"Raze,Cypher,Omen,KAY/O,Gekko","Breach,Raze,Cypher,Omen,Gekko"
Sunset,SLTitans Esports,EX0TIK GAMING,13,6,8,4,2,5,"Cypher,Omen,KAY/O,Neon,Iso","Breach,Raze,Cypher,Sova,Omen"
Sunset,1000rr club,InTenZive,6,13,1,6,7,5,"Breach,Raze,Cypher,Sova,Omen","Cypher,Sova,Omen,KAY/O,Neon"
Sunset,Nexum EC,Capacitanes,13,5,5,1,4,8,"Phoenix,KAY/O,Chamber,Harbor,Deadlock","Breach,Raze,Cypher,Omen,Gekko"
Sunset,DSYRE Academy,Dimonis,3,13,3,9,4,0,"Breach,Cypher,Sova,Omen,Neon","Cypher,Omen,KAY/O,Chamber,Gekko"
Sunset,Melilla Titans Academy,IAPEsports,1,13,1,11,2,0,"Breach,Cypher,Sova,Omen,Neon","Breach,Raze,Cypher,Omen,Yoru"
Sunset,Team Falcons Vega,BBL Queens,13,11,8,4,7,5,"Breach,Raze,Cypher,Omen,Gekko","Breach,Cypher,Sova,Omen,Neon"
Haven,Blindspot Academy,Blue Moon eSports,2,13,0,3,10,2,"Sova,Killjoy,Omen,Jett,KAY/O","Breach,Cypher,Sova,Jett,Astra"
Haven,All Knights,RETA Esports,9,13,1,9,4,8,"Breach,Cypher,Sova,Omen,Neon","Killjoy,Viper,Omen,Jett,Skye"
Abyss,Str1ve eSports,Cuban Raft Raiders,13,5,8,4,1,5,"Breach,Cypher,Sova,Jett,Astra","Cypher,Sova,Omen,Jett,KAY/O"
Bind,CGN Esports,PCIFIC Espor,8,13,7,5,8,1,"Raze,Sova,Viper,Brimstone,Sage","Raze,Viper,Brimstone,Fade,Gekko"
Lotus,Blindspot Academy,Blue Moon eSports,7,13,4,8,5,3,"Breach,Raze,Cypher,Omen,Gekko","Breach,Raze,Viper,Astra,Fade"
Icebox,Team Falcons Vega,BBL Queens,14,12,8,5,7,6,"Sova,Killjoy,Viper,Jett,Gekko","Sova,Killjoy,Viper,Jett,Iso"
Ascent,New Origins Esports,2strong,5,13,2,4,9,3,"Cypher,Sova,Omen,Jett,KAY/O","Sova,Killjoy,Phoenix,Omen,Jett"
Sunset,InTenZive,SLTitans Esports,5,13,0,6,7,5,"Raze,Cypher,Sova,Omen,Gekko","Cypher,Sova,Omen,KAY/O,Neon"
Sunset,Team GMask,Nexum EC,13,11,6,6,5,7,"Breach,Raze,Cypher,Omen,Gekko","Phoenix,KAY/O,Chamber,Harbor,Deadlock"
Sunset,EX0TIK GAMING,Team Galaga,13,11,7,5,6,6,"Breach,Raze,Cypher,Sova,Omen","Raze,Cypher,Omen,KAY/O,Gekko"
Sunset,RevenantVAL,1000rr club,8,13,5,7,6,3,"Breach,Cypher,Omen,Neon,Gekko","Breach,Raze,Cypher,Omen,Gekko"
Sunset,Dimonis,Capacitanes,13,9,6,6,3,7,"Raze,Cypher,Omen,KAY/O,Gekko","Raze,Cypher,Sova,Omen,Gekko"
Sunset,The Avengers,bazinga esports,9,13,6,6,7,3,"Breach,Cypher,Sova,Omen,Neon","Breach,Cypher,Sova,Omen,Neon"
Sunset,IAPEsports,DSYRE Academy,9,13,3,7,6,6,"Breach,Raze,Cypher,Omen,Yoru","Breach,Cypher,Sova,Omen,Neon"
Sunset,Melilla Titans Academy,The giornalisti,13,5,10,2,3,3,"Breach,Cypher,Sova,Omen,Neon","Breach,Cypher,Sova,Omen,Neon"
Sunset,AMBYS Team,Poverineeh,13,11,5,7,4,8,"Cypher,Sova,Omen,KAY/O,Neon","Breach,Cypher,Omen,Neon,Gekko"
Sunset,Velocity Gaming (EU),Lost Dynasty,13,3,10,2,1,3,"Breach,Cypher,Sova,Omen,Neon","Breach,Cypher,Sova,Omen,Neon"
Abyss,CGN Esports,PCIFIC Espor,9,13,5,7,6,4,"Cypher,Sova,Phoenix,Omen,Jett","Cypher,Sova,Omen,Jett,KAY/O"
Sunset,New Origins Esports,2strong,12,14,6,7,7,6,"Breach,Cypher,Sova,Omen,Neon","Breach,Cypher,Sova,Omen,Neon"
Bind,Team Falcons Vega,BBL Queens,13,15,9,5,10,4,"Raze,Viper,Brimstone,Skye,Gekko","Breach,Raze,Cypher,Omen,Skye"
Haven,Velocity Gaming (EU),Lost Dynasty,13,9,6,6,3,7,"Cypher,Sova,Omen,Yoru,Iso","Breach,Sova,Killjoy,Omen,Jett"
Lotus,CGN Esports,PCIFIC Espor,9,13,6,4,9,3,"Raze,Sova,Killjoy,Omen,Gekko","Breach,Cypher,Sova,Omen,Neon"
Haven,ALTERNATE aTTaX Ruby,Karmine Corp GC,2,13,0,3,10,2,"Breach,Cypher,Sova,Omen,Jett","Breach,Sova,Killjoy,Omen,Neon"
Sunset,ALTERNATE aTTaX Ruby,Karmine Corp GC,0,13,0,12,1,0,"Breach,Raze,Cypher,Sova,Omen","Breach,Cypher,Sova,Omen,Neon"
Haven,Pegasus Esports,Fruit Bowl,13,5,8,4,1,5,"Breach,Sova,Killjoy,Omen,Jett","Breach,Cypher,Sova,Omen,Neon"
Bind,Team Ruthless,Perfectionists,10,13,6,5,8,4,"Raze,Brimstone,Chamber,Fade,Gekko","Raze,Viper,Brimstone,Fade,Gekko"
Sunset,Pegasus Esports,Fruit Bowl,1,13,0,2,11,1,"Breach,Raze,Cypher,Sova,Omen","Raze,Cypher,Omen,KAY/O,Gekko"
Haven,Team Accelerate,Team Serenity,10,13,3,9,4,7,"Breach,Cypher,Sova,Omen,Jett","Sova,Killjoy,Omen,Jett,Iso"
Haven,Team Ruthless,Perfectionists,13,11,6,6,5,7,"Sova,Killjoy,Reyna,Omen,Jett","Breach,Cypher,Sova,Omen,Jett"
Bind,NewD,Dark Horse Knights,13,6,6,1,5,7,"Breach,Cypher,Viper,Brimstone,Yoru","Raze,Viper,Brimstone,Skye,Gekko"
Ascent,Team Ruthless,Perfectionists,9,13,6,6,7,3,"Sova,Killjoy,Omen,Jett,KAY/O","Sova,Killjoy,Omen,Jett,KAY/O"
Abyss,Team Accelerate,Team Serenity,10,13,6,6,7,4,"Breach,Cypher,Omen,Jett,Harbor","Sova,Viper,Jett,Yoru,Astra"
Haven,NewD,Dark Horse Knights,13,6,6,1,5,7,"Breach,Cypher,Omen,Jett,Deadlock","Breach,Sova,Killjoy,Omen,Jett"
Haven,Galorys,M80,12,14,7,6,8,5,"Breach,Sova,Killjoy,Omen,Jett","Breach,Sova,Killjoy,Omen,Jett"
Sunset,Galorys,M80,13,11,8,4,7,5,"Breach,Cypher,Sova,Omen,Neon","Breach,Cypher,Omen,Yoru,Gekko"
Icebox,Galorys,M80,11,13,6,6,7,5,"Sova,Killjoy,Viper,Sage,Jett","Killjoy,Viper,Omen,KAY/O,Gekko"
Bind,All Knights,2Game Esports,13,10,10,1,9,3,"Raze,Cypher,Brimstone,Skye,Deadlock","Raze,Viper,Brimstone,Skye,Gekko"
Abyss,All Knights,2Game Esports,13,7,6,6,1,7,"Cypher,Sova,Omen,Jett,KAY/O","Cypher,Sova,Omen,Jett,KAY/O"
Sunset,All Knights,2Game Esports,10,13,6,5,8,4,"Breach,Cypher,Sova,Omen,Neon","Breach,Cypher,Sova,Omen,Neon"
Haven,Odd 1 OUT,ALTERNATE aTTaX Ruby,13,11,4,8,3,9,"Breach,Sova,Killjoy,Omen,Jett","Breach,Cypher,Sova,Omen,Jett"
Sunset,Odd 1 OUT,ALTERNATE aTTaX Ruby,13,10,7,5,5,6,"Breach,Cypher,Sova,Omen,Neon","Breach,Raze,Cypher,Sova,Omen"
Haven,Team Falcons Vega,HEROIC Valkyries,7,13,3,5,8,4,"Breach,Cypher,Sova,Omen,Jett","Cypher,Sova,Omen,Yoru,Iso"
Abyss,Team Falcons Vega,HEROIC Valkyries,2,13,2,10,3,0,"Cypher,Sova,Omen,Jett,KAY/O","Breach,Cypher,Sova,Jett,Astra"
Icebox,RETA Esports,M80,9,13,3,7,6,6,"Sova,Killjoy,Viper,Jett,Harbor","Killjoy,Viper,Omen,KAY/O,Gekko"
Lotus,RETA Esports,M80,13,10,5,6,4,8,"Raze,Killjoy,Viper,Omen,Fade","Breach,Cypher,Omen,Yoru,Fade"
Haven,RETA Esports,M80,4,13,4,8,5,0,"Killjoy,Viper,Omen,Jett,Skye","Breach,Sova,Killjoy,Omen,Jett"
Abyss,TSM,2Game Esports,9,13,5,7,6,4,"Sova,Viper,Jett,Yoru,Astra","Cypher,Sova,Omen,Jett,KAY/O"
Bind,Permitta Unicorns GC,FOKUS Sakura,5,13,3,9,4,2,"Raze,Viper,Brimstone,Skye,Gekko","Raze,Viper,Brimstone,Yoru,Gekko"
Icebox,TSM,2Game Esports,11,13,6,6,7,5,"Killjoy,Viper,Reyna,Omen,Gekko","Sova,Killjoy,Viper,Jett,KAY/O"
Sunset,Veni eSports Venom,NEON BLADE,6,13,4,3,10,2,"Breach,Cypher,Sova,Omen,Neon","Breach,Raze,Cypher,Omen,Gekko"
Sunset,Permitta Unicorns GC,FOKUS Sakura,8,13,2,7,6,6,"Breach,Raze,Cypher,Sova,Omen","Breach,Cypher,Omen,Neon,Fade"
Sunset,TSM,2Game Esports,13,11,6,6,5,7,"Breach,Cypher,Omen,Neon,Gekko","Breach,Cypher,Sova,Omen,Neon"
Haven,Scald eSport GC,SSP Numina,5,13,4,8,5,1,"Breach,Killjoy,Omen,Jett,Fade","Breach,Sova,Killjoy,Omen,Jett"
Haven,Veni eSports Venom,NEON BLADE,8,13,4,5,8,4,"Breach,Sova,Killjoy,Omen,Neon","Breach,Sova,Killjoy,Omen,Jett"
Bind,Silly Seals,Dortmund eSports Dynasty,13,9,7,5,4,6,"Raze,Viper,Astra,Fade,Gekko","Breach,Raze,Cypher,Brimstone,Fade"
Abyss,teamhoppers,Blindspot Kunai,13,5,6,0,5,7,"Sova,Sage,Jett,Astra,KAY/O","Breach,Cypher,Omen,Neon,Gekko"
Haven,Entropy Azúcar,LVENGERS,12,14,4,9,5,8,"Breach,Sova,Killjoy,Omen,Jett","Breach,Sova,Killjoy,Omen,Jett"
Sunset,RIZON Sugar,ALTERNATE aTTaX Ruby,6,13,4,8,5,2,"Breach,Raze,Cypher,Omen,Fade","Breach,Raze,Cypher,Sova,Omen"
Bind,Scald eSport GC,SSP Numina,8,13,7,5,8,1,"Breach,Raze,Cypher,Brimstone,Deadlock","Raze,Cypher,Skye,Astra,Deadlock"
Bind,Entropy Azúcar,LVENGERS,8,13,6,6,7,2,"Raze,Viper,Brimstone,Skye,Fade","Breach,Raze,Brimstone,Yoru,Harbor"
Lotus,RIZON Sugar,ALTERNATE aTTaX Ruby,2,13,0,3,10,2,"Breach,Raze,Cypher,Omen,Fade","Breach,Raze,Cypher,Omen,Fade"
Haven,Silly Seals,Dortmund eSports Dynasty,13,11,7,5,6,6,"Breach,Cypher,Sova,Omen,Neon","Breach,Sova,Killjoy,Omen,Jett"
Lotus,Veni eSports Venom,NEON BLADE,14,12,9,4,8,5,"Breach,Omen,Chamber,Neon,Gekko","Raze,Killjoy,Astra,Chamber,Fade"
Haven,teamhoppers,Blindspot Kunai,13,7,6,2,5,7,"Raze,Killjoy,Viper,Skye,Astra","Breach,Sova,Killjoy,Omen,Jett"
Haven,Galorys,All Knights,7,13,5,3,10,2,"Breach,Sova,Killjoy,Omen,Jett","Breach,Cypher,Sova,Omen,Neon"
Sunset,Galorys,All Knights,13,15,8,6,9,5,"Breach,Cypher,Sova,Omen,Neon","Breach,Cypher,Sova,Omen,Neon"
Haven,TSM,RETA Esports,5,13,2,4,9,3,"Breach,Cypher,Sova,Omen,Neon","Killjoy,Viper,Omen,Jett,Skye"
Bind,TSM,RETA Esports,13,6,4,3,3,9,"Raze,Brimstone,Skye,Gekko,Deadlock","Raze,Viper,Brimstone,Skye,Gekko"
Icebox,TSM,RETA Esports,6,13,5,7,6,1,"Killjoy,Viper,Reyna,Omen,Gekko","Sova,Killjoy,Viper,Jett,Harbor"
Ascent,ROA SYNC,Reveal Multigaming Jushimori,5,13,3,9,4,2,"Cypher,Sova,Omen,Jett,KAY/O","Sova,Killjoy,Phoenix,Omen,Jett"
Bind,ROA SYNC,Reveal Multigaming Jushimori,6,13,1,6,7,5,"Breach,Raze,Cypher,Brimstone,Skye","Breach,Raze,Cypher,Brimstone,Fade"
Haven,Team Falcons Vega,GIANTX GC,13,7,4,4,3,9,"Breach,Cypher,Sova,Omen,Jett","Killjoy,Viper,Omen,Yoru,Gekko"
Sunset,Team Falcons Vega,GIANTX GC,3,13,0,4,9,3,"Breach,Raze,Cypher,Omen,Gekko","Breach,Cypher,Sova,Omen,Neon"
Abyss,Team Falcons Vega,GIANTX GC,13,8,9,3,5,4,"Cypher,Sova,Omen,Jett,KAY/O","Breach,Cypher,Jett,Astra,Gekko"
Icebox,M80,All Knights,15,13,6,8,5,9,"Killjoy,Viper,Omen,KAY/O,Gekko","Sova,Killjoy,Viper,Gekko,Iso"
Sunset,M80,All Knights,14,12,9,4,8,5,"Breach,Cypher,Omen,Yoru,Gekko","Breach,Cypher,Sova,Omen,Neon"
Abyss,Galorys,TSM,17,19,8,10,9,9,"Cypher,Sova,Omen,Jett,Gekko","Sova,Viper,Jett,Yoru,Astra"
Haven,Galorys,TSM,13,5,9,3,2,4,"Breach,Sova,Killjoy,Omen,Jett","Breach,Cypher,Sova,Omen,Jett"
Bind,Galorys,TSM,12,14,8,5,9,4,"Raze,Viper,Brimstone,Fade,Gekko","Raze,Brimstone,Skye,Gekko,Deadlock"
Sunset,RETA Esports,2Game Esports,7,13,3,5,8,4,"Breach,Cypher,Sova,Omen,Neon","Breach,Cypher,Sova,Omen,Neon"
Icebox,Scald eSport GC,TOG Kitsune,13,10,6,5,5,7,"Sova,Killjoy,Viper,Sage,Jett","Sova,Killjoy,Viper,Sage,Jett"
Ascent,SSP Numina,ALTERNATE aTTaX Ruby,8,13,4,8,5,4,"Sova,Killjoy,Omen,Jett,KAY/O","Sova,Killjoy,Omen,Jett,KAY/O"
Bind,RETA Esports,2Game Esports,2,13,0,3,10,2,"Raze,Viper,Brimstone,Skye,Gekko","Raze,Viper,Brimstone,Skye,Gekko"
Ascent,Entropy Azúcar,Blindspot Kunai,13,7,8,4,3,5,"Sova,Killjoy,Omen,Jett,KAY/O","Breach,Sova,Killjoy,Omen,Jett"
Ascent,LVENGERS,Dortmund eSports Dynasty,13,1,11,1,0,2,"Cypher,Sova,Omen,Yoru,Deadlock","Sova,Killjoy,Omen,Jett,KAY/O"
Bind,Scald eSport GC,TOG Kitsune,13,10,6,6,4,7,"Breach,Raze,Cypher,Brimstone,Deadlock","Raze,Cypher,Viper,Omen,Skye"
Sunset,SSP Numina,ALTERNATE aTTaX Ruby,1,13,0,2,11,1,"Breach,Raze,Cypher,Omen,Gekko","Breach,Raze,Cypher,Sova,Omen"
Lotus,Entropy Azúcar,Blindspot Kunai,13,9,8,4,5,5,"Breach,Raze,Killjoy,Omen,Fade","Breach,Raze,Killjoy,Omen,Gekko"
Lotus,LVENGERS,Dortmund eSports Dynasty,11,13,2,10,3,9,"Breach,Raze,Cypher,Omen,Fade","Breach,Raze,Killjoy,Omen,Fade"
Ascent,SK Nebula,Permitta Unicorns GC,13,7,6,6,1,7,"Sova,Killjoy,Omen,Jett,KAY/O","Sova,Killjoy,Omen,Jett,KAY/O"
Ascent,Veni eSports Venom,ROA SYNC,5,13,3,3,10,2,"Sova,Killjoy,Omen,Jett,KAY/O","Cypher,Sova,Omen,Jett,KAY/O"
Ascent,Silly Seals,NEON BLADE,4,13,0,12,1,4,"Sova,Killjoy,Omen,Jett,KAY/O","Sova,Killjoy,Omen,Jett,KAY/O"
Abyss,teamhoppers,Reveal Multigaming Jushimori,13,3,9,3,0,4,"Sova,Sage,Jett,Astra,KAY/O","Breach,Cypher,Jett,Astra"
Haven,RIZON Sugar,FOKUS Sakura,9,13,3,9,4,6,"Breach,Cypher,Omen,Yoru,Iso","Sova,Killjoy,Omen,Jett,Iso"
Haven,Silly Seals,NEON BLADE,2,13,0,3,10,2,"Breach,Sova,Killjoy,Omen,Neon","Breach,Sova,Killjoy,Omen,Jett"
Haven,SK Nebula,Permitta Unicorns GC,13,6,5,2,4,8,"Breach,Cypher,Sova,Omen,Jett","Breach,Cypher,Sova,Omen,Jett"
Haven,teamhoppers,Reveal Multigaming Jushimori,13,2,3,0,2,10,"Raze,Killjoy,Viper,Skye,Astra","Breach,Sova,Killjoy,Omen,Jett"
Haven,LVENGERS,Dortmund eSports Dynasty,13,11,8,4,7,5,"Breach,Sova,Killjoy,Omen,Jett","Breach,Sova,Killjoy,Omen,Jett"
Bind,Veni eSports Venom,ROA SYNC,6,13,4,8,5,2,"Breach,Raze,Viper,Brimstone,Gekko","Breach,Raze,Cypher,Brimstone,Skye"
Haven,Entropy Azúcar,Blindspot Kunai,14,16,8,7,9,6,"Breach,Sova,Killjoy,Omen,Jett","Breach,Sova,Killjoy,Omen,Jett"
Abyss,RIZON Sugar,FOKUS Sakura,0,13,0,12,1,0,"Cypher,Sova,Omen,Yoru,Astra","Breach,Cypher,Omen,Jett,Neon"
Sunset,Odd 1 OUT,NASR Ignite,10,13,6,6,7,4,"Breach,Cypher,Sova,Omen,Neon","Cypher,Sova,Omen,KAY/O,Neon"
Ascent,Odd 1 OUT,NASR Ignite,5,13,0,6,7,5,"Sova,Killjoy,Omen,Jett,KAY/O","Cypher,Sova,Omen,Jett,Deadlock"
Haven,Odd 1 OUT,NASR Ignite,13,9,5,5,4,8,"Breach,Sova,Killjoy,Omen,Jett","Breach,Cypher,Sova,Omen,Neon"
Haven,ZINGERS,KineTiX eSports X1,13,9,5,7,2,8,"Breach,Killjoy,Omen,Jett,Iso","Breach,Cypher,Sova,Jett,Astra"
Sunset,NASR Ignite,ALTERNATE aTTaX Ruby,5,13,1,5,8,4,"Cypher,Sova,Omen,KAY/O,Neon","Breach,Raze,Cypher,Sova,Omen"
Lotus,The Cult,Defient Esports,11,13,6,6,7,5,"Raze,Killjoy,Omen,Skye,Fade","Breach,Raze,Killjoy,Omen,Fade"
Abyss,NASR Ignite,ALTERNATE aTTaX Ruby,15,17,6,10,7,9,"Cypher,Sova,Omen,Jett,KAY/O","Sova,Sage,Jett,Astra,KAY/O"
Haven,The Cult,Defient Esports,9,13,6,6,7,3,"Breach,Raze,Cypher,Omen,Skye","Breach,Sova,Killjoy,Omen,Neon"
Sunset,Team Falcons Vega,Valiant GC,14,12,10,3,9,4,"Breach,Raze,Cypher,Omen,Gekko","Breach,Cypher,Sova,Omen,Neon"
Haven,Team Falcons Vega,Valiant GC,14,12,9,4,8,5,"Breach,Cypher,Sova,Omen,Jett","Breach,Sova,Killjoy,Omen,Jett"
Sunset,K7 Esports GC,New Combat Line GC,13,9,7,3,6,6,"Cypher,Omen,Jett,Gekko,Iso","Raze,Cypher,Sova,Omen,Iso"
Lotus,K7 Esports GC,New Combat Line GC,7,13,4,4,9,3,"Cypher,Omen,Jett,Gekko,Iso","Raze,Killjoy,Viper,Omen,Fade"
Haven,K7 Esports GC,New Combat Line GC,13,6,11,1,5,2,"Breach,Cypher,Sova,Omen,Jett","Breach,Sova,Killjoy,Phoenix,Omen"
Abyss,K7 Esports GC,New Combat Line GC,7,13,3,5,8,4,"Breach,Cypher,Sova,Omen,Jett","Breach,Cypher,Sova,Omen,Neon"
Ascent,K7 Esports GC,New Combat Line GC,13,9,6,6,3,7,"Sova,Killjoy,Omen,Jett,KAY/O","Sova,Killjoy,Omen,Jett,KAY/O"
Abyss,The Ultimates,PCIFIC Espor,7,13,4,8,5,3,"Cypher,Sova,Omen,Jett,KAY/O","Cypher,Sova,Omen,Jett,KAY/O"
Bind,Blue Moon eSports,Tap Tap Boom eSports,13,5,2,4,1,11,"Breach,Raze,Cypher,Brimstone,Fade","Raze,Viper,Brimstone,Fade,Gekko"
Ascent,GIANTX GC,BBL Queens,13,6,4,3,3,9,"Sova,Killjoy,Omen,Jett,KAY/O","Sova,Killjoy,Omen,Jett,KAY/O"
Bind,Team Liquid Brazil,TBS GC,13,4,3,2,2,10,"Raze,Cypher,Viper,Brimstone,Skye","Raze,Viper,Brimstone,Skye,Gekko"
Haven,Blue Moon eSports,Tap Tap Boom eSports,13,6,6,1,5,7,"Breach,Cypher,Sova,Jett,Astra","Breach,Cypher,Sova,Omen,Jett"
Haven,The Ultimates,PCIFIC Espor,11,13,8,4,9,3,"Cypher,Sova,Omen,Neon,Iso","Breach,Sova,Killjoy,Omen,Jett"
Sunset,GIANTX GC,BBL Queens,13,8,6,6,2,7,"Breach,Cypher,Sova,Omen,Neon","Cypher,Sova,Neon,Iso,Clove"
Sunset,Team Liquid Brazil,TBS GC,13,9,6,6,3,7,"Raze,Cypher,Omen,KAY/O,Gekko","Cypher,Sova,Omen,KAY/O,Neon"
Lotus,Moon,The Easy Crew,6,13,2,5,8,4,"Raze,Killjoy,Omen,Skye,Neon","Raze,Killjoy,Viper,Omen,Fade"
Sunset,Apeks,CGN Esports,13,9,8,2,7,5,"Cypher,Sova,Omen,KAY/O,Neon","Raze,Cypher,Sova,Phoenix,Omen"
Abyss,G2 Gozen,Karmine Corp GC,13,10,8,3,7,5,"Sova,Killjoy,Yoru,Astra,Harbor","Cypher,Sova,Omen,Jett,KAY/O"
Haven,Moon,The Easy Crew,8,13,3,6,7,5,"Breach,Sova,Killjoy,Omen,Jett","Killjoy,Viper,Omen,Jett,Skye"
Ascent,Team Liquid Brazil,TBS GC,14,12,6,7,5,8,"Sova,Killjoy,Omen,Jett,KAY/O","Sova,Killjoy,Omen,Jett,KAY/O"
Ascent,Apeks,CGN Esports,13,5,5,1,4,8,"Cypher,Sova,Omen,Yoru,Deadlock","Sova,Killjoy,Phoenix,Jett,Astra"
Bind,G2 Gozen,Karmine Corp GC,13,4,3,2,2,10,"Raze,Brimstone,Omen,Skye,Gekko","Raze,Viper,Astra,Fade,Gekko"
Ascent,Union Atta I,Blindspot Academy,13,6,5,2,4,8,"Killjoy,Omen,Jett,KAY/O","Sova,Killjoy,Omen,Jett,KAY/O"
Abyss,Union Atta I,Blindspot Academy,13,9,5,7,2,8,"Sova,Omen,Yoru,Gekko","Cypher,Sova,Omen,Jett,KAY/O"
Bind,ASNA,SCARZ Youth,12,14,4,9,5,8,"Raze,Viper,Brimstone,Fade,Gekko","Raze,Viper,Brimstone,Reyna,Fade"
Haven,ASNA,SCARZ Youth,7,13,3,9,4,4,"Breach,Sova,Killjoy,Omen,Jett","Sova,Killjoy,Reyna,Omen,Jett"
Ascent,ASNA,SCARZ Youth,13,8,5,7,1,8,"Sova,Killjoy,Omen,Jett,KAY/O","Sova,Killjoy,Omen,Jett,KAY/O"
Icebox,SCARZ Youth,Haven Liberty,13,7,8,4,3,5,"Sova,Killjoy,Viper,Reyna,Jett","Sova,Killjoy,Reyna,Jett,Clove"
Ascent,SCARZ Youth,Haven Liberty,13,6,8,4,2,5,"Sova,Killjoy,Reyna,Omen,Jett","Sova,Killjoy,Omen,Jett,KAY/O"
Lotus,SCARZ Youth,Haven Liberty,4,13,0,5,8,4,"Raze,Killjoy,Omen,Fade,Clove","Raze,Omen,Chamber,Fade,Clove"
Ascent,ASNA,RE ENDLESS,13,3,10,2,1,3,"Sova,Killjoy,Omen,Jett,KAY/O","Sova,Killjoy,Jett,Astra,KAY/O"
Haven,ASNA,RE ENDLESS,13,7,7,1,6,6,"Breach,Sova,Killjoy,Omen,Jett","Breach,Cypher,Sova,Jett,Astra"
Haven,Shopify Rebellion,YFP X,10,13,5,7,6,5,"Breach,Cypher,Sova,Omen,Jett","Breach,Cypher,Sova,Omen,Jett"
Ascent,Shopify Rebellion,YFP X,13,9,7,5,4,6,"Cypher,Sova,Omen,Jett,Deadlock","Cypher,Sova,Omen,Jett,Deadlock"
Sunset,Berzerkers,washed,13,15,6,8,7,7,"Breach,Cypher,Sova,Omen,Neon","Breach,Cypher,Sova,Omen,Neon"
Haven,Northwood University,Maryville University,11,13,6,6,7,5,"Sova,Jett,Astra,Deadlock,Iso","Breach,Sova,Killjoy,Omen,Neon"
Abyss,Shopify Rebellion,YFP X,9,13,6,6,7,3,"Cypher,Sova,Omen,Jett,KAY/O","Cypher,Sova,Omen,Jett,Harbor"
Haven,Zen eSports GC,Deagle Ravagers,13,8,6,3,5,7,"Breach,Sova,Killjoy,Omen,Jett","Breach,Sova,Killjoy,Omen,Jett"
Icebox,Berzerkers,Special Grade,13,9,9,3,6,4,"Sova,Killjoy,Viper,Reyna,Jett","Sova,Killjoy,Viper,Jett,Clove"
Sunset,Prime (NA),Northwood University,8,13,5,4,9,3,"Breach,Cypher,Sova,Neon,Clove","Breach,Raze,Cypher,Sova,Omen"
Sunset,Bolivian Brawlers,Maryville University,2,13,2,10,3,0,"Breach,Cypher,Sova,Omen,Neon","Breach,Raze,Cypher,Sova,Omen"
Sunset,Blinn Esports,washed,8,13,4,5,8,4,"Breach,Cypher,Omen,Neon,Gekko","Breach,Cypher,Sova,Omen,Neon"
Haven,YFP X,oomfies,13,8,5,7,1,8,"Breach,Cypher,Sova,Omen,Jett","Breach,Cypher,Sova,Omen,Neon"
Haven,Hebron High School,Special Grade,4,13,1,11,2,3,"Breach,Killjoy,Reyna,Omen,Yoru","Breach,Cypher,Sova,Omen,Jett"
Haven,Koala Pound,Maryville University,3,13,0,4,9,3,"Breach,Cypher,Sova,Omen,Neon","Breach,Sova,Killjoy,Omen,Neon"
Sunset,Northwood University,Boise State University,13,5,8,4,1,5,"Breach,Raze,Cypher,Sova,Omen","Cypher,Sova,Omen,Yoru,Neon"
Lotus,Zen eSports GC,Deagle Ravagers,13,9,9,3,6,4,"Raze,Killjoy,Viper,Omen,Fade","Raze,Killjoy,Viper,Omen,Fade"
Lotus,Prime (NA),SeanGares' Kittens,13,6,6,1,5,7,"Raze,Sova,Killjoy,Omen,Clove","Breach,Killjoy,Omen,Neon,Gekko"
Haven,Blinn Esports,Columbia College,13,5,4,2,3,9,"Breach,Sova,Omen,Chamber,Neon","Breach,Sova,Killjoy,Omen,Yoru"
Haven,SaD Purple,Berzerkers,17,19,6,12,7,11,"Breach,Sova,Killjoy,Omen,Jett","Cypher,Sova,Omen,Yoru,Iso"
Ascent,Bolivian Brawlers,Non-Verbal,13,9,8,4,5,5,"Sova,Killjoy,Omen,Jett,KAY/O","Cypher,Sova,Omen,Yoru,Deadlock"
Sunset,washed,Painguins,13,5,9,3,2,4,"Breach,Cypher,Sova,Omen,Neon","Cypher,Sova,Omen,KAY/O,Neon"
Ascent,Shopify Rebellion,mesos millionaires,13,3,9,3,0,4,"Cypher,Sova,Omen,Jett,Deadlock","Sova,Killjoy,Jett,Astra,KAY/O"
Bind,ES Esports,Blinn Esports,6,13,2,10,3,4,"Raze,Cypher,Brimstone,Gekko,Deadlock","Raze,Viper,Brimstone,Skye"
Sunset,UCSD Gold,Koala Pound,9,13,4,8,5,5,"Cypher,Sova,Omen,KAY/O,Neon","Breach,Raze,Cypher,Omen,Gekko"
Sunset,Dexterity Gaming,Maryville University,3,13,1,11,2,2,"Breach,Raze,Cypher,Viper,Omen","Breach,Raze,Cypher,Sova,Omen"
Bind,Forsaken Shadows,Boise State University,9,13,4,6,7,5,"Raze,Cypher,Sova,Brimstone,Yoru","Raze,Brimstone,Skye,Gekko,Deadlock"
Lotus,YFP X,oomfies,20,18,10,9,9,10,"Raze,Killjoy,Viper,Omen,Fade","Raze,Cypher,Brimstone,Omen,Fade"
Ascent,YDZ Esports,Painguins,6,13,3,9,4,3,"Sova,Killjoy,Omen,Jett,KAY/O","Cypher,Sova,Omen,Yoru,Deadlock"
Haven,Prime (NA),Cumberland Rising,13,11,7,5,6,6,"Sova,Killjoy,Viper,Omen,Jett","Breach,Cypher,Sova,Omen,Neon"
Bind,Shopify Rebellion,mesos millionaires,13,4,5,0,4,8,"Raze,Cypher,Viper,Brimstone,Skye","Raze,Viper,Skye,Chamber,Clove"
Haven,Hebron High School,Christians Rottweilers,13,6,7,5,1,6,"Breach,Killjoy,Omen,Yoru,Neon","Breach,Cypher,Sova,Omen,Jett"
Haven,washed,MYVRA,13,0,1,0,0,12,"Breach,Cypher,Sova,Omen,Neon","Breach,Raze,Killjoy,Astra,Fade"
Lotus,Bolivian Brawlers,West Virginia University,13,10,5,7,3,8,"Breach,Killjoy,Omen,Neon,Fade","Breach,Cypher,Sova,Astra,Neon"
Sunset,Lemonade Stand,Non-Verbal,10,13,8,4,9,2,"Cypher,Sova,Omen,KAY/O,Neon","Breach,Cypher,Sova,Omen,Neon"
Icebox,whats a pretzel,Berzerkers,2,13,2,10,3,0,"Sova,Killjoy,Viper,Reyna,Jett","Sova,Killjoy,Viper,Reyna,Jett"
Haven,SeanGares' Kittens,OC Eagles,13,7,5,3,4,8,"Breach,Cypher,Sova,Omen,Neon","Breach,Cypher,Sova,Omen,Neon"
Ascent,Northwood University,zZz,13,2,10,2,0,3,"Cypher,Sova,Omen,Jett,Deadlock","Sova,Killjoy,Omen,Jett"
Bind,CSP Val Blue,Columbia College,10,13,4,7,6,6,"Breach,Raze,Brimstone,Omen,Skye","Breach,Brimstone,Yoru,Fade,Deadlock"
Bind,kellogs cereal,ES Esports,9,13,7,3,10,2,"Raze,Cypher,Viper,Skye,Clove","Raze,Cypher,Brimstone,Gekko,Deadlock"
Ascent,Dexterity Gaming,Event Horizon,13,3,9,3,0,4,"Sova,Killjoy,Omen,Jett","Sova,Killjoy,Omen,Jett,KAY/O"
Sunset,Prime (NA),KU Esports,13,9,7,3,6,6,"Breach,Cypher,Sova,Neon,Clove","Breach,Cypher,Omen,KAY/O,Neon"
Sunset,Bolivian Brawlers,Prospects Hitmen,13,6,5,2,4,8,"Breach,Raze,Cypher,Omen,Gekko","Breach,Raze,Cypher,Sova,Omen"
Haven,Lemonade Stand,Atlas Esports,13,2,3,0,2,10,"Omen,Yoru,Fade,Deadlock,Clove","Breach,Cypher,Sova,Omen,Jett"
Haven,YDZ Esports,Moon (NA),13,9,5,5,4,8,"Breach,Cypher,Sova,Omen,Neon","Breach,Cypher,Sova,Omen,Neon"
Haven,Koala Pound,USeeEye,15,13,7,7,6,8,"Breach,Cypher,Sova,Omen,Neon","Breach,Cypher,Sova,Omen,Neon"
Lotus,Hebron Black,zZz,1,13,1,11,2,0,"Breach,Raze,Killjoy,Omen,Fade","Breach,Cypher,Sova,Omen,Neon"
Haven,SaD Purple,Mythos Wraiths,13,6,9,3,3,4,"Breach,Sova,Killjoy,Omen,Jett","Killjoy,Viper,Omen,Jett,Skye"
Lotus,Dropouts,Painguins,8,13,6,6,7,2,"Raze,Killjoy,Viper,Omen,Fade","Breach,Cypher,Omen,Neon,Gekko"
Lotus,Origin,Non-Verbal,2,13,2,10,3,0,"Raze,Cypher,Omen,Fade,Gekko","Raze,Cypher,Omen,Fade,Deadlock"
Icebox,Christians Rottweilers,sharkie,13,10,6,5,5,7,"Sova,Killjoy,Viper,Jett,KAY/O","Sova,Killjoy,Viper,Reyna,Jett"
Haven,Northwood University,Northeastern Gold,13,3,3,1,2,10,"Sova,Jett,Astra,Deadlock,Iso","Breach,Sova,Killjoy,Omen,Jett"
Sunset,Vila das Flores,TBS GC,4,13,1,4,9,3,"Breach,Sova,Sage,Omen,Neon","Cypher,Sova,Omen,KAY/O,Neon"
Sunset,Ibreon Esports Sapphire,West Virginia University,2,13,2,10,3,0,"Breach,Cypher,Sova,Omen,Neon","Breach,Cypher,Sova,Omen,Neon"
Sunset,TMU Blue,Boise State University,13,15,7,7,8,6,"Breach,Cypher,Sova,Omen,Neon","Cypher,Sova,Omen,Yoru,Neon"
Bind,OMNISCIENT,Hebron High School,9,13,5,5,8,4,"Raze,Cypher,Brimstone,Yoru,Fade","Raze,Cypher,Brimstone,Skye,Yoru"
Lotus,whats a pretzel,Utica Blue,13,6,8,4,2,5,"Raze,Viper,Fade,Deadlock,Clove","Breach,Raze,Cypher,Omen,Fade"
Haven,Berzerkers,Siena Heights University,13,8,6,3,5,7,"Cypher,Sova,Omen,Yoru,Iso","Breach,Skye,Astra,Neon,Clove"
Bind,SeanGares' Kittens,Penguin Platoon,13,3,4,0,3,9,"Raze,Cypher,Viper,Brimstone,Skye","Raze,Viper,Fade,Gekko,Clove"
Bind,Harrisburg University,MYVRA,12,14,7,6,8,5,"Raze,Cypher,Viper,Brimstone,Gekko","Raze,Cypher,Brimstone,Skye,Fade"
Haven,A Good Team,UCSD Gold,4,13,2,10,3,2,"Breach,Cypher,Sova,Omen,Jett","Cypher,Sova,Omen,Neon,Iso"
Sunset,Aspyre x Swarm,OC Eagles,8,13,3,6,7,5,"Breach,Cypher,Sova,Omen,Neon","Breach,Raze,Cypher,Omen,Gekko"
Ascent,Cumberland Rising,Goth Girl Sanctuary,13,4,9,3,1,4,"Sova,Killjoy,Omen,Jett,KAY/O","Sova,Killjoy,Omen,Jett,KAY/O"
Ascent,5NC,Blinn Esports,9,13,3,9,4,6,"Breach,Sova,Killjoy,Omen,Jett","Cypher,Sova,Omen,Yoru,Deadlock"
Ascent,Columbia College,Shifty505,13,3,11,1,2,2,"Cypher,Sova,Omen,Yoru","Sova,Killjoy,Omen,Jett,KAY/O"
Sunset,PCIFIC Espor,CGN Esports,5,13,3,9,4,2,"Breach,Raze,Cypher,Omen,Gekko","Raze,Cypher,Sova,Phoenix,Omen"
Haven,CSP Val Blue,Omnipotence,13,0,12,0,0,1,"Breach,Cypher,Sova,Omen,Neon","Breach,Sova,Killjoy,Omen,Neon"
Haven,Team Galaga,RevenantVAL,13,9,5,5,4,8,"Breach,Sova,Killjoy,Omen,Jett","Breach,Cypher,Sova,Omen,Jett"
Haven,Nexum EC,Odyssey Gaming,13,2,3,0,2,10,"Breach,Viper,Omen,Neon","Breach,Cypher,Sova,Omen,Jett"
Haven,EX0TIK GAMING,IAPEsports,13,8,4,5,3,9,"Breach,Cypher,Sova,Omen,Jett","Breach,Cypher,Sova,Omen,Jett"
Haven,The giornalisti,SLTitans Esports,7,13,6,2,11,1,"Cypher,Sova,Omen,Yoru,Iso","Breach,Sova,Killjoy,Omen,Jett"
Haven,DSYRE Academy,AMBYS Team,13,7,7,1,6,6,"Breach,Cypher,Sova,Omen,Jett","Cypher,Sova,Omen,Yoru,Iso"
Haven,Melilla Titans Academy,InTenZive,9,13,3,9,4,6,"Breach,Killjoy,Astra,Neon,Fade","Breach,Cypher,Sova,Omen,Neon"
Haven,1000rr club,Team GMask,13,6,7,5,1,6,"Breach,Sova,Killjoy,Omen,Jett","Breach,Cypher,Sova,Jett,Astra"
Haven,Poverineeh,Dimonis,4,13,2,3,10,2,"Breach,Cypher,Sova,Omen,Jett","Cypher,Sova,Jett,Iso,Clove"
Ascent,Vila das Flores,TBS GC,4,13,4,8,5,0,"Cypher,Sova,Phoenix,Omen,Jett","Sova,Killjoy,Omen,Jett,KAY/O"
Ascent,PCIFIC Espor,CGN Esports,8,13,4,5,8,4,"Cypher,Sova,Omen,Jett,KAY/O","Sova,Killjoy,Phoenix,Jett,Astra"
Lotus,G2 Gozen,ALTERNATE aTTaX Ruby,13,5,3,3,2,10,"Raze,Cypher,Omen,Fade,Deadlock","Breach,Raze,Cypher,Omen,Fade"
Bind,Team Liquid Brazil,REVOADA,13,6,5,2,4,8,"Raze,Cypher,Viper,Brimstone,Skye","Raze,Cypher,Viper,Brimstone,Skye"
Abyss,PCIFIC Espor,CGN Esports,13,11,5,7,4,8,"Cypher,Sova,Omen,Jett,KAY/O","Cypher,Sova,Phoenix,Omen,Jett"
Abyss,G2 Gozen,ALTERNATE aTTaX Ruby,13,4,3,2,2,10,"Sova,Killjoy,Yoru,Astra,Harbor","Sova,Sage,Jett,Astra,KAY/O"
Ascent,Team Liquid Brazil,REVOADA,13,2,11,1,1,2,"Sova,Killjoy,Omen,Jett,KAY/O","Sova,Killjoy,Omen,Jett,KAY/O"
Haven,Melilla Titans Academy,EX0TIK GAMING,9,13,6,6,7,3,"Breach,Killjoy,Astra,Neon,Fade","Breach,Sova,Killjoy,Omen,Jett"
Haven,Dimonis,Team Galaga,11,13,5,7,6,6,"Breach,Cypher,Sova,Omen,Jett","Breach,Sova,Killjoy,Omen,Jett"
Haven,RevenantVAL,DSYRE Academy,13,6,5,2,4,8,"Breach,Cypher,Sova,Omen,Jett","Breach,Cypher,Sova,Omen,Jett"
Haven,The giornalisti,Poverineeh,13,4,3,2,2,10,"Cypher,Sova,Omen,Yoru,Iso","Breach,Cypher,Sova,Omen,Yoru"
Haven,Odyssey Gaming,SLTitans Esports,2,13,2,1,12,0,"Cypher,Sova,Killjoy,Omen,Jett","Breach,Sova,Killjoy,Omen,Jett"
Haven,bazinga esports,Team GMask,7,13,3,5,8,4,"Breach,Cypher,Sova,Omen,Jett","Breach,Cypher,Sova,Jett,Astra"
Haven,InTenZive,Capacitanes,13,6,4,3,3,9,"Cypher,Sova,Omen,Chamber,Neon","Breach,Sova,Killjoy,Omen,Jett"
Haven,1000rr club,AMBYS Team,13,5,3,3,2,10,"Breach,Sova,Killjoy,Omen,Jett","Cypher,Sova,Omen,Yoru,Iso"
Haven,Nexum EC,IAPEsports,13,15,2,12,3,11,"Breach,Viper,Omen,Neon","Breach,Cypher,Sova,Omen,Jett"
Lotus,Apeks,The Ultimates,13,5,2,4,1,11,"Raze,Cypher,Omen,KAY/O,Deadlock","Raze,Killjoy,Viper,Omen,Fade"
Sunset,BBL Queens,HEROIC Valkyries,13,1,11,1,0,2,"Cypher,Sova,Neon,Iso,Clove","Breach,Raze,Cypher,Sova,Astra"
Haven,Team Liquid Brazil,REVOADA,8,13,5,7,6,3,"Killjoy,Viper,Omen,Jett,Skye","Breach,Sova,Killjoy,Omen,Jett"
Icebox,BBL Queens,HEROIC Valkyries,13,5,8,4,1,5,"Sova,Killjoy,Viper,Jett,Iso","Sova,Killjoy,Viper,Sage,Clove"
Sunset,Apeks,The Ultimates,13,9,6,4,5,7,"Cypher,Sova,Omen,KAY/O,Neon","Breach,Raze,Cypher,Omen,Gekko"
Lotus,BBL Queens,HEROIC Valkyries,9,13,3,7,6,6,"Breach,Raze,Killjoy,Omen,Fade","Raze,Viper,Omen,Chamber,Fade"
Bind,oomfies,Tenax GC,13,4,9,3,1,4,"Raze,Viper,Brimstone,Skye,Deadlock","Raze,Viper,Brimstone,Skye,Deadlock"
Haven,Shopify Rebellion,Everyone Really Misses,13,9,7,5,4,6,"Breach,Cypher,Sova,Omen,Jett","Breach,Cypher,Sova,Omen,Neon"
Sunset,oomfies,Tenax GC,13,11,8,4,7,5,"Cypher,Sova,Omen,KAY/O,Neon","Breach,Cypher,Omen,Neon,Fade"
Haven,Teddy Tactics,mesos millionaires,6,13,2,5,8,4,"Breach,Sova,Killjoy,Omen,Neon","Breach,Sova,Killjoy,Jett,Clove"
Abyss,Shopify Rebellion,Everyone Really Misses,13,2,10,2,0,3,"Cypher,Sova,Omen,Jett,KAY/O","Sova,Viper,Jett,Yoru,Astra"
Sunset,YFP X,SaD FROST,13,10,7,4,6,6,"Breach,Raze,Cypher,Sova,Omen","Breach,Cypher,Omen,Neon,Gekko"
Lotus,Give Wingman 2 Nuclear Devices,Tenax GC,8,13,6,6,7,2,"Breach,Raze,Cypher,Omen,Gekko","Breach,Killjoy,Omen,Neon,Fade"
Ascent,Teddy Tactics,mesos millionaires,11,13,2,10,3,9,"Sova,Killjoy,Omen,Jett,KAY/O","Sova,Killjoy,Jett,Astra,KAY/O"
Abyss,YFP X,SaD FROST,13,3,4,0,3,9,"Cypher,Sova,Omen,Jett,Harbor","Cypher,Sova,Omen,Jett,Harbor"
Bind,Refrag,Everyone Really Misses,8,13,5,4,9,3,"Raze,Viper,Brimstone,Jett,Skye","Raze,Viper,Brimstone,Fade,Gekko"
Haven,Shopify Rebellion,Event Horizon GC,13,4,3,2,2,10,"Breach,Cypher,Sova,Omen,Jett","Breach,Sova,Killjoy,Omen,Jett"
Haven,Team Leveling,Vila das Flores,14,16,5,10,6,9,"Breach,Cypher,Sova,Omen,Neon","Breach,Cypher,Sova,Omen,Neon"
Haven,Refrag,Everyone Really Misses,13,8,7,2,6,6,"Cypher,Sova,Reyna,Omen,Jett","Breach,Cypher,Sova,Omen,Neon"
Ascent,Teddy Tactics,Bumble Bees,13,4,4,1,3,9,"Sova,Killjoy,Omen,Jett,KAY/O","Sova,Killjoy,Omen,Jett,KAY/O"
Bind,Give Wingman 2 Nuclear Devices,Tenax GC,16,14,7,8,6,9,"Raze,Viper,Brimstone,Skye,Gekko","Raze,Viper,Brimstone,Skye,Deadlock"
Lotus,oomfies,Catnappers,13,2,3,0,2,10,"Raze,Cypher,Brimstone,Omen,Fade","Breach,Raze,Cypher,Fade,Clove"
Abyss,YFP X,Erinite GC,13,5,8,4,1,5,"Cypher,Sova,Omen,Jett,Harbor","Cypher,Sova,Omen,Jett,Iso"
Ascent,Day By Day,SaD FROST,7,13,2,10,3,5,"Cypher,Sova,Omen,Jett,KAY/O","Sova,Killjoy,Omen,Jett,KAY/O"
Sunset,TBS GC,FURIA GC,13,10,8,3,7,5,"Cypher,Sova,Omen,KAY/O,Neon","Breach,Raze,Cypher,Omen,Gekko"
Haven,REVOADA,PS5Patas,13,4,9,3,1,4,"Breach,Sova,Killjoy,Omen,Jett","Breach,Cypher,Sova,Omen,Jett"
Ascent,Team Liquid Brazil,Athena's e-Sports,13,9,4,8,1,9,"Sova,Killjoy,Omen,Jett,KAY/O","Breach,Raze,Sova,Omen,Deadlock"
Haven,mesos millionaires, RITUAL RËAL,13,8,7,5,3,6,"Breach,Sova,Killjoy,Jett,Clove","Breach,Cypher,Sova,Omen,Jett"
Icebox,Shopify Rebellion,Event Horizon GC,13,5,8,4,1,5,"Sova,Killjoy,Viper,Jett,Harbor","Sova,Killjoy,Viper,Jett,Gekko"
Ascent,Team Leveling,Vila das Flores,7,13,3,5,8,4,"Sova,Killjoy,Omen,Jett,KAY/O","Cypher,Sova,Phoenix,Omen,Jett"
Haven,YFP X,Erinite GC,13,3,11,1,2,2,"Breach,Cypher,Sova,Omen,Jett","Breach,Sova,Killjoy,Omen,Neon"
Abyss,Refrag,Everyone Really Misses,6,13,0,7,6,6,"Sova,Omen,Jett,Astra,KAY/O","Sova,Viper,Jett,Yoru,Astra"
Bind,TBS GC,FURIA GC,13,1,11,1,0,2,"Raze,Viper,Brimstone,Skye,Gekko","Raze,Brimstone,Reyna,Skye,Clove"
Ascent,REVOADA,PS5Patas,13,4,5,0,4,8,"Sova,Killjoy,Omen,Jett,KAY/O","Sova,Killjoy,Omen,Jett,KAY/O"
Haven,Teddy Tactics,Bumble Bees,13,11,3,9,2,10,"Breach,Cypher,Sova,Omen,Neon","Breach,Sova,Killjoy,Omen,Jett"
Bind,Team Liquid Brazil,Athena's e-Sports,13,0,1,0,0,12,"Raze,Cypher,Viper,Brimstone,Skye","Raze,Cypher,Brimstone,Skye,Gekko"
Haven,oomfies,Catnappers,13,2,3,0,2,10,"Breach,Cypher,Sova,Omen,Neon","Breach,Cypher,Sova,Omen,Jett"
Haven,Day By Day,SaD FROST,7,13,3,9,4,4,"Breach,Cypher,Sova,Omen,Neon","Breach,Cypher,Sova,Omen,Neon"
Ascent,mesos millionaires, RITUAL RËAL,13,2,1,2,0,12,"Sova,Killjoy,Jett,Astra,KAY/O","Cypher,Sova,Omen,Jett,KAY/O"
Ascent,HEROIC Valkyries,Valiant GC,7,13,3,9,4,4,"Sova,Killjoy,Omen,Jett,KAY/O","Cypher,Sova,Omen,Jett,Deadlock"
Icebox,HEROIC Valkyries,Valiant GC,9,13,5,5,8,4,"Sova,Killjoy,Viper,Sage,Clove","Sova,Killjoy,Viper,Sage,Jett"
Lotus,HEROIC Valkyries,Valiant GC,17,15,9,7,8,8,"Raze,Viper,Omen,Chamber,Fade","Breach,Killjoy,Omen,Neon,Fade"
Lotus,Karmine Corp GC,Odd 1 OUT,13,8,8,4,4,5,"Breach,Cypher,Omen,Neon,Fade","Breach,Cypher,Sova,Omen,Neon"
Haven,Karmine Corp GC,Odd 1 OUT,13,10,7,4,6,6,"Breach,Sova,Killjoy,Omen,Neon","Breach,Sova,Killjoy,Omen,Jett"
Ascent,Team Liquid Brazil,Kiwizitos,13,5,9,3,2,4,"Sova,Killjoy,Omen,Jett,KAY/O","Sova,Killjoy,Omen,Jett,KAY/O"
Haven,Team Leveling,PROCURADAS,13,3,4,0,3,9,"Breach,Cypher,Sova,Omen,Neon","Breach,Cypher,Sova,Omen,Jett"
Abyss,Team Leveling,PROCURADAS,13,5,10,2,3,3,"Sova,Omen,Astra,KAY/O,Neon","Breach,Cypher,Omen,Jett,Gekko"
Icebox,Team Liquid Brazil,Kiwizitos,13,6,6,1,5,7,"Sova,Killjoy,Viper,Sage,Jett","Sova,Killjoy,Viper,Jett,Clove"
Bind,Athena's e-Sports,TOTALE Talents,13,7,8,4,3,5,"Raze,Cypher,Brimstone,Skye,Gekko","Raze,Viper,Brimstone,Fade,Gekko"
Haven,FURIA GC,Synergy BR,13,5,5,1,4,8,"Breach,Sova,Killjoy,Omen,Jett","Breach,Cypher,Sova,Omen,Neon"
Abyss,PS5Patas,As Estagiarias,13,11,4,8,3,9,"Cypher,Sova,Omen,Jett,KAY/O","Cypher,Jett,Gekko,Deadlock,Clove"
Lotus,Vila das Flores,BLOOD Stars,13,5,7,5,0,6,"Breach,Cypher,Omen,Neon,Fade","Breach,Raze,Killjoy,Omen,Gekko"
Lotus,REVOADA,Tarja Preta AIM,13,4,10,2,2,3,"Raze,Killjoy,Viper,Omen,Fade","Breach,Killjoy,Omen,Jett,Iso"
Lotus,PS5Patas,As Estagiarias,13,6,9,3,3,4,"Raze,Killjoy,Viper,Omen,Gekko","Breach,Raze,Killjoy,Omen,Gekko"
Icebox,FURIA GC,Synergy BR,13,10,5,6,4,8,"Sova,Killjoy,Viper,Reyna,Jett","Sova,Killjoy,Viper,Jett,KAY/O"
Haven,Vila das Flores,BLOOD Stars,13,1,11,1,0,2,"Breach,Cypher,Sova,Omen,Neon","Breach,Sova,Killjoy,Omen,Neon"
Abyss,Athena's e-Sports,TOTALE Talents,13,6,6,1,5,7,"Cypher,Sova,Omen,Jett,Harbor","Cypher,Sova,Omen,Jett,Harbor"
Bind,REVOADA,Tarja Preta AIM,13,2,12,0,2,1,"Raze,Cypher,Viper,Brimstone,Skye","Raze,Viper,Jett,Fade,Clove"
Abyss,ASNA,AMORIS Vega,13,9,7,5,4,6,"Breach,Jett,Astra,Fade,Harbor","Cypher,Sova,Jett,Astra,Gekko"
Bind,ASNA,AMORIS Vega,14,12,9,4,8,5,"Raze,Viper,Brimstone,Fade,Gekko","Raze,Viper,Brimstone,Fade,Gekko"
Icebox,SCARZ Youth,ESR Selection,13,7,7,1,6,6,"Sova,Killjoy,Viper,Reyna,Jett","Sova,Killjoy,Viper,Jett,KAY/O"
Haven,ENFANT,RE ENDLESS,2,13,0,3,10,2,"Breach,Sova,Killjoy,Omen,Jett","Breach,Cypher,Sova,Jett,Astra"
Icebox,Reignite Lily,Haven Liberty,8,13,4,8,5,4,"Sova,Killjoy,Viper,Jett,Harbor","Sova,Killjoy,Jett,Iso,Clove"
Sunset,Reignite Lily,Haven Liberty,0,13,0,12,1,0,"Cypher,Sova,Omen,KAY/O,Neon","Raze,Cypher,Sova,Deadlock,Clove"
Ascent,ASNA,AMORIS Vega,7,13,3,9,4,4,"Sova,Killjoy,Omen,Jett,KAY/O","Sova,Killjoy,Omen,Jett,KAY/O"
Ascent,SCARZ Youth,ESR Selection,13,9,5,5,4,8,"Sova,Killjoy,Reyna,Omen,Jett","Sova,Killjoy,Omen,Jett,KAY/O"
Lotus,ENFANT,RE ENDLESS,8,13,7,5,8,1,"Raze,Killjoy,Omen,Astra,Fade","Breach,Raze,Omen,Chamber,Fade"
Ascent,KS Esports GC,MYVRA,10,13,2,9,4,8,"Cypher,Sova,Omen,Yoru,Deadlock","Sova,Killjoy,Jett,KAY/O,Clove"
Abyss,KS Esports GC,MYVRA,9,13,6,6,7,3,"Cypher,Sova,Omen,Jett,Astra","Breach,Raze,Cypher,Sova,Astra"
Lotus,Leviatán GC,FiRePOWER GC,10,13,3,8,5,7,"Breach,Cypher,Omen,Neon,Iso","Breach,Cypher,Omen,Neon,Fade"
Ascent,Bumble Bees,Skyline Dreamers GC,13,8,9,3,5,4,"Sova,Killjoy,Omen,Jett,KAY/O","Sova,Killjoy,Omen,Jett,KAY/O"
Haven,Leviatán GC,FiRePOWER GC,6,13,5,2,11,1,"Breach,Cypher,Sova,Omen,Neon","Breach,Sova,Killjoy,Omen,Neon"
Lotus,VO Blossoms, RITUAL RËAL,5,13,4,8,5,1,"Raze,Killjoy,Omen,Fade,Gekko","Raze,Cypher,Omen,Fade,Deadlock"
Bind,Bumble Bees,Skyline Dreamers GC,13,8,6,3,5,7,"Raze,Viper,Brimstone,Skye,Deadlock","Raze,Cypher,Brimstone,Skye,Yoru"
Lotus,Erinite GC,minions united GC,13,10,6,6,4,7,"Raze,Killjoy,Omen,Fade,Gekko","Breach,Raze,Omen,Fade,Clove"
Icebox,VO Blossoms, RITUAL RËAL,13,9,7,5,4,6,"Sova,Killjoy,Viper,Jett,KAY/O","Sova,Killjoy,Viper,Reyna,Jett"
Abyss,Tenax GC,U4RIA Magnolia,13,6,8,4,2,5,"Breach,Sova,Omen,Jett,Deadlock","Sova,Killjoy,Viper,Yoru,Astra"
Abyss,Leviatán GC,FiRePOWER GC,13,4,9,3,1,4,"Cypher,Sova,Omen,Jett,Yoru","Cypher,Sova,Omen,Jett,KAY/O"
Sunset,Everyone Really Misses,Envee Sapphire GC,13,9,5,5,4,8,"Breach,Cypher,Sova,Omen,Neon","Breach,Cypher,Sova,Omen,Neon"
Haven,SaD FROST,Scooby Snackers,13,3,9,3,0,4,"Breach,Cypher,Sova,Omen,Neon","Breach,Cypher,Sova,Omen,Jett"
Haven,Erinite GC,minions united GC,13,11,7,5,6,6,"Breach,Sova,Killjoy,Omen,Neon","Breach,Sova,Killjoy,Omen,Jett"
Ascent,VO Blossoms, RITUAL RËAL,6,13,3,4,9,3,"Sova,Killjoy,Jett,KAY/O,Clove","Cypher,Sova,Omen,Jett,KAY/O"
Bind,SaD FROST,Scooby Snackers,13,1,11,1,0,2,"Raze,Cypher,Brimstone,Skye,Yoru","Raze,Viper,Skye,Gekko,Clove"
Lotus,Bumble Bees,Skyline Dreamers GC,9,13,4,8,5,5,"Raze,Killjoy,Viper,Omen,Fade","Breach,Killjoy,Neon,Gekko,Clove"
Icebox,Everyone Really Misses,Envee Sapphire GC,13,2,10,2,0,3,"Sova,Killjoy,Viper,Jett,Harbor","Sova,Killjoy,Viper,Jett,Gekko"
Lotus,Tenax GC,U4RIA Magnolia,13,4,4,1,3,9,"Breach,Killjoy,Omen,Neon,Fade","Raze,Killjoy,Viper,Omen,Fade"
Haven,MOUZ,Joblife,13,10,9,2,8,4,"Breach,Cypher,Sova,Omen,Jett","Breach,Sova,Killjoy,Astra,Neon"
Haven,Apeks,Barça eSports,13,11,2,10,1,11,"Breach,Sova,Killjoy,Omen,Jett","Breach,Sova,Killjoy,Omen,Jett"
Bind,MOUZ,Joblife,7,13,1,7,6,6,"Raze,Omen,Skye,Gekko,Clove","Raze,Viper,Brimstone,Skye,Gekko"
Abyss,Apeks,Barça eSports,13,5,6,0,5,7,"Cypher,Sova,Omen,Yoru,Astra","Cypher,Sova,Omen,Jett,KAY/O"
Sunset,Apeks,Barça eSports,10,13,9,3,10,1,"Cypher,Sova,Omen,KAY/O,Neon","Cypher,Sova,Omen,KAY/O,Neon"
Lotus,MOUZ,Joblife,13,10,6,5,5,7,"Breach,Cypher,Omen,Yoru,Fade","Raze,Sova,Killjoy,Omen,Gekko"
Ascent,PCIFIC Espor,SAW,13,7,5,3,4,8,"Sova,Killjoy,Omen,Jett,KAY/O","Cypher,Sova,Omen,Jett,KAY/O"
Icebox,DSYRE,GoNext Esports,13,5,8,4,1,5,"Sova,Killjoy,Viper,Sage,Jett","Sova,Killjoy,Viper,Jett,KAY/O"
Lotus,DSYRE,GoNext Esports,13,1,2,0,1,11,"Raze,Killjoy,Viper,Omen,Fade","Breach,Cypher,Sova,Omen,Neon"
Abyss,PCIFIC Espor,SAW,13,6,10,2,4,3,"Cypher,Sova,Omen,Jett,KAY/O","Breach,Cypher,Sova,Jett,Astra"
Abyss,RE ENDLESS,ThorN,13,9,5,7,2,8,"Cypher,Sova,Jett,Astra,KAY/O","Cypher,Sova,Phoenix,Omen,Deadlock"
Ascent,RE ENDLESS,ThorN,13,11,9,3,8,4,"Sova,Killjoy,Jett,Astra,KAY/O","Sova,Killjoy,Reyna,Omen,Jett"
Ascent,Kou-Gaming,ESR Selection,6,13,1,6,7,5,"Sova,Killjoy,Omen,Jett,KAY/O","Sova,Killjoy,Omen,Jett,KAY/O"
Icebox,ExA,Haven Liberty,3,13,1,11,2,2,"Sova,Killjoy,Viper,Omen,Jett","Sova,Killjoy,Reyna,Jett,Clove"
Haven,RE ENDLESS,ThorN,9,13,5,7,6,4,"Breach,Cypher,Sova,Jett,Astra","Sova,Killjoy,Omen,Jett,Iso"
Lotus,Kou-Gaming,ESR Selection,7,13,6,6,7,1,"Breach,Raze,Killjoy,Omen,Neon","Raze,Killjoy,Viper,Omen,Fade"
Bind,ExA,Haven Liberty,3,13,2,10,3,1,"Raze,Sova,Viper,Brimstone,Gekko","Raze,Viper,Fade,Gekko,Clove"
Haven,Refrag,Tenax GC,13,9,6,4,5,7,"Cypher,Sova,Reyna,Omen,Jett","Breach,Sova,Killjoy,Omen,Neon"
Haven,Bon Bon Bum Contra GC,FUSION X,0,13,0,1,12,0,"Breach,Sova,Killjoy,Omen,Chamber","Cypher,Sova,Astra,Gekko,Iso"
Bind,Refrag,Tenax GC,13,11,5,7,4,8,"Raze,Viper,Brimstone,Skye,Yoru","Raze,Viper,Brimstone,Skye,Deadlock"
Bind,Everyone Really Misses,Day By Day,11,13,8,4,9,3,"Raze,Viper,Brimstone,Fade,Gekko","Raze,Viper,Skye,Gekko,Clove"
Lotus,Envee Sapphire GC,scc plus 1,9,13,4,6,7,5,"Killjoy,Omen,Jett,Skye,Gekko","Breach,Raze,Killjoy,Omen,Fade"
Ascent,Bon Bon Bum Contra GC,FUSION X,2,13,1,11,2,1,"Sova,Killjoy,Phoenix,Omen,Jett","Raze,Sova,KAY/O,Iso,Clove"
Icebox,Refrag,Tenax GC,7,13,5,3,10,2,"Sova,Killjoy,Viper,Jett,KAY/O","Sova,Viper,Sage,Reyna,Chamber"
Bind,Purpose Gaming Sirens,Scooby Snackers,4,13,2,10,3,2,"Raze,Cypher,Viper,Brimstone,Skye","Raze,Viper,Skye,Gekko,Clove"
Abyss,Everyone Really Misses,Day By Day,13,9,7,3,6,6,"Sova,Viper,Jett,Yoru,Astra","Cypher,Sova,Jett,Astra,Gekko"
Haven,Shopify Rebellion,Waffle House,13,0,1,0,0,12,"Breach,Cypher,Sova,Omen,Neon","Breach,Cypher,Sova,Omen,Neon"
Sunset,Envee Sapphire GC,scc plus 1,10,13,1,10,3,9,"Breach,Cypher,Sova,Omen,Neon","Breach,Cypher,Sova,Omen,Neon"
Ascent,Shopify Rebellion,Waffle House,13,0,1,0,0,12,"Cypher,Sova,Omen,Jett,Deadlock","Cypher,Sova,Omen,Jett,Deadlock"
Abyss,oomfies,LazerrFreeks Ivy,13,1,2,0,1,11,"Sova,Omen,Jett,Astra,KAY/O","Cypher,Sova,Omen,Jett,Deadlock"
Lotus,Zen eSports GC,KRÜ BLAZE,8,13,1,8,5,7,"Raze,Killjoy,Viper,Omen,Fade","Raze,Killjoy,Viper,Omen,Fade"
Icebox,U4RIA Magnolia,Tenax GC,5,13,3,9,4,2,"Sova,Killjoy,Viper,Sage,Jett","Sova,Viper,Sage,Reyna,Chamber"
Haven,YFP X,Bumble Bees,13,6,5,2,4,8,"Breach,Sova,Killjoy,Omen,Jett","Breach,Cypher,Sova,Omen,Jett"
Lotus,Everyone Really Misses,Day By Day,10,13,7,5,8,3,"Breach,Omen,Neon,Fade,Clove","Cypher,Viper,Omen,Skye,Neon"
Sunset,Purpose Gaming Sirens,Scooby Snackers,13,9,5,7,2,8,"Breach,Raze,Cypher,Omen,Gekko","Breach,Raze,Cypher,Omen,Fade"
Icebox,Give Wingman 2 Nuclear Devices,SaD FROST,14,12,7,6,6,7,"Sova,Killjoy,Viper,Sage,Jett","Sova,Killjoy,Viper,Reyna,Iso"
Ascent,Envee Sapphire GC,scc plus 1,13,9,7,3,6,6,"Sova,Killjoy,Omen,Jett,KAY/O","Sova,Killjoy,Omen,Jett,KAY/O"
Lotus,Teddy Tactics,VO Blossoms,13,7,5,3,4,8,"Raze,Killjoy,Viper,Omen,Fade","Raze,Killjoy,Omen,Fade,Gekko"
Ascent,Tea Guzzlers,minions united GC,3,13,0,4,9,3,"Sova,Killjoy,Omen,Jett,KAY/O","Sova,Killjoy,Omen,Jett,KAY/O"
Ascent,Divine GC, RITUAL RËAL,5,13,1,5,8,4,"Sova,Killjoy,Omen,Jett,KAY/O","Cypher,Sova,Omen,Jett,KAY/O"
Haven,Catnappers,Waffle House,7,13,1,7,6,6,"Cypher,Sova,Omen,Yoru,Iso","Breach,Cypher,Sova,Omen,Neon"
Haven,Waffle House,Catnappers,13,7,6,6,1,7,"Breach,Cypher,Sova,Omen,Neon","Cypher,Sova,Omen,Yoru,Iso"
Ascent,oomfies,LazerrFreeks Ivy,13,11,11,1,10,2,"Cypher,Sova,Omen,Jett,Deadlock","Sova,Killjoy,Omen,Jett,KAY/O"
Lotus,Tea Guzzlers,minions united GC,2,13,0,3,10,2,"Breach,Raze,Omen,Skye,Clove","Breach,Raze,Omen,Fade,Clove"
Sunset,YFP X,Bumble Bees,13,2,2,1,1,11,"Breach,Raze,Cypher,Sova,Omen","Breach,Raze,Cypher,Sova,Omen"
Ascent,Day By Day,scc plus 1,13,5,7,5,0,6,"Cypher,Sova,Omen,Jett,KAY/O","Sova,Killjoy,Omen,Jett,KAY/O"
Sunset,Give Wingman 2 Nuclear Devices,SaD FROST,13,8,5,4,4,8,"Breach,Raze,Cypher,Omen,Gekko","Raze,Cypher,Omen,KAY/O,Gekko"
Haven,Purpose Gaming Sirens,Scooby Snackers,8,13,3,6,7,5,"Breach,Sova,Killjoy,Omen,Jett","Breach,Cypher,Sova,Omen,Jett"
Ascent,U4RIA Magnolia,Tenax GC,14,16,4,11,5,10,"Cypher,Sova,Omen,Jett,Deadlock","Sova,Killjoy,Omen,Jett,KAY/O"
Icebox,Zen eSports GC,KRÜ BLAZE,13,11,5,7,4,8,"Sova,Killjoy,Viper,Reyna,Neon","Sova,Killjoy,Viper,Jett,Harbor"
Haven,Teddy Tactics,VO Blossoms,13,10,6,6,4,7,"Breach,Sova,Killjoy,Omen,Neon","Breach,Sova,Killjoy,Omen,Jett"
Lotus,Divine GC, RITUAL RËAL,8,13,5,7,6,3,"Breach,Raze,Killjoy,Omen,Fade","Raze,Cypher,Omen,Fade,Deadlock"
Abyss,Catnappers,Waffle House,9,13,3,7,6,6,"Cypher,Sova,Omen,Jett,KAY/O","Breach,Cypher,Sova,Omen,Jett"
Abyss,Waffle House,Catnappers,13,9,6,6,3,7,"Breach,Cypher,Sova,Omen,Jett","Cypher,Sova,Omen,Jett,KAY/O"
Lotus,Give Wingman 2 Nuclear Devices,Purpose Gaming Sirens,13,3,10,2,1,3,"Breach,Raze,Cypher,Omen,Gekko","Breach,Killjoy,Omen,Neon,Gekko"
Lotus,Day By Day,scc plus 1,13,7,10,2,5,3,"Cypher,Viper,Omen,Skye,Neon","Killjoy,Omen,Neon,Fade,Gekko"
Lotus,LazerrFreeks Ivy,Event Horizon GC,13,8,7,5,3,6,"Raze,Killjoy,Omen,Fade,Gekko","Breach,Raze,Cypher,Omen,Fade"
Lotus,Event Horizon GC,LazerrFreeks Ivy,8,13,3,6,7,5,"Breach,Raze,Cypher,Omen,Fade","Raze,Killjoy,Omen,Fade,Gekko"
Sunset,SaD FROST,Scooby Snackers,13,3,4,0,3,9,"Raze,Cypher,Omen,KAY/O,Gekko","Breach,Raze,Cypher,Omen,Fade"
Bind,mesos millionaires,Tea Guzzlers,13,4,11,1,3,2,"Raze,Skye,Chamber,Deadlock,Clove","Raze,Brimstone,Jett,Skye,Clove"
Haven,Zen eSports GC,KRÜ BLAZE,4,13,1,4,9,3,"Breach,Sova,Killjoy,Omen,Jett","Breach,Sova,Killjoy,Omen,Jett"
Bind,Bumble Bees,Skyline Dreamers GC,13,4,3,2,2,10,"Raze,Viper,Brimstone,Skye,Deadlock","Raze,Brimstone,Reyna,Skye,Harbor"
Sunset,minions united GC,Erinite GC,11,13,9,3,10,2,"Breach,Raze,Cypher,Omen,Gekko","Breach,Raze,Cypher,Sova,Omen"
Abyss,Everyone Really Misses,Envee Sapphire GC,13,2,3,0,2,10,"Sova,Viper,Jett,Yoru,Astra","Cypher,Sova,Astra,KAY/O,Harbor"
Sunset, RITUAL RËAL,VO Blossoms,8,13,5,7,6,3,"Breach,Cypher,Omen,Neon,Gekko","Breach,Raze,Cypher,Gekko,Clove"
Lotus,Teddy Tactics,Divine GC,13,7,3,5,2,10,"Raze,Killjoy,Viper,Omen,Fade","Breach,Raze,Killjoy,Gekko,Clove"
Sunset,Day By Day,scc plus 1,2,13,0,3,10,2,"Breach,Raze,Cypher,Sova,Omen","Breach,Cypher,Sova,Omen,Neon"
Bind,Give Wingman 2 Nuclear Devices,Purpose Gaming Sirens,13,7,8,4,3,5,"Raze,Viper,Brimstone,Skye,Gekko","Raze,Cypher,Viper,Brimstone,Skye"
Sunset,Event Horizon GC,LazerrFreeks Ivy,4,13,2,3,10,2,"Breach,Cypher,Sova,Omen,Neon","Raze,Cypher,Fade,Gekko,Clove"
Sunset,LazerrFreeks Ivy,Event Horizon GC,13,4,10,2,2,3,"Raze,Cypher,Fade,Gekko,Clove","Breach,Cypher,Sova,Omen,Neon"
Ascent,Catnappers,Waffle House,13,8,6,6,2,7,"Sova,Killjoy,Omen,Jett,KAY/O","Cypher,Sova,Omen,Jett,Deadlock"
Ascent,Waffle House,Catnappers,8,13,2,7,6,6,"Cypher,Sova,Omen,Jett,Deadlock","Sova,Killjoy,Omen,Jett,KAY/O"
Abyss,mesos millionaires,Tea Guzzlers,13,7,7,1,6,6,"Sova,Omen,Yoru,Astra,Deadlock","Cypher,Sova,Jett,Astra,Gekko"
Haven,SaD FROST,Scooby Snackers,13,4,2,3,1,11,"Breach,Cypher,Sova,Omen,Neon","Breach,Cypher,Sova,Omen,Jett"
Haven,U4RIA Magnolia,Tenax GC,18,16,9,8,8,9,"Sova,Killjoy,Viper,Omen,Yoru","Breach,Sova,Killjoy,Omen,Neon"
Lotus,Everyone Really Misses,Envee Sapphire GC,13,5,7,5,0,6,"Breach,Omen,Neon,Fade,Clove","Breach,Raze,Killjoy,Omen,Fade"
Haven,Bumble Bees,Skyline Dreamers GC,13,4,8,4,0,5,"Breach,Cypher,Sova,Omen,Jett","Breach,Sova,Killjoy,Omen,Jett"
Haven,minions united GC,Erinite GC,12,14,8,5,9,4,"Breach,Sova,Killjoy,Omen,Jett","Breach,Sova,Killjoy,Omen,Neon"
Haven, RITUAL RËAL,VO Blossoms,6,13,2,10,3,4,"Breach,Cypher,Sova,Omen,Jett","Breach,Sova,Killjoy,Omen,Jett"
Abyss,SAW,The Ultimates,4,13,4,8,5,0,"Breach,Cypher,Sova,Jett,Astra","Cypher,Sova,Omen,Jett,KAY/O"
Haven,SAW,The Ultimates,6,13,3,9,4,3,"Breach,Cypher,Sova,Omen,Jett","Cypher,Sova,Omen,Neon,Iso"
Ascent,SAW,The Ultimates,13,10,6,6,4,7,"Cypher,Sova,Omen,Jett,KAY/O","Sova,Killjoy,Omen,Jett,KAY/O"
Abyss,CGN Esports,GoNext Esports,13,6,10,2,4,3,"Cypher,Sova,Phoenix,Omen,Jett","Cypher,Sova,Jett,Astra,Gekko"
Sunset,DSYRE,Barça eSports,14,12,4,9,3,10,"Breach,Raze,Cypher,Omen,Gekko","Cypher,Sova,Omen,KAY/O,Neon"
Lotus,PCIFIC Espor,Joblife,13,3,3,1,2,10,"Breach,Cypher,Sova,Omen,Neon","Raze,Killjoy,Viper,Omen,Fade"
Haven,DSYRE,Barça eSports,13,10,6,6,4,7,"Cypher,Sova,Omen,Yoru,Iso","Breach,Cypher,Sova,Omen,Neon"
Ascent,PCIFIC Espor,Joblife,13,10,7,4,6,6,"Sova,Killjoy,Phoenix,Omen,Jett","Sova,Killjoy,Omen,Jett,KAY/O"
Ascent,DSYRE,Barça eSports,8,13,1,8,5,7,"Cypher,Sova,Omen,Jett,KAY/O","Killjoy,Viper,Omen,Jett,Skye"
Haven,K7 Esports GC,Akave Esports Black,3,13,1,3,10,2,"Breach,Raze,Cypher,Omen,Jett","Breach,Cypher,Sova,Omen,Jett"
Ascent,K7 Esports GC,Akave Esports Black,0,13,0,1,12,0,"Sova,Killjoy,Omen,Jett,KAY/O","Cypher,Sova,Omen,Jett,KAY/O"
Abyss,University War GC,9z Team GC,7,13,1,7,6,6,"Breach,Cypher,Sova,Omen,Jett","Cypher,Sova,Omen,Jett,Harbor"
Icebox,University War GC,9z Team GC,5,13,1,5,8,4,"Sova,Killjoy,Viper,Sage,Omen","Sova,Killjoy,Viper,Jett,Harbor"
Abyss,MOUZ,PCIFIC Espor,10,13,4,8,5,6,"Cypher,Sova,Jett,Astra,KAY/O","Cypher,Sova,Omen,Jett,KAY/O"
Haven,MOUZ,PCIFIC Espor,7,13,2,6,7,5,"Breach,Cypher,Sova,Omen,Jett","Breach,Sova,Killjoy,Omen,Jett"
Sunset,Apeks,DSYRE,13,9,5,7,2,8,"Cypher,Sova,Omen,KAY/O,Neon","Breach,Raze,Cypher,Omen,Gekko"
Haven,Apeks,DSYRE,13,7,8,0,7,5,"Breach,Sova,Killjoy,Omen,Jett","Cypher,Sova,Omen,Yoru,Iso"
Lotus,MOUZ,PCIFIC Espor,13,10,7,4,6,6,"Breach,Cypher,Omen,Yoru,Fade","Breach,Cypher,Sova,Omen,Neon"
Haven,The Ultimates,Joblife,12,14,8,5,9,4,"Cypher,Sova,Omen,Neon,Iso","Breach,Sova,Killjoy,Astra,Neon"
Haven,CGN Esports,Barça eSports,13,9,6,6,3,7,"Sova,Killjoy,Phoenix,Omen,Jett","Breach,Cypher,Sova,Omen,Neon"
Sunset,The Ultimates,Joblife,12,14,6,7,7,6,"Breach,Raze,Cypher,Omen,Gekko","Breach,Cypher,Sova,Omen,Neon"
Ascent,CGN Esports,Barça eSports,16,14,7,8,6,9,"Sova,Killjoy,Phoenix,Jett,Astra","Killjoy,Viper,Omen,Jett,Skye"
Bind,The Ultimates,Joblife,13,11,7,5,6,6,"Raze,Viper,Brimstone,Sage,Skye","Raze,Viper,Brimstone,Skye,Gekko"
Bind,CGN Esports,Barça eSports,8,13,7,5,8,1,"Raze,Viper,Phoenix,Brimstone,Fade","Viper,Brimstone,Yoru,Fade,Gekko"
Sunset,New Combat Line GC,No Sweat Blossom,13,2,10,2,0,3,"Breach,Raze,Cypher,Omen,Clove","Breach,Raze,Cypher,Omen,Gekko"
Haven,New Combat Line GC,No Sweat Blossom,13,8,6,6,2,7,"Breach,Sova,Killjoy,Omen,Jett","Breach,Cypher,Sova,Omen,Neon"
Ascent,YFP Gaming,Blinn Esports,13,11,4,8,3,9,"Cypher,Sova,Omen,Jett,Deadlock","Cypher,Sova,Omen,Yoru,Deadlock"
Ascent,New Combat Line GC,No Sweat Blossom,13,15,4,10,5,9,"Sova,Killjoy,Omen,Jett,KAY/O","Cypher,Sova,Omen,Yoru,Deadlock"
Haven,YFP Gaming,Blinn Esports,13,8,7,2,6,6,"Breach,Cypher,Sova,Omen,Jett","Breach,Cypher,Sova,Omen,Neon"
Ascent,YFP Gaming,Blue Otter,13,4,4,1,3,9,"Cypher,Sova,Omen,Jett,Deadlock","Sova,Killjoy,Omen,Jett,KAY/O"
Haven,Blinn Esports,Special Grade,13,8,5,7,1,8,"Breach,Cypher,Sova,Omen,Neon","Breach,Sova,Killjoy,Omen,Jett"
Haven,XSOUL GC,Deagle Ravagers,8,13,5,7,6,3,"Breach,Sova,Killjoy,Omen,Neon","Breach,Sova,Killjoy,Omen,Jett"
Haven,YFP Gaming,Blue Otter,13,8,7,5,3,6,"Breach,Sova,Killjoy,Omen,Jett","Breach,Cypher,Sova,Omen,Neon"
Icebox,Blinn Esports,Special Grade,13,8,6,6,2,7,"Sova,Killjoy,Viper,Reyna,Gekko","Sova,Killjoy,Viper,Jett,Clove"
Abyss,XSOUL GC,Deagle Ravagers,1,13,0,2,11,1,"Breach,Cypher,Sova,Astra,Neon","Cypher,Sova,Omen,Jett,KAY/O"
Ascent,Apinaorkesteri,Jabba Enjoyers,13,0,1,0,0,12,"Sova,Killjoy,Omen,Jett,KAY/O","Sova,Killjoy,Omen,Jett,KAY/O"
Abyss,GoNext Esports,Barça eSports,13,10,7,5,5,6,"Cypher,Sova,Jett,Astra,Gekko","Cypher,Sova,Omen,Jett,KAY/O"
Ascent,Blue Otter,ENVEE Esports,13,9,5,7,2,8,"Sova,Killjoy,Omen,Jett,KAY/O","Sova,Killjoy,Omen,Jett,KAY/O"
Sunset,FLUFFY AIMERS,Blinn Esports,11,13,8,4,9,3,"Breach,Raze,Cypher,Omen,Skye","Breach,Cypher,Omen,Neon,Gekko"
Sunset,TSM,YFP Gaming,13,15,4,10,5,9,"Breach,Cypher,Omen,Neon,Gekko","Breach,Raze,Cypher,Sova,Omen"
Lotus,Apinaorkesteri,Jabba Enjoyers,13,3,4,0,3,9,"Raze,Killjoy,Viper,Omen,Fade","Breach,Raze,Killjoy,Omen,Fade"
Icebox,GoNext Esports,Barça eSports,13,10,3,8,2,10,"Sova,Killjoy,Viper,Jett,KAY/O","Killjoy,Viper,Jett,KAY/O,Clove"
Bind,FLUFFY AIMERS,Blinn Esports,5,13,5,7,6,0,"Raze,Viper,Brimstone,Skye,Deadlock","Raze,Viper,Brimstone,Skye,Gekko"
Haven,FlyQuest RED,Special Grade,5,13,4,8,5,1,"Killjoy,Phoenix,Astra,Fade,Gekko","Breach,Sova,Killjoy,Omen,Jett"
Icebox,Blue Otter,ENVEE Esports,12,14,6,7,7,6,"Sova,Killjoy,Viper,Jett,Gekko","Sova,Killjoy,Viper,Reyna,Jett"
Lotus,TSM,YFP Gaming,9,13,0,10,3,9,"Breach,Raze,Cypher,Omen,Fade","Breach,Raze,Cypher,Omen,Fade"
Haven,GoNext Esports,Barça eSports,10,13,4,8,5,6,"Breach,Cypher,Sova,Omen,Jett","Breach,Cypher,Sova,Omen,Neon"
Sunset,Blue Otter,ENVEE Esports,13,10,7,5,5,6,"Breach,Cypher,Sova,Omen,Neon","Breach,Cypher,Sova,Omen,Neon"
Bind,TSM,YFP Gaming,13,11,10,2,9,3,"Raze,Cypher,Brimstone,Skye,Gekko","Raze,Viper,Brimstone,Skye,Gekko"
Icebox,FlyQuest RED,Special Grade,7,13,0,8,5,7,"Sova,Killjoy,Viper,Sage,Gekko","Sova,Killjoy,Viper,Jett,Clove"
Haven,FLUFFY AIMERS,Blinn Esports,14,12,4,9,3,10,"Breach,Sova,Killjoy,Jett,Astra","Breach,Sova,Omen,Chamber,Neon"
Bind,Jabba Enjoyers,Bitfix Gaming,13,11,5,7,4,8,"Raze,Viper,Brimstone,Fade,Gekko","Raze,Cypher,Brimstone,Skye,Deadlock"
Icebox,SAW,Joblife,9,13,4,8,5,5,"Sova,Killjoy,Viper,Jett,Gekko","Sova,Killjoy,Viper,Reyna,Jett"
Haven,Apeks,CGN Esports,14,12,7,6,6,7,"Breach,Sova,Killjoy,Omen,Jett","Sova,Killjoy,Phoenix,Omen,Jett"
Haven,SAW,Joblife,2,13,0,3,10,2,"Cypher,Sova,Omen,Yoru,Iso","Breach,Sova,Killjoy,Astra,Neon"
Lotus,Jabba Enjoyers,Bitfix Gaming,13,7,7,5,2,6,"Breach,Raze,Killjoy,Omen,Fade","Breach,Raze,Cypher,Omen,Deadlock"
Haven,Apinaorkesteri,Lootcifer,13,4,5,0,4,8,"Breach,Cypher,Sova,Omen,Jett","Breach,Sova,Killjoy,Omen,Neon"
Ascent,Jabba Enjoyers,Bitfix Gaming,7,13,3,9,4,4,"Sova,Killjoy,Omen,Jett,KAY/O","Cypher,Sova,Omen,Jett,Deadlock"
Lotus,Apeks,CGN Esports,9,13,3,7,6,6,"Raze,Cypher,Omen,KAY/O,Deadlock","Raze,Sova,Killjoy,Omen,Gekko"
Abyss,MOUZ,The Ultimates,2,13,0,3,10,2,"Cypher,Sova,Jett,Astra,KAY/O","Cypher,Sova,Omen,Jett,KAY/O"
Bind,Apinaorkesteri,Lootcifer,13,10,3,9,1,10,"Raze,Viper,Brimstone,Fade,Gekko","Breach,Cypher,Sova,Omen,Yoru"
Icebox,Formulation Gaming,Bitfix Gaming,6,13,2,5,8,4,"Sova,Killjoy,Viper,Jett,Gekko","Sova,Killjoy,Viper,Jett,Harbor"
Sunset,MOUZ,The Ultimates,11,13,6,6,7,5,"Raze,Cypher,Omen,KAY/O,Gekko","Breach,Raze,Cypher,Omen,Gekko"
Ascent,Apeks,CGN Esports,14,12,8,5,7,6,"Cypher,Sova,Omen,Yoru,Deadlock","Sova,Killjoy,Phoenix,Jett,Astra"
Lotus,Lootcifer,Requiem,13,8,7,5,3,6,"Breach,Cypher,Sova,Omen,Neon","Breach,Raze,Cypher,Omen,Fade"
Lotus,Formulation Gaming,Bitfix Gaming,13,15,6,8,7,7,"Raze,Killjoy,Viper,Omen,Fade","Breach,Raze,Cypher,Omen,Deadlock"
Icebox,Lootcifer,Requiem,16,14,9,6,8,7,"Sova,Killjoy,Viper,Jett,KAY/O","Sova,Killjoy,Viper,Jett,KAY/O"
Ascent,NEANLATIYONBOLM,Jabba Enjoyers,11,13,7,5,8,4,"Sova,Killjoy,Phoenix,Omen,Jett","Sova,Killjoy,Omen,Jett,KAY/O"
Sunset,Lootcifer,Requiem,5,13,5,7,6,0,"Raze,Cypher,Viper,Omen,Fade","Breach,Cypher,Sova,Omen,Neon"
Ascent,Formulation Gaming,Bitfix Gaming,13,8,7,5,3,6,"Sova,Killjoy,Omen,Jett,KAY/O","Cypher,Sova,Omen,Jett,Deadlock"
Haven,Next In Line,Apinaorkesteri,10,13,4,7,6,6,"Breach,Cypher,Sova,Omen,Jett","Breach,Cypher,Sova,Omen,Jett"
Bind,NEANLATIYONBOLM,Jabba Enjoyers,12,14,8,5,9,4,"Raze,Viper,Brimstone,Yoru,Deadlock","Raze,Viper,Brimstone,Fade,Gekko"
Sunset,Next In Line,Apinaorkesteri,10,13,5,7,6,5,"Breach,Raze,Cypher,Omen,Gekko","Cypher,Sova,Omen,KAY/O,Neon"
Lotus,Formulation Gaming,Hidden Horizon,13,5,10,2,3,3,"Raze,Killjoy,Viper,Omen,Fade","Raze,Killjoy,Viper,Omen,Fade"
Icebox,OnlyFins,Lootcifer,5,13,2,4,9,3,"Sova,Killjoy,Viper,Reyna,Jett","Sova,Killjoy,Viper,Jett,KAY/O"
Abyss,Jabba Enjoyers,REY eSports,13,6,8,4,2,5,"Sova,Killjoy,Viper,Yoru,Astra","Cypher,Sova,Omen,Jett,KAY/O"
Ascent,Lost Puppies,Bitfix Gaming,9,13,4,6,7,5,"Sova,Killjoy,Omen,Jett,KAY/O","Cypher,Sova,Omen,Jett,Deadlock"
Bind,Requiem,Twisted Saints Esports,13,7,3,5,2,10,"Raze,Cypher,Brimstone,Skye,Deadlock","Raze,Viper,Brimstone,Skye,Gekko"
Sunset,NEANLATIYONBOLM,NoTag,13,8,7,2,6,6,"Killjoy,Yoru,Astra,Neon,Gekko","Raze,Cypher,Gekko,Iso,Clove"
Ascent,Formulation Gaming,Hidden Horizon,13,10,5,6,4,8,"Sova,Killjoy,Omen,Jett,KAY/O","Sova,Killjoy,Phoenix,Jett,Astra"
Lotus,OnlyFins,Lootcifer,14,12,4,9,3,10,"Raze,Killjoy,Omen,Neon,Fade","Cypher,Viper,Omen,Neon,Fade"
Ascent,Apinaorkesteri,CTRL x YARI Esports,13,3,2,2,1,11,"Sova,Killjoy,Omen,Jett,KAY/O","Sova,Killjoy,Omen,Jett,KAY/O"
Abyss,Next In Line,Kingslayers,13,5,9,3,2,4,"Raze,Cypher,Sova,Yoru,Astra","Cypher,Sova,Jett,Astra,Iso"
Icebox,Jabba Enjoyers,REY eSports,13,3,10,2,1,3,"Sova,Killjoy,Viper,Jett,Deadlock","Sova,Killjoy,Viper,Reyna,Neon"
Icebox,Lost Puppies,Bitfix Gaming,5,13,2,4,9,3,"Sova,Killjoy,Viper,Jett,Gekko","Sova,Killjoy,Viper,Jett,Harbor"
Haven,Requiem,Twisted Saints Esports,13,8,7,5,3,6,"Breach,Cypher,Sova,Omen,Neon","Killjoy,Viper,Omen,Jett,Skye"
Haven,Formulation Gaming,Hidden Horizon,4,13,2,10,3,2,"Breach,Sova,Killjoy,Omen,Jett","Breach,Cypher,Sova,Omen,Neon"
Haven,Apinaorkesteri,CTRL x YARI Esports,13,5,3,3,2,10,"Breach,Cypher,Sova,Omen,Jett","Breach,Sova,Killjoy,Omen,Neon"
Bind,NEANLATIYONBOLM,NoTag,13,7,7,5,2,6,"Raze,Viper,Brimstone,Yoru,Deadlock","Raze,Cypher,Brimstone,Yoru,Gekko"
Haven,OnlyFins,Lootcifer,9,13,3,7,6,6,"Breach,Cypher,Sova,Jett,Clove","Breach,Sova,Killjoy,Omen,Neon"
Ascent,Next In Line,Kingslayers,13,2,3,0,2,10,"Sova,Killjoy,Omen,Jett,KAY/O","Sova,Killjoy,Omen,Jett,KAY/O"
Ascent,みそまにあ隊,Five Ace,2,13,0,3,10,2,"Sova,Killjoy,Omen,Jett,KAY/O","Sova,Killjoy,Omen,Jett,KAY/O"
Icebox,みそまにあ隊,Five Ace,7,13,4,8,5,3,"Sova,Killjoy,Viper,Jett,Gekko","Sova,Killjoy,Viper,Jett,Iso"
Haven,FBI,Five Ace,12,14,4,9,5,8,"Breach,Cypher,Omen,Jett,KAY/O","Breach,Sova,Killjoy,Omen,Jett"
Lotus,みそまにあ隊,Lv.5,13,10,6,6,4,7,"Breach,Raze,Killjoy,Omen,Fade","Breach,Raze,Killjoy,Omen,Fade"
Icebox,Paranoia Boys,Dropouts,13,6,8,4,2,5,"Sova,Killjoy,Viper,Jett,Gekko","Sova,Killjoy,Viper,Jett,Gekko"
Ascent,No Sweat Blossom,Infiriumz Gaming GC,13,5,2,4,1,11,"Cypher,Sova,Omen,Yoru,Deadlock","Sova,Killjoy,Omen,Jett,KAY/O"
Lotus,Paranoia Boys,Dropouts,13,7,11,1,6,2,"Breach,Raze,Killjoy,Omen,Gekko","Raze,Killjoy,Viper,Omen,Fade"
Sunset,Paranoia Boys,Dropouts,8,13,4,5,8,4,"Breach,Cypher,Sova,Omen,Neon","Breach,Cypher,Omen,Neon,Gekko"
Icebox,No Sweat Blossom,Infiriumz Gaming GC,13,10,8,3,7,5,"Sova,Killjoy,Viper,Jett,Iso","Sova,Killjoy,Omen,Jett,Harbor"
Lotus,TOADS,Dropouts,7,13,7,5,8,0,"Breach,Raze,Cypher,Omen,Fade","Raze,Killjoy,Viper,Omen,Fade"
Haven,Deagle Ravagers,Dasein Club GC,13,7,6,2,5,7,"Breach,Sova,Killjoy,Omen,Jett","Breach,Sova,Killjoy,Omen,Neon"
Haven,Paranoia Boys,Poseidon Esports,16,14,10,5,9,6,"Breach,Cypher,Sova,Omen,Jett","Breach,Cypher,Sova,Omen,Jett"
Ascent,Deagle Ravagers,Dasein Club GC,13,6,3,4,2,10,"Sova,Killjoy,Omen,Jett,KAY/O","Sova,Killjoy,Omen,Jett,KAY/O"
Ascent,TOADS,Bobasaur,14,12,6,7,5,8,"Sova,Killjoy,Omen,Jett,KAY/O","Sova,Killjoy,Omen,Jett,KAY/O"
Icebox,PCIFIC Espor,The Ultimates,13,6,8,4,2,5,"Sova,Killjoy,Viper,Jett,Gekko","Omen,Jett,KAY/O,Harbor,Gekko"
Icebox,Dropouts,Forsaken Shadows,13,3,2,2,1,11,"Sova,Killjoy,Viper,Jett,Gekko","Killjoy,Viper,Reyna,Jett,Gekko"
Sunset,Paranoia Boys,Eternal Focus Crimson,13,10,7,5,5,6,"Breach,Cypher,Sova,Omen,Neon","Breach,Cypher,Omen,Neon,Fade"
Haven,Poseidon Esports,Divine Valorant,13,10,7,5,5,6,"Breach,Cypher,Sova,Omen,Jett","Sova,Killjoy,Viper,Omen,Jett"
Sunset,DSYRE,CGN Esports,9,13,2,8,5,7,"Breach,Raze,Cypher,Omen,Gekko","Raze,Cypher,Sova,Phoenix,Omen"
Lotus,PCIFIC Espor,The Ultimates,13,1,11,1,0,2,"Breach,Cypher,Sova,Omen,Neon","Raze,Viper,Omen,Chamber,Gekko"
Bind,TOADS,Una Ludio,13,10,6,6,4,7,"Raze,Cypher,Skye,Yoru,Clove","Cypher,Brimstone,Skye,Yoru,Gekko"
Lotus,Dropouts,Radiance,13,5,4,2,3,9,"Raze,Killjoy,Viper,Omen,Fade","Breach,Raze,Cypher,Omen,Fade"
Haven,Outlast Gaming,Divine Valorant,4,13,3,2,11,1,"Killjoy,Viper,Omen,Jett,Skye","Sova,Killjoy,Viper,Omen,Jett"
Haven,Forsaken Shadows,Banana Corp,13,2,10,2,0,3,"Breach,Cypher,Omen,Jett,Neon","Breach,Sova,Killjoy,Omen,Jett"
Abyss,Bobasaur,Wet Napkins,14,12,7,6,6,7,"Cypher,Sova,Omen,Yoru,Gekko","Cypher,Sova,Viper,Astra,Iso"
Ascent,Natural Order,Eternal Focus Crimson,8,13,3,6,7,5,"Breach,Sova,Sage,Omen,Jett","Raze,Sova,Killjoy,Omen,Deadlock"
Haven,Harmony,Poseidon Esports,7,13,2,6,7,5,"Breach,Cypher,Sova,Omen,Neon","Breach,Cypher,Sova,Omen,Jett"
Ascent,DSYRE,CGN Esports,3,13,0,4,9,3,"Cypher,Sova,Omen,Jett,KAY/O","Sova,Killjoy,Phoenix,Jett,Astra"
Abyss,STAKERS,REY eSports,4,13,2,3,10,2,"Cypher,Sova,Omen,Jett,Astra","Cypher,Sova,Omen,Jett,KAY/O"
Haven,DSYRE,CGN Esports,13,11,7,5,6,6,"Cypher,Sova,Omen,Yoru,Iso","Sova,Phoenix,Omen,Jett,Deadlock"
Bind,PUX Esports,Twisted Saints Esports,7,13,6,6,7,1,"Raze,Cypher,Phoenix,Fade,Harbor","Raze,Viper,Brimstone,Skye,Gekko"
Sunset,MOUZ,SAW,20,18,11,8,10,9,"Raze,Cypher,Omen,KAY/O,Gekko","Breach,Raze,Cypher,Omen,Gekko"
Sunset,STAKERS,REY eSports,13,7,5,7,0,8,"Breach,Raze,Cypher,Sova,Omen","Breach,Raze,Cypher,Omen,Gekko"
Haven,Team Nice Shot,REH Gaming,13,2,1,2,0,12,"Sova,Killjoy,Viper,Astra,Neon","Breach,Cypher,Sova,Omen,Jett"
Haven,PUX Esports,Twisted Saints Esports,9,13,3,9,4,6,"Breach,Raze,Cypher,Harbor,Iso","Killjoy,Viper,Omen,Jett,Skye"
Abyss,Kingslayers,Gladius,13,4,4,1,3,9,"Cypher,Sova,Jett,Astra,Iso","Cypher,Sova,Jett,Yoru,Astra"
Abyss,Apeks,GoNext Esports,7,13,6,6,7,1,"Cypher,Sova,Omen,Yoru,Astra","Cypher,Sova,Jett,Astra,Gekko"
Lotus,Team Colt,Banggai Cardinal,13,1,2,0,1,11,"Breach,Omen,Neon,Fade,Iso","Raze,Sage,Omen,Jett,Chamber"
Icebox,MOUZ,SAW,11,13,5,7,6,6,"Sova,Killjoy,Viper,Sage,Jett","Sova,Killjoy,Viper,Jett,Gekko"
Sunset,Team Colt,Banggai Cardinal,13,1,2,0,1,11,"Breach,Cypher,Sova,Omen,Neon","Cypher,Sova,Omen,KAY/O,Neon"
Ascent,CTRL x YARI Esports,trashcan,13,10,7,4,6,6,"Sova,Killjoy,Omen,Jett,KAY/O","Sova,Killjoy,Omen,Jett,KAY/O"
Haven,Formulation Gaming GC,Project SOS,2,13,2,10,3,0,"Breach,Omen,Skye,Chamber,Neon","Sova,Killjoy,Omen,Jett,Yoru"
Lotus,Team Nice Shot,REH Gaming,13,10,7,4,6,6,"Killjoy,Viper,Omen,Neon,Fade","Breach,Raze,Omen,Chamber,Fade"
Lotus,Atake Esports,Bitfix Gaming,2,13,2,10,3,0,"Sova,Phoenix,Skye,Chamber,Clove","Breach,Raze,Cypher,Omen,Deadlock"
Sunset,Kingslayers,Gladius,13,8,7,2,6,6,"Breach,Raze,Cypher,Sova,Omen","Cypher,Sova,Omen,KAY/O,Neon"
Haven,Apeks,GoNext Esports,5,13,4,8,5,1,"Breach,Sova,Killjoy,Omen,Jett","Breach,Cypher,Sova,Omen,Jett"
Haven,ApesOnTour,Next In Line,8,13,3,6,7,5,"Breach,Cypher,Sova,Omen,Neon","Breach,Cypher,Sova,Omen,Jett"
Ascent,Coalesce,Sentient Esports (Inactive),13,5,5,1,4,8,"Sova,Killjoy,Omen,Jett,KAY/O","Sova,Killjoy,Omen,Jett,KAY/O"
Lotus,STAKERS,REY eSports,14,16,9,6,10,5,"Breach,Killjoy,Omen,Neon,Fade","Raze,Killjoy,Viper,Omen,Fade"
Abyss,Lost Puppies,SnuTek eSports,13,9,7,3,6,6,"Breach,Cypher,Sova,Jett,Astra","Cypher,Sova,Jett,Astra,KAY/O"
Haven,Ailurus eSports,Formulation Gaming,6,13,3,9,4,3,"Cypher,Sova,Omen,Yoru,Iso","Breach,Sova,Killjoy,Omen,Neon"
Ascent,Formulation Gaming GC,Project SOS,0,13,0,1,12,0,"Sova,Killjoy,Omen,Jett,KAY/O","Cypher,Sova,Omen,Jett,Deadlock"
Sunset,E-WOLVES,Lootcifer,5,13,4,8,5,1,"Breach,Cypher,Sova,Omen,Neon","Raze,Cypher,Viper,Omen,Skye"
Ascent,Atake Esports,Bitfix Gaming,3,13,2,10,3,1,"Sova,Killjoy,Omen,Jett,KAY/O","Cypher,Sova,Omen,Jett,Deadlock"
Bind,Colony Esports,NEANLATIYONBOLM,8,13,6,3,10,2,"Raze,Viper,Brimstone,Skye,Gekko","Raze,Viper,Brimstone,Yoru,Deadlock"
Haven,Kingslayers,Gladius,3,13,1,3,10,2,"Breach,Sova,Killjoy,Astra,Neon","Killjoy,Viper,Omen,Jett,Skye"
Sunset,RYL | Royal Legion,5STARS,2,13,2,1,12,0,"Raze,Cypher,Sova,Reyna,Omen","Breach,Cypher,Sova,Omen,Neon"
Haven,DSQ Esports,Orkadia,8,13,4,8,5,4,"Breach,Sova,Killjoy,Omen,Jett","Breach,Cypher,Sova,Omen,Neon"
Ascent,ApesOnTour,Next In Line,3,13,3,9,4,0,"Sova,Killjoy,Omen,Jett,KAY/O","Sova,Killjoy,Omen,Jett,KAY/O"
Icebox,Team Nice Shot,REH Gaming,8,13,4,8,5,4,"Sova,Killjoy,Viper,Sage,Iso","Sova,Killjoy,Viper,Reyna,Jett"
Lotus,Hidden Horizon,Sakura Breeze,13,5,6,0,5,7,"Raze,Killjoy,Viper,Omen,Fade","Raze,Cypher,Omen,Fade,Deadlock"
Haven,CTRL x YARI Esports,trashcan,16,14,5,10,4,11,"Breach,Sova,Killjoy,Omen,Neon","Breach,Sova,Killjoy,Omen,Jett"
Bind,Team Colt,Twisted Saints Esports,12,14,4,9,5,8,"Raze,Viper,Omen,Skye,Iso","Raze,Viper,Brimstone,Skye,Gekko"
Sunset,Ailurus eSports,Formulation Gaming,4,13,2,10,3,2,"Raze,Cypher,Sova,Omen,Gekko","Cypher,Sova,Omen,KAY/O,Neon"
Sunset,PUX Esports,Banggai Cardinal,14,16,7,8,8,7,"Raze,Cypher,Fade,Harbor,Iso","Cypher,Sova,Omen,KAY/O,Neon"
Lotus,Jabba Enjoyers,Grow uP eSports,13,8,7,5,3,6,"Breach,Raze,Killjoy,Omen,Fade","Raze,Viper,Omen,Chamber,Fade"
Lotus,Apeks,GoNext Esports,13,11,6,6,5,7,"Raze,Cypher,Omen,KAY/O,Deadlock","Breach,Sova,Killjoy,Omen,Neon"
Abyss,MOUZ,SAW,18,16,10,7,9,8,"Cypher,Sova,Jett,Astra,KAY/O","Breach,Cypher,Sova,Jett,Astra"
Lotus,Apinaorkesteri,Da Gangalang,13,7,5,7,0,8,"Raze,Omen,Neon,Fade,Clove","Raze,Yoru,Chamber,Deadlock,Clove"
Lotus,E-WOLVES,Lootcifer,7,13,4,8,5,3,"Raze,Killjoy,Viper,Omen,Fade","Cypher,Viper,Omen,Neon,Fade"
Lotus,Lost Puppies,SnuTek eSports,13,8,9,3,5,4,"Raze,Killjoy,Viper,Omen,Fade","Breach,Raze,Sova,Killjoy,Omen"
Ascent,Hidden Horizon DACH,OnlyFins,11,13,6,6,7,5,"Sova,Killjoy,Omen,Jett,KAY/O","Cypher,Sova,Jett,Deadlock,Clove"
Bind,Sakura Breeze Academy,InTenZive,4,13,1,4,9,3,"Raze,Cypher,Omen,Fade,Gekko","Reyna,Yoru,Chamber,Neon,Clove"
Haven,Team Vortex,Purge eSports,13,9,8,2,7,5,"Raze,Killjoy,Viper,Omen,Fade","Breach,Cypher,Omen,Jett,Gekko"
Bind,DSQ Esports,Orkadia,5,13,2,4,9,3,"Raze,Viper,Brimstone,Fade,Gekko","Raze,Viper,Brimstone,Fade,Gekko"
Ascent,Colony Esports,NEANLATIYONBOLM,10,13,5,7,6,5,"Cypher,Sova,Omen,Jett,KAY/O","Sova,Killjoy,Phoenix,Omen,Jett"
Sunset,OOT Esports,STAKERS,13,15,5,9,6,8,"Breach,Raze,Cypher,Omen,Gekko","Breach,Raze,Cypher,Sova,Omen"
Ascent,Hidden Horizon,Sakura Breeze,13,3,9,3,0,4,"Sova,Killjoy,Phoenix,Jett,Astra","Sova,Killjoy,Omen,Jett,KAY/O"
Icebox,Atake Esports,Coalesce,5,13,4,8,5,1,"Sova,Killjoy,Viper,Sage,Jett","Sova,Killjoy,Viper,Omen,Jett"
Sunset,Formulation Gaming GC,Project SOS,14,12,6,7,5,8,"Breach,Raze,Cypher,Omen,Gekko","Breach,Cypher,Sova,Omen,Neon"
Haven,Apinaorkesteri,Da Gangalang,13,1,11,1,0,2,"Breach,Cypher,Sova,Omen,Jett","Sova,Killjoy,Phoenix,Neon,Clove"
Lotus,Sentient Esports (Inactive),Bitfix Gaming,5,13,1,5,8,4,"Breach,Raze,Cypher,Omen,Gekko","Breach,Raze,Cypher,Omen,Deadlock"
Abyss,REH Gaming,Gladius,6,13,3,9,4,3,"Cypher,Sova,Omen,Jett,Yoru","Cypher,Sova,Jett,Yoru,Astra"
Lotus,NoTag,HUSK.GG Main,13,0,1,0,0,12,"Raze,Killjoy,Omen,Jett,Gekko","Breach,Raze,Killjoy,Omen,Gekko"
Haven,RYL | Royal Legion,5STARS,11,13,7,5,8,4,"Breach,Cypher,Sova,Omen,Jett","Breach,Cypher,Sova,Omen,Neon"
Icebox,CTRL x YARI Esports,trashcan,6,13,0,7,6,6,"Sova,Killjoy,Viper,Neon,Gekko","Sova,Killjoy,Viper,Jett,KAY/O"
Ascent,Sakura Breeze Academy,InTenZive,1,13,1,11,2,0,"Cypher,Sova,Omen,Jett,KAY/O","Cypher,Sova,Omen,Jett,KAY/O"
Abyss,UNIWAY,Requiem,3,13,1,3,10,2,"Cypher,Sova,Yoru,Astra,KAY/O","Cypher,Sova,Omen,Jett,Harbor"
Abyss,Kingslayers,Team Nice Shot,13,11,6,6,5,7,"Cypher,Sova,Jett,Astra,Iso","Cypher,Sova,Viper,Jett,Astra"
Lotus,Team Colt,Twisted Saints Esports,13,6,8,4,2,5,"Breach,Omen,Neon,Fade,Iso","Raze,Killjoy,Viper,Omen,Fade"
Bind,Munich Esports,Universae,1,13,0,2,11,1,"Raze,Viper,Brimstone,Skye,Gekko","Raze,Viper,Omen,Fade,Gekko"
Haven,PUX Esports,Banggai Cardinal,13,6,9,3,3,4,"Breach,Raze,Cypher,Harbor,Iso","Killjoy,Viper,Omen,Jett,Skye"
Abyss,Hidden Horizon DACH,OnlyFins,7,13,6,6,7,1,"Cypher,Sova,Omen,Jett,KAY/O","Cypher,Sova,Jett,Astra,KAY/O"
Sunset,NXS OGS,Adimpleo Esports,5,13,3,3,10,2,"Raze,Cypher,Neon,Gekko,Clove","Breach,Raze,Cypher,Omen,Gekko"
Icebox,Jabba Enjoyers,Grow uP eSports,13,9,7,5,4,6,"Sova,Killjoy,Viper,Jett,Deadlock","Killjoy,Viper,Omen,KAY/O,Gekko"
Bind,NoTag,HUSK.GG Main,13,2,11,1,1,2,"Raze,Cypher,Brimstone,Yoru,Gekko","Breach,Raze,Cypher,Brimstone,Gekko"
Bind,Team Vortex,Purge eSports,13,10,4,8,2,9,"Raze,Viper,Brimstone,Fade,Deadlock","Raze,Viper,Fade,Gekko,Clove"
Haven,SNOOZE Esports,ApesOnTour,10,13,4,8,5,6,"Breach,Sova,Killjoy,Omen,Jett","Breach,Cypher,Sova,Omen,Neon"
Sunset,Akatsuki,Lootcifer,7,13,6,6,7,1,"Breach,Cypher,Sova,Omen,Neon","Raze,Cypher,Viper,Omen,Skye"
Ascent,REY eSports,Hidden Horizon EAST,13,9,8,4,5,5,"Sova,Killjoy,Omen,Jett,KAY/O","Sova,Killjoy,Omen,Jett,KAY/O"
Sunset,Atake Esports,Coalesce,6,13,4,8,5,2,"Breach,Cypher,Sova,Omen,Neon","Breach,Cypher,Sova,Omen,Neon"
Sunset,REH Gaming,Gladius,3,13,1,3,10,2,"Raze,Cypher,Sova,Omen,Iso","Cypher,Sova,Omen,KAY/O,Neon"
Abyss,Sentient Esports (Inactive),Bitfix Gaming,5,13,2,4,9,3,"Breach,Sova,Jett,Astra,Harbor","Cypher,Sova,Omen,Jett,Harbor"
Lotus,OOT Esports,STAKERS,12,14,3,10,4,9,"Breach,Raze,Cypher,Omen,Fade","Breach,Killjoy,Omen,Neon,Fade"
Haven,Kingslayers,Team Nice Shot,2,13,0,3,10,2,"Breach,Sova,Killjoy,Astra,Neon","Sova,Killjoy,Viper,Astra,Neon"
Bind,Ailurus eSports,DSQ Esports,13,10,7,5,5,6,"Raze,Viper,Brimstone,Skye,Gekko","Raze,Viper,Brimstone,Fade,Gekko"
Ascent,SnuTek eSports,Glacial Guardians,8,13,4,8,5,4,"Sova,Killjoy,Omen,Jett,KAY/O","Sova,Killjoy,Omen,Jett,KAY/O"
Lotus,UNIWAY,Requiem,6,13,3,9,4,3,"Breach,Raze,Cypher,Omen,Fade","Breach,Cypher,Omen,Neon,Fade"
Haven,Sakura Breeze,Fellas in Paris,13,11,9,3,8,4,"Cypher,Omen,Yoru,Fade,Deadlock","Cypher,Sova,Omen,Yoru,Iso"
Sunset,Da Gangalang,5STARS,9,13,3,7,6,6,"Breach,Cypher,Reyna,Omen,Neon","Breach,Raze,Cypher,Sova,Omen"
Ascent,Derve Esports,Lost Puppies,2,13,0,3,10,2,"Sova,Killjoy,Omen,Jett,KAY/O","Sova,Killjoy,Omen,Jett,KAY/O"
Ascent,NXS OGS,Adimpleo Esports,1,13,1,11,2,0,"Sova,Killjoy,Omen,Jett,KAY/O","Sova,Killjoy,Omen,Jett,KAY/O"
Haven,Munich Esports,Universae,5,13,1,5,8,4,"Breach,Sova,Killjoy,Omen,Jett","Breach,Sova,Killjoy,Omen,Jett"
Lotus,RYL | Royal Legion,Apinaorkesteri,2,13,0,3,10,2,"Breach,Omen,Neon,Fade,Clove","Raze,Killjoy,Viper,Omen,Fade"
Haven,E-WOLVES,Siko Esports,10,13,8,4,9,2,"Killjoy,Viper,Omen,Jett,Skye","Breach,KAY/O,Harbor,Gekko,Iso"
Ascent,Orkadia,Formulation Gaming,4,13,0,5,8,4,"Sova,Killjoy,Omen,Jett,KAY/O","Sova,Killjoy,Omen,Jett,KAY/O"
Haven,Formulation Gaming GC,Colony Esports,12,14,8,5,9,4,"Breach,Omen,Skye,Chamber,Neon","Breach,Cypher,Sova,Omen,Neon"
Haven,NEANLATIYONBOLM,Project SOS,13,7,7,1,6,6,"Sova,Killjoy,Omen,Jett,Yoru","Sova,Killjoy,Viper,Omen,Yoru"
Abyss,Team Colt,Twisted Saints Esports,10,13,3,8,5,7,"Cypher,Sova,Jett,Yoru,Astra","Cypher,Sova,Jett,Astra,Gekko"
Bind,REY ACADEMY,HUSK.GG Main,13,2,3,0,2,10,"Raze,Viper,Brimstone,Fade,Gekko","Breach,Raze,Cypher,Brimstone,Gekko"
Bind,Derve Esports,Lost Puppies,0,13,0,12,1,0,"Raze,Viper,Brimstone,Fade,Gekko","Raze,Cypher,Brimstone,Skye,Deadlock"
Bind,PUX Esports,Banggai Cardinal,12,14,10,3,11,2,"Raze,Cypher,Phoenix,Fade,Harbor","Raze,Viper,Brimstone,Fade,Gekko"
Ascent,Team Vortex,Jabba Enjoyers,2,13,0,3,10,2,"Sova,Killjoy,Omen,Jett,KAY/O","Sova,Killjoy,Omen,Jett,KAY/O"
Haven,UNIWAY,NXS OGS,13,2,3,0,2,10,"Breach,Sova,Killjoy,Omen,Jett","Breach,Sova,Killjoy,Omen,Jett"
Haven,REH Gaming,Gladius,13,10,9,2,8,4,"Cypher,Sova,Omen,Neon,Iso","Killjoy,Viper,Omen,Jett,Skye"
Sunset,Ailurus eSports,DSQ Esports,13,6,10,2,4,3,"Raze,Cypher,Sova,Omen,Gekko","Breach,Cypher,Sova,Omen,Neon"
Sunset,OnlyFins,InTenZive,13,11,8,4,7,5,"Breach,Raze,Cypher,Sova,Clove","Raze,Cypher,Sova,Omen,Gekko"
Bind,OOT Esports,STAKERS,13,10,5,7,3,8,"Raze,Viper,Brimstone,Fade,Gekko","Raze,Viper,Brimstone,Fade,Gekko"
Sunset,RYL | Royal Legion,Apinaorkesteri,3,13,3,9,4,0,"Breach,Cypher,Sova,Omen,Neon","Cypher,Sova,Omen,KAY/O,Neon"
Haven,Akatsuki,Lootcifer,9,13,6,4,9,3,"Breach,Sova,Killjoy,Omen,Jett","Killjoy,Viper,Omen,Skye,Neon"
Haven,Grow uP eSports,Purge eSports,13,6,10,2,4,3,"Breach,Sova,Killjoy,Omen,Neon","Breach,Cypher,Omen,Jett,Gekko"
Haven,Da Gangalang,5STARS,6,13,4,8,5,2,"Breach,Sova,Killjoy,Omen,Jett","Breach,Cypher,Sova,Omen,Jett"
Bind,Sakura Breeze,Fellas in Paris,9,13,4,6,7,5,"Raze,Viper,Omen,Yoru,Fade","Raze,Viper,Brimstone,Skye,Gekko"
Lotus,REY eSports,Hidden Horizon EAST,13,9,5,5,4,8,"Raze,Killjoy,Viper,Omen,Fade","Breach,Cypher,Sova,Omen,Neon"
Icebox,SnuTek eSports,Glacial Guardians,7,13,3,9,4,4,"Breach,Sova,Killjoy,Viper,Jett","Killjoy,Viper,Jett,KAY/O,Gekko"
Sunset,E-WOLVES,Siko Esports,7,13,3,9,4,4,"Breach,Cypher,Sova,Omen,Neon","Breach,Cypher,Neon,Iso,Clove"
Sunset,Orkadia,Formulation Gaming,4,13,4,8,5,0,"Breach,Raze,Cypher,Omen,Gekko","Cypher,Sova,Omen,KAY/O,Neon"
Ascent,SNOOZE Esports,ApesOnTour,13,15,8,6,9,5,"Sova,Killjoy,Omen,Jett,KAY/O","Sova,Killjoy,Omen,Jett,KAY/O"
Ascent,CTRL x YARI Esports,Munich Esports,13,8,5,4,4,8,"Sova,Killjoy,Omen,Jett,KAY/O","Sova,Killjoy,Omen,Jett,KAY/O"
Bind,NEANLATIYONBOLM,Project SOS,13,2,10,2,0,3,"Raze,Viper,Brimstone,Yoru,Deadlock","Raze,Viper,Brimstone,Fade,Gekko"
Sunset,Kingslayers,Team Nice Shot,13,8,7,5,3,6,"Breach,Raze,Cypher,Sova,Omen","Cypher,Sova,Omen,KAY/O,Neon"
Haven,Sakura Breeze Academy,Hidden Horizon DACH,0,13,0,1,12,0,"Breach,Cypher,Omen,Jett,Fade","Sova,Killjoy,Omen,Yoru,Iso"
Abyss,Adimpleo Esports,Requiem,1,13,1,11,2,0,"Reyna,Jett,Chamber,Harbor,Gekko","Cypher,Sova,Omen,Jett,Harbor"
Bind,Bitfix Gaming,Coalesce,13,10,6,5,5,7,"Raze,Cypher,Brimstone,Skye,Deadlock","Raze,Viper,Brimstone,Fade,Gekko"
Ascent,Formulation Gaming GC,Colony Esports,3,13,2,10,3,1,"Sova,Killjoy,Omen,Jett,KAY/O","Cypher,Sova,Omen,Jett,KAY/O"
Sunset,Universae,trashcan,6,13,3,4,9,3,"Breach,Raze,Cypher,Omen,Gekko","Cypher,Sova,Omen,KAY/O,Neon"
Lotus,UNIWAY,NXS OGS,13,0,12,0,0,1,"Breach,Raze,Cypher,Omen,Fade","Breach,Raze,Killjoy,Omen,Gekko"
Haven,Adimpleo Esports,Requiem,0,13,0,12,1,0,"Breach,Cypher,Sova,Omen,Jett","Cypher,Sova,Omen,Yoru,Iso"
Icebox,Team Vortex,Jabba Enjoyers,3,13,2,2,11,1,"Killjoy,Yoru,Astra,Fade,Harbor","Sova,Killjoy,Viper,Jett,Deadlock"
Sunset,Atake Esports,Sentient Esports (Inactive),13,15,5,9,6,8,"Breach,Cypher,Sova,Omen,Neon","Raze,Cypher,Sova,Omen,Gekko"
Bind,Sakura Breeze Academy,Hidden Horizon DACH,1,13,1,11,2,0,"Raze,Cypher,Omen,Fade,Gekko","Raze,Cypher,Brimstone,Skye,Yoru"
Lotus,Sakura Breeze,Fellas in Paris,13,5,2,4,1,11,"Raze,Cypher,Omen,Fade,Deadlock","Breach,Raze,Cypher,Omen,Fade"
Ascent,REY ACADEMY,HUSK.GG Main,13,10,7,5,5,6,"Sova,Killjoy,Omen,Jett,KAY/O","Breach,Cypher,Sova,Omen,Jett"
Lotus,CTRL x YARI Esports,Munich Esports,13,5,5,1,4,8,"Breach,Cypher,Omen,Neon,Fade","Raze,Killjoy,Viper,Omen,Fade"
Lotus,Grow uP eSports,Purge eSports,13,5,3,3,2,10,"Raze,Viper,Omen,Chamber,Fade","Breach,Raze,Killjoy,Viper,Omen"
Bind,PUX Esports,Team Colt,7,13,5,7,6,2,"Raze,Cypher,Phoenix,Fade,Harbor","Raze,Viper,Omen,Skye,Iso"
Lotus,Siko Esports,Lootcifer,2,13,0,3,10,2,"Raze,Killjoy,Viper,Omen,Fade","Cypher,Viper,Omen,Neon,Fade"
Haven,OnlyFins,InTenZive,13,11,5,7,4,8,"Breach,Sova,Killjoy,Jett,Clove","Cypher,Sova,Omen,Yoru,Iso"
Ascent,Gladius,Team Nice Shot,13,8,5,7,1,8,"Cypher,Sova,Omen,Jett,KAY/O","Sova,Killjoy,Omen,Jett,KAY/O"
Haven,Universae,trashcan,6,13,5,2,11,1,"Breach,Sova,Killjoy,Omen,Jett","Breach,Sova,Killjoy,Omen,Jett"
Icebox,SNOOZE Esports,ApesOnTour,13,9,8,4,5,5,"Sova,Killjoy,Viper,Jett,Gekko","Sova,Killjoy,Viper,Reyna,Harbor"
Lotus,Kingslayers,REH Gaming,7,13,3,9,4,4,"Breach,Raze,Cypher,Omen,Gekko","Breach,Omen,Chamber,Neon,Fade"
Sunset,RYL | Royal Legion,Da Gangalang,13,8,6,3,5,7,"Breach,Cypher,Sova,Omen,Neon","Breach,Cypher,Omen,Neon,Iso"
Lotus,Ailurus eSports,Orkadia,7,13,0,8,5,7,"Raze,Cypher,Viper,Omen,Fade","Raze,Killjoy,Viper,Omen,Fade"
Sunset,Hidden Horizon EAST,STAKERS,13,11,4,8,3,9,"Breach,Cypher,Sova,Omen,Neon","Raze,Cypher,Sova,Omen,KAY/O"
Icebox,Bitfix Gaming,Coalesce,11,13,5,7,6,6,"Sova,Killjoy,Viper,Sage,Jett","Sova,Killjoy,Viper,Reyna,Jett"
Haven,Derve Esports,SnuTek eSports,12,14,6,7,7,6,"Breach,Sova,Killjoy,Omen,Jett","Breach,Cypher,Sova,Omen,Jett"
Bind,InTenZive,Hidden Horizon DACH,13,3,3,1,2,10,"Raze,Viper,Brimstone,Fade,Gekko","Raze,Viper,Brimstone,Skye,Fade"
Abyss,Atake Esports,Sentient Esports (Inactive),13,10,6,5,5,7,"Sova,Killjoy,Viper,Yoru,Astra","Breach,Sova,Jett,Astra,Harbor"
Haven,Kingslayers,REH Gaming,13,5,3,3,2,10,"Breach,Sova,Killjoy,Astra,Neon","Cypher,Sova,Phoenix,Omen,Jett"
Sunset,Siko Esports,Lootcifer,2,13,2,10,3,0,"Breach,Raze,Cypher,Sova,Omen","Raze,Cypher,Viper,Omen,Skye"
Lotus,Glacial Guardians,Lost Puppies,7,13,3,5,8,4,"Breach,Omen,Neon,Fade,Clove","Raze,Killjoy,Viper,Omen,Fade"
Bind,OOT Esports,REY eSports,12,14,5,8,6,7,"Raze,Viper,Brimstone,Fade,Gekko","Raze,Viper,Brimstone,Skye,Gekko"
Haven,UNIWAY,Adimpleo Esports,13,8,6,3,5,7,"Breach,Sova,Killjoy,Omen,Jett","Breach,Cypher,Sova,Omen,Jett"
Sunset,PUX Esports,Team Colt,13,5,7,5,0,6,"Raze,Cypher,Fade,Harbor,Iso","Breach,Cypher,Sova,Omen,Neon"
Lotus,5STARS,Apinaorkesteri,7,13,4,8,5,3,"Raze,Killjoy,Viper,Omen,Fade","Raze,Killjoy,Viper,Omen,Fade"
Sunset,NoTag,REY ACADEMY,13,7,7,1,6,6,"Raze,Cypher,Gekko,Iso,Clove","Raze,Cypher,Sova,Omen,KAY/O"
Haven,Hidden Horizon EAST,STAKERS,13,2,10,2,0,3,"Breach,Sova,Killjoy,Omen,Neon","Breach,Sova,Killjoy,Omen,Neon"
Bind,Hidden Horizon,Fellas in Paris,13,9,5,5,4,8,"Raze,Cypher,Viper,Brimstone,Skye","Raze,Viper,Brimstone,Skye,Gekko"
Bind,Project SOS,Colony Esports,17,15,10,6,9,7,"Raze,Viper,Brimstone,Fade,Gekko","Raze,Viper,Brimstone,Skye,Gekko"
Bind,Team Vortex,Grow uP eSports,13,6,5,2,4,8,"Raze,Viper,Brimstone,Fade,Deadlock","Raze,Brimstone,Fade,Gekko,Deadlock"
Lotus,trashcan,Munich Esports,13,0,12,0,0,1,"Raze,Killjoy,Viper,Omen,Fade","Raze,Killjoy,Viper,Omen,Fade"
Abyss,Akatsuki,E-WOLVES,13,5,9,3,2,4,"Cypher,Sova,Omen,Jett,Gekko","Breach,Sova,Viper,Jett,Astra"
Ascent,CTRL x YARI Esports,Universae,13,3,4,0,3,9,"Sova,Killjoy,Omen,Jett,KAY/O","Cypher,Sova,Omen,Jett,Deadlock"
Ascent,Asgard Esports,ApesOnTour,0,13,0,1,12,0,"Sova,Killjoy,Omen,Jett,KAY/O","Sova,Killjoy,Omen,Jett,KAY/O"
Bind,Formulation Gaming GC,NEANLATIYONBOLM,4,13,2,3,10,2,"Raze,Viper,Skye,Gekko,Clove","Raze,Viper,Brimstone,Yoru,Deadlock"
Haven,RYL | Royal Legion,Da Gangalang,13,10,7,4,6,6,"Breach,Cypher,Sova,Omen,Neon","Breach,Sova,Killjoy,Omen,Jett"
Sunset,Gladius,Team Nice Shot,15,13,4,10,3,11,"Cypher,Sova,Omen,KAY/O,Neon","Cypher,Sova,Omen,KAY/O,Neon"
Abyss,Purge eSports,Jabba Enjoyers,1,13,0,2,11,1,"Breach,Cypher,Sova,Jett,Astra","Sova,Killjoy,Viper,Yoru,Astra"
Ascent,SNOOZE Esports,Next In Line,10,13,7,4,9,3,"Sova,Killjoy,Omen,Jett,KAY/O","Sova,Killjoy,Omen,Jett,KAY/O"
Bind,Twisted Saints Esports,Banggai Cardinal,13,9,7,3,6,6,"Raze,Viper,Brimstone,Skye,Gekko","Raze,Viper,Brimstone,Fade,Gekko"
Lotus,Bitfix Gaming,Coalesce,16,14,9,6,8,7,"Breach,Raze,Cypher,Omen,Deadlock","Breach,Raze,Killjoy,Omen,Gekko"
Icebox,Derve Esports,SnuTek eSports,11,13,4,8,5,7,"Sova,Killjoy,Viper,Jett,Gekko","Breach,Sova,Killjoy,Viper,Jett"
Haven,Asgard Esports,ApesOnTour,3,13,1,11,2,2,"Breach,Cypher,Sova,Omen,Jett","Breach,Cypher,Sova,Omen,Neon"
Lotus,UNIWAY,Adimpleo Esports,13,1,11,1,0,2,"Breach,Raze,Cypher,Omen,Fade","Breach,Raze,Viper,Omen,Chamber"
Haven,PUX Esports,Team Colt,6,13,0,7,6,6,"Breach,Raze,Cypher,Harbor,Iso","Breach,Sova,Killjoy,Omen,Jett"
Haven,Project SOS,Colony Esports,13,6,6,1,5,7,"Sova,Killjoy,Viper,Omen,Yoru","Breach,Cypher,Sova,Omen,Neon"
Haven,Siko Esports,Lootcifer,14,12,9,4,8,5,"Breach,Cypher,Sova,Omen,Jett","Breach,Sova,Killjoy,Omen,Neon"
Lotus,OOT Esports,REY eSports,8,13,2,10,3,6,"Breach,Raze,Cypher,Omen,Fade","Raze,Killjoy,Viper,Omen,Fade"
Abyss,InTenZive,Hidden Horizon DACH,13,10,6,6,4,7,"Cypher,Sova,Jett,Astra,Gekko","Cypher,Sova,Omen,Jett,KAY/O"
Abyss,Kingslayers,REH Gaming,11,13,7,5,8,4,"Cypher,Sova,Jett,Yoru,Astra","Cypher,Sova,Jett,Yoru,Astra"
Ascent,Formulation Gaming,DSQ Esports,13,4,8,4,0,5,"Sova,Killjoy,Omen,Jett,KAY/O","Cypher,Sova,Omen,Jett,Deadlock"
Sunset,Glacial Guardians,Lost Puppies,11,13,3,9,4,8,"Cypher,Omen,KAY/O,Neon,Gekko","Breach,Cypher,Sova,Omen,Neon"
Sunset,SNOOZE Esports,Next In Line,4,13,3,9,4,1,"Breach,Raze,Cypher,Sova,Omen","Breach,Raze,Cypher,Omen,Gekko"
Haven,Gladius,Team Nice Shot,2,13,0,3,10,2,"Killjoy,Viper,Omen,Jett,Skye","Sova,Killjoy,Viper,Astra,Neon"
Bind,Purge eSports,Jabba Enjoyers,2,13,2,1,12,0,"Raze,Viper,Fade,Gekko,Clove","Raze,Viper,Brimstone,Fade,Gekko"
Bind,Ailurus eSports,Orkadia,8,13,7,5,8,1,"Raze,Viper,Brimstone,Skye,Gekko","Raze,Viper,Brimstone,Fade,Gekko"
Haven,Akatsuki,E-WOLVES,13,5,4,2,3,9,"Breach,Sova,Killjoy,Omen,Jett","Killjoy,Viper,Omen,Jett,Skye"
Lotus,Atake Esports,Sentient Esports (Inactive),10,13,5,6,7,5,"Raze,Killjoy,Viper,Omen,Fade","Breach,Raze,Cypher,Omen,Gekko"
Haven,CTRL x YARI Esports,Universae,13,6,5,2,4,8,"Breach,Sova,Killjoy,Omen,Neon","Breach,Sova,Killjoy,Omen,Jett"
Sunset,5STARS,Apinaorkesteri,7,13,7,5,8,0,"Breach,Raze,Cypher,Sova,Omen","Cypher,Sova,Omen,KAY/O,Neon"
Abyss,trashcan,Munich Esports,13,5,10,2,3,3,"Cypher,Sova,Omen,Jett,KAY/O","Cypher,Sova,Jett,Astra,Gekko"
Lotus,Hidden Horizon EAST,STAKERS,11,13,9,3,10,2,"Breach,Cypher,Sova,Omen,Neon","Breach,Killjoy,Omen,Neon,Fade"
Ascent,NoTag,REY ACADEMY,13,10,7,4,6,6,"Killjoy,Reyna,Omen,Jett,KAY/O","Sova,Killjoy,Omen,Jett,KAY/O"
Icebox,Formulation Gaming GC,NEANLATIYONBOLM,1,13,1,11,2,0,"Sova,Killjoy,Viper,Sage,Jett","Sova,Killjoy,Viper,Jett,Neon"
Sunset,Team Vortex,Grow uP eSports,13,6,9,3,3,4,"Breach,Raze,Cypher,Omen,Gekko","Breach,Raze,Cypher,Omen,Fade"
Haven,Hidden Horizon,Fellas in Paris,13,10,7,5,5,6,"Breach,Sova,Killjoy,Omen,Neon","Cypher,Sova,Omen,Yoru,Iso"
Abyss,RYL | Royal Legion,Da Gangalang,5,13,2,4,9,3,"Sova,Omen,Jett,Astra,KAY/O","Breach,Reyna,Omen,Neon,Deadlock"
Haven,Twisted Saints Esports,Banggai Cardinal,13,2,10,2,0,3,"Killjoy,Viper,Omen,Jett,Skye","Killjoy,Viper,Omen,Jett,Skye"
Sunset,Sakura Breeze Academy,OnlyFins,0,13,0,12,1,0,"Breach,Raze,Cypher,Omen,Gekko","Breach,Raze,Cypher,Sova,Omen"
Icebox,Haven Liberty,ESR Selection,13,9,5,5,4,8,"Sova,Killjoy,Reyna,Jett,Clove","Sova,Killjoy,Viper,Jett,KAY/O"
Sunset,Haven Liberty,ESR Selection,13,6,3,4,2,10,"Raze,Cypher,Sova,Deadlock,Clove","Breach,Raze,Cypher,Sova,Omen"
Ascent,Haven Liberty,ESR Selection,5,13,4,8,5,1,"Sova,Killjoy,Reyna,Omen,Jett","Sova,Killjoy,Omen,Jett,KAY/O"
Haven,Definite,ESR Selection,12,14,5,8,6,7,"Breach,Sova,Killjoy,Omen,Neon","Breach,Cypher,Sova,Astra,Neon"
Sunset,Definite,ESR Selection,6,13,2,5,8,4,"Breach,Raze,Cypher,Sova,Omen","Breach,Raze,Cypher,Sova,Omen"
Lotus,Definite,ESR Selection,13,11,9,3,8,4,"Killjoy,Viper,Omen,Neon,Fade","Raze,Killjoy,Viper,Omen,Fade"
Ascent,Haven Liberty,OEGHS A,13,2,11,1,1,2,"Raze,Sova,Killjoy,Omen,Iso","Sova,Killjoy,Omen,Jett,KAY/O"
Haven,Azzy White,Infiriumz Gaming GC,9,13,5,5,8,4,"Breach,Cypher,Sova,Omen,Neon","Breach,Sova,Killjoy,Omen,Neon"
Haven,Haven Liberty,OEGHS A,13,2,3,0,2,10,"Raze,Sova,Killjoy,Iso,Clove","Breach,Cypher,Sova,Omen,Jett"
Lotus,New Combat Line GC,No Sweat Blossom,13,10,5,7,3,8,"Raze,Killjoy,Viper,Omen,Fade","Breach,Raze,Killjoy,Omen,Gekko"
Ascent,Azzy White,Infiriumz Gaming GC,9,13,3,7,6,6,"Sova,Killjoy,Omen,Jett,KAY/O","Sova,Killjoy,Omen,Jett,KAY/O"
Ascent,New Combat Line GC,No Sweat Blossom,13,7,7,1,6,6,"Sova,Killjoy,Omen,Jett,KAY/O","Cypher,Sova,Omen,Yoru,Deadlock"
Bind,Azzy White,Infiriumz Gaming GC,13,9,7,5,4,6,"Raze,Viper,Brimstone,Skye,Deadlock","Raze,Viper,Brimstone,Yoru,Gekko"
Abyss,XSOUL GC,Deagle Ravagers,15,13,8,6,7,7,"Breach,Cypher,Sova,Astra,Neon","Cypher,Sova,Omen,Jett,KAY/O"
Bind,XSOUL GC,Deagle Ravagers,9,13,5,5,8,4,"Breach,Raze,Cypher,Brimstone,Yoru","Raze,Viper,Brimstone,Skye,Gekko"
Ascent,Dasein Club GC,Return of the Ashes,13,4,8,4,0,5,"Sova,Killjoy,Omen,Jett,KAY/O","Cypher,Sova,Omen,Jett,KAY/O"
Haven,XSOUL GC,Deagle Ravagers,13,11,6,6,5,7,"Breach,Cypher,Sova,Omen,Neon","Breach,Sova,Killjoy,Omen,Jett"
Haven,Dasein Club GC,Return of the Ashes,13,3,10,2,1,3,"Breach,Sova,Killjoy,Omen,Neon","Breach,Cypher,Sova,Omen,Neon"
Ascent,No Sweat Blossom,Infiriumz Gaming GC,13,11,9,3,8,4,"Cypher,Sova,Omen,Yoru,Deadlock","Sova,Killjoy,Omen,Jett,KAY/O"
Abyss,New Combat Line GC,Azzy White,13,1,11,1,0,2,"Breach,Cypher,Sova,Omen,Jett","Cypher,Sova,Omen,Jett,KAY/O"
Ascent,New Combat Line GC,Azzy White,13,5,4,2,3,9,"Raze,Sova,Killjoy,Omen,KAY/O","Cypher,Sova,Omen,Jett,KAY/O"
Sunset,No Sweat Blossom,Infiriumz Gaming GC,13,11,8,4,7,5,"Breach,Raze,Cypher,Omen,Gekko","Breach,Raze,Cypher,Omen,Gekko"
Ascent,Dasein Club GC,XSOUL GC,3,13,2,2,11,1,"Sova,Killjoy,Omen,Jett,KAY/O","Breach,Sova,Killjoy,Omen,Jett"
Haven,Deagle Ravagers,Return of the Ashes,13,9,7,5,4,6,"Breach,Sova,Killjoy,Omen,Jett","Breach,Cypher,Sova,Omen,Neon"
Ascent,Deagle Ravagers,Return of the Ashes,13,2,3,0,2,10,"Sova,Killjoy,Omen,Jett,KAY/O","Breach,Raze,Cypher,Sova,Omen"
Abyss,Dasein Club GC,XSOUL GC,5,13,3,9,4,2,"Cypher,Sova,Jett,Astra,Gekko","Breach,Cypher,Sova,Astra,Neon"
Sunset,Bon Bon Bum Contra GC,Akave Esports Black,6,13,0,7,6,6,"Breach,Sova,Sage,Omen,Gekko","Breach,Raze,Cypher,Omen,Gekko"
Haven,Bon Bon Bum Contra GC,Akave Esports Black,10,13,4,7,6,6,"Breach,Sova,Killjoy,Omen,Chamber","Breach,Cypher,Sova,Omen,Jett"
Haven,Leviatán GC,KRÜ BLAZE,15,13,9,5,8,6,"Breach,Cypher,Sova,Omen,Neon","Breach,Sova,Killjoy,Omen,Jett"
Icebox,Leviatán GC,KRÜ BLAZE,1,13,0,2,11,1,"Sova,Killjoy,Viper,Jett,KAY/O","Sova,Killjoy,Harbor,Iso,Clove"
Icebox,Leviatán GC,KRÜ BLAZE,1,13,0,2,11,1,"Sova,Killjoy,Viper,Jett,KAY/O","Sova,Killjoy,Harbor,Iso,Clove"
Ascent,K7 Esports GC,MYVRA,10,13,7,4,9,3,"Sova,Killjoy,Omen,Jett,KAY/O","Sova,Killjoy,Jett,KAY/O,Clove"
Abyss,K7 Esports GC,MYVRA,4,13,1,4,9,3,"Breach,Cypher,Sova,Omen,Jett","Breach,Raze,Cypher,Sova,Astra"
Sunset,Zen eSports GC,9z Team GC,10,13,4,8,5,6,"Breach,Cypher,Sova,Omen,Neon","Breach,Cypher,Omen,Neon,Gekko"
Abyss,Zen eSports GC,9z Team GC,5,13,3,3,10,2,"Breach,Cypher,Sova,Omen,Jett","Cypher,Sova,Omen,Jett,Harbor"
Ascent,KS Esports GC,FUSION X,5,13,5,7,6,0,"Cypher,Sova,Omen,Yoru,Deadlock","Raze,Sova,KAY/O,Iso,Clove"
Icebox,KS Esports GC,FUSION X,13,11,7,5,6,6,"Sova,Killjoy,Viper,Jett,Gekko","Killjoy,Jett,Astra,Gekko,Iso"
Abyss,KS Esports GC,FUSION X,5,13,4,8,5,1,"Sova,Omen,Yoru,Astra,Deadlock","Breach,Cypher,Jett,Astra,Gekko"
Haven,University War GC,FiRePOWER GC,11,13,7,5,8,4,"Breach,Cypher,Sova,Omen,Neon","Breach,Sova,Killjoy,Omen,Neon"
Abyss,University War GC,FiRePOWER GC,7,13,1,7,6,6,"Breach,Cypher,Sova,Omen,Jett","Cypher,Sova,Omen,Jett,KAY/O"
Ascent,University War GC,FiRePOWER GC,13,10,5,7,3,8,"Sova,Killjoy,Omen,Jett,KAY/O","Sova,Killjoy,Omen,Jett,KAY/O"
Sunset,Blinn Esports,SaD Esports,5,13,4,8,5,1,"Breach,Cypher,Omen,Neon,Gekko","Breach,Raze,Cypher,Sova,Omen"
Haven,Blinn Esports,SaD Esports,11,13,5,7,6,6,"Breach,Cypher,Sova,Omen,Neon","Sova,Jett,Astra,Deadlock,Iso"
Bind,kellogs cereal,Made in O'Block,13,7,7,5,2,6,"Raze,Cypher,Viper,Skye,Clove","Raze,Skye,Gekko,Deadlock,Clove"
Abyss,Freaky Furries,SaD Esports,3,13,0,4,9,3,"Cypher,Sova,Jett,Yoru,Astra","Cypher,Sova,Omen,Yoru,Harbor"
Ascent,Blinn Esports,ENVEE Esports,13,4,4,1,3,9,"Cypher,Sova,Omen,Yoru,Deadlock","Sova,Killjoy,Omen,Jett,KAY/O"
Sunset,kellogs cereal,Made in O'Block,13,9,6,6,3,7,"Breach,Raze,Cypher,Gekko,Clove","Breach,Raze,Cypher,Omen,Fade"
Bind,Freaky Furries,SaD Esports,13,8,7,5,3,6,"Raze,Viper,Brimstone,Skye,Deadlock","Raze,Cypher,Viper,Brimstone,Fade"
Sunset,Prime (NA),FAWZ Purple,13,3,11,1,2,2,"Breach,Raze,Cypher,Sova,Clove","Breach,Cypher,Sova,Omen,Neon"
Haven,Freaky Furries,SaD Esports,8,13,3,9,4,5,"Breach,Cypher,Sova,Omen,Jett","Sova,Jett,Astra,Deadlock,Iso"
Abyss,Blinn Esports,ENVEE Esports,13,11,6,6,5,7,"Cypher,Sova,Omen,Yoru,Harbor","Cypher,Viper,Omen,Yoru,Fade"
Haven,kellogs cereal,Made in O'Block,9,13,5,5,8,4,"Breach,Sova,Killjoy,Omen,Jett","Breach,Sova,Killjoy,Omen,Neon"
Bind,Prime (NA),FAWZ Purple,13,7,7,5,2,6,"Raze,Cypher,Sova,Brimstone,Clove","Raze,Viper,Brimstone,Fade,Gekko"
Abyss,EDward Gaming,Team Heretics,13,9,8,4,5,5,"Sova,Omen,Jett,Astra,KAY/O","Cypher,Sova,Jett,Astra,Gekko"
Bind,EDward Gaming,Team Heretics,11,13,6,6,7,5,"Raze,Viper,Brimstone,Fade,Gekko","Raze,Viper,Brimstone,Fade,Gekko"
Lotus,EDward Gaming,Team Heretics,13,9,7,3,6,6,"Breach,Omen,Neon,Fade,Clove","Raze,Killjoy,Viper,Omen,Fade"
Sunset,EDward Gaming,Team Heretics,13,4,11,1,3,2,"Cypher,Sova,Omen,KAY/O,Neon","Raze,Cypher,Sova,Omen,KAY/O"
Haven,EDward Gaming,Team Heretics,6,13,3,9,4,3,"Breach,Cypher,Sova,Omen,Neon","Breach,Cypher,Sova,Omen,Neon"
Sunset,FDR,Eternal Focus Crimson,6,13,1,6,7,5,"Breach,Raze,Cypher,Omen,Gekko","Breach,Cypher,Omen,Neon,Fade"
Abyss,FDR,Eternal Focus Crimson,13,6,5,2,4,8,"Cypher,Sova,Omen,Jett,Gekko","Cypher,Sova,Yoru,Astra,Gekko"
Sunset,West Virginia University,ENVEE Esports,5,13,2,4,9,3,"Breach,Cypher,Sova,Omen,Neon","Breach,Cypher,Sova,Omen,Neon"
Bind,FDR,Eternal Focus Crimson,8,13,3,6,7,5,"Raze,Viper,Brimstone,Fade,Gekko","Omen,Yoru,Fade,Harbor,Deadlock"
Haven, Unjustified,kellogs cereal,9,13,7,5,8,2,"Breach,Cypher,Sova,Omen,Jett","Breach,Sova,Killjoy,Omen,Jett"
Abyss,West Virginia University,ENVEE Esports,4,13,4,8,5,0,"Cypher,Sova,Omen,Jett,Harbor","Cypher,Viper,Omen,Yoru,Fade"
Bind,Una Ludio,FDR,6,13,4,8,5,2,"Raze,Cypher,Brimstone,Skye,Fade","Raze,Viper,Brimstone,Fade,Gekko"
Ascent,Mythos Wraiths,Eternal Focus Crimson,4,13,3,9,4,1,"Cypher,Sova,Omen,Jett,Deadlock","Raze,Sova,Killjoy,Omen,Deadlock"
Bind,Freaky Furries,Koufs Fun Club,13,11,5,7,4,8,"Raze,Viper,Brimstone,Skye,Deadlock","Raze,Brimstone,Yoru,Fade,Deadlock"
Ascent,Prime (NA),Gondal Enjoyers,13,5,3,3,2,10,"Sova,Killjoy,Omen,Jett,Fade","Cypher,Sova,Omen,Jett,Iso"
Ascent,Mongolia Car,SaD Esports,8,13,5,7,6,3,"Sova,Killjoy,Omen,Jett,KAY/O","Cypher,Sova,Omen,Jett,Deadlock"
Ascent, Unjustified,kellogs cereal,13,15,4,10,5,9,"Sova,Killjoy,Omen,Jett,KAY/O","Sova,Killjoy,Omen,Jett,KAY/O"
Ascent,Blinn Esports,1KRR and Racoone,13,3,10,2,1,3,"Cypher,Sova,Omen,Yoru,Deadlock","Cypher,Sova,Omen,Jett,Deadlock"
Sunset,Converse Purple,Eternal Focus Crimson,4,13,3,9,4,1,"Breach,Raze,Cypher,Sova,Omen","Breach,Cypher,Omen,Neon,Fade"
Sunset,SaD FROST,FDR,5,13,3,9,4,2,"Cypher,Omen,KAY/O,Neon,Gekko","Breach,Raze,Cypher,Omen,Gekko"
Ascent,West Virginia University,ENVEE Esports,17,15,10,6,9,7,"Sova,Killjoy,Omen,Jett,KAY/O","Sova,Killjoy,Omen,Jett,KAY/O"
Bind,UC CSU,Cumberland Phoenix,8,13,4,8,5,4,"Raze,Viper,Brimstone,Reyna,Skye","Breach,Neon,Fade,Iso,Clove"
Ascent,Low Budget,Una Ludio,8,13,2,7,6,6,"Sova,Killjoy,Omen,Jett,KAY/O","Sova,Killjoy,Omen,Jett,KAY/O"
Ascent,FAWZ Purple,lost cause,13,6,7,0,6,6,"Sova,Killjoy,Omen,Jett,KAY/O","Sova,Killjoy,Omen,Jett,KAY/O"
Haven,Freaky Furries,Koufs Fun Club,13,9,9,3,6,4,"Breach,Cypher,Sova,Omen,Jett","Sova,Killjoy,Omen,Jett,Iso"
Sunset,Mongolia Car,SaD Esports,5,13,3,9,4,2,"Breach,Cypher,Sova,Omen,Neon","Breach,Raze,Cypher,Sova,Omen"
Icebox,Forsaken Shadows,Mythos Wraiths,11,13,4,8,5,7,"Sova,Killjoy,Viper,Jett,Yoru","Sova,Killjoy,Viper,Jett,Harbor"
Haven,Prime (NA),Gondal Enjoyers,14,12,8,5,7,6,"Sova,Killjoy,Viper,Omen,Jett","Cypher,Sova,Yoru,Iso,Clove"
Haven,Blinn Esports,1KRR and Racoone,13,9,4,6,3,9,"Breach,Sova,Omen,Chamber,Neon","Breach,Cypher,Omen,Jett,Deadlock"
Ascent,Made in O'Block,Ivy League Dropouts,13,10,3,9,1,10,"Sova,Killjoy,Omen,Jett,KAY/O","Cypher,Sova,Omen,Yoru,Deadlock"
Abyss,Vovin, Unjustified,8,13,2,7,6,6,"Cypher,Sova,Jett,Yoru,Astra","Sova,Viper,Jett,Yoru,Astra"
Abyss,FAWZ Purple,lost cause,13,5,7,5,0,6,"Cypher,Sova,Jett,Astra,Gekko","Sova,Jett,Yoru,Astra,Deadlock"
Haven,Big Baller Brand,SaD FROST,7,13,3,9,4,4,"Breach,Cypher,Sova,Omen,Neon","Breach,Cypher,Sova,Omen,Neon"
Ascent,UC CSU,Cumberland Phoenix,5,13,1,5,8,4,"Cypher,Sova,Omen,Jett,KAY/O","Sova,Killjoy,Omen,Jett,KAY/O"
Haven,Converse Purple,Team Image,13,10,7,4,6,6,"Breach,Cypher,Sova,Omen,Jett","Breach,Sova,Killjoy,Omen,Neon"
Haven,Mongolia Car,SaD Esports,13,6,4,3,3,9,"Breach,Cypher,Sova,Omen,Neon","Sova,Jett,Astra,Deadlock,Iso"
Ascent,minions united GC,Una Ludio,10,13,5,6,7,5,"Sova,Killjoy,Omen,Jett,KAY/O","Sova,Killjoy,Omen,Jett,KAY/O"
Split,Berzerkers,West Virginia University,7,13,4,8,5,3,"Breach,Raze,Cypher,Omen,Yoru","Breach,Raze,Viper,Skye,Clove"
Sunset,Forsaken Shadows,Vibin Out Vex,13,5,3,3,2,10,"Raze,Cypher,Omen,Neon,Gekko","Breach,Cypher,Sova,Omen,Neon"
Ascent,Mythos Wraiths,Harmony Onyx,13,6,9,3,3,4,"Cypher,Sova,Omen,Jett,Deadlock","Sova,Killjoy,Omen,Jett,KAY/O"
Bind,goobers,FDR,1,13,1,11,2,0,"Cypher,Brimstone,Jett,Gekko,Deadlock","Raze,Viper,Brimstone,Fade,Gekko"
Bind,Made in O'Block,Ivy League Dropouts,13,10,6,6,4,7,"Raze,Viper,Skye,Gekko,Clove","Raze,Brimstone,Skye,Yoru,Gekko"
Bind,Prestige XOXO,Low Budget,1,13,0,2,11,1,"Raze,Viper,Skye,Harbor,Gekko","Raze,Viper,Brimstone,Skye,Gekko"
Bind,Freaky Furries,add3r's kittens,13,7,7,5,2,6,"Raze,Viper,Brimstone,Skye,Deadlock","Raze,Brimstone,Yoru,Fade,Gekko"
Sunset,Prime (NA),Gondal Enjoyers,10,13,1,10,3,9,"Breach,Raze,Cypher,Sova,Clove","Raze,Cypher,Fade,Iso,Clove"
Bind,Eternal Focus Crimson,Prestige Esports,13,11,5,7,4,8,"Omen,Yoru,Fade,Harbor,Deadlock","Raze,Viper,Brimstone,Skye,Gekko"
Bind,Vovin, Unjustified,5,13,3,9,4,2,"Raze,Viper,Fade,Gekko,Clove","Raze,Cypher,Viper,Brimstone,Skye"
Ascent,ENVEE Esports,Dexterity Gaming,13,6,10,2,4,3,"Sova,Killjoy,Omen,Jett,KAY/O","Cypher,Sova,Omen,Jett,KAY/O"
Split,Asura Onyx,FAWZ Purple,6,13,3,9,4,3,"Raze,Cypher,Viper,Omen,Skye","Raze,Cypher,Omen,Skye,Gekko"
Sunset,1KRR and Racoone,hunter505,13,10,7,4,6,6,"Breach,Cypher,Omen,Neon,Deadlock","Breach,Raze,Cypher,Omen,Gekko"
Ascent,Cumberland Phoenix,SEN SHAHZAM,13,7,6,6,1,7,"Sova,Killjoy,Omen,Jett,KAY/O","Sova,Killjoy,Omen,Jett,KAY/O"
Haven,Boomer Squad,Koufs Fun Club,10,13,2,9,4,8,"Cypher,Sova,Omen,Yoru,Deadlock","Sova,Killjoy,Omen,Jett,Iso"
Haven,Mongolia Car,Be Like Matt,13,6,8,4,2,5,"Breach,Cypher,Sova,Omen,Neon","Phoenix,Sage,Chamber,Gekko,Clove"
Abyss,Freaky Furries,add3r's kittens,13,2,3,0,2,10,"Cypher,Sova,Jett,Yoru,Astra","Sova,Killjoy,Jett,Yoru,Astra"
Sunset,minions united GC,Centic Junior,13,1,11,1,0,2,"Breach,Raze,Cypher,Omen,Gekko","Breach,Cypher,Neon,Fade,Clove"
Haven,SaD Esports,YDZ Esports,13,1,2,0,1,11,"Sova,Jett,Astra,Deadlock,Iso","Cypher,Sova,Omen,Yoru,Iso"
Haven,Skyline Dreamers GC,Team Image,4,13,1,4,9,3,"Breach,Killjoy,Omen,Jett,Gekko","Breach,Sova,Killjoy,Omen,Neon"
Ascent,UC CSU,Shrek's Ogres,13,6,7,5,1,6,"Cypher,Sova,Omen,Jett,KAY/O","Breach,Cypher,Yoru,Fade,Clove"
Haven,Forsaken Shadows,Natural Order,13,8,4,5,3,9,"Sova,Killjoy,Reyna,Omen,Jett","Breach,Cypher,Sova,Omen,Jett"
Bind,SaD FROST,Barely Acceptable,15,13,6,8,5,9,"Raze,Viper,Brimstone,Skye,Chamber","Raze,Viper,Brimstone,Omen,KAY/O"
Haven,Made in O'Block,Ivy League Dropouts,6,13,2,5,8,4,"Breach,Sova,Killjoy,Omen,Neon","Cypher,Sova,Omen,Jett,Iso"
Ascent,kaiju corp,Vibin Out Vex,10,13,7,5,8,3,"Cypher,Sova,Omen,Jett,KAY/O","Sova,Killjoy,Omen,Jett,KAY/O"
Haven,Venatus,goobers,8,13,4,5,8,4,"Breach,Sova,Killjoy,Omen,Jett","Cypher,Sova,Omen,Jett,KAY/O"
Ascent,Berzerkers,West Virginia University,14,16,7,8,8,7,"Cypher,Sova,Omen,Yoru,Deadlock","Sova,Killjoy,Omen,Jett,KAY/O"
Ascent,Empire Invictus,Una Ludio,4,13,1,4,9,3,"Cypher,Sova,Omen,Jett,KAY/O","Sova,Killjoy,Omen,Jett,KAY/O"
Sunset,Charmers GC,FDR,0,13,0,12,1,0,"Breach,Raze,Cypher,Omen,Gekko","Breach,Raze,Cypher,Omen,Gekko"
Ascent,Eternal Focus Crimson,Outcast Gaming,13,0,1,0,0,12,"Raze,Sova,Killjoy,Omen,Deadlock","Cypher,Sova,Omen,Jett,KAY/O"
Lotus,Harmony White,Mythos Wraiths,9,13,7,5,8,2,"Breach,Raze,Killjoy,Omen,Gekko","Raze,Cypher,Viper,Omen,Fade"
Haven,Gondal Enjoyers,OREGON CRACK,13,7,10,2,5,3,"Cypher,Sova,Phoenix,Neon,Clove","Cypher,Sova,Omen,Yoru,Iso"
Lotus,Mighty Meowers,Low Budget,7,13,1,7,6,6,"Breach,Raze,Cypher,Omen,Gekko","Raze,Killjoy,Viper,Omen,Fade"
Haven,Elite Dynasty,Prestige Esports,5,13,1,5,8,4,"Breach,Cypher,Sova,Omen,Neon","Breach,Cypher,Sova,Omen,Jett"
Lotus,Converse Purple,Freakazoids,13,6,5,2,4,8,"Breach,Raze,Killjoy,Omen,Fade","Breach,Raze,Cypher,Omen,Fade"
Ascent,SEN SHAHZAM,Kaizen (NA),13,0,12,0,0,1,"Sova,Killjoy,Omen,Jett,KAY/O","Cypher,Sova,Omen,Jett,KAY/O"
Split,Corvus Esports,lost cause,5,13,3,3,10,2,"Raze,Cypher,Omen,Jett,Skye","Raze,Omen,Skye,Chamber,Iso"
Haven,Vovin, Unjustified,13,7,4,4,3,9,"Breach,Cypher,Sova,Omen,Jett","Breach,Cypher,Sova,Omen,Jett"
Bind,Asura Onyx,FAWZ Purple,7,13,4,8,5,3,"Raze,Viper,Brimstone,Fade,Gekko","Raze,Viper,Brimstone,Skye,Gekko"
Pearl,Mongolia Car,Be Like Matt,13,6,9,3,3,4,"Sova,Killjoy,Jett,Astra,KAY/O","Killjoy,Viper,Jett,Skye,Harbor"
Sunset,Boomer Squad,Koufs Fun Club,7,13,4,8,5,3,"Raze,Cypher,Reyna,Astra,Gekko","Raze,Cypher,Omen,Neon,Fade"
Haven,1KRR and Racoone,hunter505,13,8,10,2,6,3,"Breach,Cypher,Omen,Neon,Deadlock","Breach,Sova,Killjoy,Omen,Neon"
Pearl,Blinn Esports,whats a pretzel,13,7,10,2,5,3,"Killjoy,Viper,Yoru,Astra,Fade","Sova,Killjoy,Viper,Yoru,Harbor"
Haven,Freaky Furries,add3r's kittens,10,13,6,5,8,4,"Breach,Cypher,Sova,Omen,Jett","Breach,Sova,Killjoy,Omen,Jett"
Haven,ENVEE Esports,Dexterity Gaming,13,5,4,2,3,9,"Breach,Cypher,Sova,Omen,Jett","Breach,Sova,Killjoy,Omen,Jett"
Pearl,ABG luvrs,Prime (NA),12,14,8,5,9,4,"Sova,Killjoy,Astra,Neon,Gekko","Cypher,Sova,Viper,Jett,Astra"
Ascent,SaD Esports,YDZ Esports,13,7,6,2,5,7,"Cypher,Sova,Omen,Jett,Deadlock","Sova,Killjoy,Omen,Jett,KAY/O"
Bind,Gondal Enjoyers,OREGON CRACK,13,7,7,5,2,6,"Raze,Yoru,Fade,Deadlock,Clove","Raze,Cypher,Brimstone,Reyna,Fade"
Ascent,threehunna,Ivy League Dropouts,3,13,1,11,2,2,"Sova,Killjoy,Omen,Jett,KAY/O","Cypher,Sova,Omen,Yoru,Deadlock"
Haven,Berzerkers,West Virginia University,13,8,7,2,6,6,"Cypher,Sova,Omen,Jett,Iso","Breach,Cypher,Sova,Omen,Neon"
Haven,Blinn Esports,whats a pretzel,13,2,11,1,1,2,"Breach,Sova,Omen,Chamber,Neon","Breach,Omen,Chamber,Neon,Fade"
Abyss,Corvus Esports,lost cause,10,13,8,4,9,2,"Breach,Cypher,Sova,Omen,Jett","Sova,Jett,Astra,Neon,Deadlock"
Split,BUGBLENDER,Made in O'Block,6,13,4,8,5,2,"Raze,Viper,Omen,Jett,Skye","Raze,Cypher,Jett,Skye,Astra"
Haven,CCG Esports,UC CSU,12,14,4,9,5,8,"Cypher,Sova,Omen,Yoru,Iso","Breach,Cypher,Sova,Omen,Jett"
Sunset,Una Ludio,Shrek's Ogres,6,13,3,9,4,3,"Breach,Cypher,Sova,Omen,Neon","Breach,Raze,Viper,Gekko,Clove"
Ascent,Cumberland Phoenix,Atlas Esports,13,6,5,2,4,8,"Sova,Killjoy,Omen,Jett,KAY/O","Sova,Killjoy,Omen,Jett,KAY/O"
Bind, Unjustified,Blackline,13,11,6,6,5,7,"Raze,Cypher,Viper,Brimstone,Skye","Raze,Viper,Brimstone,Skye,Fade"
Abyss,Asura Onyx,FAWZ Purple,14,12,6,7,5,8,"Cypher,Sova,Viper,Omen,Yoru","Cypher,Sova,Jett,Astra,Gekko"
Ascent,Goon that jawn,Boomer Squad,5,13,3,9,4,2,"Sova,Killjoy,Omen,Jett,Yoru","Cypher,Sova,Omen,Jett,Deadlock"
Ascent,YDZ Esports,Event Horizon,13,4,9,3,1,4,"Sova,Killjoy,Omen,Jett,KAY/O","Sova,Killjoy,Omen,Jett,KAY/O"
Haven,threehunna,Ivy League Dropouts,6,13,4,3,10,2,"Breach,Cypher,Sova,Omen,Jett","Cypher,Sova,Omen,Jett,Iso"
Split,Be Like Matt,Nearest Airport,13,9,3,7,2,10,"Raze,Cypher,Viper,Omen,Skye","Raze,Omen,Yoru,Astra,Fade"
Sunset,ABG luvrs,Prime (NA),10,13,6,6,7,4,"Breach,Cypher,Sova,Omen,Neon","Breach,Raze,Cypher,Sova,Clove"
Abyss,Harmony,OREGON CRACK,6,13,1,6,7,5,"Breach,Cypher,Sova,Omen,Jett","Cypher,Sova,Reyna,Jett,Astra"
Bind,Aspyre x Swarm,hunter505,8,13,6,6,7,2,"Raze,Viper,Brimstone,Fade,Gekko","Raze,Cypher,Reyna,Skye,Clove"
Bind,add3r's kittens,Good Career,13,8,8,4,4,5,"Raze,Brimstone,Yoru,Fade,Gekko","Raze,Viper,Brimstone,Skye,Gekko"
Haven,BUGBLENDER,Made in O'Block,4,13,0,5,8,4,"Breach,Cypher,Sova,Omen,Yoru","Breach,Sova,Killjoy,Omen,Neon"
Abyss,Kaizen (NA),Divine Valorant,14,12,8,5,7,6,"Cypher,Jett,Skye,Astra,Harbor","Sova,Viper,Jett,Yoru,Astra"
Bind,Xclusive,SEN SHAHZAM,5,13,4,2,11,1,"Raze,Cypher,Brimstone,Fade,Gekko","Raze,Viper,Brimstone,Reyna,Gekko"
Haven,les piments,Shrek's Ogres,1,13,1,11,2,0,"Breach,Cypher,Sova,Omen,Jett","Cypher,Sova,Omen,Jett,Yoru"
Haven,West Virginia University,Team Digital,13,5,6,0,5,7,"Breach,Cypher,Sova,Omen,Neon","Breach,Cypher,Sova,Omen,Jett"
Ascent, Unjustified,Blackline,13,5,7,5,0,6,"Sova,Killjoy,Omen,Jett,KAY/O","Sova,Killjoy,Omen,Jett,KAY/O"
Abyss,Koufs Fun Club,Spate Esports,13,6,8,4,2,5,"Cypher,Sova,Reyna,Omen,Jett","Cypher,Omen,Jett,Skye,Harbor"
Bind,Wet Napkins,Atlas Esports,9,13,3,7,6,6,"Raze,Viper,Brimstone,Skye,Iso","Raze,Viper,Brimstone,Skye,Gekko"
Pearl,Unckies,Dexterity Gaming,8,13,3,9,4,5,"Sova,Killjoy,Jett,Yoru,Astra","Killjoy,Viper,Jett,Harbor,Gekko"
Haven,Goon that jawn,Boomer Squad,13,7,4,4,3,9,"Breach,Cypher,Sova,Omen,Yoru","Cypher,Sova,Omen,Yoru,Deadlock"
Ascent,whats a pretzel,OC Eagles,13,11,5,7,4,8,"Cypher,Sova,Omen,Yoru,Deadlock","Sova,Killjoy,Omen,Jett,KAY/O"
Lotus,Bongo Cat,UC CSU,10,13,6,6,7,4,"Breach,Killjoy,Jett,Fade,Clove","Raze,Killjoy,Viper,Omen,Fade"
Bind,Acrylic eSports,Una Ludio,6,13,2,10,3,4,"Raze,Viper,Brimstone,Skye,Chamber","Raze,Cypher,Brimstone,Skye,Fade"
Sunset,Non-Verbal,1KRR and Racoone,4,13,4,8,5,0,"Breach,Cypher,Sova,Omen,Neon","Breach,Cypher,Omen,Neon,Deadlock"
Ascent,Paranoia Boys,CCG Esports,4,13,2,10,3,2,"Sova,Killjoy,Omen,Jett,KAY/O","Sova,Killjoy,Omen,Jett,KAY/O"
Bind,Harmony,OREGON CRACK,8,13,0,9,4,8,"Raze,Cypher,Brimstone,Skye,Deadlock","Raze,Cypher,Brimstone,Reyna,Fade"
Sunset,Aspyre x Swarm,hunter505,6,13,5,7,6,1,"Breach,Cypher,Omen,Neon,Fade","Breach,Raze,Cypher,Omen,Gekko"
Bind,YDZ Esports,Event Horizon,14,12,7,6,6,7,"Raze,Viper,Brimstone,Fade,Gekko","Raze,Viper,Brimstone,Fade,Gekko"
Ascent,NoPrac,Cumberland Phoenix,3,13,1,11,2,2,"Sova,Killjoy,Omen,Jett,KAY/O","Sova,Killjoy,Omen,Jett,KAY/O"
Ascent,Boise State University,FAWZ Purple,11,13,3,9,4,8,"Cypher,Sova,Omen,Jett,Deadlock","Sova,Killjoy,Omen,Jett,KAY/O"
Bind,Shane's Kittens,Ivy League Dropouts,2,13,2,10,3,0,"Raze,Cypher,Skye,Gekko,Clove","Raze,Brimstone,Skye,Yoru,Gekko"
Pearl,Be Like Matt,Nearest Airport,14,12,6,7,5,8,"Killjoy,Viper,Jett,Skye,Harbor","Killjoy,Jett,Astra,KAY/O,Fade"
Sunset,Prime (NA),BALLZ,13,8,7,5,3,6,"Breach,Raze,Cypher,Sova,Clove","Breach,Cypher,Sova,Omen,Neon"
Pearl,add3r's kittens,Good Career,13,11,3,9,2,10,"Sova,Killjoy,Jett,Yoru,Astra","Killjoy,Viper,Jett,Fade,Harbor"
Bind,Made in O'Block,Made in Brampton,13,4,8,4,0,5,"Raze,Viper,Skye,Gekko,Clove","Raze,Cypher,Brimstone,Sage,Chamber"
Pearl,The Bees Knees,lost cause,10,13,8,4,9,2,"Killjoy,Viper,Jett,Skye,Harbor","Killjoy,Phoenix,Jett,Skye,Astra"
Sunset,Goon that jawn,Boomer Squad,11,13,4,8,5,7,"Breach,Raze,Cypher,Sova,Omen","Raze,Cypher,Reyna,Astra,Gekko"
Haven,Unckies,Dexterity Gaming,11,13,5,7,6,6,"Breach,Sova,Killjoy,Omen,Jett","Breach,Sova,Killjoy,Omen,Jett"
Abyss,West Virginia University,Team Digital,14,12,9,4,8,5,"Cypher,Sova,Omen,Jett,Harbor","Cypher,Sova,Omen,Jett,KAY/O"
Bind,Be Like Matt,Nearest Airport,7,13,4,4,9,3,"Raze,Viper,Skye,Chamber,Clove","Raze,Cypher,Omen,Yoru,Deadlock"
Abyss,whats a pretzel,OC Eagles,13,8,9,3,5,4,"Sova,Omen,Jett,Harbor,Deadlock","Cypher,Sova,Omen,Yoru,KAY/O"
Haven,Non-Verbal,1KRR and Racoone,9,13,4,8,5,5,"Killjoy,Viper,Omen,Jett,Skye","Breach,Cypher,Omen,Neon,Deadlock"
Haven,Shane's Kittens,Ivy League Dropouts,8,13,6,6,7,2,"Breach,Sova,Killjoy,Omen,Jett","Cypher,Sova,Omen,Jett,Iso"
Sunset,Made in O'Block,Made in Brampton,13,3,9,3,0,4,"Breach,Raze,Cypher,Omen,Fade","Raze,Cypher,Sova,Omen,Gekko"
Haven,Koufs Fun Club,Spate Esports,15,13,8,6,7,7,"Sova,Killjoy,Omen,Jett,Iso","Breach,Cypher,Sova,Neon,Clove"
Abyss, Unjustified,Blackline,15,17,7,9,8,8,"Sova,Viper,Jett,Yoru,Astra","Cypher,Sova,Viper,Yoru,Astra"
Haven,YDZ Esports,Event Horizon,11,13,3,9,4,8,"Cypher,Sova,Omen,Yoru,Iso","Breach,Sova,Killjoy,Omen,Jett"
Haven,Aspyre x Swarm,hunter505,13,9,6,4,5,7,"Killjoy,Viper,Omen,Jett,Skye","Breach,Sova,Killjoy,Omen,Neon"
Sunset,Harmony,OREGON CRACK,13,10,9,2,8,4,"Breach,Cypher,Sova,Omen,Neon","Raze,Cypher,Gekko,Iso,Clove"
Ascent,The Bees Knees,lost cause,9,13,6,6,7,3,"Sova,Killjoy,Omen,Jett,KAY/O","Sova,Killjoy,Reyna,Omen,Jett"
Abyss,Boise State University,FAWZ Purple,9,13,7,5,8,2,"Cypher,Sova,Omen,Jett,Harbor","Cypher,Sova,Jett,Astra,Gekko"
Ascent,add3r's kittens,Good Career,10,13,2,9,4,8,"Sova,Killjoy,Omen,Jett,KAY/O","Sova,Killjoy,Omen,Jett,KAY/O"
Haven,Prime (NA),BALLZ,13,10,8,3,7,5,"Sova,Killjoy,Viper,Omen,Jett","Breach,Cypher,Sova,Omen,Neon"
Lotus,Leviatán,Team Heretics,3,13,2,2,11,1,"Breach,Raze,Cypher,Omen,Fade","Raze,Killjoy,Viper,Omen,Fade"
Abyss,Leviatán,Team Heretics,13,9,5,7,2,8,"Cypher,Sova,Omen,Jett,Harbor","Cypher,Sova,Jett,Astra,Gekko"
Sunset,Leviatán,Team Heretics,13,15,9,5,10,4,"Breach,Cypher,Sova,Omen,Neon","Raze,Cypher,Sova,Omen,KAY/O"
Icebox,Leviatán,Team Heretics,7,13,5,7,6,2,"Sova,Killjoy,Viper,Jett,Harbor","Sova,Killjoy,Viper,Neon,Gekko"
Ascent,Made in O'Block,OC Eagles,3,13,2,10,3,1,"Sova,Killjoy,Omen,Jett,KAY/O","Sova,Killjoy,Omen,Jett,KAY/O"
Split,Predator X Gaming,Spate Esports,13,15,5,9,6,8,"Breach,Raze,Cypher,Skye,Astra","Raze,Cypher,Omen,Jett,Skye"
Split,Bobo is Hobo,Boomer Squad,9,13,2,8,5,7,"Raze,Cypher,Viper,Skye,Astra","Raze,Cypher,Viper,Omen,Skye"
Split,whats a pretzel,kellogs cereal,13,5,8,4,1,5,"Raze,Cypher,Viper,Omen,Skye","Raze,Cypher,Viper,Omen,Skye"
Abyss,Be Like Matt,A Good Team,13,11,7,5,6,6,"Cypher,Sova,Omen,Yoru,Deadlock","Cypher,Sova,Jett,Astra,Gekko"
Ascent,Nearest Airport,OREGON CRACK,13,6,9,3,3,4,"Cypher,Sova,Omen,Yoru,Deadlock","Sova,Killjoy,Omen,Jett,Deadlock"
Split,hunter505,Ivy League Dropouts,16,14,4,11,3,12,"Raze,Cypher,Viper,Skye,Astra","Raze,Cypher,Viper,Omen,Skye"
Haven,Predator X Gaming,Spate Esports,11,13,7,5,8,4,"Breach,Cypher,Sova,Omen,Jett","Breach,Cypher,Sova,Neon,Clove"
Ascent,Bobo is Hobo,Boomer Squad,8,13,3,6,7,5,"Cypher,Sova,Omen,Jett,KAY/O","Sova,Killjoy,Omen,Jett,KAY/O"
Haven,Made in O'Block,OC Eagles,15,13,9,5,8,6,"Breach,Sova,Killjoy,Omen,Neon","Breach,Cypher,Sova,Omen,Neon"
Bind,ABG luvrs,Event Horizon,3,13,1,11,2,2,"Raze,Viper,Brimstone,Fade,Gekko","Raze,Viper,Brimstone,Fade,Gekko"
Bind,the gnomes,Dexterity Gaming,7,13,3,5,8,4,"Raze,Viper,Brimstone,Skye,Gekko","Raze,Cypher,Viper,Brimstone,Skye"
Ascent,add3r's kittens, Unjustified,14,12,10,3,9,4,"Raze,Killjoy,Sage,Fade,Clove","Sova,Killjoy,Omen,Jett,KAY/O"
Abyss,whats a pretzel,kellogs cereal,8,13,4,8,5,4,"Cypher,Sova,Omen,Jett,Harbor","Cypher,Sova,Reyna,Jett,Astra"
Pearl,1KRR and Racoone,Vovin,13,6,8,4,2,5,"Viper,Jett,Astra,Fade,Deadlock","Viper,Jett,Skye,Yoru,Harbor"
Bind,Nearest Airport,OREGON CRACK,13,6,10,2,4,3,"Raze,Cypher,Omen,Yoru,Deadlock","Raze,Cypher,Brimstone,Fade,Iso"
Pearl,Be Like Matt,A Good Team,11,13,5,7,6,6,"Killjoy,Viper,Jett,Skye,Harbor","Cypher,Sova,Jett,Astra,Gekko"
Sunset,Predator X Gaming,Spate Esports,13,5,9,3,2,4,"Breach,Raze,Cypher,Omen,Fade","Breach,Raze,Phoenix,Omen,Deadlock"
Haven,hunter505,Ivy League Dropouts,13,7,5,3,4,8,"Breach,Sova,Killjoy,Omen,Neon","Sova,Killjoy,Yoru,Iso,Clove"
Haven,ABG luvrs,Event Horizon,5,13,3,3,10,2,"Cypher,Sova,Omen,Yoru,Iso","Breach,Sova,Killjoy,Omen,Jett"
Haven,Bobo is Hobo,Boomer Squad,13,9,9,3,6,4,"Breach,Cypher,Sova,Jett,Astra","Cypher,Sova,Omen,Yoru,Deadlock"
Abyss,add3r's kittens, Unjustified,13,8,8,4,4,5,"Cypher,Sova,Jett,Iso,Clove","Sova,Viper,Jett,Yoru,Astra"
Haven,whats a pretzel,kellogs cereal,13,9,7,5,4,6,"Breach,Cypher,Sova,Omen,Jett","Breach,Sova,Killjoy,Omen,Jett"
Pearl,the gnomes,Dexterity Gaming,11,13,4,8,5,7,"Sova,Killjoy,Viper,Yoru,Harbor","Killjoy,Viper,Jett,Harbor,Gekko"
Abyss,Made in O'Block,OC Eagles,12,14,5,8,6,7,"Cypher,Sova,Yoru,Astra,KAY/O","Cypher,Sova,Omen,Yoru,KAY/O"
Ascent,Non-Verbal,Nearest Airport,13,10,7,5,5,6,"Cypher,Sova,Omen,Yoru,Deadlock","Cypher,Sova,Omen,Yoru,Deadlock"
Bind,1KRR and Racoone,Vovin,13,11,7,5,6,6,"Raze,Cypher,Skye,Deadlock,Clove","Raze,Viper,Fade,Gekko,Clove"
Sunset,Good Career,Gondal Enjoyers,13,9,9,1,8,4,"Breach,Raze,Cypher,Omen,Gekko","Raze,Cypher,Fade,Gekko,Clove"
Haven,Spate Esports,lost cause,13,7,6,2,5,7,"Breach,Cypher,Sova,Neon,Clove","Cypher,Sova,Omen,Yoru,Iso"
Sunset,Be Like Matt,A Good Team,15,13,3,11,2,12,"Breach,Raze,Cypher,Omen,Gekko","Raze,Cypher,Sova,Omen,KAY/O"
Split,BALLZ,Event Horizon,5,13,5,7,6,0,"Raze,Cypher,Omen,Skye,Neon","Raze,Cypher,Viper,Omen,Skye"
Pearl,Ivy League Dropouts,The Bees Knees,13,6,4,3,3,9,"Killjoy,Phoenix,Jett,Astra,Fade","Killjoy,Jett,Yoru,Astra,Fade"
Ascent,Bobo is Hobo,YDZ Esports,6,13,2,5,8,4,"Cypher,Sova,Omen,Jett,Deadlock","Sova,Killjoy,Omen,Jett,KAY/O"
Bind,Freaky Furries,hunter505,13,11,5,7,4,8,"Raze,Viper,Brimstone,Fade,Deadlock","Raze,Cypher,Skye,Deadlock,Clove"
Haven,Non-Verbal,Nearest Airport,13,3,3,1,2,10,"Killjoy,Viper,Omen,Jett,Skye","Breach,Sova,Killjoy,Omen,Jett"
Ascent,Unckies,whats a pretzel,13,4,3,2,2,10,"Cypher,Sova,Omen,Jett,Deadlock","Cypher,Sova,Omen,Jett,KAY/O"
Haven,Mongolia Car,Predator X Gaming,13,7,8,4,3,5,"Breach,Cypher,Sova,Omen,Neon","Breach,Cypher,Sova,Omen,Jett"
Sunset,ENVEE Esports,ABG luvrs,13,9,7,5,4,6,"Breach,Cypher,Sova,Omen,Neon","Breach,Cypher,Sova,Omen,Neon"
Haven,Goon that jawn,Team Digital,13,9,5,5,4,8,"Cypher,Sova,Omen,Jett,Yoru","Breach,Cypher,Sova,Omen,Jett"
Bind,FAWZ Purple,Vovin,4,13,1,4,9,3,"Raze,Viper,Brimstone,Fade,Gekko","Raze,Viper,Fade,Gekko,Clove"
Haven,Harmony,Dexterity Gaming,9,13,6,4,9,3,"Breach,Sova,Killjoy,Omen,Neon","Breach,Sova,Killjoy,Omen,Neon"
Pearl,add3r's kittens,Aspyre x Swarm,15,17,6,10,7,9,"Sova,Killjoy,Phoenix,Jett,Astra","Cypher,Sova,Jett,Astra,Gekko"
Split,Good Career,Gondal Enjoyers,13,11,7,5,6,6,"Raze,Cypher,Omen,Jett,Skye","Raze,Cypher,Viper,Skye,Clove"
Bind,Blackline,OREGON CRACK,10,13,5,6,7,5,"Raze,Cypher,Brimstone,Skye,Fade","Raze,Cypher,Brimstone,Fade,Iso"
Haven,Made in Brampton,Prime (NA),4,13,1,4,9,3,"Breach,Sova,Killjoy,Jett,Astra","Sova,Killjoy,Viper,Omen,Jett"
Sunset,SaD Esports,Made in O'Block,13,6,8,4,2,5,"Breach,Raze,Cypher,Sova,Omen","Breach,Raze,Cypher,Gekko,Clove"
Sunset,Corvus Esports,Boomer Squad,4,13,0,5,8,4,"Raze,Cypher,Jett,Gekko,Clove","Raze,Cypher,Reyna,Astra,Gekko"
Ascent,Berzerkers,the gnomes,13,4,9,3,1,4,"Cypher,Sova,Omen,Yoru,Deadlock","Sova,Killjoy,Omen,Jett,KAY/O"
Bind,Shane's Kittens,OC Eagles,9,13,1,9,4,8,"Raze,Cypher,Viper,Skye,Clove","Raze,Cypher,Viper,Brimstone,Skye"
Ascent,Spate Esports,lost cause,14,12,9,4,8,5,"Cypher,Sova,Omen,Jett,Deadlock","Sova,Killjoy,Reyna,Omen,Jett"
Sunset,Mongolia Car,Predator X Gaming,13,2,10,2,0,3,"Breach,Cypher,Sova,Omen,Neon","Breach,Raze,Cypher,Omen,Fade"
Haven,Freaky Furries,hunter505,13,6,7,5,1,6,"Breach,Cypher,Sova,Omen,Jett","Sova,Killjoy,Reyna,Omen,Neon"
Ascent,West Virginia University,Be Like Matt,13,8,6,6,2,7,"Sova,Killjoy,Omen,Jett,KAY/O","Cypher,Sova,Omen,Jett,Deadlock"
Sunset,Ivy League Dropouts,The Bees Knees,13,9,4,6,3,9,"Breach,Cypher,Sova,Omen,Neon","Breach,Raze,Cypher,Omen,Fade"
Pearl,Unckies,whats a pretzel,13,3,9,3,0,4,"Sova,Killjoy,Jett,Yoru,Astra","Sova,Yoru,Astra,Gekko,Deadlock"
Bind, Unjustified,Asura Onyx,13,5,5,1,4,8,"Raze,Cypher,Viper,Brimstone,Skye","Raze,Viper,Skye,Fade,Clove"
Ascent,ENVEE Esports,ABG luvrs,13,8,10,2,6,3,"Sova,Killjoy,Omen,Jett,KAY/O","Cypher,Sova,Omen,Jett,KAY/O"
Abyss,Goon that jawn,Team Digital,13,8,7,5,3,6,"Cypher,Sova,Omen,Yoru,Neon","Cypher,Sova,Omen,Jett,KAY/O"
Ascent,BALLZ,Event Horizon,12,14,4,9,5,8,"Sova,Killjoy,Reyna,Omen,Jett","Sova,Killjoy,Omen,Jett,KAY/O"
Pearl,Made in Brampton,Prime (NA),2,13,2,10,3,0,"Raze,Cypher,Phoenix,Chamber,Clove","Cypher,Sova,Viper,Reyna,Astra"
Bind,Non-Verbal,Nearest Airport,11,13,3,9,4,8,"Raze,Brimstone,Fade,Gekko,Deadlock","Raze,Cypher,Omen,Yoru,Deadlock"
Haven,Blackline,OREGON CRACK,3,13,0,4,9,3,"Breach,Cypher,Sova,Omen,Neon","Breach,Cypher,Sova,Omen,Jett"
Abyss,FAWZ Purple,Vovin,13,11,10,2,9,3,"Cypher,Sova,Jett,Astra,Gekko","Cypher,Sova,Jett,Yoru,Astra"
Bind,Bobo is Hobo,YDZ Esports,15,13,6,8,5,9,"Raze,Cypher,Sova,Viper,Brimstone","Raze,Viper,Brimstone,Fade,Gekko"
Pearl,Koufs Fun Club,Good Career,13,6,3,4,2,10,"Killjoy,Phoenix,Omen,Jett,Fade","Killjoy,Viper,Yoru,Astra,Fade"
Pearl,Corvus Esports,Boomer Squad,6,13,1,6,7,5,"Sova,Killjoy,Jett,Skye,Astra","Killjoy,Viper,Jett,Harbor,Gekko"
Haven,Blinn Esports,1KRR and Racoone,13,3,10,2,1,3,"Breach,Cypher,Sova,Omen,Neon","Cypher,Omen,Jett,Yoru,Neon"
Haven,SaD Esports,Made in O'Block,13,11,9,3,8,4,"Sova,Jett,Astra,Deadlock,Iso","Breach,Sova,Killjoy,Omen,Neon"
Sunset,Gondal Enjoyers,Boise State University,13,1,11,1,0,2,"Raze,Cypher,Fade,Gekko,Clove","Cypher,Sova,Omen,Yoru,Neon"
Haven,Berzerkers,the gnomes,13,8,5,4,4,8,"Cypher,Sova,Omen,Jett,Yoru","Breach,Sova,Killjoy,Omen,Jett"
Ascent,Shane's Kittens,OC Eagles,5,13,4,8,5,1,"Sova,Killjoy,Omen,Jett,KAY/O","Sova,Killjoy,Omen,Jett,KAY/O"
Bind,West Virginia University,Be Like Matt,4,13,2,10,3,2,"Raze,Viper,Brimstone,Skye,Gekko","Raze,Viper,Skye,Chamber,Clove"
Sunset,Harmony,Dexterity Gaming,13,15,8,6,9,5,"Breach,Cypher,Sova,Omen,Neon","Breach,Cypher,Sova,Omen,Neon"
Sunset,add3r's kittens,Aspyre x Swarm,14,16,9,6,10,5,"Breach,Raze,Cypher,Omen,Gekko","Breach,Cypher,Omen,Neon,Fade"
Ascent, Unjustified,Asura Onyx,13,3,9,3,0,4,"Sova,Killjoy,Omen,Jett,KAY/O","Sova,Killjoy,Omen,Jett,KAY/O"
Haven,A Good Team,threehunna,13,4,10,2,2,3,"Breach,Cypher,Sova,Omen,Neon","Breach,Sova,Killjoy,Omen,Jett"
Abyss,Freaky Furries,Ivy League Dropouts,13,7,7,5,2,6,"Cypher,Sova,Jett,Yoru,Astra","Breach,Cypher,Sova,Omen,Jett"
Haven,Koufs Fun Club,Good Career,13,2,11,1,1,2,"Sova,Killjoy,Omen,Jett,Iso","Breach,Cypher,Sova,Omen,Jett"
Pearl,ENVEE Esports,ABG luvrs,11,13,4,8,5,7,"Sova,Killjoy,Jett,Astra,KAY/O","Sova,Killjoy,Astra,Neon,Gekko"
Abyss,Unckies,whats a pretzel,7,13,2,6,7,5,"Cypher,Sova,Omen,Jett,Harbor","Sova,Omen,Jett,Harbor,Deadlock"
Haven,BALLZ,Event Horizon,13,8,5,7,1,8,"Breach,Cypher,Sova,Omen,Neon","Breach,Sova,Killjoy,Omen,Jett"
Pearl,Blinn Esports,1KRR and Racoone,13,4,9,3,1,4,"Killjoy,Viper,Jett,Skye,Harbor","Viper,Yoru,Astra,Fade,Iso"
Haven,FAWZ Purple,Vovin,5,13,3,9,4,2,"Breach,Sova,Killjoy,Omen,Jett","Breach,Cypher,Sova,Omen,Jett"
Ascent,Mongolia Car,Spate Esports,13,6,6,6,0,7,"Sova,Killjoy,Omen,Jett,KAY/O","Cypher,Sova,Omen,Jett,Deadlock"
Haven,Nearest Airport,OREGON CRACK,13,6,6,1,5,7,"Breach,Sova,Killjoy,Omen,Jett","Breach,Cypher,Sova,Omen,Jett"
Haven,Bobo is Hobo,YDZ Esports,8,13,2,7,6,6,"Breach,Cypher,Sova,Omen,Jett","Cypher,Sova,Omen,Yoru,Iso"
Haven,Gondal Enjoyers,Boise State University,13,4,10,2,2,3,"Cypher,Sova,Yoru,Iso,Clove","Sova,Jett,Astra,Deadlock,Iso"
Abyss,Corvus Esports,Boomer Squad,13,8,6,3,5,7,"Breach,Sova,Omen,Jett,Deadlock","Breach,Cypher,Sova,Jett,Astra"
Sunset,A Good Team,threehunna,13,3,2,2,1,11,"Raze,Cypher,Sova,Omen,KAY/O","Breach,Raze,Cypher,Omen,Gekko"
Split,West Virginia University,Be Like Matt,13,5,5,1,4,8,"Breach,Raze,Viper,Skye,Clove","Raze,Cypher,Viper,Omen,Skye"
Bind,Freaky Furries,Ivy League Dropouts,13,6,9,3,3,4,"Raze,Viper,Brimstone,Fade,Deadlock","Raze,Viper,Brimstone,Fade,Gekko"
Bind,SaD Esports,Shane's Kittens,13,6,4,3,3,9,"Raze,Viper,Brimstone,Yoru,Fade","Raze,Cypher,Viper,Skye,Clove"
Sunset,Unckies,kellogs cereal,13,6,4,3,3,9,"Breach,Raze,Cypher,Omen,Gekko","Raze,Omen,Gekko,Deadlock,Iso"
Split,Dexterity Gaming,the gnomes,7,13,4,8,5,3,"Raze,Cypher,Viper,Omen,Skye","Raze,Cypher,Omen,Jett,Skye"
Haven,Goon that jawn,Made in Brampton,13,6,4,3,3,9,"Raze,Astra,Chamber,Neon,Fade","Sova,Phoenix,Chamber,Neon,Clove"
Haven,Aspyre x Swarm,Asura Onyx,13,9,8,2,7,5,"Killjoy,Viper,Omen,Jett,Skye","Breach,Cypher,Sova,Omen,Jett"
Sunset,Mongolia Car,Spate Esports,13,7,7,5,2,6,"Breach,Cypher,Sova,Omen,Neon","Breach,Raze,Phoenix,Omen,Deadlock"
Haven,Made in O'Block,OC Eagles,13,10,7,4,6,6,"Breach,Sova,Killjoy,Omen,Neon","Breach,Cypher,Sova,Omen,Neon"
Sunset,Non-Verbal,Blackline,13,3,9,3,0,4,"Breach,Cypher,Sova,Omen,Neon","Breach,Raze,Cypher,Omen,Gekko"
Sunset,Nearest Airport,OREGON CRACK,10,13,4,7,6,6,"Breach,Raze,Cypher,Sova,Omen","Raze,Cypher,Gekko,Iso,Clove"
Haven,Berzerkers,Harmony,13,4,9,3,1,4,"Cypher,Sova,Omen,Jett,Yoru","Breach,Sova,Killjoy,Omen,Neon"
Haven,Good Career,Boise State University,13,7,6,6,1,7,"Breach,Cypher,Sova,Omen,Jett","Sova,Jett,Astra,Deadlock,Iso"
Sunset,ABG luvrs,Event Horizon,13,10,8,3,7,5,"Breach,Cypher,Sova,Omen,Neon","Raze,Cypher,Sova,Omen,KAY/O"
Haven,Bobo is Hobo,Corvus Esports,13,2,11,1,1,2,"Breach,Cypher,Sova,Omen,Jett","Cypher,Sova,Omen,Jett,Iso"
Haven,kellogs cereal,BUGBLENDER,13,11,8,4,7,5,"Breach,Cypher,Sova,Omen,Jett","Breach,Sova,Killjoy,Omen,Jett"
Haven,whats a pretzel,BUGBLENDER,13,11,8,4,7,5,"Breach,Cypher,Sova,Omen,Jett","Breach,Sova,Killjoy,Omen,Jett"
Haven,Vovin,1KRR and Racoone,6,13,4,8,5,2,"Breach,Cypher,Sova,Omen,Neon","Breach,Cypher,Omen,Neon,Deadlock"
Pearl,Koufs Fun Club,Gondal Enjoyers,13,4,5,0,4,8,"Killjoy,Phoenix,Omen,Jett,Fade","Cypher,Yoru,Astra,Fade,Deadlock"
Sunset,SaD Esports,Shane's Kittens,13,2,2,1,1,11,"Breach,Raze,Cypher,Sova,Omen","Raze,Cypher,Omen,Fade,Gekko"
Ascent,West Virginia University,A Good Team,13,7,6,6,1,7,"Sova,Killjoy,Omen,Jett,KAY/O","Cypher,Sova,Omen,Jett,Deadlock"
Abyss,Be Like Matt,threehunna,13,3,10,2,1,3,"Cypher,Sova,Omen,Yoru,Deadlock","Cypher,Sova,Jett,Astra,Gekko"
Haven,hunter505,The Bees Knees,13,5,3,3,2,10,"Sova,Killjoy,Omen,Neon,Iso","Breach,Sova,Killjoy,Omen,Jett"
Ascent,Blinn Esports,FAWZ Purple,13,6,10,2,4,3,"Cypher,Sova,Omen,Yoru,Deadlock","Sova,Killjoy,Omen,Jett,KAY/O"
Ascent,ENVEE Esports,BALLZ,13,7,7,5,2,6,"Sova,Killjoy,Omen,Jett,KAY/O","Sova,Killjoy,Reyna,Omen,Jett"
Pearl,Goon that jawn,Made in Brampton,13,6,4,3,3,9,"Cypher,Reyna,Yoru,Astra,Fade","Viper,Jett,Chamber,Harbor,Gekko"
Haven,add3r's kittens, Unjustified,13,8,7,2,6,6,"Breach,Sova,Killjoy,Omen,Neon","Breach,Cypher,Sova,Omen,Jett"
Pearl,lost cause,Predator X Gaming,9,13,3,9,4,6,"Cypher,Jett,Astra,Fade,Gekko","Killjoy,Viper,Jett,Skye,Harbor"
Bind,YDZ Esports,Boomer Squad,13,10,9,3,7,4,"Raze,Viper,Brimstone,Fade,Gekko","Raze,Viper,Gekko,Deadlock,Clove"
Haven,Freaky Furries,Ivy League Dropouts,11,13,8,4,9,3,"Breach,Cypher,Sova,Omen,Jett","Sova,Killjoy,Yoru,Iso,Clove"
Pearl,Vovin,1KRR and Racoone,6,13,2,10,3,4,"Breach,Killjoy,Astra,Neon,Gekko","Viper,Jett,Astra,Fade,Deadlock"
Pearl,Bobo is Hobo,Corvus Esports,13,7,5,7,0,8,"Sova,Killjoy,Jett,Astra,Gekko","Killjoy,Jett,Skye,Astra,Fade"
Haven,Dexterity Gaming,the gnomes,9,13,3,9,4,6,"Breach,Sova,Killjoy,Omen,Jett","Breach,Sova,Killjoy,Omen,Jett"
Abyss,Non-Verbal,Blackline,13,8,8,4,4,5,"Cypher,Sova,Omen,Jett,Harbor","Sova,Killjoy,Viper,Yoru,Astra"
Bind,Made in O'Block,OC Eagles,13,7,7,1,6,6,"Raze,Skye,Gekko,Deadlock,Clove","Raze,Cypher,Viper,Brimstone,Skye"
Sunset,ENVEE Esports,BALLZ,13,1,2,0,1,11,"Breach,Cypher,Sova,Omen,Neon","Breach,Cypher,Sova,Omen,Neon"
Haven,West Virginia University,A Good Team,13,2,10,2,0,3,"Breach,Cypher,Sova,Omen,Neon","Breach,Cypher,Sova,Omen,Jett"
Haven,Unckies,kellogs cereal,13,11,8,4,7,5,"Breach,Sova,Killjoy,Omen,Jett","Sova,Killjoy,Omen,Jett,Yoru"
Pearl,Aspyre x Swarm,Asura Onyx,13,8,5,7,1,8,"Cypher,Sova,Jett,Astra,Gekko","Killjoy,Viper,Jett,Skye,Astra"
Pearl,Be Like Matt,threehunna,13,4,9,3,1,4,"Killjoy,Viper,Jett,Skye,Harbor","Killjoy,Viper,Jett,Skye,Harbor"
Pearl,SaD Esports,Shane's Kittens,3,13,3,9,4,0,"Killjoy,Viper,Jett,Skye,Astra","Killjoy,Jett,Skye,Astra,Fade"
Abyss,Blinn Esports,FAWZ Purple,13,0,1,0,0,12,"Cypher,Sova,Omen,Jett,Deadlock","Cypher,Sova,Jett,Astra,Gekko"
Haven,Mongolia Car,Spate Esports,11,13,5,7,6,6,"Breach,Cypher,Sova,Omen,Jett","Breach,Cypher,Sova,Neon,Clove"
Bind,Nearest Airport,OREGON CRACK,13,10,9,2,8,4,"Raze,Cypher,Omen,Yoru,Deadlock","Raze,Cypher,Brimstone,Fade,Iso"
Bind,whats a pretzel,BUGBLENDER,13,6,7,5,1,6,"Raze,Brimstone,Fade,Gekko,Deadlock","Raze,Viper,Omen,Skye,Yoru"
Bind,kellogs cereal,BUGBLENDER,13,6,7,5,1,6,"Raze,Brimstone,Fade,Gekko,Deadlock","Raze,Viper,Omen,Skye,Yoru"
Sunset,Berzerkers,Harmony,13,9,8,2,7,5,"Breach,Raze,Cypher,Sova,Omen","Breach,Cypher,Sova,Omen,Neon"
Haven,Koufs Fun Club,Gondal Enjoyers,13,6,6,6,0,7,"Cypher,Sova,Omen,Jett,Iso","Breach,Sova,Killjoy,Astra,Neon"
Haven,ABG luvrs,Event Horizon,14,12,8,5,7,6,"Cypher,Sova,Omen,Yoru,Iso","Breach,Sova,Killjoy,Omen,Neon"
Sunset,lost cause,Predator X Gaming,4,13,3,9,4,1,"Breach,Cypher,Sova,Neon,Clove","Breach,Raze,Cypher,Omen,Fade"
Sunset,Good Career,Boise State University,13,10,6,5,5,7,"Breach,Raze,Cypher,Omen,Gekko","Cypher,Sova,Omen,Yoru,Neon"
Ascent,add3r's kittens, Unjustified,13,6,5,2,4,8,"Sova,Killjoy,Reyna,Omen,Jett","Sova,Killjoy,Omen,Jett,KAY/O"
Pearl,hunter505,The Bees Knees,13,7,7,5,2,6,"Killjoy,Skye,Astra,Neon,Harbor","Killjoy,Jett,Astra,KAY/O,Fade"
Icebox,SeanGares' Kittens,royexakim1,11,13,4,8,5,7,"Sova,Killjoy,Viper,Jett,Iso","Sova,Killjoy,Viper,Reyna,Jett"
Bind,SeanGares' Kittens,royexakim1,8,13,6,3,10,2,"Raze,Viper,Brimstone,Skye,Gekko","Raze,Viper,Brimstone,Skye,Yoru"
Abyss,Evil Genies,SeanGares' Kittens,9,13,5,7,6,4,"Cypher,Sova,Omen,Jett,Astra","Cypher,Sova,Jett,Astra,Iso"
Haven,Evil Genies,SeanGares' Kittens,5,13,4,8,5,1,"Breach,Cypher,Sova,Omen,Jett","Cypher,Sova,Omen,Jett,Iso"
Lotus,Evil Genies,SeanGares' Kittens,13,10,7,4,6,6,"Breach,Raze,Cypher,Omen,Gekko","Breach,Raze,Cypher,Omen,Gekko"
Lotus,royexakim1,asians n kehm,13,6,5,2,4,8,"Raze,Killjoy,Viper,Omen,Fade","Raze,Killjoy,Viper,Omen,Fade"
Sunset,royexakim1,asians n kehm,13,5,3,3,2,10,"Breach,Raze,Cypher,Sova,Omen","Breach,Cypher,Sova,Omen,Neon"
Abyss,Team Heretics,Sentinels,13,7,5,3,4,8,"Cypher,Sova,Jett,Astra,Gekko","Cypher,Sova,Omen,Jett,KAY/O"
Icebox,Team Heretics,Sentinels,13,9,5,7,2,8,"Sova,Killjoy,Viper,Neon,Gekko","Sova,Killjoy,Viper,Jett,KAY/O"
Haven,Team Heretics,Sentinels,8,13,5,7,6,3,"Raze,Killjoy,Sage,Omen,Gekko","Breach,Cypher,Sova,Omen,Neon"
Abyss,EDward Gaming,Leviatán,13,11,6,6,5,7,"Sova,Omen,Jett,Astra,KAY/O","Cypher,Sova,Omen,Jett,Harbor"
Lotus,EDward Gaming,Leviatán,13,4,8,4,0,5,"Breach,Omen,Neon,Fade,Clove","Breach,Raze,Cypher,Omen,Fade"
Icebox,EDward Gaming,Leviatán,14,16,3,12,4,11,"Sova,Killjoy,Viper,Jett,KAY/O","Sova,Killjoy,Viper,Jett,Harbor"
Haven,New Combat Line GC,NTH,10,13,6,5,8,4,"Breach,Sova,Killjoy,Omen,Jett","Raze,Sova,Killjoy,Reyna,Clove"
Icebox,New Combat Line GC,NTH,9,13,8,4,9,1,"Sova,Killjoy,Viper,Jett,Gekko","Sova,Viper,Jett,Chamber,Iso"
Ascent,Deagle Ravagers,Sphinx GC,11,13,3,9,4,8,"Sova,Killjoy,Omen,Jett,KAY/O","Sova,Killjoy,Omen,Jett,KAY/O"
Haven,Deagle Ravagers,Sphinx GC,11,13,3,9,4,8,"Breach,Sova,Killjoy,Omen,Jett","Breach,Sova,Killjoy,Omen,Neon"
Ascent,Bon Bon Bum Contra GC,MYVRA,13,6,6,1,5,7,"Sova,Killjoy,Phoenix,Omen,Jett","Sova,Killjoy,Omen,Jett,KAY/O"
Lotus,Bon Bon Bum Contra GC,MYVRA,10,13,6,5,8,4,"Breach,Raze,Cypher,Omen,Gekko","Breach,Raze,Cypher,Omen,Fade"
Sunset,Bon Bon Bum Contra GC,MYVRA,13,11,6,6,5,7,"Breach,Sova,Sage,Omen,Gekko","Breach,Raze,Cypher,Omen,Fade"
Icebox,9z Team GC,KRÜ BLAZE,5,13,2,4,9,3,"Killjoy,Viper,Jett,KAY/O,Gekko","Sova,Killjoy,Harbor,Iso,Clove"
Ascent,MIBR GC,LOUD GC,13,10,6,6,4,7,"Sova,Killjoy,Omen,Jett,KAY/O","Cypher,Sova,Omen,Neon,Deadlock"
Haven,9z Team GC,KRÜ BLAZE,7,13,2,6,7,5,"Breach,Cypher,Omen,Neon,Gekko","Breach,Sova,Killjoy,Omen,Jett"
Lotus,MIBR GC,LOUD GC,9,13,3,9,4,6,"Raze,Killjoy,Viper,Omen,Fade","Cypher,Omen,KAY/O,Neon,Fade"
Ascent,9z Team GC,KRÜ BLAZE,13,10,6,5,5,7,"Cypher,Sova,Omen,Jett,KAY/O","Sova,Killjoy,Omen,Jett,KAY/O"
Haven,MIBR GC,LOUD GC,14,12,8,5,7,6,"Breach,Cypher,Sova,Omen,Jett","Killjoy,Omen,Jett,Skye,Gekko"
Sunset,MIBR GC,LOUD GC,13,11,6,6,5,7,"Breach,Raze,Cypher,Omen,Gekko","Raze,Cypher,Omen,KAY/O,Gekko"
Bind,MIBR GC,LOUD GC,9,13,2,10,3,7,"Raze,Viper,Brimstone,Fade,Gekko","Raze,Cypher,Brimstone,Skye,Deadlock"
Icebox,Striders,esports team αD,13,8,8,4,4,5,"Sova,Killjoy,Viper,Jett,Harbor","Cypher,Sova,Omen,Jett,Harbor"
Sunset,BC SWELL,PARON,13,4,8,4,0,5,"Cypher,Sova,Omen,KAY/O,Neon","Raze,Sova,Killjoy,Omen,Astra"
Lotus,IGZIST,Delight,13,15,9,5,10,4,"Breach,Cypher,Sova,Omen,Neon","Breach,Raze,Cypher,Omen,Fade"
Sunset,Striders,esports team αD,5,13,0,6,7,5,"Cypher,Sova,Omen,KAY/O,Neon","Raze,Cypher,Sage,Omen,Fade"
Ascent,SCARZ,REVE RISE MAX,12,14,6,7,7,6,"Sova,Killjoy,Omen,Jett,KAY/O","Sova,Killjoy,Omen,Jett,KAY/O"
Abyss,BC SWELL,PARON,9,13,7,5,8,2,"Sova,Killjoy,Omen,Jett,Yoru","Sova,Omen,Chamber,Neon,Iso"
Haven,IGZIST,Delight,13,5,3,3,2,10,"Breach,Sova,Killjoy,Omen,Jett","Breach,Cypher,Sova,Omen,Neon"
Sunset,SCARZ,REVE RISE MAX,9,13,4,6,7,5,"Cypher,Sova,Omen,KAY/O,Neon","Breach,Cypher,Sova,Omen,Neon"
Bind,Striders,esports team αD,13,10,6,6,4,7,"Raze,Viper,Brimstone,Fade,Gekko","Raze,Cypher,Viper,Skye,Harbor"
Sunset,IGZIST,Delight,3,13,2,10,3,1,"Breach,Cypher,Sova,Omen,Neon","Cypher,Sova,Omen,KAY/O,Neon"
Ascent,BC SWELL,PARON,13,5,4,2,3,9,"Sova,Killjoy,Omen,Jett,KAY/O","Sova,Killjoy,Omen,Jett,KAY/O"
Abyss,K7 Esports GC,KS Esports GC,10,13,6,6,7,4,"Breach,Cypher,Sova,Omen,Jett","Sova,Omen,Yoru,Astra,Deadlock"
Ascent,K7 Esports GC,KS Esports GC,9,13,2,8,5,7,"Sova,Killjoy,Omen,Jett,KAY/O","Cypher,Sova,Omen,Yoru,Deadlock"
Abyss,Zen eSports GC,FiRePOWER GC,10,13,6,5,8,4,"Breach,Cypher,Sova,Omen,Jett","Cypher,Sova,Omen,Jett,KAY/O"
Icebox,Team Liquid Brazil,LOUD GC,8,13,1,8,5,7,"Killjoy,Viper,Omen,KAY/O,Gekko","Killjoy,Viper,Jett,KAY/O,Gekko"
Ascent,Zen eSports GC,FiRePOWER GC,11,13,7,5,8,4,"Sova,Killjoy,Omen,Jett,KAY/O","Sova,Killjoy,Omen,Jett,KAY/O"
Sunset,Team Liquid Brazil,LOUD GC,5,13,1,5,8,4,"Breach,Raze,Cypher,Sova,Omen","Raze,Cypher,Omen,KAY/O,Gekko"
Bind,Team Liquid Brazil,LOUD GC,12,14,6,7,7,6,"Raze,Cypher,Viper,Brimstone,Skye","Raze,Cypher,Brimstone,Skye,Deadlock"
Abyss,BLUE BEES.ESP,BC SWELL,13,11,6,6,5,7,"Breach,Sova,Omen,Yoru,Deadlock","Sova,Killjoy,Viper,Yoru,Astra"
Ascent,WICKED,PARON,11,13,3,9,4,8,"Sova,Killjoy,Omen,Jett,KAY/O","Sova,Killjoy,Omen,Jett,KAY/O"
Lotus,IGZIST,FAV gaming,2,13,1,2,11,1,"Breach,Cypher,Sova,Omen,Neon","Raze,Cypher,Viper,Omen,Fade"
Lotus,BLUE BEES.ESP,BC SWELL,11,13,7,5,8,4,"Breach,Omen,Neon,Fade,Clove","Raze,Killjoy,Viper,Omen,Fade"
Haven,TRIDENT,Delight,4,13,3,9,4,1,"Breach,Sova,Killjoy,Omen,Jett","Breach,Cypher,Sova,Omen,Neon"
Sunset,SCARZ,NOEZ FOXX,9,13,2,8,5,7,"Cypher,Sova,Omen,KAY/O,Neon","Cypher,Sova,Omen,KAY/O,Neon"
Sunset,Crest Gaming ZST,Striders,13,11,5,7,4,8,"Breach,Raze,Cypher,Omen,Jett","Cypher,Sova,Omen,KAY/O,Neon"
Icebox,NIX VISION,esports team αD,2,13,1,2,11,1,"Cypher,Viper,KAY/O,Gekko,Deadlock","Cypher,Sova,Omen,Jett,Harbor"
Sunset,IGZIST,FAV gaming,6,13,3,9,4,3,"Breach,Cypher,Sova,Omen,Neon","Breach,Raze,Cypher,Sova,Omen"
Icebox,BLUE BEES.ESP,BC SWELL,13,8,9,3,5,4,"Sova,Killjoy,Viper,Jett,Clove","Sova,Killjoy,Viper,Jett,Gekko"
Ascent,Crest Gaming ZST,Striders,13,5,4,2,3,9,"Sage,Omen,Jett,KAY/O,Fade","Cypher,Sova,Omen,Jett,Deadlock"
Ascent,SCARZ,NOEZ FOXX,10,13,3,9,4,7,"Sova,Killjoy,Omen,Jett,KAY/O","Sova,Killjoy,Omen,Jett,KAY/O"
Haven,WICKED,PARON,13,15,5,9,6,8,"Breach,Sova,Killjoy,Omen,Jett","Breach,Sova,Killjoy,Omen,Jett"
Bind,TRIDENT,Delight,9,13,7,5,8,2,"Raze,Viper,Brimstone,Fade,Gekko","Raze,Viper,Omen,Skye,Gekko"
Sunset,NIX VISION,esports team αD,4,13,1,4,9,3,"Breach,Raze,Cypher,Sova,Omen","Raze,Cypher,Sage,Omen,Fade"
Sunset,Akave Esports Black,FUSION X,8,13,6,6,7,2,"Breach,Raze,Cypher,Omen,Gekko","Breach,Raze,Cypher,Omen,Gekko"
Ascent,Akave Esports Black,FUSION X,2,13,0,3,10,2,"Cypher,Sova,Omen,Jett,KAY/O","Raze,Sova,KAY/O,Iso,Clove"
Ascent,University War GC,Leviatán GC,6,13,5,7,6,1,"Sova,Killjoy,Omen,Jett,KAY/O","Cypher,Sova,Omen,Jett,Deadlock"
Haven,Team Liquid Brazil,MIBR GC,6,13,2,5,8,4,"Cypher,Sova,Omen,Yoru,Iso","Breach,Cypher,Sova,Omen,Jett"
Haven,University War GC,Leviatán GC,0,13,0,1,12,0,"Breach,Cypher,Sova,Omen,Neon","Breach,Cypher,Sova,Omen,Neon"
Ascent,Team Liquid Brazil,MIBR GC,7,13,2,6,7,5,"Sova,Killjoy,Omen,Jett,KAY/O","Sova,Killjoy,Omen,Jett,KAY/O"
Sunset,University War GC,Leviatán GC,13,5,5,1,4,8,"Breach,Raze,Cypher,Omen,Fade","Breach,Cypher,Omen,Neon,Fade"
Icebox,LOUD GC,Team Leveling,13,10,8,4,6,5,"Killjoy,Viper,Jett,KAY/O,Gekko","Killjoy,Viper,KAY/O,Gekko,Iso"
Sunset,LOUD GC,Team Leveling,13,6,9,3,3,4,"Raze,Cypher,Omen,KAY/O,Gekko","Breach,Cypher,Sova,Omen,Neon"
Ascent,WICKED,BC SWELL,9,13,3,7,6,6,"Sova,Killjoy,Omen,Jett,KAY/O","Sova,Killjoy,Omen,Jett,KAY/O"
Ascent,TRIDENT,IGZIST,7,13,3,9,4,4,"Sova,Killjoy,Omen,Jett,KAY/O","Sova,Killjoy,Omen,Jett,KAY/O"
Bind,NOEZ FOXX,REVE RISE MAX,13,9,4,6,3,9,"Raze,Cypher,Brimstone,Skye,Deadlock","Raze,Cypher,Viper,Brimstone,Skye"
Icebox,WICKED,BC SWELL,6,13,6,6,7,0,"Sova,Killjoy,Viper,Jett,Iso","Sova,Killjoy,Viper,Jett,Gekko"
Bind,TRIDENT,IGZIST,13,8,9,0,8,4,"Raze,Viper,Brimstone,Fade,Gekko","Raze,Brimstone,Omen,Skye,Gekko"
Lotus,NOEZ FOXX,REVE RISE MAX,13,5,4,2,3,9,"Raze,Killjoy,Viper,Omen,Fade","Raze,Killjoy,Viper,Omen,Fade"
Ascent,Striders,esports team αD,13,5,5,1,4,8,"Cypher,Sova,Omen,Jett,Deadlock","Sova,Killjoy,Omen,Jett,KAY/O"
Lotus,Delight,FAV gaming,5,13,3,9,4,2,"Breach,Raze,Cypher,Omen,Fade","Raze,Killjoy,Viper,Omen,Fade"
Haven,PARON,BLUE BEES.ESP,6,13,2,10,3,4,"Breach,Sova,Killjoy,Omen,Jett","Sova,Killjoy,Omen,Yoru,Iso"
Bind,Crest Gaming ZST,NIX VISION,13,4,3,2,2,10,"Raze,Cypher,Brimstone,Jett,Skye","Raze,Brimstone,Reyna,Skye,Harbor"
Haven,WICKED,BC SWELL,13,8,8,4,4,5,"Breach,Sova,Killjoy,Omen,Jett","Cypher,Sova,Omen,Yoru,Clove"
Haven,TRIDENT,IGZIST,5,13,2,4,9,3,"Breach,Sova,Killjoy,Omen,Jett","Breach,Sova,Killjoy,Omen,Jett"
Haven,Delight,FAV gaming,3,13,2,10,3,1,"Breach,Cypher,Sova,Omen,Neon","Breach,Cypher,Sova,Omen,Jett"
Bind,Striders,esports team αD,13,5,8,4,1,5,"Raze,Viper,Brimstone,Fade,Gekko","Raze,Cypher,Viper,Skye,Harbor"
Icebox,Crest Gaming ZST,NIX VISION,13,3,10,2,1,3,"Killjoy,Viper,Jett,KAY/O,Clove","Cypher,Viper,KAY/O,Gekko,Deadlock"
Lotus,PARON,BLUE BEES.ESP,4,13,4,8,5,0,"Raze,Killjoy,Viper,Omen,Fade","Breach,Omen,Neon,Fade,Clove"
Ascent,NOEZ FOXX,REVE RISE MAX,12,14,6,7,7,6,"Sova,Killjoy,Omen,Jett,KAY/O","Sova,Killjoy,Omen,Jett,KAY/O"
Abyss,"Fenrir ""White"" E-Club",NTH,3,13,0,4,9,3,"Cypher,Sova,Omen,Jett,KAY/O","Cypher,Jett,KAY/O,Iso,Clove"
Haven,"Fenrir ""White"" E-Club",NTH,7,13,5,7,6,2,"Breach,Cypher,Sova,Omen,Jett","Raze,Sova,Killjoy,Reyna,Clove"
Ascent,Sphinx GC,Return of the Ashes,13,9,6,6,3,7,"Sova,Killjoy,Omen,Jett,KAY/O","Breach,Raze,Cypher,Sova,Omen"
Icebox,Kaoticcc and Friends,Blue Otter,8,13,1,8,5,7,"Sova,Killjoy,Viper,Reyna,Jett","Sova,Killjoy,Viper,Jett,Gekko"
Sunset,Kaoticcc and Friends,Blue Otter,2,13,0,3,10,2,"Breach,Raze,Cypher,Omen,Gekko","Breach,Cypher,Sova,Omen,Neon"
Icebox,Sphinx GC,Return of the Ashes,13,10,6,5,5,7,"Sova,Killjoy,Viper,Jett,Gekko","Sova,Killjoy,Viper,Jett,KAY/O"
Icebox,Be Like Matt,Blue Otter,1,13,0,2,11,1,"Sova,Killjoy,Viper,Reyna,Jett","Sova,Killjoy,Viper,Jett,Gekko"
Ascent,Cuddle Gang,Kaoticcc and Friends,8,13,4,8,5,4,"Sova,Killjoy,Omen,Jett,KAY/O","Sova,Killjoy,Omen,Jett,KAY/O"
Bind,Cuddle Gang,Kaoticcc and Friends,1,13,1,11,2,0,"Raze,Viper,Brimstone,Skye,Iso","Raze,Viper,Brimstone,Skye,Yoru"
Sunset,Be Like Matt,Blue Otter,10,13,6,6,7,4,"Breach,Raze,Cypher,Omen,Gekko","Breach,Cypher,Sova,Omen,Neon"
Icebox,Team Heretics,DRX,13,10,8,3,7,5,"Sova,Killjoy,Viper,Neon,Gekko","Sova,Killjoy,Viper,Jett,KAY/O"
Sunset,Team Heretics,DRX,13,5,6,0,5,7,"Raze,Cypher,Sova,Omen,KAY/O","Breach,Cypher,Sova,Omen,Neon"
Abyss,Team Heretics,DRX,5,13,0,6,7,5,"Cypher,Sova,Jett,Astra,Gekko","Cypher,Sova,Omen,Jett,KAY/O"
Lotus,Sentinels,FNATIC,13,6,8,4,2,5,"Raze,Killjoy,Viper,Omen,Fade","Raze,Killjoy,Viper,Omen,Fade"
Bind,Sentinels,FNATIC,9,13,7,5,8,2,"Raze,Viper,Brimstone,Fade,Gekko","Raze,Viper,Astra,Fade,Gekko"
Sunset,Sentinels,FNATIC,13,11,9,3,8,4,"Raze,Cypher,Omen,KAY/O,Gekko","Breach,Raze,Cypher,Sova,Astra"
Haven,Cuddle Gang,Fluffy Men,8,13,3,9,4,5,"Breach,Sova,Killjoy,Neon,Clove","Breach,Cypher,Sova,Omen,Jett"
Bind,No Sweat Blossom,NTH,9,13,5,5,8,4,"Raze,Cypher,Brimstone,Gekko,Deadlock","Raze,Cypher,Brimstone,Skye,Yoru"
Lotus,Georgia Tech Gold,Harmony,13,7,7,1,6,6,"Raze,Killjoy,Fade,Gekko,Clove","Breach,Killjoy,Omen,Neon,Fade"
Sunset,Blue Otter,Special Grade,13,7,7,5,2,6,"Breach,Cypher,Sova,Omen,Neon","Breach,Cypher,Sova,Omen,Neon"
Sunset,Cuddle Gang,Fluffy Men,13,10,5,7,3,8,"Raze,Cypher,KAY/O,Fade,Clove","Breach,Raze,Cypher,Omen,Fade"
Icebox,Be Like Matt,Dogo Fanclub,13,4,5,0,4,8,"Sova,Killjoy,Viper,Reyna,Jett","Sova,Killjoy,Viper,Reyna,Jett"
Sunset,Georgia Tech Gold,Harmony,13,3,9,3,0,4,"Raze,Cypher,Sova,Gekko,Clove","Breach,Cypher,Sova,Omen,Neon"
Haven,No Sweat Blossom,NTH,11,13,5,7,6,6,"Breach,Cypher,Omen,Neon,Iso","Raze,Sova,Killjoy,Reyna,Omen"
Haven,Blue Otter,Special Grade,13,3,2,2,1,11,"Breach,Cypher,Sova,Omen,Neon","Sova,Jett,Astra,Deadlock,Iso"
Haven,Kaoticcc and Friends,add3r's kittens,13,11,6,6,5,7,"Sova,Killjoy,Omen,Jett,Iso","Breach,Sova,Killjoy,Omen,Neon"
Sunset,Be Like Matt,Dogo Fanclub,13,7,5,3,4,8,"Breach,Raze,Cypher,Omen,Gekko","Breach,Raze,Cypher,Sova,Clove"
Bind,Kaoticcc and Friends,add3r's kittens,13,5,4,2,3,9,"Raze,Viper,Brimstone,Skye,Yoru","Raze,Brimstone,Yoru,Fade,Gekko"
Lotus,Georgia Tech Gold,les piments,13,9,6,6,3,7,"Raze,Killjoy,Fade,Gekko,Clove","Raze,Killjoy,Viper,Omen,Fade"
Lotus,Fluffy Men,4Gods1Bum,14,12,7,6,6,7,"Breach,Raze,Cypher,Omen,Fade","Raze,Killjoy,Viper,Omen,Fade"
Icebox,Special Grade,LoungeLizardWW,13,9,3,9,0,10,"Sova,Killjoy,Viper,Reyna,Jett","Sova,Killjoy,Viper,Reyna,Gekko"
Abyss,Return of the Ashes,XSOUL GC,13,8,6,3,5,7,"Breach,Cypher,Sova,Astra,Neon","Breach,Cypher,Sova,Jett,Astra"
Icebox,Dogo Fanclub,The GRID,13,10,8,4,6,5,"Sova,Killjoy,Viper,Reyna,Jett","Sova,Killjoy,Viper,Reyna,Jett"
Lotus,Harmony,slackers,13,7,8,4,3,5,"Breach,Killjoy,Omen,Neon,Fade","Breach,Raze,Omen,Gekko,Deadlock"
Haven,Fluffy Men,4Gods1Bum,13,3,3,1,2,10,"Breach,Cypher,Sova,Omen,Jett","Breach,Cypher,Sova,Omen,Jett"
Sunset,Blue Otter,whats a pretzel,13,10,10,2,8,3,"Breach,Cypher,Sova,Omen,Neon","Raze,Cypher,Yoru,Fade,Clove"
Bind,Akatsuki Aimers,Georgia Tech Gold,8,13,3,6,7,5,"Raze,Viper,Brimstone,Fade,Gekko","Raze,Cypher,Yoru,Gekko,Clove"
Ascent,Special Grade,LoungeLizardWW,13,8,3,6,2,10,"Cypher,Sova,Omen,Jett,Deadlock","Sova,Killjoy,Omen,Jett,KAY/O"
Icebox,Kaoticcc and Friends,Non Verbal,13,3,4,0,3,9,"Sova,Killjoy,Viper,Reyna,Jett","Sova,Killjoy,Viper,Jett,Gekko"
Abyss,SaD Esports,add3r's kittens,7,13,4,4,9,3,"Sova,Omen,Yoru,KAY/O,Harbor","Cypher,Jett,Yoru,Astra,Gekko"
Sunset,Dogo Fanclub,The GRID,13,7,8,4,3,5,"Breach,Raze,Cypher,Gekko,Clove","Breach,Raze,Cypher,Omen,Fade"
Ascent,ENVEE Esports,Be Like Matt,8,13,3,6,7,5,"Sova,Killjoy,Omen,Jett,KAY/O","Sova,Killjoy,Omen,Jett,KAY/O"
Haven,Blue Otter,whats a pretzel,13,5,2,4,1,11,"Breach,Cypher,Sova,Omen,Neon","Breach,Cypher,Sova,Omen,Jett"
Lotus,Cuddle Gang,SeanGares' Kittens,14,12,10,3,9,4,"Breach,Raze,Killjoy,Gekko,Clove","Breach,Cypher,Neon,Gekko,Clove"
Sunset,Kaoticcc and Friends,Non Verbal,13,10,4,7,3,9,"Breach,Raze,Cypher,Omen,Gekko","Breach,Cypher,Sova,Omen,Neon"
Sunset,Harmony,KU Esports,13,10,7,4,6,6,"Breach,Cypher,Sova,Omen,Neon","Breach,Cypher,Omen,KAY/O,Neon"
Icebox,ENVEE Esports,Be Like Matt,3,13,0,4,9,3,"Sova,Killjoy,Viper,Reyna,Jett","Sova,Killjoy,Viper,Reyna,Jett"
Abyss,4Gods1Bum,YDZ Esports,13,8,5,4,4,8,"Cypher,Sova,Omen,Jett,Yoru","Cypher,Sova,Omen,Yoru,KAY/O"
Haven,Akatsuki Aimers,School Project,13,8,6,6,2,7,"Sova,Jett,KAY/O,Chamber,Clove","Cypher,Sova,Omen,Jett,Skye"
Lotus,slackers,Eternal Focus Crimson,14,12,10,3,9,4,"Breach,Raze,Omen,Gekko,Deadlock","Raze,Cypher,Omen,Fade,Deadlock"
Lotus,Dogo Fanclub,The GRID,6,13,3,9,4,3,"Raze,Cypher,Omen,Neon,Fade","Raze,Cypher,Skye,Deadlock,Clove"
Haven,Return of the Ashes,XSOUL GC,21,19,8,12,7,13,"Breach,Cypher,Sova,Omen,Neon","Breach,Cypher,Sova,Omen,Jett"
Lotus,les piments,Omnipotence,13,10,7,5,5,6,"Raze,Killjoy,Viper,Omen,Fade","Raze,Cypher,Omen,Fade,Deadlock"
Haven,Cuddle Gang,SeanGares' Kittens,13,6,4,3,3,9,"Breach,Sova,Killjoy,Neon,Clove","Cypher,Yoru,Astra,Fade,Iso"
Sunset,No Sweat Blossom,Infiriumz Gaming GC,13,11,8,4,7,5,"Breach,Raze,Cypher,Omen,Iso","Breach,Raze,Cypher,Omen,Gekko"
Sunset,Nightblood Gaming,LoungeLizardWW,11,13,4,8,5,7,"Breach,Cypher,Sova,Omen,Neon","Breach,Raze,Cypher,Omen,Fade"
Abyss,Azzy White,NTH,7,13,1,7,6,6,"Cypher,Sova,Omen,Jett,KAY/O","Cypher,Jett,Astra,KAY/O,Iso"
Haven,whats a pretzel,Nearest Airport,13,5,6,0,5,7,"Breach,Cypher,Sova,Omen,Jett","Breach,Killjoy,Omen,Neon,Fade"
Ascent,TOS Gaming,slackers,4,13,2,10,3,2,"Sova,Killjoy,Omen,Jett,KAY/O","Cypher,Sova,Omen,Jett,KAY/O"
Icebox,Kitten Whiskers,Georgia Tech Gold,16,18,9,8,10,7,"Sova,Viper,Reyna,Jett,Gekko","Sova,Killjoy,Viper,Reyna,Jett"
Sunset,A Good Team,Non Verbal,4,13,2,3,10,2,"Raze,Cypher,Sova,Omen,Gekko","Breach,Cypher,Sova,Omen,Neon"
Haven,4Gods1Bum,YDZ Esports,13,6,7,5,1,6,"Breach,Cypher,Sova,Omen,Jett","Breach,Sova,Killjoy,Omen,Jett"
Haven,KU Esports,Radford University,13,9,5,5,4,8,"Breach,Sova,Killjoy,Omen,Jett","Breach,Sova,Killjoy,Omen,Jett"
Ascent,Omnipotence,Outcast Gaming,13,3,9,3,0,4,"Breach,Sova,Killjoy,Omen,KAY/O","Cypher,Sova,Omen,Jett,Deadlock"
Haven,Atlas Esports,Akatsuki Aimers,5,13,1,5,8,4,"Breach,Cypher,Sova,Omen,Jett","Sova,Jett,KAY/O,Chamber,Clove"
Lotus,Eternal Focus Crimson,Converse Purple,13,11,7,5,6,6,"Raze,Cypher,Omen,Fade,Deadlock","Breach,Raze,Killjoy,Omen,Gekko"
Sunset,Sho,Harmony,5,13,2,4,9,3,"Breach,Cypher,Omen,Neon,Fade","Breach,Cypher,Sova,Omen,Neon"
Ascent,les piments,The Worst Generation,13,5,8,4,1,5,"Sova,Killjoy,Omen,Jett,KAY/O","Sova,Killjoy,Omen,Jett,KAY/O"
Ascent,Nightblood Gaming,LoungeLizardWW,11,13,2,10,3,9,"Cypher,Sova,Omen,Yoru,Deadlock","Sova,Killjoy,Omen,Jett,KAY/O"
Icebox,Azzy White,NTH,5,13,3,3,10,2,"Sova,Viper,Jett,Harbor,Gekko","Sova,Viper,Jett,Chamber,Iso"
Lotus,No Sweat Blossom,Infiriumz Gaming GC,13,6,9,3,3,4,"Breach,Raze,Killjoy,Omen,Iso","Breach,Raze,Killjoy,Omen,Jett"
Ascent,add3r's kittens,random fricks,14,12,9,4,8,5,"Sova,Killjoy,Omen,Jett,KAY/O","Sova,Killjoy,Omen,Jett,Yoru"
Bind,Be Like Matt,Bosnian Bullets,13,7,8,4,3,5,"Raze,Cypher,Viper,Brimstone,Skye","Raze,Sova,Viper,Brimstone,Reyna"
Ascent,whats a pretzel,Nearest Airport,9,13,4,8,5,5,"Cypher,Sova,Omen,Yoru,Deadlock","Cypher,Sova,Omen,Yoru,Deadlock"
Haven,ABG luvrs,SeanGares' Kittens,6,13,2,5,8,4,"Cypher,Sova,Omen,Yoru,Deadlock","Cypher,Yoru,Fade,Iso,Clove"
Icebox,The GRID,Berzerkers,13,8,4,5,3,9,"Sova,Killjoy,Viper,Reyna,Jett","Sova,Killjoy,Viper,Reyna,Jett"
Abyss,XSOUL GC,raised,13,7,7,1,6,6,"Breach,Cypher,Sova,Jett,Astra","Breach,Omen,Jett,KAY/O,Neon"
Sunset,First Rounded,KU Esports,7,13,2,6,7,5,"Breach,Raze,Cypher,Sova,Omen","Breach,Cypher,Omen,KAY/O,Neon"
Haven,Outlast Gaming,Georgia Tech Gold,11,13,7,5,8,4,"Killjoy,Viper,Omen,Jett,Skye","Breach,Sova,Killjoy,Omen,Neon"
Bind,NME,School Project,8,13,3,6,7,5,"Raze,Viper,Brimstone,Fade,Gekko","Omen,Yoru,Fade,Deadlock,Clove"
Ascent,Big Baller Brand,slackers,10,13,3,9,4,7,"Sova,Killjoy,Omen,Jett,KAY/O","Cypher,Sova,Omen,Jett,Yoru"
Lotus,les piments,Divine GC,13,4,4,1,3,9,"Raze,Killjoy,Viper,Omen,Fade","Breach,Raze,Killjoy,Gekko,Clove"
Bind,4Gods1Bum,YDZ Esports,7,13,3,5,8,4,"Raze,Viper,Brimstone,Yoru,Gekko","Raze,Brimstone,Skye,Yoru,Deadlock"
Ascent,Be Like Matt,Bosnian Bullets,13,5,10,2,3,3,"Sova,Killjoy,Omen,Jett,KAY/O","Sova,Killjoy,Omen,Jett,KAY/O"
Lotus,add3r's kittens,random fricks,13,10,8,3,7,5,"Breach,Cypher,Omen,Neon,Gekko","Breach,Killjoy,Neon,Fade,Clove"
Lotus,Nightblood Gaming,LoungeLizardWW,13,8,7,2,6,6,"Breach,Cypher,Sova,Astra,Neon","Breach,Raze,Cypher,Omen,Fade"
Ascent,Giddions,Eternal Focus Crimson,2,13,1,11,2,1,"Cypher,Sova,Omen,Jett,KAY/O","Raze,Sova,Killjoy,Omen,Deadlock"
Haven,Converse Purple,Spearhead,13,10,9,2,8,4,"Cypher,Sova,Omen,Neon,Iso","Cypher,Sova,Reyna,Omen,Neon"
Sunset,Nine Lives Esports,Sho,5,13,3,9,4,2,"Breach,Raze,Cypher,Gekko,Clove","Breach,Cypher,Omen,Neon,Fade"
Lotus,Outcast Gaming,Vortex VTX,13,9,7,5,4,6,"Raze,Viper,Omen,Chamber,Fade","Breach,Cypher,Viper,Omen,Neon"
Ascent,Kitten Whiskers,DRIFT,13,4,5,0,4,8,"Sova,Jett,Yoru,Deadlock,Clove","Sova,Killjoy,Jett,KAY/O,Clove"
Bind,Radford University,SimonSaysFF,13,2,3,0,2,10,"Raze,Brimstone,Omen,Skye,Gekko","Raze,Killjoy,Neon,Gekko,Clove"
Haven,twobits money crew,The Worst Generation,8,13,6,6,7,2,"Killjoy,Viper,Omen,Jett,Skye","Breach,Sova,Killjoy,Omen,Neon"
Sunset,ABG luvrs,SeanGares' Kittens,5,13,3,3,10,2,"Breach,Raze,Cypher,Omen,Gekko","Breach,Cypher,Sova,Astra,Neon"
Ascent,Acrylic eSports,TOS Gaming,12,14,5,8,6,7,"Killjoy,Viper,Omen,Jett,Skye","Sova,Killjoy,Omen,Jett,KAY/O"
Haven,abandoned,Omnipotence,7,13,5,7,6,2,"Breach,Cypher,Sova,Omen,Jett","Cypher,Sova,Omen,Yoru,Neon"
Haven,A Good Team,Non Verbal,15,17,11,5,12,4,"Breach,Cypher,Sova,Omen,Jett","Killjoy,Viper,Omen,Jett,Skye"
Bind,whats a pretzel,Nearest Airport,13,7,5,3,4,8,"Viper,Brimstone,Skye,Yoru,Gekko","Raze,Cypher,Omen,Yoru,Deadlock"
Lotus,The GRID,Berzerkers,13,6,8,4,2,5,"Raze,Cypher,Skye,Deadlock,Clove","Raze,Cypher,Jett,Gekko,Clove"
Haven,XSOUL GC,raised,15,13,6,8,5,9,"Breach,Cypher,Sova,Omen,Jett","Cypher,Sova,Omen,Yoru,Iso"
Icebox,Return of the Ashes,Dasein Club GC,13,10,5,6,4,8,"Sova,Killjoy,Viper,Jett,KAY/O","Killjoy,Viper,Reyna,KAY/O,Gekko"
Ascent,XSOUL GC,raised,13,15,9,5,10,4,"Sova,Killjoy,Omen,Jett,KAY/O","Sova,Reyna,Omen,Jett,Deadlock"
Haven,Return of the Ashes,Dasein Club GC,13,9,4,6,3,9,"Breach,Cypher,Sova,Omen,Neon","Breach,Sova,Killjoy,Omen,Jett"
Lotus,Leviatán,Team Heretics,13,10,9,2,8,4,"Breach,Raze,Cypher,Omen,Fade","Raze,Killjoy,Viper,Omen,Fade"
Icebox,Leviatán,Team Heretics,15,13,8,6,7,7,"Sova,Killjoy,Viper,Jett,Harbor","Sova,Killjoy,Viper,Neon,Gekko"
Sunset,Sentinels,EDward Gaming,6,13,4,3,10,2,"Breach,Cypher,Omen,Neon,Fade","Cypher,Sova,Omen,KAY/O,Neon"
Lotus,Sentinels,EDward Gaming,9,13,3,7,6,6,"Raze,Killjoy,Viper,Omen,Fade","Breach,Omen,Neon,Fade,Clove"
Haven,Sentinels,EDward Gaming,13,9,8,4,5,5,"Breach,Cypher,Sova,Omen,Neon","Breach,Cypher,Sova,Omen,Neon"
Icebox,Bosnian Bullets,Furious Five,13,9,6,6,3,7,"Sova,Killjoy,Viper,Sage,Jett","Sova,Killjoy,Viper,Reyna,Jett"
Abyss,YDZ Esports,Event Horizon,13,7,7,5,2,6,"Cypher,Sova,Omen,Jett,KAY/O","Cypher,Sova,Omen,Jett,KAY/O"
Icebox,Goon that jawn,Berzerkers,11,13,6,6,7,5,"Raze,Sova,Killjoy,Viper,Reyna","Sova,Killjoy,Viper,Reyna,Jett"
Ascent,Bosnian Bullets,Furious Five,13,8,7,5,3,6,"Sova,Killjoy,Omen,Jett,KAY/O","Cypher,Sova,Omen,Jett,KAY/O"
Sunset,LazerrFreeks Mythic,random fricks,5,13,0,6,7,5,"Breach,Raze,Cypher,Omen,Fade","Cypher,Sova,Omen,Neon,Iso"
Haven,YDZ Esports,Event Horizon,12,14,5,8,6,7,"Cypher,Sova,Omen,Yoru,Iso","Breach,Sova,Killjoy,Omen,Jett"
Ascent,Goon that jawn,Berzerkers,8,13,6,6,7,2,"Raze,Sova,Killjoy,Omen,Iso","Sova,Killjoy,Reyna,Omen,Jett"
Haven,Bosnian Bullets,Furious Five,8,13,2,7,6,6,"Breach,Sova,Killjoy,Omen,Jett","Breach,Cypher,Sova,Omen,Jett"
Ascent,Paranoia Vortex,ABG luvrs,5,13,4,8,5,1,"Sova,Killjoy,Omen,Yoru,Deadlock","Sova,Killjoy,Omen,Jett,KAY/O"
Haven,LazerrFreeks Mythic,random fricks,6,13,1,6,7,5,"Killjoy,Viper,Omen,Jett,Skye","Cypher,Sova,Omen,Yoru,Iso"
Haven,Goon that jawn,Berzerkers,13,7,8,4,3,5,"Raze,Cypher,Sova,Reyna,Omen","Cypher,Sova,Jett,Iso,Clove"
Haven,SeanGares' Kittens,Rice Bowl,13,9,7,5,4,6,"Cypher,Omen,Jett,Gekko,Iso","Cypher,Killjoy,Sage,Omen,Deadlock"
Lotus,YDZ Esports,Event Horizon,13,7,7,1,6,6,"Raze,Killjoy,Viper,Omen,Fade","Breach,Raze,Cypher,Omen,Fade"
Lotus,AURA,Akatsuki Aimers,9,13,4,6,7,5,"Breach,Raze,Killjoy,Omen,Gekko","Breach,Cypher,Omen,Neon,Fade"
Haven,Paranoia Vortex,ABG luvrs,13,11,6,6,5,7,"Sova,Killjoy,Reyna,Omen,Jett","Cypher,Sova,Omen,Yoru,Deadlock"
Sunset,Fluffy Men,Bosnian Bullets,13,7,6,2,5,7,"Breach,Raze,Cypher,Omen,Fade","Breach,Raze,Cypher,Sova,Omen"
Haven,Legion Nyx,Infiriumz Gaming GC,1,13,1,11,2,0,"Breach,Sova,Killjoy,Omen,Jett","Breach,Sova,Killjoy,Omen,Neon"
Lotus,Be Like Matt,Barely Acceptable,13,8,7,5,3,6,"Reyna,Chamber,Neon,Gekko,Clove","Breach,Raze,Killjoy,Omen,Gekko"
Lotus,Be Like Matt,Barely Acceptable,13,8,7,5,3,6,"Reyna,Chamber,Neon,Gekko,Clove","Breach,Raze,Killjoy,Omen,Gekko"
Bind,SeanGares' Kittens,Rice Bowl,13,5,10,2,3,3,"Raze,Viper,Brimstone,Yoru,Fade","Raze,Viper,Brimstone,Skye,Gekko"
Sunset,Non Verbal,BALLSOHARD UNIVERSITY,13,4,8,4,0,5,"Breach,Cypher,Sova,Omen,Neon","Breach,Cypher,Sova,Omen,Jett"
Icebox,Resonate,A Good Team,8,13,2,7,6,6,"Sova,Killjoy,Viper,Jett,Iso","Sova,Killjoy,Viper,Reyna,Jett"
Lotus,LazerrFreeks Mythic,random fricks,13,4,9,3,1,4,"Raze,Killjoy,Viper,Omen,Fade","Raze,Killjoy,Omen,Jett,Fade"
Ascent,LoungeLizardWW,Motion Men,13,6,8,4,2,5,"Sova,Killjoy,Omen,Jett,KAY/O","Cypher,Sova,Omen,Jett,Deadlock"
Bind,Nearest Airport,The blockade,13,0,1,0,0,12,"Raze,Cypher,Omen,Yoru,Deadlock","Raze,Viper,Jett,Skye,Clove"
Haven,Whiff Nation,Event Horizon,3,13,0,4,9,3,"Breach,Cypher,Sova,Omen,Jett","Breach,Sova,Killjoy,Omen,Jett"
Haven,Goon that jawn,Cuddle Gang,10,13,8,4,9,2,"Cypher,Sova,Omen,Yoru,Iso","Breach,Sova,Killjoy,Omen,Jett"
Ascent,Fluffy Men,Bosnian Bullets,13,5,3,3,2,10,"Sova,Killjoy,Omen,Jett,KAY/O","Sova,Killjoy,Omen,Jett,KAY/O"
Lotus,Paranoia Vortex,ABG luvrs,6,13,6,6,7,0,"Breach,Sova,Killjoy,Omen,Neon","Breach,Killjoy,Omen,Yoru,Gekko"
Icebox,New Combat Line GC,"Fenrir ""White"" E-Club",13,4,4,1,3,9,"Sova,Killjoy,Viper,Jett,Gekko","Reyna,Chamber,Gekko,Iso,Clove"
Icebox,Non Verbal,BALLSOHARD UNIVERSITY,13,4,8,4,0,5,"Sova,Killjoy,Viper,Jett,Gekko","Sova,Killjoy,Viper,Jett,Harbor"
Ascent,Legion Nyx,Infiriumz Gaming GC,12,14,8,5,9,4,"Breach,Sova,Killjoy,Omen,Jett","Sova,Killjoy,Omen,Jett,KAY/O"
Bind,AURA,Akatsuki Aimers,7,13,5,7,6,2,"Raze,Viper,Brimstone,Fade,Gekko","Raze,Viper,Brimstone,Fade,Gekko"
Abyss,NTH,Stay K'O,13,8,8,4,4,5,"Cypher,Yoru,Neon,Iso,Clove","Sova,Omen,Yoru,KAY/O,Deadlock"
Ascent,whats a pretzel,Eternal Focus Crimson,13,5,5,1,4,8,"Cypher,Sova,Omen,Yoru,Deadlock","Sova,Killjoy,Omen,Deadlock,Iso"
Sunset,Furious Five,Astane Anarchy,13,11,9,3,8,4,"Breach,Cypher,Sova,Omen,Neon","Breach,Raze,Cypher,Omen,Fade"
Lotus,LoungeLizardWW,Motion Men,13,6,6,1,5,7,"Breach,Raze,Cypher,Omen,Fade","Breach,Killjoy,Omen,Neon,Fade"
Haven,Resonate,A Good Team,9,13,8,4,9,1,"Sova,Killjoy,Omen,Jett,Iso","Breach,Cypher,Sova,Omen,Jett"
Lotus,Dogo Fanclub,SeanGares' Kittens,13,11,7,5,6,6,"Raze,Cypher,Omen,Yoru,Gekko","Breach,Cypher,Neon,Gekko,Clove"
Lotus,random fricks,Lionheart eSports,13,7,6,6,1,7,"Raze,Killjoy,Omen,Jett,Fade","Breach,Cypher,Omen,Neon,Gekko"
Haven,Be Like Matt,4Gods1Bum,10,13,8,3,10,2,"Breach,Sova,Killjoy,Omen,Jett","Breach,Cypher,Sova,Omen,Jett"
Haven,Nearest Airport,The blockade,13,10,4,8,2,9,"Breach,Omen,Chamber,Neon,Fade","Cypher,Sova,Omen,Jett,Yoru"
Haven,CB,Berzerkers,9,13,5,5,8,4,"Breach,Sova,Killjoy,Omen,Jett","Cypher,Sova,Jett,Iso,Clove"
Haven,Fluffy Men,Bosnian Bullets,9,13,2,10,3,7,"Breach,Sova,Killjoy,Omen,Jett","Breach,Sova,Killjoy,Omen,Jett"
Bind,CHURCH OF CHAEWON KIM,ABG luvrs,7,13,4,4,9,3,"Raze,Viper,Brimstone,Skye,Deadlock","Raze,Viper,Brimstone,Fade,Gekko"
Haven,Blue Otter,LazerrFreeks Mythic,13,11,6,6,5,7,"Breach,Cypher,Sova,Omen,Neon","Killjoy,Viper,Omen,Jett,Skye"
Ascent,ENVEE Esports,YDZ Esports,13,7,7,5,2,6,"Sova,Killjoy,Omen,Jett,KAY/O","Sova,Killjoy,Omen,Jett,KAY/O"
Lotus,Whiff Nation,Event Horizon,13,9,5,7,2,8,"Raze,Killjoy,Viper,Omen,Fade","Breach,Raze,Cypher,Omen,Fade"
Ascent,Goon that jawn,Cuddle Gang,13,15,5,9,6,8,"Raze,Sova,Sage,Omen,KAY/O","Sova,Killjoy,Jett,KAY/O,Clove"
Lotus,whats a pretzel,Eternal Focus Crimson,13,6,9,3,3,4,"Raze,Viper,Fade,Deadlock,Clove","Breach,Raze,Cypher,Omen,Fade"
Ascent,New Combat Line GC,"Fenrir ""White"" E-Club",13,8,2,7,1,11,"Sova,Killjoy,Omen,Jett,Gekko","Breach,Sova,Killjoy,Omen,Jett"
Icebox,NTH,Stay K'O,13,3,10,2,1,3,"Sova,Viper,Jett,Chamber,Iso","Killjoy,Viper,Jett,KAY/O,Clove"
Bind,LoungeLizardWW,Motion Men,9,13,6,4,9,3,"Raze,Brimstone,Reyna,Fade,Gekko","Raze,Viper,Brimstone,Reyna,Skye"
Haven,Barely Acceptable,Dexterity Gaming,13,4,9,3,1,4,"Breach,Cypher,Sova,Omen,Jett","Killjoy,Viper,Jett,Skye,Harbor"
Haven,Furious Five,Astane Anarchy,13,10,8,4,6,5,"Breach,Cypher,Sova,Omen,Jett","Breach,Cypher,Sova,Omen,Jett"
Abyss,FDR,AURA,5,13,1,5,8,4,"Cypher,Sova,Reyna,Omen,Jett","Cypher,Sova,Jett,Astra,KAY/O"
Sunset,Akatsuki Aimers,Poseidon Esports,13,11,7,5,6,6,"Breach,Raze,Sage,Omen,Gekko","Breach,Raze,Cypher,Sova,Omen"
Ascent,Dogo Fanclub,SeanGares' Kittens,13,5,2,4,1,11,"Sova,Killjoy,Omen,Jett,KAY/O","Cypher,Sova,Omen,Yoru,Deadlock"
Icebox,random fricks,Lionheart eSports,13,9,9,3,6,4,"Sova,Killjoy,Viper,Reyna,Jett","Sova,Killjoy,Viper,Jett,Gekko"
Lotus,roofcampers,Rice Bowl,12,14,6,7,7,6,"Breach,Raze,Killjoy,Omen,Fade","Raze,Killjoy,Viper,Omen,Fade"
Abyss,Be Like Matt,4Gods1Bum,11,13,6,6,7,5,"Sova,Viper,Omen,Yoru,Chamber","Cypher,Sova,Omen,Jett,Yoru"
Sunset,Blue Otter,LazerrFreeks Mythic,13,1,11,1,0,2,"Breach,Cypher,Sova,Omen,Neon","Breach,Raze,Cypher,Omen,Fade"
Bind,Resonate,The GRID,8,13,5,7,6,3,"Raze,Cypher,Viper,Brimstone,Skye","Raze,Brimstone,Skye,Deadlock,Clove"
Lotus,ENVEE Esports,YDZ Esports,13,5,8,4,1,5,"Raze,Killjoy,Viper,Omen,Fade","Raze,Killjoy,Viper,Omen,Fade"
Icebox,CB,Berzerkers,3,13,2,10,3,1,"Sova,Viper,Sage,Reyna,Chamber","Sova,Killjoy,Viper,Reyna,Jett"
Sunset,CHURCH OF CHAEWON KIM,ABG luvrs,9,13,6,4,9,3,"Breach,Raze,Cypher,Omen,Gekko","Breach,Raze,Cypher,Omen,Gekko"
Ascent,Whiff Nation,Event Horizon,6,13,4,8,5,2,"Sova,Killjoy,Omen,Jett,KAY/O","Sova,Killjoy,Omen,Jett,KAY/O"
Lotus,APX,The blockade,6,13,2,5,8,4,"Raze,Killjoy,Omen,Yoru,Fade","Raze,Killjoy,Viper,Fade,Clove"
Haven,Nightblood Gaming,Paranoia Vortex,13,2,3,0,2,10,"Breach,Cypher,Sova,Omen,Jett","Sova,Killjoy,Jett,Astra,Iso"
Haven,SaD Esports,Nearest Airport,13,5,9,3,2,4,"Sova,Jett,Astra,Deadlock,Iso","Breach,Omen,Chamber,Neon,Fade"
Haven,Eternal Focus Crimson,SaD FROST,13,10,5,7,3,8,"Breach,Cypher,Sova,Omen,Neon","Sova,Killjoy,Omen,Jett,Iso"
Haven,Eternal Focus Crimson,SaD FROST,13,10,5,7,3,8,"Breach,Cypher,Sova,Omen,Neon","Sova,Killjoy,Omen,Jett,Iso"
Haven,Special Grade,Non Verbal,13,10,7,4,6,6,"Breach,Cypher,Sova,Omen,Jett","Killjoy,Viper,Omen,Jett,Skye"
Haven,Kaoticcc and Friends,LoungeLizardWW,13,0,12,0,0,1,"Sova,Killjoy,Omen,Jett,Iso","Breach,Cypher,Sova,Omen,Jett"
Ascent,Motion Men,Kraken,13,5,5,1,4,8,"Cypher,Sova,Omen,Jett,Deadlock","Cypher,Sova,Omen,Jett,Deadlock"
Ascent,roofcampers,Rice Bowl,13,2,10,2,0,3,"Sova,Killjoy,Phoenix,Omen,Jett","Sova,Killjoy,Omen,Jett,KAY/O"
Ascent,Outlaw Empire,Akatsuki Aimers,4,13,4,8,5,0,"Cypher,Sova,Omen,Jett,Deadlock","Cypher,Sova,Omen,Jett,KAY/O"
Ascent,Bosnian Bullets,Astane Anarchy,13,8,6,6,2,7,"Sova,Killjoy,Omen,Jett,KAY/O","Breach,Killjoy,Omen,Jett,Fade"
Haven,lackers,FDR,9,13,4,6,7,5,"Breach,Cypher,Sova,Omen,Jett","Cypher,Sova,Reyna,Omen,Jett"
Lotus,AURA,Elation Esports,13,6,6,1,5,7,"Breach,Raze,Killjoy,Omen,Gekko","Breach,Cypher,Omen,Yoru,KAY/O"
Lotus,Barely Acceptable,Dexterity Gaming,13,9,5,5,4,8,"Breach,Raze,Killjoy,Omen,Gekko","Raze,Killjoy,Viper,Omen,Fade"
Bind,Be Like Matt,4Gods1Bum,13,7,9,3,4,4,"Raze,Viper,Brimstone,Skye,Yoru","Raze,Viper,Brimstone,Skye,Gekko"
Bind,add3r's kittens,whats a pretzel,13,6,6,6,0,7,"Raze,Brimstone,Yoru,Fade,Gekko","Raze,Cypher,Brimstone,Skye,Deadlock"
Haven,Resonate,The GRID,13,9,7,5,4,6,"Sova,Killjoy,Omen,Jett,Iso","Cypher,Sova,Omen,Yoru,Iso"
Sunset,TT GC,Dasein Club GC,6,13,5,7,6,1,"Breach,Raze,Cypher,Omen,Gekko","Breach,Raze,Cypher,Sova,Omen"
Sunset,APX,The blockade,5,13,3,9,4,2,"Cypher,Sova,Omen,Yoru,Neon","Breach,Raze,Cypher,Omen,Deadlock"
Haven,Poseidon Esports,In My Prime,13,3,4,0,3,9,"Breach,Sova,Killjoy,Omen,Jett","Cypher,Sova,Omen,Yoru,Iso"
Ascent,Nightblood Gaming,Paranoia Vortex,13,5,10,2,3,3,"Cypher,Sova,Omen,Yoru,Deadlock","Sova,Killjoy,Omen,Jett,KAY/O"
Abyss,SaD Esports,Nearest Airport,13,3,11,1,2,2,"Sova,Omen,Yoru,KAY/O,Harbor","Cypher,Sova,Omen,Jett,Harbor"
Haven,Dogo Fanclub,SeanGares' Kittens,15,17,8,8,9,7,"Sova,Killjoy,Omen,Jett,Clove","Cypher,Yoru,Fade,Iso,Clove"
Lotus,Team Atlantis,A Good Team,2,13,0,3,10,2,"Breach,Raze,Cypher,Omen,Gekko","Raze,Killjoy,Omen,Yoru,Gekko"
Haven,CHURCH OF CHAEWON KIM,ABG luvrs,13,10,9,3,7,4,"Cypher,Sova,Omen,Yoru,Iso","Cypher,Sova,Omen,Yoru,Deadlock"
Sunset,Cuddle Gang,Berzerkers,13,10,8,4,6,5,"Raze,Cypher,KAY/O,Fade,Clove","Raze,Cypher,Sova,Omen,Jett"
Bind,LazerrFreeks Mythic,Lionheart eSports,13,11,7,5,6,6,"Raze,Viper,Brimstone,Fade,Gekko","Raze,Viper,Skye,Gekko,Clove"
Icebox,Special Grade,Non Verbal,13,2,3,0,2,10,"Sova,Killjoy,Viper,Jett,KAY/O","Sova,Killjoy,Viper,Jett,Clove"
Ascent,Event Horizon,YDZ Esports,6,13,3,9,4,3,"Sova,Killjoy,Omen,Jett,KAY/O","Sova,Killjoy,Omen,Jett,KAY/O"
Bind,Kaoticcc and Friends,LoungeLizardWW,13,5,6,0,5,7,"Raze,Viper,Brimstone,Skye,Yoru","Raze,Brimstone,Reyna,Skye,Gekko"
Lotus,Resonate,The GRID,3,13,3,9,4,0,"Raze,Killjoy,Omen,Neon,Gekko","Raze,Cypher,Skye,Deadlock,Clove"
Abyss,Motion Men,Kraken,13,6,5,2,4,8,"Breach,Cypher,Sova,Omen,Jett","Cypher,Sova,Omen,Yoru,Harbor"
Abyss,Eternal Focus Crimson,SaD FROST,13,9,9,3,6,4,"Cypher,Sova,Yoru,Astra,Gekko","Cypher,Sova,Jett,Astra,Gekko"
Abyss,Eternal Focus Crimson,SaD FROST,13,9,9,3,6,4,"Cypher,Sova,Yoru,Astra,Gekko","Cypher,Sova,Jett,Astra,Gekko"
Haven,roofcampers,Rice Bowl,8,13,4,8,5,4,"Cypher,Sova,Omen,Jett,Skye","Breach,Sova,Killjoy,Omen,Jett"
Haven,Sphinx GC,Deagle Ravagers,13,15,9,5,10,4,"Breach,Sova,Killjoy,Omen,Neon","Breach,Sova,Killjoy,Omen,Jett"
Haven,Team Atlantis,A Good Team,3,13,0,4,9,3,"Cypher,Sova,Omen,Yoru,Iso","Breach,Cypher,Sova,Omen,Jett"
Haven,add3r's kittens,whats a pretzel,13,8,6,3,5,7,"Breach,Sova,Killjoy,Omen,Neon","Breach,Cypher,Sova,Omen,Jett"
Ascent,Nine Lives Esports,Outlaw Empire,7,13,5,3,10,2,"Sova,Killjoy,Omen,Jett,KAY/O","Cypher,Sova,Omen,Jett,Deadlock"
Lotus,Day By Day,lackers,7,13,4,8,5,3,"Raze,Killjoy,Viper,Omen,Fade","Breach,Raze,Omen,Gekko,Deadlock"
Abyss,Goon that jawn,CB,13,9,8,2,7,5,"Raze,Sova,Killjoy,Omen,Neon","Cypher,Sova,Jett,Astra,Gekko"
Ascent,Fluffy Men,Furious Five,13,1,2,0,1,11,"Sova,Killjoy,Omen,Jett,KAY/O","Cypher,Sova,Omen,Yoru,Deadlock"
Icebox,TT GC,Dasein Club GC,6,13,3,9,4,3,"Sova,Killjoy,Viper,Reyna,Clove","Killjoy,Viper,Jett,KAY/O,Gekko"
Haven,Dexterity Gaming,4Gods1Bum,4,13,0,5,8,4,"Killjoy,Viper,Jett,Skye,Harbor","Cypher,Sova,Omen,Yoru,Iso"
Haven,Malecient Parasside,raised,1,13,0,2,11,1,"Breach,Killjoy,Omen,Jett,Skye","Cypher,Sova,Omen,Yoru,Iso"
Abyss,Nearest Airport,The blockade,13,7,8,4,3,5,"Cypher,Sova,Omen,Jett,Harbor","Cypher,Sova,Yoru,Astra,Iso"
Lotus,ENVEE Esports,Whiff Nation,13,1,11,1,0,2,"Killjoy,Viper,Omen,Jett,Fade","Raze,Killjoy,Viper,Omen,Fade"
Haven,Bosnian Bullets,Astane Anarchy,13,10,6,6,4,7,"Breach,Sova,Killjoy,Omen,Jett","Breach,Cypher,Sova,Omen,Neon"
Ascent,CLICK,In My Prime,11,13,2,10,3,9,"Sova,Killjoy,Reyna,Omen,Jett","Sova,Killjoy,Omen,Jett,KAY/O"
Sunset,Blue Otter,random fricks,13,8,5,4,4,8,"Breach,Cypher,Sova,Omen,Neon","Breach,Raze,Cypher,Omen,Gekko"
Lotus,Senchigami,Akatsuki Aimers,5,13,0,6,7,5,"Breach,Raze,Killjoy,Omen,Gekko","Breach,Cypher,Omen,Neon,Fade"
Lotus,Cuddle Gang,Berzerkers,13,9,5,5,4,8,"Breach,Raze,Killjoy,Gekko,Clove","Breach,Raze,Cypher,Omen,Gekko"
Lotus,Event Horizon,YDZ Esports,13,8,5,4,4,8,"Breach,Raze,Cypher,Omen,Fade","Raze,Omen,Fade,Deadlock,Clove"
Sunset,Non Verbal,BALLSOHARD UNIVERSITY,13,5,8,4,1,5,"Breach,Cypher,Sova,Omen,Neon","Breach,Raze,Cypher,Omen,Fade"
Lotus,Dogo Fanclub,roofcampers,13,4,10,2,2,3,"Raze,Cypher,Omen,Neon,Fade","Breach,Raze,Killjoy,Omen,Gekko"
Lotus,LoungeLizardWW,Kraken,13,3,4,0,3,9,"Breach,Raze,Cypher,Omen,Fade","Breach,Cypher,Omen,Neon,Fade"
Haven,Poseidon Esports,Atlas Esports,13,11,9,3,8,4,"Breach,Sova,Killjoy,Omen,Jett","Breach,Sova,Killjoy,Omen,Jett"
Lotus,LazerrFreeks Mythic,Lionheart eSports,9,13,5,5,8,4,"Raze,Killjoy,Viper,Omen,Fade","Breach,Cypher,Omen,Neon,Gekko"
Icebox,Special Grade,Natural Order,13,2,3,0,2,10,"Sova,Killjoy,Viper,Jett,KAY/O","Sova,Killjoy,Viper,Jett,Iso"
Sunset,Nightblood Gaming,CHURCH OF CHAEWON KIM,13,7,8,4,3,5,"Breach,Cypher,Sova,Omen,Neon","Breach,Raze,Cypher,Omen,Gekko"
Ascent,Paranoia Vortex,ABG luvrs,14,12,7,6,6,7,"Sova,Killjoy,Omen,Jett,KAY/O","Sova,Killjoy,Omen,Jett,KAY/O"
Icebox,Be Like Matt,Barely Acceptable,13,8,7,5,3,6,"Sova,Killjoy,Viper,Reyna,Jett","Sova,Killjoy,Viper,Jett,Gekko"
Lotus,Kaoticcc and Friends,Motion Men,13,6,5,2,4,8,"Breach,Raze,Killjoy,Omen,Fade","Breach,Cypher,Omen,Neon,Fade"
Sunset,Resonate,Team Atlantis,13,3,10,2,1,3,"Raze,Cypher,Omen,Gekko,Iso","Raze,Cypher,Omen,Neon,Gekko"
Lotus,add3r's kittens,Eternal Focus Crimson,13,10,7,5,5,6,"Sova,Sage,Yoru,KAY/O,Clove","Breach,Raze,Cypher,Omen,Fade"
Ascent,whats a pretzel,SaD FROST,13,2,2,1,1,11,"Cypher,Sova,Omen,Yoru,Deadlock","Sova,Killjoy,Omen,Jett,KAY/O"
Haven,SaD Esports,APX,13,2,3,0,2,10,"Sova,Jett,Astra,Deadlock,Iso","Breach,Sova,Killjoy,Omen,Jett"
Haven,SeanGares' Kittens,Rice Bowl,13,2,3,0,2,10,"Cypher,Yoru,Astra,Fade,Iso","Breach,Sova,Killjoy,Omen,Jett"
Ascent,The GRID,A Good Team,13,6,3,4,2,10,"Cypher,Sova,Reyna,Omen,Jett","Cypher,Sova,Omen,Yoru,Deadlock"
Icebox,Goon that jawn,CB,13,6,4,3,3,9,"Sova,Killjoy,Viper,Reyna,Jett","Sova,Viper,Sage,Reyna,Chamber"
Ascent,ENVEE Esports,Whiff Nation,13,2,1,2,0,12,"Sova,Killjoy,Omen,Jett,KAY/O","Cypher,Sova,Omen,Jett,Deadlock"
Haven,Kaizen (NA),FDR,7,13,2,6,7,5,"Breach,Sova,Killjoy,Omen,Jett","Cypher,Sova,Reyna,Omen,Jett"
Haven,Fluffy Men,Furious Five,13,9,6,4,5,7,"Breach,Cypher,Sova,Omen,Jett","Breach,Cypher,Sova,Omen,Jett"
Lotus,Dexterity Gaming,4Gods1Bum,6,13,4,3,10,2,"Raze,Killjoy,Viper,Omen,Fade","Raze,Killjoy,Viper,Omen,Fade"
Haven,Cuddle Gang,Berzerkers,10,13,3,8,5,7,"Breach,Sova,Killjoy,Omen,Jett","Cypher,Sova,Omen,Jett,Iso"
Sunset,Bosnian Bullets,Astane Anarchy,9,13,4,6,7,5,"Breach,Raze,Cypher,Sova,Omen","Breach,Raze,Cypher,Omen,Fade"
Haven,Non Verbal,BALLSOHARD UNIVERSITY,13,5,8,4,1,5,"Killjoy,Viper,Omen,Jett,Skye","Breach,Cypher,Sova,Omen,Jett"
Icebox,Blue Otter,random fricks,13,10,8,4,6,5,"Sova,Killjoy,Viper,Jett,Gekko","Sova,Killjoy,Viper,Reyna,Jett"
Bind,Dogo Fanclub,roofcampers,13,6,8,4,2,5,"Raze,Brimstone,Reyna,Yoru,Gekko","Raze,Cypher,Viper,Brimstone,Skye"
Bind,Vibin Out Vex,AURA,5,13,5,7,6,0,"Raze,Cypher,Viper,Gekko,Clove","Raze,Viper,Brimstone,Fade,Gekko"
Lotus,Nightblood Gaming,CHURCH OF CHAEWON KIM,13,4,4,1,3,9,"Breach,Cypher,Sova,Astra,Neon","Raze,Killjoy,Viper,Omen,Fade"
Abyss,Malecient Parasside,raised,5,13,0,6,7,5,"Sova,Jett,Astra,Harbor,Gekko","Breach,Omen,Jett,KAY/O,Neon"
Icebox,Kaoticcc and Friends,Motion Men,13,2,3,0,2,10,"Sova,Killjoy,Viper,Reyna,Jett","Sova,Killjoy,Viper,Reyna,Gekko"
Abyss,Special Grade,Natural Order,13,4,4,1,3,9,"Cypher,Sova,Viper,Omen,Yoru","Sova,Killjoy,Viper,Jett,Astra"
Abyss,LazerrFreeks Mythic,Lionheart eSports,13,3,9,3,0,4,"Cypher,Sova,Viper,Omen,Yoru","Sova,Killjoy,Viper,Omen,Yoru"
Haven,whats a pretzel,SaD FROST,13,2,3,0,2,10,"Breach,Cypher,Sova,Omen,Jett","Breach,Sova,Killjoy,Omen,Jett"
Ascent,SeanGares' Kittens,Rice Bowl,13,1,2,0,1,11,"Cypher,Sova,Omen,Yoru,Deadlock","Sova,Killjoy,Omen,Jett,KAY/O"
Sunset,Be Like Matt,Barely Acceptable,13,2,10,2,0,3,"Breach,Raze,Cypher,Omen,Gekko","Breach,Cypher,Omen,Yoru,Neon"
Sunset,SaD Esports,APX,13,3,9,3,0,4,"Breach,Raze,Cypher,Sova,Omen","Cypher,Sova,Omen,Yoru,Neon"
Lotus,TT GC,Dasein Club GC,13,9,5,5,4,8,"Breach,Raze,Killjoy,Omen,Fade","Breach,Cypher,Omen,Neon,Fade"
Bind,Sphinx GC,Deagle Ravagers,10,13,5,7,6,5,"Viper,Skye,Yoru,Astra,Gekko","Breach,Raze,Viper,Brimstone,Gekko"
Ascent,LoungeLizardWW,Kraken,13,7,8,0,7,5,"Sova,Killjoy,Omen,Jett,KAY/O","Cypher,Sova,Omen,Jett,Deadlock"
Haven,add3r's kittens,Eternal Focus Crimson,13,7,10,2,5,3,"Cypher,Sova,Phoenix,Omen,Jett","Cypher,Sova,Omen,Skye,Neon"
Lotus,The GRID,A Good Team,13,3,4,0,3,9,"Raze,Cypher,Skye,Deadlock,Clove","Breach,Killjoy,Omen,Neon,Gekko"
Haven,Event Horizon,YDZ Esports,12,14,6,7,7,6,"Breach,Sova,Killjoy,Omen,Jett","Cypher,Sova,Omen,Yoru,Iso"
Haven,Paranoia Vortex,ABG luvrs,13,8,8,4,4,5,"Sova,Killjoy,Omen,Jett,Deadlock","Cypher,Sova,Phoenix,Omen,Jett"
Haven,Resonate,Team Atlantis,13,2,3,0,2,10,"Sova,Killjoy,Omen,Jett,Iso","Breach,Sova,Killjoy,Omen,Jett"
Bind,G2 Esports,FNATIC,11,13,7,5,8,4,"Raze,Viper,Brimstone,Skye,Gekko","Raze,Viper,Astra,Fade,Gekko"
Haven,G2 Esports,FNATIC,3,13,3,9,4,0,"Sova,Killjoy,Viper,Omen,Yoru","Cypher,Sova,Omen,Yoru,Iso"
Abyss,DRX,Trace Esports,13,5,4,2,3,9,"Cypher,Sova,Omen,Jett,KAY/O","Cypher,Sova,Jett,Astra,KAY/O"
Lotus,DRX,Trace Esports,13,3,10,2,1,3,"Raze,Viper,Omen,Chamber,Fade","Raze,Killjoy,Viper,Omen,Fade"
Sunset,Legiowon Puff,Stay K'O,7,13,4,8,5,3,"Breach,Raze,Cypher,Omen,Deadlock","Raze,Omen,Skye,Deadlock,Clove"
Haven,MOCHI,Legion Nyx,9,13,3,7,6,6,"Killjoy,Viper,Omen,Jett,Skye","Breach,Sova,Killjoy,Omen,Jett"
Icebox,MOCHI,Legion Nyx,11,13,5,7,6,6,"Sova,Killjoy,Viper,Jett,Gekko","Sova,Killjoy,Jett,Harbor,Gekko"
Ascent,Legiowon Puff,Stay K'O,17,15,6,10,5,11,"Sova,Killjoy,Omen,Jett,KAY/O","Breach,Sova,Omen,Jett,Deadlock"
Abyss,NTH,FEK ESPORTS GC,13,8,7,2,6,6,"Cypher,Jett,Chamber,Gekko,Clove","Sova,Viper,Jett,Harbor,Gekko"
Abyss,"Fenrir ""White"" E-Club",Azzy White,13,10,9,2,8,4,"Cypher,Sova,Omen,Jett,KAY/O","Cypher,Sova,Omen,Jett,KAY/O"
Sunset,ONE BULLET GAMING GC,Infiriumz Gaming GC,6,13,5,7,6,1,"Breach,Cypher,Omen,Neon,Gekko","Breach,Raze,Cypher,Omen,Gekko"
Lotus,New Combat Line GC,No Sweat Blossom,13,10,8,4,6,5,"Raze,Killjoy,Viper,Omen,Fade","Breach,Killjoy,Omen,Neon,Iso"
Bind,"Fenrir ""White"" E-Club",Azzy White,13,7,4,4,3,9,"Breach,Raze,Cypher,Brimstone,Deadlock","Raze,Brimstone,Skye,Yoru,Gekko"
Bind,MOCHI,Legion Nyx,13,6,10,2,4,3,"Raze,Viper,Brimstone,Fade,Gekko","Breach,Raze,Cypher,Brimstone,Skye"
Ascent,ONE BULLET GAMING GC,Infiriumz Gaming GC,5,13,4,2,11,1,"Breach,Sova,Killjoy,Omen,Jett","Sova,Killjoy,Omen,Jett,KAY/O"
Abyss,Legiowon Puff,Stay K'O,8,13,7,5,8,1,"Cypher,Sova,Omen,Jett,KAY/O","Sova,Omen,Yoru,KAY/O,Deadlock"
Haven,New Combat Line GC,No Sweat Blossom,13,6,4,3,3,9,"Breach,Sova,Killjoy,Omen,Neon","Breach,Cypher,Omen,Neon,Iso"
Sunset,Zen eSports GC,Leviatán GC,13,10,8,3,7,5,"Breach,Cypher,Sova,Omen,Neon","Breach,Cypher,Omen,Neon,Fade"
Lotus,Malecient Parasside,Krows Corax,13,10,7,5,5,6,"Killjoy,Omen,Skye,Neon,Gekko","Breach,Cypher,Omen,Neon,Gekko"
Bind,Sphinx GC,Return of the Ashes,13,7,7,5,2,6,"Viper,Skye,Yoru,Astra,Gekko","Breach,Raze,Cypher,Brimstone,Gekko"
Abyss,Malecient Parasside,Krows Corax,13,8,5,4,4,8,"Sova,Jett,Astra,Harbor,Gekko","Cypher,Sova,Jett,Astra,Gekko"
Abyss,Zen eSports GC,Leviatán GC,14,12,9,4,8,5,"Breach,Cypher,Sova,Omen,Jett","Cypher,Sova,Omen,Jett,Yoru"
Abyss,UC Esports,raised,5,13,3,3,10,2,"Cypher,Omen,Jett,Harbor,Gekko","Breach,Omen,Jett,KAY/O,Neon"
Abyss,XSOUL GC,Deagle Ravagers,5,13,2,4,9,3,"Breach,Cypher,Sova,Jett,Astra","Cypher,Sova,Omen,Jett,KAY/O"
Icebox,Dasein Club GC,B Site Nova,13,5,5,1,4,8,"Killjoy,Viper,Jett,KAY/O,Gekko","Sova,Killjoy,Viper,Jett,Gekko"
Lotus,Zen eSports GC,Leviatán GC,10,13,6,6,7,4,"Raze,Killjoy,Viper,Omen,Fade","Breach,Cypher,Omen,Neon,Iso"
Haven,Sphinx GC,Return of the Ashes,15,13,6,8,5,9,"Breach,Sova,Killjoy,Omen,Neon","Breach,Cypher,Sova,Omen,Neon"
Sunset,Malecient Parasside,Krows Corax,13,15,8,6,9,5,"Breach,Raze,Cypher,Omen,KAY/O","Breach,Cypher,Sova,Omen,Neon"
Icebox,UC Esports,raised,2,13,1,11,2,1,"Sova,Killjoy,Viper,Jett,KAY/O","Viper,Reyna,Jett,Harbor,Gekko"
Haven,XSOUL GC,Deagle Ravagers,3,13,3,9,4,0,"Breach,Cypher,Sova,Omen,Jett","Breach,Sova,Killjoy,Omen,Jett"
Sunset,Dasein Club GC,B Site Nova,13,4,10,2,2,3,"Breach,Raze,Cypher,Sova,Omen","Breach,Raze,Cypher,Omen,Gekko"
Abyss,Team Heretics,FNATIC,14,12,10,3,9,4,"Cypher,Sova,Jett,Astra,Gekko","Sova,Killjoy,Viper,Yoru,Astra"
Lotus,Team Heretics,FNATIC,13,3,4,0,3,9,"Raze,Killjoy,Viper,Omen,Fade","Raze,Killjoy,Viper,Omen,Fade"
Abyss,G2 Esports,Leviatán,5,13,4,8,5,1,"Sova,Killjoy,Viper,Yoru,Astra","Cypher,Sova,Omen,Jett,Harbor"
Icebox,G2 Esports,Leviatán,14,16,10,5,11,4,"Sova,Killjoy,Viper,Harbor,Gekko","Sova,Killjoy,Viper,Jett,Harbor"
Sunset,No Sweat Blossom,NTH,13,5,5,1,4,8,"Breach,Raze,Cypher,Omen,Iso","Raze,Cypher,Omen,Fade,Gekko"
Ascent,Stay K'O,FIXAM,13,11,10,2,9,3,"Breach,Sova,Omen,Jett,Deadlock","Sova,Killjoy,Omen,Jett,KAY/O"
Haven,No Sweat Blossom,NTH,8,13,2,7,6,6,"Breach,Raze,Cypher,Omen,Fade","Raze,Sova,Killjoy,Reyna,Omen"
Haven,MOCHI,Azzy White,5,13,4,8,5,1,"Killjoy,Viper,Omen,Jett,Skye","Breach,Omen,Neon,Fade,Iso"
Lotus,NovaCrew,Infiriumz Gaming GC,1,13,1,11,2,0,"Breach,Killjoy,Jett,Yoru,Astra","Breach,Raze,Killjoy,Omen,Jett"
Bind,ONE BULLET GAMING GC,"Fenrir ""White"" E-Club",4,13,2,10,3,2,"Raze,Viper,Skye,Gekko,Clove","Breach,Raze,Cypher,Brimstone,Deadlock"
Haven,New Combat Line GC,Legiowon Puff,13,7,6,2,5,7,"Breach,Sova,Killjoy,Omen,Jett","Breach,Killjoy,Omen,Jett,Gekko"
Abyss,Stay K'O,FIXAM,13,9,6,4,5,7,"Sova,Omen,Yoru,KAY/O,Deadlock","Cypher,Sova,Omen,Jett,KAY/O"
Ascent,No Sweat Blossom,NTH,13,9,7,5,4,6,"Cypher,Sova,Omen,Jett,Deadlock","Raze,Sova,Killjoy,Reyna,Omen"
Ascent,ONE BULLET GAMING GC,"Fenrir ""White"" E-Club",6,13,3,9,4,3,"Breach,Sova,Killjoy,Omen,Jett","Breach,Sova,Killjoy,Omen,Jett"
Ascent,NovaCrew,Infiriumz Gaming GC,5,13,3,9,4,2,"Sova,Killjoy,Jett,KAY/O,Clove","Sova,Killjoy,Omen,Jett,KAY/O"
Sunset,New Combat Line GC,Legiowon Puff,13,4,9,3,1,4,"Breach,Raze,Cypher,Omen,Clove","Breach,Raze,Cypher,Omen,Deadlock"
Haven,XSOUL GC,Dasein Club GC,13,5,8,4,1,5,"Breach,Cypher,Sova,Omen,Jett","Breach,Cypher,Sova,Omen,Neon"
Haven,Malecient Parasside,Return of the Ashes,7,13,5,3,10,2,"Breach,Killjoy,Omen,Skye,Neon","Breach,Cypher,Sova,Omen,Neon"
Sunset,Sphinx GC,UC Esports,13,8,8,4,4,5,"Breach,Cypher,Omen,Neon,Fade","Breach,Raze,Cypher,Omen,Fade"
Ascent,XSOUL GC,Dasein Club GC,13,9,3,9,0,10,"Sova,Killjoy,Omen,Jett,KAY/O","Sova,Killjoy,Omen,Jett,KAY/O"
Sunset,TT GC,Deagle Ravagers,4,13,2,10,3,2,"Breach,Raze,Cypher,Sova,Omen","Breach,Raze,Cypher,Omen,Gekko"
Ascent,Sphinx GC,UC Esports,13,2,3,0,2,10,"Sova,Killjoy,Omen,Jett,KAY/O","Sova,Killjoy,Omen,Jett,KAY/O"
Ascent,Malecient Parasside,Return of the Ashes,13,15,4,10,5,9,"Sova,Killjoy,Omen,Jett,KAY/O","Breach,Raze,Cypher,Sova,Omen"
Lotus,TT GC,Deagle Ravagers,2,13,2,10,3,0,"Breach,Raze,Killjoy,Omen,Fade","Raze,Killjoy,Viper,Omen,Fade"
Lotus,XSOUL GC,Dasein Club GC,6,13,1,6,7,5,"Breach,Raze,Cypher,Omen,Fade","Breach,Cypher,Omen,Neon,Fade"
Haven,Requiem,Siko Esports,13,10,5,6,4,8,"Cypher,Sova,Omen,Yoru,Iso","Breach,Cypher,Sova,Omen,Jett"
Sunset,Requiem,Siko Esports,8,13,3,6,7,5,"Raze,Cypher,Omen,KAY/O,Gekko","Breach,Raze,Cypher,Sova,Omen"
Lotus,Requiem,Siko Esports,13,7,6,2,5,7,"Raze,Cypher,Viper,Omen,Fade","Raze,Killjoy,Viper,Omen,Fade"
Icebox,Requiem,Siko Esports,13,3,9,3,0,4,"Killjoy,Viper,Jett,KAY/O,Gekko","Sova,Killjoy,Viper,KAY/O,Clove"
Sunset,Trace Esports,EDward Gaming,10,13,2,10,3,8,"Breach,Raze,Cypher,Sova,Omen","Cypher,Sova,Omen,KAY/O,Neon"
Bind,Trace Esports,EDward Gaming,7,13,5,3,10,2,"Raze,Cypher,Brimstone,Skye,Deadlock","Raze,Viper,Brimstone,Fade,Gekko"
Haven,DRX,Sentinels,8,13,2,7,6,6,"Breach,Cypher,Sova,Omen,Jett","Breach,Cypher,Sova,Omen,Neon"
Sunset,DRX,Sentinels,13,15,7,7,8,6,"Breach,Cypher,Sova,Omen,Neon","Breach,Cypher,Omen,Neon,Fade"
Haven,Bon Bon Bum Contra GC,KS Esports GC,13,9,7,3,6,6,"Breach,Sova,Killjoy,Omen,Chamber","Breach,Sova,Killjoy,Omen,Jett"
Icebox,Bon Bon Bum Contra GC,KS Esports GC,8,13,4,5,8,4,"Sova,Killjoy,Reyna,Jett,Harbor","Sova,Killjoy,Viper,Jett,Gekko"
Haven,9z Team GC,FiRePOWER GC,13,6,8,4,2,5,"Breach,Cypher,Omen,Neon,Gekko","Breach,Sova,Killjoy,Omen,Neon"
Icebox,9z Team GC,FiRePOWER GC,13,9,5,5,4,8,"Killjoy,Viper,Jett,KAY/O,Gekko","Killjoy,Viper,Omen,KAY/O,Gekko"
Abyss,K7 Esports GC,FUSION X,9,13,7,5,8,2,"Breach,Cypher,Sova,Omen,Jett","Breach,Cypher,Omen,Jett,Gekko"
Haven,minions united GC,SaD FROST,11,13,8,4,9,3,"Breach,Sova,Killjoy,Omen,Jett","Sova,Killjoy,Omen,Jett,Iso"
Haven,K7 Esports GC,FUSION X,6,13,5,7,6,1,"Breach,Cypher,Sova,Omen,Jett","Cypher,Sova,Astra,Gekko,Iso"
Ascent,minions united GC,SaD FROST,2,13,2,10,3,0,"Sova,Killjoy,Omen,Jett,KAY/O","Sova,Killjoy,Omen,Jett,KAY/O"
Lotus,University War GC,KRÜ BLAZE,5,13,2,4,9,3,"Breach,Raze,Killjoy,Omen,Fade","Raze,Killjoy,Viper,Omen,Fade"
Ascent,University War GC,KRÜ BLAZE,2,13,2,10,3,0,"Sova,Killjoy,Omen,Jett,KAY/O","Sova,Killjoy,Omen,Jett,KAY/O"
Haven,spaceW,NAPOLYON,5,13,4,8,5,1,"Breach,Sova,Killjoy,Omen,Jett","Killjoy,Viper,Omen,Jett,Skye"
Ascent,Legion Nyx,Legiowon Puff,4,13,3,9,4,1,"Breach,Sova,Killjoy,Omen,Jett","Sova,Killjoy,Omen,Jett,KAY/O"
Bind,"Fenrir ""White"" E-Club",FEK ESPORTS GC,13,4,9,3,1,4,"Breach,Raze,Cypher,Brimstone,Deadlock","Breach,Raze,Viper,Omen,Gekko"
Icebox,Stay K'O,MOCHI,1,13,0,2,11,1,"Killjoy,Viper,Jett,KAY/O,Clove","Sova,Killjoy,Viper,Jett,Gekko"
Abyss,FIXAM,Azzy White,3,13,0,4,9,3,"Breach,Jett,Astra,Chamber,Gekko","Cypher,Sova,Omen,Jett,KAY/O"
Lotus,No Sweat Blossom,NovaCrew,13,3,3,1,2,10,"Breach,Killjoy,Omen,Neon,Iso","Cypher,Skye,Astra,Chamber,Gekko"
Lotus,Infiriumz Gaming GC,NTH,16,18,9,8,10,7,"Breach,Raze,Killjoy,Omen,Jett","Killjoy,Jett,Gekko,Iso,Clove"
Abyss,"Fenrir ""White"" E-Club",FEK ESPORTS GC,13,6,6,1,5,7,"Cypher,Sova,Omen,Jett,KAY/O","Sova,Viper,Jett,KAY/O,Harbor"
Bind,Legion Nyx,Legiowon Puff,8,13,2,10,3,6,"Breach,Raze,Cypher,Brimstone,Skye","Raze,Cypher,Viper,Brimstone,Skye"
Ascent,FIXAM,Azzy White,6,13,5,7,6,1,"Sova,Killjoy,Omen,Jett,KAY/O","Cypher,Sova,Omen,Jett,KAY/O"
Ascent,No Sweat Blossom,NovaCrew,13,2,12,0,2,1,"Cypher,Sova,Omen,Jett,Deadlock","Sova,Killjoy,Jett,KAY/O,Clove"
Bind,Stay K'O,MOCHI,13,15,10,4,11,3,"Brimstone,Skye,Yoru,Gekko,Clove","Raze,Viper,Brimstone,Fade,Gekko"
Haven,Infiriumz Gaming GC,NTH,1,13,1,1,12,0,"Breach,Sova,Killjoy,Omen,Neon","Raze,Sova,Killjoy,Reyna,Omen"
Ascent,Goon that jawn,SaD Purple,12,14,6,7,7,6,"Sova,Killjoy,Omen,Jett,Yoru","Sova,Killjoy,Omen,Jett,KAY/O"
Lotus,Deagle Ravagers,raised,13,9,4,6,3,9,"Raze,Killjoy,Viper,Omen,Fade","Breach,Raze,Killjoy,Omen,Neon"
Lotus,Goon that jawn,SaD Purple,9,13,3,7,6,6,"Breach,Killjoy,Omen,Neon,Fade","Breach,Raze,Cypher,Omen,Fade"
Haven,Deagle Ravagers,raised,13,7,6,2,5,7,"Breach,Sova,Killjoy,Omen,Jett","Cypher,Sova,Omen,Yoru,Iso"
Icebox,Dasein Club GC,Krows Corax,13,4,10,2,2,3,"Killjoy,Viper,Jett,KAY/O,Gekko","Sova,Viper,Jett,Harbor,Gekko"
Haven,Return of the Ashes,B Site Nova,13,5,5,1,4,8,"Breach,Cypher,Sova,Omen,Neon","Breach,Sova,Killjoy,Omen,Jett"
Icebox,Goon that jawn,SaD Purple,13,5,2,4,1,11,"Sova,Killjoy,Viper,Reyna,Jett","Sova,Killjoy,Viper,Reyna,Jett"
Abyss,Dasein Club GC,Krows Corax,13,10,11,1,9,2,"Cypher,Sova,Omen,Jett,Iso","Cypher,Sova,Jett,Astra,Gekko"
Abyss,Deagle Ravagers,raised,9,13,6,6,7,3,"Cypher,Sova,Omen,Jett,KAY/O","Breach,Omen,Jett,KAY/O,Neon"
Sunset,Return of the Ashes,B Site Nova,13,7,6,2,5,7,"Breach,Cypher,Omen,Neon,Gekko","Breach,Raze,Cypher,Omen,Gekko"
Icebox,SaD Purple,Burger Boyz 2.0,17,15,9,7,8,8,"Sova,Killjoy,Viper,Reyna,Jett","Sova,Killjoy,Viper,Jett,Gekko"
Ascent,Goon that jawn,MORBIDLY OBESE,13,9,5,7,2,8,"Sova,Killjoy,Omen,Jett,Yoru","Sova,Killjoy,Omen,Jett,KAY/O"
Ascent,BB Esports,Amanakomeow,1,13,0,2,11,1,"Cypher,Sova,Omen,Jett,KAY/O","Cypher,Sova,Omen,Jett,Deadlock"
Lotus,Goon that jawn,MORBIDLY OBESE,11,13,4,8,5,7,"Breach,Cypher,Neon,Fade,Clove","Raze,Killjoy,Omen,Fade,Gekko"
Lotus,SaD Purple,Burger Boyz 2.0,13,6,5,2,4,8,"Breach,Raze,Cypher,Omen,Fade","Breach,Raze,Cypher,Omen,Gekko"
Bind,BB Esports,Amanakomeow,10,13,6,6,7,4,"Raze,Viper,Brimstone,Fade,Gekko","Raze,Cypher,Brimstone,Skye,Deadlock"
Icebox,InTenZive,SZK Esports,10,13,4,8,5,6,"Sova,Killjoy,Viper,Jett,KAY/O","Sova,Killjoy,Viper,Jett,Iso"
Haven,Goon that jawn,MORBIDLY OBESE,13,9,9,3,6,4,"Breach,Sova,Killjoy,Omen,Yoru","Breach,Cypher,Sova,Omen,Jett"
Ascent,Vila das Flores,REVOADA,10,13,6,6,7,4,"Cypher,Sova,Phoenix,Omen,Jett","Sova,Killjoy,Omen,Jett,KAY/O"
Bind,SaD Purple,Burger Boyz 2.0,7,13,1,7,6,6,"Raze,Viper,Brimstone,Skye,Deadlock","Raze,Brimstone,Skye,Gekko,Deadlock"
Ascent,Amanakomeow,Hidden Horizon,13,3,9,3,0,4,"Cypher,Sova,Omen,Jett,Deadlock","Sova,Killjoy,Omen,Jett,KAY/O"
Sunset,BB Esports,Cognizant,15,13,4,10,3,11,"Breach,Cypher,Sova,Omen,Neon","Breach,Cypher,Sova,Omen,Neon"
Sunset,InTenZive,SZK Esports,7,13,1,7,6,6,"Raze,Cypher,Sova,Omen,Gekko","Breach,Raze,Cypher,Omen,Gekko"
Lotus,Vila das Flores,REVOADA,4,13,3,9,4,1,"Breach,Cypher,Omen,Neon,Fade","Raze,Killjoy,Viper,Skye,Clove"
Haven,Next In Line,BB Esports,10,13,4,7,6,6,"Breach,Cypher,Sova,Omen,Neon","Cypher,Sova,Omen,Jett,Iso"
Bind,Cognizant,EXO Clan,13,8,10,2,6,3,"Breach,Cypher,Brimstone,Neon,Gekko","Raze,Viper,Brimstone,Fade,Gekko"
Bind,Amanakomeow,Phantom Fury,13,11,10,2,9,3,"Raze,Cypher,Brimstone,Skye,Deadlock","Cypher,Brimstone,KAY/O,Neon,Gekko"
Sunset,InTenZive,Nexum EC,13,10,8,3,7,5,"Raze,Cypher,Sova,Omen,Gekko","Cypher,Sova,Omen,Jett,KAY/O"
Lotus,SZK Esports,INCOGNITO,13,2,10,2,0,3,"Breach,Raze,Killjoy,Omen,Fade","Breach,Cypher,Omen,Neon,Gekko"
Abyss,Vila das Flores,REVOADA,13,8,3,6,2,10,"Cypher,Sova,Omen,Jett,Harbor","Cypher,Sova,Reyna,Omen,Jett"
Bind,Nexum EC,STAKERS,13,5,11,1,4,2,"Raze,Omen,Skye,KAY/O,Clove","Breach,Raze,Cypher,Brimstone,Skye"
Abyss,INCOGNITO,Solar Flare,13,7,6,2,5,7,"Breach,Cypher,Sova,Omen,Jett","Cypher,Sova,Omen,Jett,Deadlock"
Haven,SZK Esports,GMBLERS Esports,13,5,3,3,2,10,"Breach,Sova,Killjoy,Omen,Jett","Breach,Sova,Killjoy,Omen,Jett"
Sunset,InTenZive,IAPEsports,13,6,9,3,3,4,"Raze,Cypher,Sova,Omen,Gekko","Breach,Raze,Cypher,Omen,Yoru"
Lotus,spaceW,MAU Academy,13,5,8,4,1,5,"Breach,Raze,Killjoy,Omen,Gekko","Raze,Killjoy,Viper,Omen,Fade"
Bind,Vila das Flores,REVOADA,8,13,5,7,6,3,"Viper,Brimstone,Yoru,Neon,Fade","Raze,Viper,Brimstone,Jett,Skye"
Haven,X1 Esports,NAPOLYON,8,13,2,7,6,6,"Breach,Cypher,Sova,Omen,Jett","Killjoy,Viper,Omen,Jett,Skye"
Sunset,TFT Demons,MAU Academy,7,13,4,4,9,3,"Breach,Raze,Cypher,Sova,Omen","Cypher,Sova,Omen,KAY/O,Neon"
Ascent,NEANLATIYONBOLM,spaceW,10,13,6,5,8,4,"Sova,Killjoy,Omen,Jett,Yoru","Breach,Sova,Killjoy,Omen,Jett"
Haven,Rulers Of Fate,NAPOLYON,4,13,3,9,4,1,"Breach,Sova,Killjoy,Omen,Jett","Killjoy,Viper,Omen,Jett,Skye"
Ascent,X1 Esports,aynenkankaondan,13,2,3,0,2,10,"Cypher,Sova,Omen,Jett,KAY/O","Sova,Killjoy,Omen,Jett,KAY/O"
Haven,Vila das Flores,REVOADA,13,7,6,6,1,7,"Breach,Cypher,Sova,Omen,Neon","Breach,Sova,Killjoy,Omen,Neon"
Sunset,FAV gaming,IGZIST,13,11,8,4,7,5,"Breach,Raze,Cypher,Sova,Omen","Breach,Cypher,Sova,Omen,Neon"
Abyss,The MongolZ,BC SWELL,13,10,5,6,4,8,"Cypher,Viper,Skye,Yoru,Astra","Sova,Killjoy,Viper,Yoru,Astra"
Ascent,FAV gaming,IGZIST,13,10,9,2,8,4,"Sova,Killjoy,Omen,Jett,KAY/O","Sova,Killjoy,Omen,Jett,KAY/O"
Sunset,esports team αD,The MongolZ,10,13,5,6,7,5,"Raze,Cypher,Sage,Omen,Fade","Breach,Cypher,Omen,Neon,Gekko"
Ascent,BC SWELL,RIP root,13,6,6,1,5,7,"Sova,Killjoy,Omen,Jett,KAY/O","Sova,Killjoy,Omen,Jett,KAY/O"
Haven,IGZIST,Slovo Yakuta,13,7,5,3,4,8,"Breach,Sova,Killjoy,Omen,Jett","Breach,Sova,Killjoy,Omen,Jett"
Lotus,EDward Gaming,Paper Rex,13,4,9,3,1,4,"Breach,Omen,Neon,Fade,Clove","Raze,Cypher,Omen,Jett,Skye"
Ascent,FAV gaming,WICKED,13,4,4,1,3,9,"Sova,Killjoy,Omen,Jett,KAY/O","Sova,Killjoy,Omen,Jett,KAY/O"
Sunset,SilhouetteS,FAV gaming,1,13,1,11,2,0,"Cypher,Sova,Omen,Jett,KAY/O","Breach,Raze,Cypher,Sova,Omen"
Abyss,BC SWELL,ゆぴお戦隊ゴレンジャー,13,3,4,0,3,9,"Sova,Killjoy,Viper,Yoru,Astra","Omen,Jett,KAY/O,Gekko,Deadlock"
Ascent,TeamDuration,IGZIST,3,13,3,9,4,0,"Sova,Killjoy,Omen,Jett,KAY/O","Sova,Killjoy,Omen,Jett,KAY/O"
Lotus,TRIDENT,Slovo Yakuta,5,13,2,4,9,3,"Breach,Raze,Killjoy,Omen,Fade","Breach,Killjoy,Jett,Gekko,Clove"
Sunset,RIP root,Vtuber,13,8,9,0,8,4,"Breach,Cypher,Sova,Omen,Neon","Breach,Cypher,Sova,Omen,Neon"
Sunset,WICKED,toshio,13,0,12,0,0,1,"Breach,Cypher,Sova,Omen,Neon","Cypher,Sova,Phoenix,Omen,Clove"
Abyss,The MongolZ,NIX EAST,13,5,5,1,4,8,"Cypher,Viper,Skye,Yoru,Astra","Viper,Sage,Omen,Skye,KAY/O"
Sunset,esports team αD,DragonGaming,13,6,10,2,4,3,"Raze,Cypher,Sage,Omen,Fade","Raze,Cypher,Sova,Omen,Gekko"
Sunset,EDward Gaming,Paper Rex,13,8,6,6,2,7,"Cypher,Sova,Omen,KAY/O,Neon","Breach,Raze,Sage,Omen,Gekko"
Icebox,EDward Gaming,Paper Rex,3,13,0,4,9,3,"Sova,Killjoy,Viper,Jett,KAY/O","Sova,Killjoy,Viper,Sage,Jett"
Sunset,Leviatán,Team Vitality,13,4,3,2,2,10,"Breach,Cypher,Sova,Omen,Neon","Cypher,Sova,Omen,KAY/O,Neon"
Icebox,Leviatán,Team Vitality,14,12,6,7,5,8,"Sova,Killjoy,Viper,Jett,Harbor","Sova,Killjoy,Viper,Jett,Gekko"
Sunset,Special Grade,MORBIDLY OBESE,6,13,4,8,5,2,"Breach,Raze,Cypher,Omen,Gekko","Breach,Raze,Cypher,Sova,Clove"
Ascent,Goon that jawn,Maryville University,13,5,8,4,1,5,"Sova,Killjoy,Omen,Jett,Yoru","Sova,Killjoy,Omen,Jett,KAY/O"
Bind,Special Grade,MORBIDLY OBESE,13,9,5,7,2,8,"Raze,Brimstone,Fade,Gekko,Deadlock","Raze,Viper,Brimstone,Yoru,Fade"
Bind,SaD Purple,Nightblood Gaming,13,7,9,3,4,4,"Raze,Viper,Brimstone,Skye,Deadlock","Raze,Brimstone,Skye,Gekko,Deadlock"
Icebox,Burger Boyz 2.0,LazerrFreeks Mythic,13,7,7,1,6,6,"Sova,Killjoy,Viper,Jett,Gekko","Sova,Killjoy,Viper,Reyna,Jett"
Lotus,Crack Babies,les piments,4,13,3,9,4,1,"Raze,Killjoy,Viper,Omen,Fade","Breach,Cypher,Omen,Neon,Fade"
Icebox,Crack Babies,les piments,7,13,5,7,6,2,"Sova,Viper,Sage,Reyna,Chamber","Sova,Killjoy,Viper,Reyna,Jett"
Ascent,Special Grade,MORBIDLY OBESE,9,13,2,8,5,7,"Cypher,Sova,Omen,Yoru,Deadlock","Sova,Killjoy,Omen,Jett,KAY/O"
Haven,Burger Boyz 2.0,LazerrFreeks Mythic,15,13,11,3,10,4,"Breach,Sova,Killjoy,Omen,Neon","Killjoy,Viper,Omen,Jett,Skye"
Lotus,SaD Purple,Nightblood Gaming,10,13,7,5,8,3,"Breach,Raze,Cypher,Omen,Fade","Breach,Cypher,Sova,Astra,Neon"
Haven,Goon that jawn,Maryville University,14,12,6,7,5,8,"Breach,Sova,Killjoy,Omen,Yoru","Breach,Cypher,Sova,Omen,Jett"
Sunset,SaD FROST,VO Blossoms,13,1,2,0,1,11,"Breach,Cypher,Neon,Gekko,Clove","Raze,Cypher,KAY/O,Gekko,Clove"
Lotus,Burger Boyz 2.0,LazerrFreeks Mythic,3,13,3,9,4,0,"Breach,Raze,Cypher,Omen,Gekko","Raze,Killjoy,Viper,Omen,Fade"
Lotus,FAT Opps,MORBIDLY OBESE,8,13,8,4,9,0,"Raze,Killjoy,Viper,Omen,Fade","Raze,Killjoy,Omen,Fade,Gekko"
Sunset,yolo,Crack Babies,18,20,10,9,11,8,"Breach,Raze,Cypher,Omen,Gekko","Breach,Raze,Cypher,Omen,Gekko"
Abyss,Goon that jawn,Maryville University,6,13,2,5,8,4,"Cypher,Sova,Reyna,Omen,Yoru","Sova,Viper,Omen,Yoru,Iso"
Ascent,SaD Purple,Nightblood Gaming,13,11,7,5,6,6,"Sova,Killjoy,Omen,Jett,KAY/O","Cypher,Sova,Omen,Yoru,Deadlock"
Ascent,Omnipotence,les piments,3,13,3,9,4,0,"Breach,Sova,Killjoy,Omen,KAY/O","Cypher,Sova,Omen,Jett,KAY/O"
Haven,SaD FROST,VO Blossoms,14,12,11,2,10,3,"Breach,Sova,Killjoy,Jett,Clove","Breach,Sova,Killjoy,Omen,Jett"
Icebox,ROSE,LazerrFreeks Mythic,8,13,3,6,7,5,"Killjoy,Viper,Sage,Jett,Gekko","Sova,Killjoy,Viper,Reyna,Jett"
Lotus,yolo,Lotus 8 Purple,13,6,5,2,4,8,"Breach,Raze,Cypher,Omen,Gekko","Breach,Raze,Cypher,Omen,Gekko"
Ascent,FAT Opps,MORBIDLY OBESE,13,15,7,7,8,6,"Sova,Killjoy,Omen,Jett,KAY/O","Sova,Killjoy,Omen,Jett,KAY/O"
Haven,Goon that jawn,Deleta Esports,13,5,3,3,2,10,"Breach,Sova,Killjoy,Omen,Yoru","Sova,Killjoy,Reyna,Jett,Clove"
Haven,PR ESPORTS,Crack Babies,9,13,4,8,5,5,"Breach,Sova,Killjoy,Omen,Jett","Breach,Sova,Killjoy,Omen,Jett"
Bind,Fast Food Workers,Maryville University,10,13,4,8,5,6,"Raze,Cypher,Viper,Brimstone,Skye","Raze,Cypher,Viper,Brimstone,Skye"
Ascent,les piments,twobits money crew,13,8,7,2,6,6,"Sova,Killjoy,Reyna,Omen,Jett","Sova,Killjoy,Omen,Jett,KAY/O"
Abyss,Omnipotence,OutGoing Esports,13,7,6,2,5,7,"Breach,Sova,Killjoy,Omen,Jett","Breach,Cypher,Sova,Omen,Jett"
Haven,ROSE,LazerrFreeks Mythic,7,13,2,6,7,5,"Breach,Sova,Killjoy,Omen,Jett","Killjoy,Viper,Omen,Jett,Skye"
Icebox,Asians and Skuba,Nightblood Gaming,11,13,7,5,8,4,"Sova,Killjoy,Viper,Reyna,Jett","Sova,Killjoy,Viper,Omen,Iso"
Lotus,SaD Purple,Last Resistance,13,5,9,3,2,4,"Breach,Raze,Cypher,Omen,Fade","Breach,Cypher,Neon,Fade,Clove"
Sunset,Br0cken BOis,les piments,2,13,1,11,2,1,"Cypher,Sova,Omen,KAY/O,Neon","Raze,Cypher,Sova,Omen,Gekko"
Bind,Goon that jawn,Deleta Esports,13,10,5,6,4,8,"Raze,Viper,Yoru,Fade,Clove","Raze,Cypher,Brimstone,Skye,Gekko"
Bind,Clemson Esports,yolo,11,13,6,6,7,5,"Raze,Viper,Brimstone,Skye,Yoru","Raze,Cypher,Viper,Brimstone,Skye"
Ascent,The Outcasts,PR ESPORTS,2,13,0,3,10,2,"Cypher,Sova,Phoenix,Omen,Jett","Sova,Killjoy,Omen,Jett,KAY/O"
Ascent,Fast Food Workers,Maryville University,13,5,8,4,1,5,"Cypher,Sova,Omen,Jett,Deadlock","Sova,Killjoy,Omen,Jett,KAY/O"
Haven,washed players,Crack Babies,3,13,2,10,3,1,"Breach,Sova,Killjoy,Omen,Jett","Breach,Sova,Killjoy,Omen,Jett"
Haven,FAT Opps,MORBIDLY OBESE,13,11,9,3,8,4,"Killjoy,Viper,Omen,Jett,Skye","Breach,Cypher,Sova,Omen,Jett"
Haven,Burger Boyz 2.0,Nearest Airport,13,8,8,1,7,5,"Breach,Sova,Killjoy,Omen,Neon","Breach,Cypher,Sova,Omen,Neon"
Bind,REVOADA,Team Leveling,13,10,7,4,6,6,"Raze,Jett,Skye,Chamber,Clove","Raze,Viper,Brimstone,Skye,Gekko"
Icebox,Special Grade,LoungeLizardWW,13,8,6,6,2,7,"Sova,Killjoy,Viper,Jett,Gekko","Sova,Killjoy,Viper,Reyna,Jett"
Ascent,Nephillium BLACK,Omnipotence,6,13,1,6,7,5,"Sova,Killjoy,Omen,Jett,Fade","Breach,Sova,Killjoy,Omen,KAY/O"
Icebox,SaD Purple,Last Resistance,13,7,8,0,7,5,"Sova,Killjoy,Viper,Reyna,Jett","Sova,Viper,Reyna,Jett,Deadlock"
Ascent,Acrylic eSports,Lotus 8 Purple,6,13,2,10,3,4,"Killjoy,Viper,Omen,Jett,Skye","Sova,Killjoy,Omen,Jett,KAY/O"
Sunset,LazerrFreeks Mythic,Cuddle Gang,13,8,6,3,5,7,"Breach,Raze,Cypher,Omen,Fade","Breach,Raze,Cypher,Sova,Omen"
Sunset,Asians and Skuba,Nightblood Gaming,12,14,8,5,9,4,"Breach,Raze,Cypher,Sova,Omen","Breach,Cypher,Sova,Omen,Neon"
Sunset,Fast Food Workers,Maryville University,8,13,5,4,9,3,"Breach,Raze,Cypher,Omen,Gekko","Breach,Raze,Cypher,Sova,Omen"
Ascent,OutGoing Esports,The Side Homies,13,3,10,2,1,3,"Sova,Killjoy,Omen,Jett,KAY/O","Raze,Killjoy,Omen,Jett,Gekko"
Haven,twobits money crew,Bigsteppas,13,0,1,0,0,12,"Breach,Cypher,Sova,Omen,Jett","Cypher,Reyna,Omen,Neon,Gekko"
Abyss,Burger Boyz 2.0,Nearest Airport,13,8,6,3,5,7,"Breach,Cypher,Sova,Omen,Yoru","Cypher,Sova,Omen,Jett,Harbor"
Sunset,Special Grade,LoungeLizardWW,13,6,3,4,2,10,"Breach,Raze,Cypher,Omen,Gekko","Breach,Raze,Cypher,Omen,Gekko"
Icebox,Deleta Esports,Jawns IV,13,10,8,4,6,5,"Sova,Killjoy,Viper,Reyna,Jett","Sova,Killjoy,Viper,Gekko,Iso"
Abyss,REVOADA,Team Leveling,13,7,8,4,3,5,"Cypher,Sova,Reyna,Omen,Jett","Breach,Omen,KAY/O,Neon,Deadlock"
Lotus,FAT Opps,4star,13,9,6,6,3,7,"Raze,Killjoy,Viper,Omen,Fade","Raze,Cypher,Fade,Gekko,Clove"
Lotus,Goon that jawn,Raven Esports,13,6,10,2,4,3,"Breach,Cypher,Neon,Fade,Clove","Breach,Raze,Cypher,Omen,Fade"
Lotus,ENVEE YSL,Last Resistance,13,8,7,2,6,6,"Breach,Cypher,Neon,Fade,Clove","Raze,Omen,Fade,Deadlock,Clove"
Ascent,Fast Food Workers,English or Spanish,13,2,10,2,0,3,"Cypher,Sova,Omen,Jett,Deadlock","Sova,Killjoy,Omen,Jett,KAY/O"
Lotus,LazerrFreeks Mythic,Cuddle Gang,10,13,10,2,11,0,"Raze,Killjoy,Viper,Omen,Fade","Raze,Killjoy,Omen,Fade,Gekko"
Haven,ROSE,Team Digital,13,9,9,1,8,4,"Sova,Killjoy,Omen,Yoru,Neon","Breach,Sova,Killjoy,Omen,Jett"
Haven,Dexterity Gaming,Nearest Airport,5,13,1,5,8,4,"Breach,Sova,Killjoy,Omen,Jett","Breach,Sova,Omen,Chamber,Neon"
Haven,Asians and Skuba,Lionheart eSports,13,4,8,4,0,5,"Breach,Cypher,Sova,Omen,Jett","Sova,Killjoy,Viper,Omen,Yoru"
Lotus,Deleta Esports,Jawns IV,13,7,8,4,3,5,"Raze,Killjoy,Jett,Gekko,Clove","Raze,Killjoy,Viper,Omen,Fade"
Icebox,SaD Purple,Forsaken Shadows,14,12,7,6,6,7,"Sova,Killjoy,Viper,Jett,Iso","Sova,Killjoy,Viper,Reyna,Jett"
Lotus,LoungeLizardWW,Moon (NA),13,4,10,2,2,3,"Raze,Cypher,Omen,Fade,Gekko","Raze,Killjoy,Viper,Omen,Fade"
Ascent,MORBIDLY OBESE,Fargo North Dakota,13,11,4,8,3,9,"Sova,Killjoy,Omen,Jett,KAY/O","Cypher,Sova,Omen,Jett,Iso"
Abyss,Maryville University,Emma's Bakas,13,1,11,1,0,2,"Sova,Viper,Omen,Yoru,Iso","Breach,Raze,Cypher,Astra,Iso"
Lotus,Nightblood Gaming,Heavenly Sword Sect,13,8,3,6,2,10,"Breach,Cypher,Sova,Astra,Neon","Raze,Killjoy,Yoru,Gekko,Clove"
Bind,FAT Opps,4star,11,13,5,7,6,6,"Raze,Viper,Brimstone,Skye,Gekko","Raze,Viper,Brimstone,Fade,Gekko"
Bind,Special Grade,ABG luvrs,13,1,11,1,0,2,"Raze,Brimstone,Fade,Gekko,Deadlock","Raze,Viper,Brimstone,Reyna,Skye"
Haven,Goon that jawn,Raven Esports,13,7,7,5,2,6,"Breach,Sova,Killjoy,Omen,Yoru","Sova,Killjoy,Viper,Phoenix,Omen"
Bind,Burger Boyz 2.0,Harmony,13,6,10,2,4,3,"Raze,Brimstone,Skye,Gekko,Deadlock","Raze,Cypher,Brimstone,Skye,Deadlock"
Icebox,REVOADA,Team Leveling,11,13,9,3,10,2,"Sova,Killjoy,Viper,Jett,Gekko","Killjoy,Viper,KAY/O,Gekko,Iso"
Haven,Fast Food Workers,English or Spanish,14,12,10,3,9,4,"Breach,Sova,Killjoy,Omen,Jett","Breach,Cypher,Sova,Omen,Jett"
Lotus,Asians and Skuba,Lionheart eSports,13,8,8,4,4,5,"Breach,Cypher,Omen,Neon,Gekko","Raze,Killjoy,Viper,Omen,Fade"
Sunset,Maryville University,Emma's Bakas,13,3,4,0,3,9,"Breach,Raze,Cypher,Sova,Omen","Breach,Raze,Cypher,Deadlock,Clove"
Haven,Deleta Esports,Jawns IV,10,13,4,8,5,6,"Cypher,Sova,Phoenix,Omen,Jett","Breach,Sova,Killjoy,Omen,Jett"
Bind,Dexterity Gaming,Nearest Airport,8,13,7,5,8,1,"Raze,Brimstone,Skye,Yoru,Harbor","Raze,Cypher,Omen,Yoru,Deadlock"
Abyss,SaD Purple,Forsaken Shadows,13,8,7,5,3,6,"Cypher,Sova,Omen,Jett,Yoru","Cypher,Sova,Jett,Astra,Gekko"
Haven,LazerrFreeks Mythic,Cuddle Gang,13,11,6,6,5,7,"Killjoy,Viper,Omen,Jett,Skye","Breach,Sova,Killjoy,Omen,Jett"
Haven,MORBIDLY OBESE,Fargo North Dakota,13,8,8,1,7,5,"Breach,Cypher,Sova,Omen,Jett","Sova,Killjoy,Reyna,Omen,Jett"
Ascent,Nightblood Gaming,Heavenly Sword Sect,13,3,3,1,2,10,"Cypher,Sova,Omen,Yoru,Deadlock","Sova,Killjoy,Jett,KAY/O,Clove"
Abyss,ROSE,Team Digital,13,11,7,5,6,6,"Cypher,Sova,Jett,Astra,Deadlock","Cypher,Sova,Omen,Jett,KAY/O"
Haven,Special Grade,ABG luvrs,13,3,3,1,2,10,"Sova,Jett,Astra,Deadlock,Iso","Cypher,Sova,Phoenix,Omen,Jett"
Haven,ENVEE YSL,Last Resistance,18,16,7,10,6,11,"Killjoy,Viper,Omen,Jett,Skye","Cypher,Sova,Omen,Yoru,Iso"
Bind,LoungeLizardWW,Moon (NA),13,11,8,4,7,5,"Raze,Cypher,Brimstone,Yoru,Gekko","Raze,Viper,Brimstone,Fade,Gekko"
Haven,FAT Opps,4star,13,10,4,7,3,9,"Killjoy,Viper,Omen,Jett,Skye","Cypher,Sova,Reyna,Omen,Jett"
Haven,Burger Boyz 2.0,Harmony,13,2,10,2,0,3,"Breach,Sova,Killjoy,Omen,Neon","Breach,Sova,Killjoy,Omen,Neon"
Ascent,Nexum EC,SZK Esports,13,11,6,6,5,7,"Breach,Omen,Neon,Fade,Deadlock","Sova,Killjoy,Omen,Jett,KAY/O"
Ascent,bazinga esports,KHORE GAMING,13,7,5,3,4,8,"Sova,Killjoy,Omen,Jett,KAY/O","Sova,Killjoy,Omen,Jett,KAY/O"
Ascent,GMBLERS Esports,Solar Flare,4,13,1,4,9,3,"Sova,Killjoy,Omen,Jett,KAY/O","Sova,Killjoy,Omen,Jett,KAY/O"
Ascent,InTenZive,IAPEsports,7,13,2,10,3,5,"Sova,Killjoy,Omen,Jett,KAY/O","Cypher,Sova,Omen,Jett,Deadlock"
Ascent,INCOGNITO,Zeniths,13,6,6,1,5,7,"Cypher,Sova,Reyna,Omen,Jett","Sova,Killjoy,Omen,Jett,KAY/O"
Lotus,TBS GC,Vila das Flores,5,13,4,8,5,1,"Breach,Cypher,Omen,Neon,Fade","Breach,Cypher,Omen,Neon,Fade"
Bind,TBS GC,Vila das Flores,5,13,2,4,9,3,"Viper,Brimstone,Neon,Fade,Gekko","Viper,Brimstone,Yoru,Neon,Fade"
Lotus,FNATIC,KRÜ Esports,13,5,5,1,4,8,"Raze,Killjoy,Viper,Omen,Fade","Raze,Killjoy,Viper,Omen,Fade"
Haven,FNATIC,KRÜ Esports,13,9,7,3,6,6,"Cypher,Sova,Omen,Yoru,Iso","Breach,Cypher,Sova,Omen,Neon"
Sunset,FNATIC,KRÜ Esports,11,13,7,5,8,4,"Breach,Raze,Cypher,Sova,Astra","Breach,Cypher,Sova,Omen,Neon"
Icebox,Gen.G Esports,Sentinels,6,13,5,7,6,1,"Killjoy,Viper,Jett,KAY/O,Gekko","Sova,Killjoy,Viper,Jett,KAY/O"
Lotus,Gen.G Esports,Sentinels,9,13,4,6,7,5,"Raze,Killjoy,Viper,Omen,Fade","Raze,Killjoy,Viper,Omen,Fade"
Bind,Cuddle Gang,Bolton Esports,13,9,3,9,0,10,"Raze,Cypher,Brimstone,Skye,Fade","Raze,Cypher,Brimstone,Reyna,Gekko"
Icebox,English or Spanish,Ball Knowers,13,9,5,7,2,8,"Sova,Killjoy,Viper,Jett,KAY/O","Sova,Killjoy,Viper,Jett,Gekko"
Sunset,Lionheart eSports,Kraken,13,9,6,6,3,7,"Breach,Cypher,Sova,Omen,Neon","Breach,Raze,Cypher,Omen,Gekko"
Icebox,demeanorfps,Nearest Airport,11,13,5,7,6,6,"Sova,Killjoy,Viper,Jett,Clove","Sova,Killjoy,Viper,Reyna,Jett"
Ascent,Cuddle Gang,Bolton Esports,13,5,8,4,1,5,"Sova,Killjoy,Omen,Jett,Deadlock","Cypher,Sova,Omen,Jett,Deadlock"
Sunset,Heavenly Sword Sect,Astane Anarchy,13,11,6,6,5,7,"Raze,Cypher,Omen,KAY/O,Gekko","Breach,Raze,Cypher,Omen,Fade"
Haven,English or Spanish,Ball Knowers,13,2,10,2,0,3,"Breach,Cypher,Sova,Omen,Jett","Cypher,Sova,Reyna,Omen,Jett"
Abyss,Good Career,Moon (NA),6,13,3,4,9,3,"Cypher,Sova,Omen,Jett,KAY/O","Breach,Sova,Viper,Omen,Jett"
Haven,Team Digital,El Dorado,13,4,9,3,1,4,"Breach,Sova,Killjoy,Omen,Jett","Breach,Cypher,Sova,Omen,Neon"
Ascent,SeanGares' Kittens,Last Resistance,6,13,4,8,5,2,"Sova,Killjoy,Omen,Jett,KAY/O","Cypher,Sova,Omen,Yoru,Fade"
Ascent,Raven Esports,Prospects Hitmen,13,11,6,6,5,7,"Sova,Killjoy,Omen,Jett,KAY/O","Sova,Killjoy,Omen,Jett,KAY/O"
Bind,Emma's Bakas,Spate Esports,13,5,5,1,4,8,"Raze,Viper,Brimstone,Jett,Skye","Raze,Viper,Yoru,Gekko,Clove"
Bind,Event Horizon,Forsaken Shadows,6,13,2,5,8,4,"Raze,Viper,Brimstone,Fade,Gekko","Raze,Cypher,Brimstone,Yoru,Fade"
Icebox,Jawns IV,Fhouse,13,5,11,1,4,2,"Sova,Killjoy,Viper,Gekko,Iso","Sova,Killjoy,Viper,Reyna,Jett"
Abyss,Lionheart eSports,Kraken,13,9,6,4,5,7,"Cypher,Sova,Viper,Omen,Yoru","Cypher,Sova,Omen,Jett,Harbor"
Abyss,demeanorfps,Nearest Airport,11,13,6,6,7,5,"Breach,Cypher,Jett,Astra,Gekko","Cypher,Sova,Omen,Jett,Harbor"
Icebox,Heavenly Sword Sect,Astane Anarchy,13,8,6,3,5,7,"Sova,Killjoy,Viper,Jett,Iso","Sova,Killjoy,Viper,Sage,Reyna"
Ascent,Mickey Masters,Bedwars Lions,13,5,5,1,4,8,"Sova,Killjoy,Reyna,Omen,Jett","Sova,Killjoy,Omen,Jett,KAY/O"
Haven,MORBIDLY OBESE,Cuddle Gang,14,12,6,7,5,8,"Breach,Cypher,Sova,Omen,Jett","Breach,Sova,Killjoy,Omen,Jett"
Lotus,ABG luvrs,CCG Esports,13,2,10,2,0,3,"Breach,Killjoy,Omen,Yoru,Gekko","Breach,Cypher,Neon,Gekko,Clove"
Icebox,SeanGares' Kittens,Last Resistance,8,13,3,6,7,5,"Sova,Killjoy,Viper,Jett,KAY/O","Sova,Viper,Reyna,Jett,Deadlock"
Ascent,Team Digital,El Dorado,13,6,7,5,1,6,"Sova,Killjoy,Omen,Jett,KAY/O","Cypher,Sova,Omen,Jett,Deadlock"
Lotus,Fargo North Dakota,Asura Onyx,13,11,7,5,6,6,"Killjoy,Reyna,Omen,Neon,Fade","Reyna,Chamber,Fade,Iso,Clove"
Haven,Bolton Esports,Somali Pirates,13,10,3,9,1,10,"Breach,Cypher,Sova,Omen,Jett","Breach,Sova,Killjoy,Omen,Jett"
Bind,Good Career,Moon (NA),11,13,3,9,4,8,"Raze,Brimstone,Skye,Gekko,Deadlock","Raze,Viper,Brimstone,Fade,Gekko"
Icebox,Event Horizon,Forsaken Shadows,8,13,5,7,6,3,"Killjoy,Viper,Jett,KAY/O,Gekko","Sova,Killjoy,Viper,Reyna,Jett"
Haven,Jawns IV,Fhouse,13,6,7,5,1,6,"Breach,Sova,Killjoy,Omen,Jett","Breach,Cypher,Sova,Omen,Jett"
Sunset,Emma's Bakas,Spate Esports,13,9,7,5,4,6,"Breach,Raze,Cypher,Deadlock,Clove","Breach,Raze,Phoenix,Omen,Deadlock"
Haven,Raven Esports,Prospects Hitmen,13,15,9,5,10,4,"Sova,Killjoy,Viper,Yoru,Harbor","Killjoy,Viper,Omen,Jett,Skye"
Lotus,VO Blossoms,ColdHearts GC,13,5,3,3,2,10,"Raze,Killjoy,Omen,Fade,Gekko","Raze,Cypher,Omen,Skye,Deadlock"
Haven,Fargo North Dakota,Asura Onyx,13,4,9,3,1,4,"Sova,Killjoy,Reyna,Omen,Jett","Cypher,Sova,Omen,Yoru,Iso"
Ascent,Ball Knowers,Scarlet Knights Black,19,17,7,11,6,12,"Sova,Killjoy,Omen,Jett,KAY/O","Sova,Killjoy,Omen,Jett,KAY/O"
Ascent,MORBIDLY OBESE,Cuddle Gang,5,13,3,3,10,2,"Sova,Killjoy,Omen,Jett,KAY/O","Sova,Killjoy,Omen,Jett,Deadlock"
Ascent,Team Atlantis,Harmony,10,13,5,7,6,5,"Cypher,Sova,Omen,Jett,KAY/O","Cypher,Sova,Omen,Jett,Deadlock"
Haven,ABG luvrs,CCG Esports,13,6,7,5,1,6,"Cypher,Sova,Phoenix,Omen,Jett","Killjoy,Viper,Omen,Jett,Skye"
Sunset,Full Sail Armada,Kraken,7,13,3,5,8,4,"Cypher,Sova,Jett,Gekko,Clove","Breach,Raze,Cypher,Omen,Gekko"
Sunset,Maryville University,Heavenly Sword Sect,13,8,5,7,1,8,"Breach,Raze,Cypher,Sova,Omen","Raze,Cypher,Sova,Omen,KAY/O"
Ascent,demeanorfps,LoungeLizardWW,11,13,4,8,5,7,"Cypher,Sova,Omen,Jett,KAY/O","Cypher,Sova,Omen,Jett,KAY/O"
Lotus,Bolton Esports,Somali Pirates,3,13,3,9,4,0,"Breach,Killjoy,Omen,Neon,Gekko","Breach,Raze,Killjoy,Omen,Fade"
Haven,Mickey Masters,Bedwars Lions,11,13,6,6,7,5,"Breach,Sova,Killjoy,Omen,Jett","Killjoy,Viper,Omen,Jett,Skye"
Bind,SaD FROST,Charmers GC,13,6,8,4,2,5,"Raze,Cypher,Yoru,Fade,Clove","Raze,Viper,Brimstone,Skye,Gekko"
Bind,Raven Esports,Prospects Hitmen,13,4,3,2,2,10,"Raze,Cypher,Viper,Brimstone,Skye","Raze,Cypher,Brimstone,Skye,Gekko"
Lotus,4star,Whiff Nation,13,4,3,2,2,10,"Raze,Cypher,Fade,Gekko,Clove","Raze,Killjoy,Viper,Omen,Gekko"
Bind,Nightblood Gaming,Emma's Bakas,13,6,6,1,5,7,"Raze,Brimstone,Skye,Gekko,Deadlock","Raze,Viper,Skye,Deadlock,Clove"
Sunset,Event Horizon Red,Forsaken Shadows,7,13,3,5,8,4,"Breach,Raze,Cypher,Omen,Gekko","Raze,Cypher,Omen,Gekko,Iso"
Lotus,99 Stealers,Last Resistance,9,13,7,5,8,2,"Breach,Raze,Cypher,Omen,Fade","Breach,Cypher,Neon,Fade,Clove"
Ascent,El Dorado,The Bees Knees,14,12,4,9,3,10,"Cypher,Sova,Omen,Jett,Deadlock","Cypher,Sova,Reyna,Omen,Jett"
Bind,COPPER BLUE OVALS,Moon (NA),11,13,5,7,6,6,"Raze,Viper,Astra,Fade,Gekko","Raze,Viper,Brimstone,Fade,Gekko"
Icebox,SeanGares' Kittens,Deleta Esports,10,13,4,7,6,6,"Sova,Killjoy,Viper,Jett,KAY/O","Sova,Killjoy,Viper,Reyna,Jett"
Bind,CHURCH OF CHAEWON KIM,Nearest Airport,10,13,5,6,7,5,"Raze,Viper,Brimstone,Fade,Gekko","Raze,Cypher,Omen,Yoru,Deadlock"
Abyss,Mickey Masters,Bedwars Lions,13,2,3,0,2,10,"Raze,Cypher,Sova,Jett,Astra","Sova,Killjoy,Viper,Yoru,Astra"
Sunset,Team Atlantis,Harmony,3,13,0,4,9,3,"Raze,Cypher,Neon,Gekko,Clove","Breach,Cypher,Sova,Omen,Neon"
Haven,VO Blossoms,ColdHearts GC,13,9,7,3,6,6,"Breach,Sova,Killjoy,Omen,Jett","Breach,Sova,Omen,Jett,Chamber"
Sunset,Jawns IV,ENVEE YSL,10,13,5,6,7,5,"Breach,Raze,Sage,Omen,Gekko","Breach,Raze,Cypher,Omen,Fade"
Sunset,Fargo North Dakota,LazerrFreeks Mythic,7,13,5,7,6,2,"Breach,Raze,Cypher,Sova,Omen","Breach,Raze,Cypher,Omen,Fade"
Bind,Fast Food Workers,Lionheart eSports,13,6,4,3,3,9,"Raze,Cypher,Omen,Gekko,Deadlock","Raze,Reyna,Skye,Deadlock,Clove"
Icebox,SaD FROST,Charmers GC,13,1,11,1,0,2,"Sova,Killjoy,Viper,Reyna,Jett","Sova,Killjoy,Viper,Jett,Gekko"
Ascent,4star,Whiff Nation,13,2,3,0,2,10,"Cypher,Sova,Omen,Jett,Deadlock","Cypher,Sova,Omen,Jett,Deadlock"
Lotus,MORBIDLY OBESE,Cuddle Gang,13,6,5,2,4,8,"Raze,Cypher,Omen,Fade,Gekko","Breach,Raze,Killjoy,Omen,Fade"
Ascent,Bolton Esports,Somali Pirates,13,8,6,6,2,7,"Cypher,Sova,Omen,Jett,Deadlock","Sova,Killjoy,Omen,Jett,KAY/O"
Ascent,Full Sail Armada,Kraken,13,10,9,2,8,4,"Breach,Cypher,Sova,Jett,Clove","Cypher,Sova,Omen,Jett,Deadlock"
Haven,Dexterity Gaming,Good Career,13,8,8,4,4,5,"Breach,Sova,Killjoy,Omen,Jett","Breach,Sova,Killjoy,Omen,Jett"
Ascent,ABG luvrs,CCG Esports,9,13,5,5,8,4,"Cypher,Sova,Omen,Yoru,Deadlock","Sova,Killjoy,Omen,Jett,KAY/O"
Icebox,Ball Knowers,Scarlet Knights Black,13,11,7,5,6,6,"Sova,Killjoy,Viper,Jett,Gekko","Sova,Killjoy,Viper,Harbor,Deadlock"
Bind,Asians and Skuba,English or Spanish,13,7,9,3,4,4,"Raze,Viper,Brimstone,Fade,Gekko","Raze,Viper,Brimstone,Skye,Deadlock"
Bind,Malevolent Kitchen,Prospects Hitmen,7,13,2,6,7,5,"Raze,Cypher,Brimstone,Skye,Gekko","Raze,Cypher,Brimstone,Skye,Gekko"
Lotus,demeanorfps,LoungeLizardWW,9,13,7,5,8,2,"Breach,Raze,Cypher,Omen,Gekko","Raze,Cypher,Omen,Fade,Gekko"
Bind,Rice Bowl,Asura Onyx,7,13,3,5,8,4,"Raze,Viper,Brimstone,Skye,Gekko","Raze,Viper,Skye,Fade,Clove"
Sunset,Astane Anarchy,RECR,13,8,9,3,5,4,"Breach,Raze,Cypher,Omen,Fade","Raze,Cypher,Omen,KAY/O,Gekko"
Sunset,CHURCH OF CHAEWON KIM,Nearest Airport,4,13,1,4,9,3,"Breach,Raze,Cypher,Omen,Gekko","Breach,Raze,Cypher,Omen,Gekko"
Ascent,Special Grade,Harmony,13,1,11,1,0,2,"Cypher,Sova,Omen,Yoru,Deadlock","Cypher,Sova,Omen,Jett,Deadlock"
Haven,CB,Spate Esports,4,13,1,11,2,3,"Breach,Sova,Killjoy,Omen,Jett","Breach,Cypher,Sova,Neon,Clove"
Ascent,Jawns IV,ENVEE YSL,1,13,1,11,2,0,"Cypher,Sova,Omen,Yoru,Deadlock","Sova,Killjoy,Omen,Jett,KAY/O"
Haven,Maryville University,Heavenly Sword Sect,14,16,10,5,11,4,"Breach,Sova,Killjoy,Omen,Jett","Cypher,Sova,Omen,Yoru,Iso"
Haven,COPPER BLUE OVALS,Moon (NA),13,9,6,4,5,7,"Breach,Cypher,Sova,Omen,Jett","Breach,Sova,Killjoy,Omen,Jett"
Bind,Event Horizon Red,Forsaken Shadows,13,10,5,6,4,8,"Viper,Brimstone,Jett,Skye,Gekko","Raze,Cypher,Sova,Brimstone,Yoru"
Abyss,Fast Food Workers,Lionheart eSports,13,4,3,2,2,10,"Sova,Omen,Jett,Yoru,Chamber","Sova,Killjoy,Viper,Omen,Yoru"
Sunset,Nightblood Gaming,Emma's Bakas,14,16,3,12,4,11,"Breach,Cypher,Sova,Omen,Neon","Breach,Raze,Cypher,Deadlock,Clove"
Icebox,El Dorado,The Bees Knees,10,13,6,5,8,4,"Sova,Killjoy,Viper,Reyna,Jett","Raze,Sova,Killjoy,Viper,Reyna"
Haven,Full Sail Armada,Kraken,2,13,1,11,2,1,"Breach,Sova,Jett,Yoru,Astra","Killjoy,Viper,Omen,Jett,Skye"
Icebox,99 Stealers,Last Resistance,14,16,8,7,9,6,"Sova,Killjoy,Viper,Jett,Gekko","Sova,Viper,Reyna,Jett,Deadlock"
Lotus,SeanGares' Kittens,Deleta Esports,14,16,8,7,9,6,"Reyna,Astra,Harbor,Gekko,Clove","Raze,Killjoy,Jett,Gekko,Clove"
Icebox,Fargo North Dakota,LazerrFreeks Mythic,10,13,6,5,8,4,"Sova,Killjoy,Viper,Jett,KAY/O","Sova,Killjoy,Viper,Reyna,Jett"
Haven,Mickey Masters,Paranoia Boys,14,12,6,7,5,8,"Breach,Sova,Killjoy,Omen,Jett","Breach,Cypher,Sova,Omen,Jett"
Haven,Goon that jawn,Event Horizon,13,10,8,4,6,5,"Breach,Cypher,Sova,Omen,Yoru","Breach,Sova,Killjoy,Omen,Jett"
Lotus,SaD Purple,Raven Esports,13,11,8,4,7,5,"Raze,Viper,Omen,Fade,Deadlock","Breach,Raze,Cypher,Omen,Fade"
Haven,Team Atlantis,bricknodes,13,6,5,2,4,8,"Breach,Cypher,Omen,Jett,Deadlock","Breach,Sova,Killjoy,Omen,Jett"
Icebox,Fhouse,Lotus 8 Purple,13,6,4,3,3,9,"Sova,Killjoy,Viper,Reyna,Jett","Sova,Killjoy,Viper,Sage,Jett"
Ascent,FAT Opps,Team Digital,13,3,3,1,2,10,"Sova,Killjoy,Omen,Jett,KAY/O","Sova,Killjoy,Omen,Jett,KAY/O"
Haven,Endear Eclipse,Whiff Nation,10,13,5,6,7,5,"Breach,Cypher,Sova,Omen,Yoru","Breach,Cypher,Sova,Omen,Jett"
Haven,Asians and Skuba,English or Spanish,13,10,7,5,5,6,"Breach,Sova,Killjoy,Omen,Jett","Breach,Cypher,Sova,Omen,Jett"
Icebox,Dexterity Gaming,Good Career,8,13,5,7,6,3,"Sova,Killjoy,Viper,Jett,Gekko","Sova,Killjoy,Viper,Reyna,Jett"
Icebox,Clemson Esports,Bedwars Lions,5,13,3,3,10,2,"Sova,Killjoy,Viper,Jett,Harbor","Killjoy,Viper,Jett,KAY/O,Gekko"
Haven,Malevolent Kitchen,Prospects Hitmen,9,13,9,3,10,0,"Breach,Cypher,Sova,Omen,Jett","Killjoy,Viper,Omen,Jett,Skye"
Ascent,VO Blossoms,ColdHearts GC,7,13,4,8,5,3,"Sova,Killjoy,Jett,KAY/O,Clove","Sova,Killjoy,Phoenix,Omen,Jett"
Haven,Ball Knowers,Scarlet Knights Black,11,13,6,6,7,5,"Cypher,Sova,Reyna,Omen,Jett","Breach,Cypher,Sova,Omen,Jett"
Lotus,MORBIDLY OBESE,Bolton Esports,13,10,6,5,5,7,"Raze,Cypher,Omen,Fade,Gekko","Breach,Killjoy,Omen,Neon,Gekko"
Lotus,Rice Bowl,Asura Onyx,7,13,1,7,6,6,"Raze,Killjoy,Viper,Omen,Fade","Killjoy,Yoru,Fade,Iso,Clove"
Bind,ROSE,4star,13,11,7,5,6,6,"Raze,Brimstone,Skye,Gekko,Deadlock","Raze,Viper,Brimstone,Fade,Gekko"
Icebox,Charmers GC,Harmony Amethyst,13,4,4,1,3,9,"Sova,Killjoy,Viper,Jett,Gekko","Sova,Killjoy,Viper,Jett,Harbor"
Haven,Burger Boyz 2.0,ABG luvrs,16,14,6,9,5,10,"Breach,Sova,Killjoy,Omen,Neon","Cypher,Sova,Phoenix,Omen,Jett"
Sunset,Special Grade,Harmony,13,7,7,1,6,6,"Breach,Raze,Cypher,Omen,Gekko","Breach,Cypher,Sova,Omen,Neon"
Haven,CCG Esports,Scenario Cats,13,1,2,0,1,11,"Killjoy,Viper,Omen,Jett,Skye","Breach,Sova,Killjoy,Omen,Jett"
Haven,Jawns IV,ENVEE YSL,13,11,9,3,8,4,"Breach,Sova,Killjoy,Omen,Jett","Cypher,Sova,Omen,Yoru,Iso"
Haven,FAT Opps,Team Digital,13,2,3,0,2,10,"Killjoy,Viper,Omen,Jett,Skye","Breach,Sova,Killjoy,Omen,Jett"
Lotus,Astane Anarchy,RECR,13,10,3,9,1,10,"Breach,Raze,Killjoy,Omen,Fade","Breach,Cypher,Sova,Astra,Neon"
Sunset,CB,Spate Esports,8,13,7,5,8,1,"Breach,Raze,Cypher,Omen,Gekko","Raze,Cypher,Omen,Yoru,Gekko"
Abyss,Maryville University,Heavenly Sword Sect,13,10,7,5,5,6,"Sova,Viper,Omen,Yoru,Iso","Cypher,Sova,Omen,Jett,Iso"
Ascent,Paranoia Boys,Day By Day,13,2,10,2,0,3,"Sova,Killjoy,Omen,Jett,KAY/O","Sova,Killjoy,Omen,Jett,KAY/O"
Haven,SeanGares' Kittens,Deleta Esports,13,9,9,3,6,4,"Cypher,Sova,Omen,Jett,Iso","Raze,Sova,Omen,Jett,Gekko"
Haven,El Dorado,The Bees Knees,13,9,7,3,6,6,"Breach,Cypher,Sova,Omen,Neon","Cypher,Sova,Reyna,Omen,Jett"
Lotus,Goon that jawn,Event Horizon,13,5,3,3,2,10,"Breach,Cypher,Neon,Fade,Clove","Breach,Raze,Cypher,Omen,Fade"
Haven,SaD Purple,Raven Esports,13,7,3,5,2,10,"Cypher,Sova,Omen,Yoru,Iso","Sova,Killjoy,Viper,Yoru,Harbor"
Ascent,Nightblood Gaming,Emma's Bakas,13,8,8,4,4,5,"Cypher,Sova,Omen,Yoru,Deadlock","Cypher,Omen,Jett,KAY/O,Deadlock"
Haven,99 Stealers,Last Resistance,13,5,8,4,1,5,"Killjoy,Viper,Omen,Jett,Skye","Killjoy,Viper,Omen,Jett,Skye"
Haven,Fhouse,Lotus 8 Purple,13,2,3,0,2,10,"Breach,Cypher,Sova,Omen,Jett","Breach,Sova,Killjoy,Omen,Jett"
Haven,Event Horizon Red,Forsaken Shadows,12,14,8,5,9,4,"Breach,Sova,Killjoy,Omen,Jett","Breach,Sova,Killjoy,Omen,Jett"
Sunset,Team Atlantis,bricknodes,13,7,4,4,3,9,"Raze,Cypher,Neon,Gekko,Clove","Breach,Raze,Cypher,Omen,Gekko"
Ascent,Nearest Airport,LoungeLizardWW,12,14,5,8,6,7,"Cypher,Sova,Omen,Yoru,Deadlock","Cypher,Sova,Omen,Jett,KAY/O"
Ascent,COPPER BLUE OVALS,Moon (NA),8,13,5,7,6,3,"Sova,Phoenix,Sage,KAY/O,Clove","Cypher,Sova,Omen,Jett,Deadlock"
Haven,Fargo North Dakota,LazerrFreeks Mythic,13,8,7,2,6,6,"Sova,Killjoy,Reyna,Jett,Clove","Killjoy,Viper,Omen,Jett,Skye"
Icebox,demeanorfps,CHURCH OF CHAEWON KIM,13,8,9,3,5,4,"Sova,Killjoy,Viper,Jett,Clove","Sova,Killjoy,Viper,Jett,Gekko"
Ascent,CCG Esports,Scenario Cats,13,0,12,0,0,1,"Sova,Killjoy,Omen,Jett,KAY/O","Sova,Killjoy,Omen,Jett,KAY/O"
Ascent,Eagle Uncs,Clemson Esports,8,13,4,8,5,4,"Sova,Killjoy,Omen,Jett,KAY/O","Sova,Killjoy,Omen,Jett,KAY/O"
Ascent,Malevolent Kitchen,Prospects Hitmen,13,10,5,6,4,8,"Sova,Killjoy,Omen,Jett,KAY/O","Sova,Killjoy,Omen,Jett,KAY/O"
Ascent,Burger Boyz 2.0,ABG luvrs,13,3,9,3,0,4,"Sova,Killjoy,Omen,Jett,KAY/O","Cypher,Sova,Omen,Yoru,Deadlock"
Ascent,Rice Bowl,Asura Onyx,13,4,8,4,0,5,"Sova,Killjoy,Omen,Jett,KAY/O","Sova,Killjoy,Omen,Jett,KAY/O"
Haven,Lionheart eSports,Kraken,13,10,7,5,5,6,"Sova,Killjoy,Viper,Omen,Yoru","Killjoy,Viper,Omen,Jett,Skye"
Abyss,Mickey Masters,Dog Barkers,13,6,6,1,5,7,"Raze,Cypher,Sova,Reyna,Astra","Breach,Cypher,Sova,Jett,Astra"
Lotus,Dexterity Gaming,Good Career,13,9,10,2,7,3,"Raze,Killjoy,Viper,Omen,Fade","Raze,Omen,Chamber,Fade,Deadlock"
Ascent,Endear Eclipse,Whiff Nation,7,13,2,6,7,5,"Cypher,Sova,Omen,Jett,KAY/O","Cypher,Sova,Omen,Jett,Deadlock"
Abyss,ROSE,4star,13,9,7,3,6,6,"Cypher,Sova,Yoru,Astra,Deadlock","Cypher,Sova,Omen,Jett,Yoru"
Sunset,Bedwars Lions,Destined2Rise,13,9,8,4,5,5,"Breach,Raze,Cypher,Omen,Gekko","Raze,Cypher,Omen,KAY/O,Gekko"
Haven,Minas D'ouro,Vila das Flores,11,13,5,7,6,6,"Breach,Cypher,Sova,Omen,Neon","Breach,Cypher,Sova,Omen,Neon"
Lotus,Charmers GC,Harmony Amethyst,8,13,2,7,6,6,"Breach,Raze,Killjoy,Omen,Fade","Breach,Raze,Killjoy,Omen,Gekko"
Haven,MORBIDLY OBESE,Bolton Esports,13,11,5,7,4,8,"Breach,Cypher,Sova,Omen,Jett","Breach,Cypher,Sova,Omen,Jett"
Ascent,Jawns IV,Fhouse,13,2,10,2,0,3,"Cypher,Sova,Omen,Yoru,Deadlock","Sova,Killjoy,Omen,Jett,KAY/O"
Lotus,Waffle House,VO Blossoms,6,13,5,7,6,1,"Breach,Raze,Cypher,Omen,Gekko","Raze,Killjoy,Omen,Fade,Gekko"
Icebox,Alphaware Olympians,Paranoia Boys,6,13,3,9,4,3,"Sova,Killjoy,Viper,Jett,Gekko","Sova,Killjoy,Viper,Jett,Gekko"
Haven,Cuddle Gang,Somali Pirates,13,2,10,2,0,3,"Breach,Sova,Killjoy,Jett,Astra","Breach,Sova,Killjoy,Omen,Jett"
Lotus,Event Horizon,Forsaken Shadows,13,4,9,3,1,4,"Breach,Raze,Cypher,Omen,Fade","Raze,Cypher,Omen,Fade,Deadlock"
Haven,SaD FROST,Pixy Chixs,13,3,9,3,0,4,"Sova,Killjoy,Jett,Iso,Clove","Breach,Sova,Killjoy,Omen,Jett"
Lotus,Team Digital,The Bees Knees,13,6,10,2,4,3,"Breach,Raze,Killjoy,Omen,Fade","Raze,Killjoy,Viper,Omen,Fade"
Bind,TBS GC,Panela Antiaderente,13,6,8,4,2,5,"Viper,Brimstone,Neon,Fade,Gekko","Viper,Brimstone,Skye,Neon,Iso"
Icebox,English or Spanish,Scarlet Knights Black,13,11,6,6,5,7,"Sova,Killjoy,Viper,Chamber,Iso","Sova,Killjoy,Viper,Harbor,Deadlock"
Lotus,Nightblood Gaming,CB,13,5,5,1,4,8,"Breach,Cypher,Sova,Astra,Neon","Breach,Raze,Killjoy,Omen,Gekko"
Abyss,Raven Esports,Prospects Hitmen,13,3,3,1,2,10,"Cypher,Sova,Omen,Jett,KAY/O","Cypher,Sova,Omen,Jett,Harbor"
Lotus,Nearest Airport,LoungeLizardWW,10,13,5,6,7,5,"Raze,Viper,Omen,Chamber,Fade","Raze,Cypher,Omen,Fade,Gekko"
Lotus,REVOADA,TOTALE Talents,13,3,4,0,3,9,"Raze,Killjoy,Viper,Omen,Fade","Cypher,Omen,Neon,Fade,Gekko"
Ascent,Akatsuki Aimers,Day By Day,5,13,0,6,7,5,"Cypher,Sova,Omen,Jett,KAY/O","Sova,Killjoy,Omen,Jett,KAY/O"
Lotus,bricknodes,Harmony,9,13,7,3,10,2,"Breach,Raze,Killjoy,Omen,Gekko","Breach,Killjoy,Omen,Neon,Fade"
Icebox,AURA,Bedwars Lions,1,13,0,2,11,1,"Sova,Killjoy,Sage,Jett,Harbor","Killjoy,Viper,Jett,KAY/O,Gekko"
Lotus,Emma's Bakas,Spate Esports,13,11,4,8,3,9,"Raze,Killjoy,Fade,Iso,Clove","Breach,Cypher,Omen,Neon,Fade"
Haven,ColdHearts GC,Prestige XOXO,13,6,4,3,3,9,"Sova,Omen,Jett,Chamber,Iso","Omen,Jett,Fade,Gekko,Deadlock"
Icebox,Team Leveling,sakki,13,1,2,0,1,11,"Killjoy,Viper,KAY/O,Gekko,Iso","Sova,Killjoy,Viper,Iso,Clove"
Abyss,Maryville University,Astane Anarchy,13,1,11,1,0,2,"Sova,Viper,Omen,Yoru,Iso","Cypher,Sova,Omen,Deadlock,Iso"
Lotus,Last Resistance,Deleta Esports,12,14,10,3,11,2,"Breach,Cypher,Neon,Fade,Clove","Raze,Killjoy,Jett,Gekko,Clove"
Bind,Lil Steppas,Mickey Masters,2,13,2,10,3,0,"Raze,Viper,Reyna,Omen,Gekko","Raze,Brimstone,Skye,Yoru,Iso"
Haven,Fargo North Dakota,Rice Bowl,13,5,3,3,2,10,"Cypher,Sova,Reyna,Omen,Yoru","Breach,Sova,Killjoy,Omen,Jett"
Icebox,ROSE,Endear Eclipse,13,3,3,1,2,10,"Killjoy,Viper,Sage,Jett,Gekko","Sova,Killjoy,Viper,Jett,Gekko"
Haven,Goon that jawn,Event Horizon Red,13,4,4,1,3,9,"Breach,Cypher,Sova,Omen,Yoru","Breach,Sova,Killjoy,Omen,Jett"
Haven,Fast Food Workers,Full Sail Armada,13,2,10,2,0,3,"Sova,Killjoy,Omen,Jett,Iso","Breach,Cypher,Omen,Jett,Deadlock"
Lotus,FAT Opps,El Dorado,13,2,10,2,0,3,"Raze,Killjoy,Viper,Omen,Fade","Breach,Raze,Killjoy,Omen,Gekko"
Haven,Burger Boyz 2.0,CCG Esports,13,9,10,2,7,3,"Breach,Sova,Killjoy,Omen,Neon","Breach,Cypher,Sova,Omen,Neon"
Ascent,Heavenly Sword Sect,RECR,13,7,9,3,4,4,"Sova,Killjoy,Omen,Jett,KAY/O","Sova,Killjoy,Omen,Jett,KAY/O"
Ascent,Omnipotence,Eagle Uncs,6,13,6,6,7,0,"Breach,Sova,Killjoy,Omen,KAY/O","Sova,Killjoy,Omen,Jett,KAY/O"
Lotus,Dexterity Gaming,COPPER BLUE OVALS,13,6,6,1,5,7,"Raze,Killjoy,Viper,Omen,Fade","Raze,Killjoy,Viper,Astra,Fade"
Haven,SeanGares' Kittens,99 Stealers,14,12,8,5,7,6,"Phoenix,Reyna,Omen,Chamber,Iso","Killjoy,Viper,Omen,Jett,Skye"
Lotus,SaD Purple,Malevolent Kitchen,13,1,12,0,1,1,"Raze,Omen,Chamber,Fade,Deadlock","Raze,Killjoy,Omen,Fade,Gekko"
Haven,demeanorfps,CHURCH OF CHAEWON KIM,9,13,6,6,7,3,"Cypher,Sova,Omen,Jett,Iso","Breach,Cypher,Sova,Omen,Neon"
Lotus,LazerrFreeks Mythic,Asura Onyx,13,7,3,5,2,10,"Raze,Killjoy,Viper,Omen,Fade","Raze,Killjoy,Yoru,Fade,Clove"
Haven,ENVEE YSL,Lotus 8 Purple,13,3,9,3,0,4,"Cypher,Sova,Omen,Yoru,Iso","Breach,Sova,Killjoy,Omen,Jett"
Icebox,Special Grade,Team Atlantis,13,6,10,2,4,3,"Sova,Killjoy,Viper,Jett,Gekko","Sova,Killjoy,Viper,Jett,Clove"
Haven,Asians and Skuba,Ball Knowers,13,7,9,3,4,4,"Omen,Yoru,Fade,Deadlock,Clove","Cypher,Sova,Reyna,Omen,Jett"
Lotus,Good Career,Moon (NA),13,4,4,1,3,9,"Raze,Omen,Chamber,Fade,Deadlock","Raze,Killjoy,Viper,Omen,Fade"
Lotus,Goon that jawn,Event Horizon Red,13,1,11,1,0,2,"Breach,Cypher,Neon,Fade,Clove","Raze,Killjoy,Viper,Omen,Fade"
Bind,SaD FROST,Pixy Chixs,13,7,12,0,7,1,"Raze,Viper,Skye,Chamber,Clove","Raze,Cypher,Viper,Brimstone,Skye"
Lotus,ABG luvrs,Scenario Cats,13,3,12,0,3,1,"Breach,Killjoy,Omen,Yoru,Gekko","Raze,Killjoy,Omen,Fade,Gekko"
Bind,4star,Whiff Nation,13,5,3,3,2,10,"Raze,Viper,Brimstone,Fade,Gekko","Raze,Cypher,Viper,Brimstone,Skye"
Ascent,Minas D'ouro,Vila das Flores,11,13,2,10,3,9,"Sova,Killjoy,Omen,Jett,KAY/O","Cypher,Sova,Phoenix,Omen,Jett"
Haven,Waffle House,VO Blossoms,8,13,7,5,8,1,"Breach,Cypher,Sova,Omen,Neon","Breach,Sova,Killjoy,Omen,Jett"
Icebox,ColdHearts GC,Prestige XOXO,13,2,10,2,0,3,"Sova,Killjoy,Viper,Reyna,Jett","Sova,Killjoy,Viper,Harbor,Iso"
Ascent,MORBIDLY OBESE,Bolton Esports,11,13,6,6,7,5,"Sova,Killjoy,Omen,Jett,KAY/O","Cypher,Sova,Omen,Jett,Deadlock"
Ascent,TBS GC,Panela Antiaderente,13,5,5,1,4,8,"Sova,Killjoy,Omen,Jett,KAY/O","Sova,Killjoy,Omen,Jett,KAY/O"
Ascent,Fast Food Workers,Full Sail Armada,13,1,11,1,0,2,"Cypher,Sova,Omen,Yoru,Deadlock","Breach,Cypher,Sova,Neon,Clove"
Ascent,Nightblood Gaming,CB,13,3,10,2,1,3,"Cypher,Sova,Omen,Yoru,Deadlock","Sova,Killjoy,Omen,Jett,KAY/O"
Haven,SaD Purple,Malevolent Kitchen,13,4,10,2,2,3,"Sova,Sage,Reyna,Jett,Clove","Breach,Cypher,Sova,Omen,Jett"
Lotus,Cuddle Gang,Somali Pirates,13,10,8,3,7,5,"Breach,Raze,Killjoy,Omen,Fade","Breach,Raze,Killjoy,Omen,Fade"
Ascent,Fargo North Dakota,Rice Bowl,13,4,4,1,3,9,"Sova,Killjoy,Phoenix,Omen,Jett","Sova,Killjoy,Omen,Jett,KAY/O"
Bind,Charmers GC,Harmony Amethyst,13,11,7,5,6,6,"Raze,Viper,Brimstone,Skye,Gekko","Breach,Raze,Viper,Brimstone,Skye"
Sunset,bricknodes,Harmony,6,13,3,9,4,3,"Breach,Raze,Cypher,Omen,Gekko","Breach,Cypher,Sova,Omen,Neon"
Abyss,Destined2Rise,Cosmic Scorpus,13,2,3,0,2,10,"Cypher,Sova,Jett,Astra,Harbor","Cypher,Sova,Omen,Jett,Gekko"
Ascent,Dog Barkers,Winner POV,13,2,10,2,0,3,"Sova,Killjoy,Omen,Jett,KAY/O","Sova,Killjoy,Omen,Jett,KAY/O"
Haven,REVOADA,TOTALE Talents,13,7,10,2,5,3,"Breach,Sova,Killjoy,Omen,Jett","Cypher,Sova,Omen,Yoru,Iso"
Ascent,LazerrFreeks Mythic,Asura Onyx,13,3,3,1,2,10,"Sova,Killjoy,Omen,Jett,KAY/O","Sova,Killjoy,Omen,Jett,KAY/O"
Bind,Team Leveling,sakki,13,3,9,3,0,4,"Raze,Viper,Brimstone,Skye,Gekko","Raze,Cypher,Brimstone,Skye,Deadlock"
Sunset,Emma's Bakas,Spate Esports,13,3,4,0,3,9,"Breach,Raze,Cypher,Deadlock,Clove","Raze,Cypher,Omen,Yoru,Gekko"
Ascent,ROSE,Endear Eclipse,13,6,5,2,4,8,"Cypher,Sova,Omen,Yoru,Deadlock","Cypher,Sova,Omen,Jett,KAY/O"
Sunset,Dexterity Gaming,COPPER BLUE OVALS,13,4,3,2,2,10,"Breach,Raze,Cypher,Omen,Gekko","Breach,Raze,Cypher,Omen,Gekko"
Haven,Maryville University,Astane Anarchy,13,4,3,2,2,10,"Breach,Sova,Killjoy,Omen,Jett","Breach,Cypher,Sova,Omen,Jett"
Bind,Nearest Airport,LoungeLizardWW,13,11,4,8,3,9,"Raze,Cypher,Omen,Yoru,Deadlock","Raze,Viper,Brimstone,Yoru,Fade"
Bind,Astral Vision Infinite,Clemson Esports,12,14,7,6,8,5,"Raze,Cypher,Brimstone,Yoru,Fade","Raze,Viper,Brimstone,Skye,Gekko"
Haven,English or Spanish,Scarlet Knights Black,13,10,6,5,5,7,"Breach,Cypher,Sova,Omen,Jett","Breach,Cypher,Sova,Omen,Jett"
Lotus,Jawns IV,Fhouse,14,12,9,4,8,5,"Raze,Killjoy,Viper,Omen,Fade","Breach,Raze,Cypher,Omen,Gekko"
Abyss,Lionheart eSports,Kraken,13,11,10,2,9,3,"Sova,Killjoy,Viper,Omen,Yoru","Cypher,Sova,Omen,Yoru,Harbor"
Ascent,Raven Esports,Prospects Hitmen,13,8,7,5,3,6,"Sova,Killjoy,Omen,Jett,KAY/O","Sova,Killjoy,Omen,Jett,KAY/O"
Haven,Event Horizon,Forsaken Shadows,13,11,6,6,5,7,"Breach,Sova,Killjoy,Omen,Jett","Breach,Sova,Killjoy,Omen,Jett"
Lotus,demeanorfps,CHURCH OF CHAEWON KIM,13,4,8,4,0,5,"Breach,Raze,Cypher,Omen,Gekko","Breach,Cypher,Omen,Neon,Fade"
Haven,FAT Opps,El Dorado,13,5,4,2,3,9,"Killjoy,Viper,Omen,Jett,Skye","Breach,Sova,Killjoy,Omen,Jett"
Bind,Last Resistance,Deleta Esports,9,13,3,7,6,6,"Raze,Viper,KAY/O,Fade,Clove","Raze,Cypher,Brimstone,Skye,Gekko"
Abyss,Team Digital,The Bees Knees,13,10,9,2,8,4,"Cypher,Sova,Omen,Jett,KAY/O","Cypher,Sova,Reyna,Jett,Astra"
Ascent,ENVEE YSL,Lotus 8 Purple,13,5,4,2,3,9,"Sova,Killjoy,Omen,Jett,KAY/O","Sova,Killjoy,Omen,Jett,KAY/O"
Ascent,Asians and Skuba,Ball Knowers,13,2,3,0,2,10,"Cypher,Sova,Omen,Yoru,Deadlock","Sova,Killjoy,Omen,Jett,KAY/O"
Sunset,SeanGares' Kittens,99 Stealers,13,8,6,3,5,7,"Cypher,Killjoy,Brimstone,Yoru,Deadlock","Breach,Raze,Cypher,Omen,Fade"
Sunset,Good Career,Moon (NA),13,2,3,0,2,10,"Breach,Raze,Cypher,Omen,Gekko","Cypher,Sova,Omen,KAY/O,Neon"
Lotus,Heavenly Sword Sect,RECR,13,7,7,5,2,6,"Raze,Killjoy,Viper,Omen,Fade","Breach,Cypher,Sova,Astra,Neon"
Haven,Special Grade,Team Atlantis,13,3,3,1,2,10,"Sova,Jett,Astra,Deadlock,Iso","Cypher,Sova,Omen,Yoru,Iso"
Haven,ABG luvrs,Scenario Cats,13,1,2,0,1,11,"Cypher,Sova,Phoenix,Omen,Jett","Breach,Sova,Killjoy,Omen,Jett"
Lotus,4star,Whiff Nation,13,1,12,0,1,1,"Raze,Cypher,Fade,Gekko,Clove","Breach,Raze,Cypher,Omen,Gekko"
Ascent,Burger Boyz 2.0,CCG Esports,13,10,7,5,5,6,"Sova,Killjoy,Omen,Jett,KAY/O","Sova,Killjoy,Omen,Jett,KAY/O"
Haven,Coalesce,NEANLATIYONBOLM,13,2,10,2,0,3,"Breach,Sova,Killjoy,Omen,Jett","Sova,Killjoy,Omen,Jett,Yoru"
Icebox,Coalesce,NEANLATIYONBOLM,13,10,6,6,4,7,"Sova,Killjoy,Viper,Reyna,Jett","Sova,Killjoy,Viper,Jett,Yoru"
Bind,FUT Esports,Paper Rex,6,13,3,9,4,3,"Raze,Viper,Brimstone,Fade,Gekko","Raze,Viper,Brimstone,Fade,Gekko"
Sunset,FUT Esports,Paper Rex,11,13,6,6,7,5,"Breach,Raze,Cypher,Omen,Gekko","Breach,Raze,Sage,Omen,Gekko"
Sunset,Talon Esports,Team Vitality,8,13,2,7,6,6,"Raze,Cypher,Omen,Fade,Deadlock","Cypher,Sova,Omen,KAY/O,Neon"
Lotus,Talon Esports,Team Vitality,6,13,4,3,10,2,"Raze,Omen,Fade,Deadlock,Clove","Breach,Raze,Cypher,Omen,Fade"
Bind,minions united GC,LazerrFreeks Ivy,13,4,9,3,1,4,"Raze,Viper,Brimstone,Skye,Gekko","Raze,Cypher,Skye,Yoru,Clove"
Bind,TOTALE Talents,Karasuno Crows,13,9,7,3,6,6,"Raze,Viper,Brimstone,Fade,Gekko","Raze,Viper,Brimstone,Fade,Gekko"
Bind,sakki,BLOOD Stars,13,11,7,5,6,6,"Raze,Viper,Brimstone,Sage,Skye","Raze,Cypher,Brimstone,Fade,Gekko"
Abyss,Vila das Flores,PROCURADAS,13,7,7,1,6,6,"Cypher,Sova,Omen,Jett,Harbor","Breach,Cypher,Omen,Jett,Gekko"
Bind,Panela Antiaderente,Athena's e-Sports,13,9,3,7,2,10,"Viper,Brimstone,Skye,Neon,Gekko","Raze,Cypher,Brimstone,Skye,Gekko"
Ascent,TOTALE Talents,Karasuno Crows,8,13,3,6,7,5,"Cypher,Sova,Omen,Jett,Deadlock","Sova,Killjoy,Omen,Jett,KAY/O"
Lotus,Minas D'ouro,Addictes GC,13,6,6,1,5,7,"Breach,Raze,Killjoy,Omen,Fade","Breach,Cypher,Omen,Neon,Fade"
Haven,TBS GC,As de copas,13,3,4,0,3,9,"Breach,Sova,Killjoy,Omen,Jett","Breach,Sova,Killjoy,Omen,Neon"
Bind,Team Leveling,BmE,13,5,5,1,4,8,"Brimstone,Skye,Neon,Gekko,Deadlock","Raze,Viper,Skye,Gekko,Clove"
Bind,REVOADA,Moranguinhas,13,2,3,0,2,10,"Brimstone,Skye,Chamber,Neon,Clove","Killjoy,Brimstone,Jett,Skye,Gekko"
Haven,Vila das Flores,PROCURADAS,13,3,9,3,0,4,"Breach,Cypher,Sova,Omen,Neon","Breach,Cypher,Sova,Omen,Jett"
Lotus,sakki,BLOOD Stars,13,7,8,4,3,5,"Breach,Killjoy,Omen,Neon,Fade","Raze,Killjoy,Viper,Omen,Gekko"
Bind,TBS GC,As de copas,13,1,11,1,0,2,"Viper,Brimstone,Neon,Fade,Gekko","Raze,Cypher,Brimstone,Skye,Gekko"
Icebox,Team Leveling,BmE,13,1,2,0,1,11,"Killjoy,Viper,KAY/O,Gekko,Iso","Sova,Killjoy,Viper,Sage,Gekko"
Ascent,Minas D'ouro,Addictes GC,13,4,10,2,2,3,"Sova,Killjoy,Omen,Jett,KAY/O","Sova,Killjoy,Omen,Jett,KAY/O"
Icebox,TOTALE Talents,Karasuno Crows,13,7,10,2,5,3,"Sova,Killjoy,Viper,Jett,Gekko","Sova,Killjoy,Viper,Sage,Jett"
Haven,Panela Antiaderente,Athena's e-Sports,13,9,8,4,5,5,"Breach,Sova,Killjoy,Omen,Neon","Breach,Killjoy,Omen,Neon,Gekko"
Icebox,REVOADA,Moranguinhas,13,3,10,2,1,3,"Sova,Killjoy,Viper,Jett,Iso","Sova,Killjoy,Viper,Jett,Gekko"
Icebox,Bilibili Gaming,KRÜ Esports,4,13,3,9,4,1,"Killjoy,Viper,Sage,Jett,KAY/O","Sova,Killjoy,Viper,Jett,Gekko"
Lotus,Bilibili Gaming,KRÜ Esports,9,13,7,5,8,2,"Breach,Viper,Omen,Neon,Fade","Raze,Killjoy,Viper,Omen,Fade"
Lotus,Sentinels,FunPlus Phoenix,13,5,4,2,3,9,"Raze,Killjoy,Viper,Omen,Fade","Breach,Viper,Omen,Chamber,Gekko"
Bind,Sentinels,FunPlus Phoenix,13,8,4,8,0,9,"Raze,Viper,Brimstone,Fade,Gekko","Viper,Omen,Yoru,Chamber,Fade"
Haven,SaD FROST,Envee Sapphire GC,13,3,11,1,2,2,"Breach,Sova,Killjoy,Jett,Clove","Cypher,Sova,Omen,Yoru,Iso"
Lotus,SaD FROST,LazerrFreeks Ivy,13,5,5,1,4,8,"Breach,Raze,Cypher,Gekko,Clove","Raze,Killjoy,Omen,Fade,Gekko"
Ascent,Tenax GC,Envee Sapphire GC,13,9,8,2,7,5,"Cypher,Sova,Omen,Jett,KAY/O","Sova,Killjoy,Omen,Jett,KAY/O"
Bind,EDward Gaming,G2 Esports,11,13,8,4,9,3,"Raze,Viper,Brimstone,Fade,Gekko","Raze,Viper,Brimstone,Skye,Gekko"
Haven,EDward Gaming,G2 Esports,11,13,5,7,6,6,"Breach,Cypher,Sova,Omen,Neon","Sova,Killjoy,Viper,Omen,Yoru"
Icebox,EDward Gaming,G2 Esports,13,8,9,3,5,4,"Sova,Killjoy,Viper,Jett,KAY/O","Sova,Killjoy,Viper,Harbor,Gekko"
Ascent,Leviatán,Trace Esports,5,13,2,10,3,3,"Cypher,Sova,Omen,Jett,Deadlock","Sova,Killjoy,Omen,Jett,KAY/O"
Sunset,Leviatán,Trace Esports,13,9,6,4,5,7,"Breach,Cypher,Sova,Omen,Neon","Breach,Raze,Cypher,Sova,Omen"
Bind,Leviatán,Trace Esports,10,13,5,6,7,5,"Raze,Viper,Brimstone,Skye,Gekko","Raze,Cypher,Brimstone,Skye,Deadlock"
Abyss,The blockade,Mickey Masters,5,13,1,5,8,4,"Breach,Raze,Cypher,Sova,Astra","Raze,Cypher,Sova,Astra,Gekko"
Haven,5 Retired Tier 2 Players,Mickey Masters,6,13,1,6,7,5,"Breach,Sova,Killjoy,Omen,Jett","Breach,Sova,Killjoy,Jett,Astra"
Haven,The blockade,Mickey Masters,6,13,1,6,7,5,"Breach,Sova,Killjoy,Omen,Jett","Breach,Sova,Killjoy,Jett,Astra"
Lotus,Spate Esports,The blockade,6,13,1,6,7,5,"Breach,Cypher,Omen,Neon,Fade","Raze,Killjoy,Viper,Fade,Clove"
Haven,Spate Esports,Weber State University,13,2,11,1,1,2,"Breach,Cypher,Sova,Neon,Clove","Breach,Cypher,Sova,Omen,Jett"
Haven,Mickey Masters,OutGoing Esports,13,2,11,1,1,2,"Breach,Sova,Killjoy,Jett,Astra","Breach,Sova,Killjoy,Omen,Jett"
Ascent,5 Retired Tier 2 Players,Death be Happen,13,2,10,2,0,3,"Sova,Killjoy,Omen,Jett,KAY/O","Sova,Killjoy,Omen,Jett,KAY/O"
Ascent,ST x WTP,The blockade,9,13,2,8,5,7,"Sova,Killjoy,Omen,Jett,KAY/O","Sova,Killjoy,Omen,Jett,KAY/O"
Haven,Weber State University,Poseidon Esports,13,3,4,0,3,9,"Breach,Cypher,Sova,Omen,Jett","Breach,Sova,Killjoy,Omen,Jett"
Sunset,Death be Happen,Team Fishy,13,3,9,3,0,4,"Breach,Raze,Cypher,Omen,Gekko","Raze,Cypher,Sova,Omen,Gekko"
Abyss,OutGoing Esports,Outline Esports,13,8,8,4,4,5,"Breach,Cypher,Sova,Omen,Jett","Raze,Cypher,Sova,Astra,Gekko"
Ascent,Legacy,SAGAZ,8,13,6,6,7,2,"Sova,Killjoy,Omen,Jett,KAY/O","Breach,Sova,Killjoy,Omen,Jett"
Icebox,Legacy,SAGAZ,10,13,8,4,9,2,"Sova,Killjoy,Viper,Reyna,Iso","Killjoy,Viper,KAY/O,Gekko,Iso"
Lotus,Legacy,SAGAZ,8,13,2,7,6,6,"Breach,Cypher,Omen,Neon,Iso","Breach,Cypher,Omen,Neon,Iso"
Abyss,Coalesce,Requiem,6,13,5,7,6,1,"Cypher,Sova,Omen,Jett,KAY/O","Cypher,Sova,Omen,Jett,KAY/O"
Haven,Coalesce,Requiem,14,12,7,6,6,7,"Breach,Sova,Killjoy,Omen,Jett","Cypher,Sova,Omen,Yoru,Iso"
Icebox,Coalesce,Requiem,10,13,5,7,6,5,"Sova,Killjoy,Viper,Reyna,Jett","Killjoy,Viper,Jett,KAY/O,Gekko"
Lotus,FNATIC,DRX,6,13,1,6,7,5,"Raze,Killjoy,Viper,Omen,Fade","Raze,Viper,Omen,Chamber,Fade"
Abyss,FNATIC,DRX,11,13,5,7,6,6,"Sova,Killjoy,Viper,Yoru,Astra","Cypher,Sova,Omen,Jett,KAY/O"
Bind,Gen.G Esports,Team Heretics,10,13,6,5,8,4,"Raze,Cypher,Viper,Brimstone,Skye","Viper,Skye,Yoru,Astra,Gekko"
Lotus,Gen.G Esports,Team Heretics,11,13,8,4,9,3,"Raze,Killjoy,Viper,Omen,Fade","Raze,Killjoy,Viper,Omen,Fade"
Abyss,Gen.G Esports,Team Heretics,13,11,7,5,6,6,"Sova,Viper,Jett,Yoru,Astra","Cypher,Sova,Jett,Astra,Gekko"
Ascent,Tenax GC,Charmers GC,13,2,2,1,1,11,"Cypher,Sova,Omen,Jett,KAY/O","Sova,Killjoy,Omen,Deadlock,Clove"
Sunset,Akave Esports Black,MYVRA,13,5,3,3,2,10,"Breach,Raze,Cypher,Omen,Gekko","Breach,Raze,Cypher,Omen,Fade"
Haven,Legacy,Agropesca Jacare,13,15,9,5,10,4,"Cypher,Sova,Phoenix,Omen,Iso","Cypher,Sova,Omen,Yoru,Iso"
Abyss,Akave Esports Black,MYVRA,11,13,5,7,6,6,"Sova,Omen,Jett,Gekko,Deadlock","Breach,Raze,Cypher,Sova,Astra"
Lotus,Legacy,Agropesca Jacare,11,13,4,8,5,7,"Breach,Cypher,Omen,Neon,Iso","Raze,Omen,Chamber,Fade,Clove"
Haven,Akave Esports Black,MYVRA,13,7,5,7,0,8,"Cypher,Sova,Omen,Jett,Skye","Breach,Raze,Killjoy,Astra,Fade"
Icebox,NIGERIA 96,SAGAZ,3,13,2,10,3,1,"Sova,Killjoy,Viper,Jett,Harbor","Killjoy,Viper,KAY/O,Gekko,Iso"
Ascent,NIGERIA 96,SAGAZ,11,13,6,6,7,5,"Cypher,Sova,Omen,Jett,Deadlock","Breach,Sova,Killjoy,Omen,Jett"
Sunset,NEANLATIYONBOLM,Siko Esports,7,13,6,6,7,1,"Killjoy,Yoru,Astra,Neon,Gekko","Breach,Raze,Cypher,Sova,Omen"
Sunset,NEANLATIYONBOLM,Osiris,13,7,7,1,6,6,"Breach,Raze,Cypher,Sova,Omen","Killjoy,Yoru,Astra,Neon,Gekko"
Bind,NEANLATIYONBOLM,Osiris,5,13,1,5,8,4,"Raze,Viper,Brimstone,Skye,Gekko","Raze,Viper,Brimstone,Yoru,Deadlock"
Bind,NEANLATIYONBOLM,Siko Esports,13,5,8,4,1,5,"Raze,Viper,Brimstone,Yoru,Deadlock","Raze,Viper,Brimstone,Skye,Gekko"
Haven,NEANLATIYONBOLM,Siko Esports,9,13,3,9,4,6,"Sova,Killjoy,Omen,Jett,Yoru","Breach,Cypher,Sova,Omen,Jett"
Haven,NEANLATIYONBOLM,Osiris,13,9,4,6,3,9,"Breach,Cypher,Sova,Omen,Jett","Sova,Killjoy,Omen,Jett,Yoru"
Abyss,Sad Green,Goon that jawn,9,13,4,8,5,5,"Cypher,Sova,Omen,Jett,Deadlock","Cypher,Sova,Omen,Yoru,Neon"
Bind,Sad Green,Goon that jawn,13,11,6,6,5,7,"Raze,Viper,Brimstone,Skye,Deadlock","Raze,Viper,Skye,Yoru,Clove"
Ascent,Burger Boyz 2.0,#flyaway,9,13,6,6,7,3,"Cypher,Sova,Omen,Jett,Deadlock","Sova,Killjoy,Omen,Jett,KAY/O"
Ascent,Sad Green,Goon that jawn,12,14,7,6,8,5,"Sova,Killjoy,Omen,Jett,KAY/O","Sova,Killjoy,Reyna,Omen,Yoru"
Bind,Burger Boyz 2.0,#flyaway,9,13,2,8,5,7,"Raze,Brimstone,Skye,Gekko,Deadlock","Raze,Brimstone,Reyna,Yoru,Gekko"
Icebox,SAGAZ,Agropesca Jacare,1,13,0,2,11,1,"Killjoy,Viper,KAY/O,Gekko,Iso","Sova,Killjoy,Viper,Iso,Clove"
Haven,SAGAZ,Agropesca Jacare,5,13,1,5,8,4,"Breach,Sova,Killjoy,Omen,Neon","Cypher,Sova,Omen,Yoru,Iso"
Ascent,Burger Boyz 2.0,Sad Green,2,13,2,10,3,0,"Cypher,Sova,Omen,Jett,Deadlock","Sova,Killjoy,Omen,Jett,KAY/O"
Icebox,Burger Boyz 2.0,Sad Green,4,13,2,3,10,2,"Sova,Killjoy,Viper,Jett,Gekko","Sova,Killjoy,Viper,Reyna,Jett"
Icebox,Legacy,NIGERIA 96,13,3,11,1,2,2,"Sova,Killjoy,Viper,Reyna,Iso","Sova,Killjoy,Viper,Jett,Harbor"
Bind,Burger Boyz 2.0,Sad Green,13,7,8,4,3,5,"Raze,Brimstone,Skye,Gekko,Deadlock","Raze,Viper,Brimstone,Skye,Deadlock"
Lotus,Legacy,NIGERIA 96,13,3,10,2,1,3,"Breach,Cypher,Omen,Neon,Iso","Breach,Cypher,Omen,Neon,Fade"
Haven,Goon that jawn,#flyaway,13,10,6,5,5,7,"Cypher,Sova,Omen,Jett,Yoru","Breach,Cypher,Sova,Omen,Jett"
Bind,Goon that jawn,#flyaway,13,6,6,1,5,7,"Raze,Viper,Brimstone,Yoru,Gekko","Raze,Brimstone,Reyna,Yoru,Gekko"
Abyss,Legacy,NIGERIA 96,11,13,7,5,8,4,"Cypher,Sova,Omen,Jett,KAY/O","Cypher,Sova,Yoru,Astra,Iso"
Abyss,EarnYourMedal,Sad Green,8,13,4,8,5,4,"Cypher,Sova,Reyna,Jett,Astra","Cypher,Sova,Jett,Astra,Deadlock"
Bind,Shake and Jake,Burger Boyz 2.0,5,13,1,5,8,4,"Raze,Viper,Brimstone,Skye,Deadlock","Raze,Brimstone,Skye,Gekko,Deadlock"
Icebox,EarnYourMedal,Sad Green,6,13,2,5,8,4,"Sova,Killjoy,Viper,Reyna,Jett","Sova,Killjoy,Viper,Reyna,Jett"
Ascent,Shake and Jake,Burger Boyz 2.0,10,13,7,5,8,3,"Sova,Killjoy,Omen,Jett,KAY/O","Cypher,Sova,Omen,Jett,Deadlock"
Abyss,#flyaway,ROSE,13,8,5,4,4,8,"Cypher,Sova,Jett,Astra,Deadlock","Cypher,Sova,Omen,Yoru,Deadlock"
Haven,Goon that jawn,Dolbaebi,14,12,8,5,7,6,"Breach,Cypher,Sova,Omen,Yoru","Breach,Cypher,Sova,Jett,Clove"
Bind,#flyaway,ROSE,13,2,10,2,0,3,"Raze,Brimstone,Reyna,Yoru,Gekko","Raze,Brimstone,Skye,Gekko,Deadlock"
Ascent,Goon that jawn,Dolbaebi,13,7,5,7,0,8,"Sova,Killjoy,Reyna,Omen,Yoru","Sova,Killjoy,Omen,Jett,KAY/O"
Icebox,Vixen Esports,PARABELLUM,1,13,0,2,11,1,"Viper,Reyna,Jett,Iso,Clove","Sova,Killjoy,Viper,Jett,KAY/O"
Haven,Shake and Jake,Burger Boyz 2.0,13,11,6,6,5,7,"Breach,Sova,Killjoy,Omen,Jett","Breach,Sova,Killjoy,Omen,Jett"
Icebox,EarnYourMedal,F5 Esports,14,12,8,5,7,6,"Sova,Killjoy,Viper,Reyna,Jett","Sova,Killjoy,Viper,Reyna,Jett"
Abyss,Vixen Esports,PARABELLUM,2,13,2,10,3,0,"Breach,Cypher,Sova,Omen,Jett","Breach,Cypher,Jett,Astra,Gekko"
Lotus,EarnYourMedal,F5 Esports,13,11,4,8,3,9,"Raze,Killjoy,Reyna,Omen,Skye","Breach,Raze,Cypher,Fade,Clove"
Haven,Reign Above,Dolbaebi,7,13,3,9,4,4,"Breach,Sova,Killjoy,Omen,Jett","Breach,Cypher,Sova,Jett,Clove"
Ascent,#flyaway,OverLoaded,13,11,9,3,8,4,"Sova,Killjoy,Omen,Jett,KAY/O","Cypher,Sova,Omen,Yoru,Fade"
Lotus,ARTHEA,STRIX,13,3,9,3,0,4,"Breach,Killjoy,Omen,Jett,Gekko","Breach,Raze,Cypher,Omen,Gekko"
Ascent,uhhhhh,Burger Boyz 2.0,7,13,3,5,8,4,"Sova,Killjoy,Reyna,Omen,Jett","Cypher,Sova,Omen,Jett,Deadlock"
Bind,Reign Above,Dolbaebi,7,13,3,9,4,4,"Raze,Viper,Brimstone,Skye,Chamber","Raze,Cypher,Brimstone,Skye,Gekko"
Bind,#flyaway,OverLoaded,13,5,7,5,0,6,"Raze,Brimstone,Reyna,Yoru,Gekko","Raze,Viper,KAY/O,Fade,Clove"
Haven,uhhhhh,Burger Boyz 2.0,3,13,0,4,9,3,"Breach,Sova,Killjoy,Omen,Jett","Breach,Sova,Killjoy,Omen,Jett"
Haven,ARTHEA,STRIX,13,8,7,2,6,6,"Breach,Sova,Killjoy,Omen,Jett","Breach,Cypher,Omen,Jett,Skye"
Bind,EDward Gaming,FUT Esports,13,10,8,4,6,5,"Raze,Viper,Brimstone,Fade,Gekko","Raze,Viper,Brimstone,Fade,Gekko"
Lotus,EDward Gaming,FUT Esports,13,9,8,4,5,5,"Breach,Omen,Neon,Fade,Clove","Breach,Cypher,Viper,Omen,Jett"
Lotus,G2 Esports,Paper Rex,13,9,4,6,3,9,"Raze,Killjoy,Viper,Omen,Fade","Omen,Jett,KAY/O,Neon,Fade"
Icebox,G2 Esports,Paper Rex,13,8,8,4,4,5,"Sova,Killjoy,Viper,Harbor,Gekko","Sova,Killjoy,Viper,Sage,Jett"
Icebox,the gnomes,F5 Esports,11,13,7,5,8,4,"Sova,Killjoy,Viper,Jett,Gekko","Sova,Killjoy,Viper,Reyna,Jett"
Haven,the gnomes,F5 Esports,13,10,10,1,9,3,"Breach,Sova,Killjoy,Omen,Jett","Breach,Sova,Killjoy,Jett,Astra"
Lotus,the gnomes,F5 Esports,14,16,6,9,7,8,"Breach,Cypher,Omen,Neon,Gekko","Breach,Raze,Cypher,Fade,Clove"
Lotus,F5 Esports,The Villans,13,5,10,2,3,3,"Breach,Raze,Cypher,Fade,Clove","Raze,Killjoy,Viper,Omen,Skye"
Abyss,OverLoaded,Reign Above,13,9,7,5,4,6,"Cypher,Sova,Omen,Jett,Harbor","Cypher,Sova,Omen,Jett,Yoru"
Lotus,the gnomes,Event Horizon,13,8,7,5,3,6,"Breach,Cypher,Omen,Neon,Gekko","Breach,Raze,Cypher,Omen,Fade"
Lotus,Team Liquid Brazil,NIGERIA 96,11,13,5,7,6,6,"Raze,Killjoy,Viper,Omen,Fade","Breach,Cypher,Omen,Neon,Fade"
Bind,Agropesca Jacare,NoOrg9,13,1,2,0,1,11,"Raze,Cypher,Viper,Brimstone,Skye","Raze,Viper,Brimstone,Skye,Gekko"
Abyss,The Villans,Raiders of the Knight,13,11,9,3,8,4,"Cypher,Jett,Astra,Gekko,Iso","Raze,Cypher,Omen,Gekko,Iso"
Haven,F5 Esports,OverLoaded,11,13,5,7,6,6,"Breach,Sova,Killjoy,Jett,Astra","Killjoy,Viper,Omen,Jett,Skye"
Ascent,the gnomes,Reign Above,13,15,5,9,6,8,"Sova,Killjoy,Omen,Jett,KAY/O","Sova,Killjoy,Omen,Jett,KAY/O"
Lotus,FIU Varsity,Event Horizon,5,13,3,9,4,2,"Raze,Omen,Skye,Chamber,Gekko","Breach,Raze,Cypher,Omen,Fade"
Haven,Agropesca Jacare,NoOrg9,13,5,4,2,3,9,"Cypher,Sova,Omen,Yoru,Iso","Breach,Cypher,Sova,Omen,Jett"
Ascent,Team Liquid Brazil,NIGERIA 96,11,13,4,8,5,7,"Sova,Killjoy,Omen,Jett,KAY/O","Cypher,Sova,Omen,Jett,Deadlock"
Ascent,Event Horizon,OverLoaded,8,13,6,3,10,2,"Sova,Killjoy,Omen,Jett,KAY/O","Cypher,Sova,Omen,Yoru,Fade"
Bind,Raiders of the Knight,Reign Above,8,13,6,6,7,2,"Raze,Reyna,Astra,Chamber,Iso","Raze,Viper,Brimstone,Skye,Chamber"
Abyss,IAPEsports,Grow uP eSports,13,9,7,3,6,6,"Breach,Phoenix,Omen,Yoru,KAY/O","Cypher,Phoenix,Astra,Neon,Gekko"
Abyss,GMBLERS Esports,bazinga esports,13,8,8,1,7,5,"Sova,Omen,Jett,Gekko,Deadlock","Cypher,Sova,Omen,Jett,Harbor"
Abyss,INCOGNITO,InTenZive,9,13,5,5,8,4,"Breach,Cypher,Jett,Astra,Gekko","Sova,Jett,Astra,Gekko,Deadlock"
Abyss,Nexum EC,Solar Flare,8,13,4,5,8,4,"Omen,Jett,KAY/O,Fade,Deadlock","Sova,Omen,Jett,Gekko,Deadlock"
Abyss,STAKERS,Zeniths,7,13,3,5,8,4,"Breach,Cypher,Sova,Jett,Astra","Breach,Omen,Jett,Gekko,Deadlock"
Haven,The Villans,the gnomes,10,13,6,5,8,4,"Killjoy,Viper,Jett,Skye,Clove","Breach,Sova,Killjoy,Omen,Jett"
Sunset,#flyaway,uhhhhh,13,6,3,4,2,10,"Breach,Raze,Cypher,Omen,Gekko","Breach,Raze,Cypher,Omen,Fade"
Lotus,F5 Esports,FIU Varsity,13,11,8,4,7,5,"Breach,Cypher,Neon,Fade,Clove","Raze,Omen,Skye,Chamber,Gekko"
Ascent,#flyaway,uhhhhh,11,13,5,7,6,6,"Sova,Killjoy,Omen,Neon,Iso","Sova,Killjoy,Reyna,Omen,Jett"
Lotus,Goon that jawn,The Villans,13,10,9,3,7,4,"Viper,Reyna,Astra,Chamber,Deadlock","Raze,Cypher,Reyna,Gekko,Clove"
Bind,#flyaway,uhhhhh,13,6,9,3,3,4,"Raze,Brimstone,Reyna,Yoru,Gekko","Raze,Skye,Deadlock,Iso,Clove"
Bind,PARABELLUM,STRIX,13,3,4,0,3,9,"Breach,Viper,Brimstone,Jett,Skye","Breach,Raze,Cypher,Omen,Skye"
Abyss,GMBLERS Esports,Nexum EC,3,13,3,9,4,0,"Cypher,Sova,Omen,Harbor,Iso","Omen,Jett,KAY/O,Fade,Deadlock"
Abyss,STAKERS,KHORE GAMING,13,10,9,2,8,4,"Breach,Cypher,Sova,Jett,Astra","Breach,Sova,Killjoy,Omen,Jett"
Abyss,bazinga esports,IAPEsports,11,13,6,6,7,5,"Cypher,Sova,Omen,Jett,Harbor","Breach,Phoenix,Omen,Yoru,KAY/O"
Abyss,InTenZive,Solar Flare,13,3,2,2,1,11,"Sova,Jett,Astra,Gekko,Deadlock","Cypher,Sova,Omen,Jett,KAY/O"
Abyss,INCOGNITO,Grow uP eSports,13,3,4,0,3,9,"Breach,Cypher,Jett,Astra,Gekko","Cypher,Phoenix,Astra,Neon,Gekko"
Ascent,Goon that jawn,The Villans,13,5,8,4,1,5,"Sova,Killjoy,Omen,Jett,Iso","Cypher,Sova,Omen,Jett,Deadlock"
Ascent,PARABELLUM,STRIX,13,5,6,0,5,7,"Sova,Killjoy,Omen,Jett,KAY/O","Breach,Cypher,Sova,Omen,Jett"
Ascent,ARTHEA,Vixen Esports,10,13,6,5,8,4,"Sova,Killjoy,Omen,Jett,KAY/O","Sova,Killjoy,Sage,Omen,Jett"
Haven,ARTHEA,Vixen Esports,7,13,6,6,7,1,"Breach,Sova,Killjoy,Omen,Jett","Breach,Sova,Killjoy,Omen,Jett"
Bind,Team Vitality,Trace Esports,7,13,6,6,7,1,"Raze,Viper,Omen,Fade,Gekko","Raze,Cypher,Brimstone,Skye,Deadlock"
Sunset,Team Vitality,Trace Esports,13,7,5,3,4,8,"Cypher,Sova,Omen,KAY/O,Neon","Breach,Raze,Cypher,Sova,Omen"
Ascent,Team Vitality,Trace Esports,13,15,7,7,8,6,"Sova,Killjoy,Omen,Jett,KAY/O","Sova,Killjoy,Omen,Jett,KAY/O"
Ascent,Leviatán,Talon Esports,13,8,5,4,4,8,"Cypher,Sova,Omen,Jett,Deadlock","Sova,Phoenix,Sage,KAY/O,Clove"
Bind,Leviatán,Talon Esports,13,11,6,6,5,7,"Raze,Viper,Brimstone,Skye,Gekko","Viper,Omen,Skye,Yoru,Neon"
Icebox,Sad Green,OverLoaded,6,13,3,4,9,3,"Sova,Killjoy,Viper,Reyna,Jett","Sova,Viper,Reyna,Jett,Deadlock"
Bind,Sad Green,OverLoaded,13,7,7,5,2,6,"Raze,Viper,Brimstone,Skye,Deadlock","Raze,Viper,KAY/O,Fade,Clove"
Ascent,Sad Green,OverLoaded,9,13,1,9,4,8,"Sova,Killjoy,Omen,Jett,KAY/O","Cypher,Sova,Omen,Yoru,Fade"
Sunset,EarnYourMedal,Raiders of the Knight,13,10,7,5,5,6,"Cypher,Reyna,Omen,Jett,Gekko","Raze,Cypher,Omen,Gekko,Iso"
Haven,Shake and Jake,FIU Varsity,13,2,10,2,0,3,"Sova,Phoenix,Jett,Iso,Clove","Sova,Reyna,Omen,Chamber,Neon"
Haven,EarnYourMedal,Raiders of the Knight,13,4,5,0,4,8,"Cypher,Sova,Reyna,Jett,Astra","Sova,Killjoy,Omen,Jett,Iso"
Haven,OverLoaded,the gnomes,11,13,6,6,7,5,"Killjoy,Viper,Omen,Jett,Skye","Breach,Sova,Killjoy,Omen,Jett"
Lotus,Shake and Jake,FIU Varsity,13,3,9,3,0,4,"Breach,Raze,Cypher,Fade,Clove","Raze,Omen,Skye,Chamber,Gekko"
Icebox,Bedwars Lions,Akatsuki Aimers,13,3,9,3,0,4,"Killjoy,Viper,Jett,KAY/O,Gekko","Sova,Killjoy,Viper,Jett,Gekko"
Bind,Sad Green,Dolbaebi,6,13,3,4,9,3,"Raze,Cypher,Brimstone,Skye,Deadlock","Raze,Viper,Brimstone,Skye,Deadlock"
Bind,FIU Varsity,Raiders of the Knight,3,13,1,3,10,2,"Raze,Brimstone,Skye,Yoru,Chamber","Raze,Skye,Astra,Chamber,Iso"
Ascent,OverLoaded,the gnomes,13,9,5,7,2,8,"Cypher,Sova,Omen,Yoru,Fade","Sova,Killjoy,Omen,Jett,KAY/O"
Ascent,Shake and Jake,EarnYourMedal,13,10,7,5,5,6,"Sova,Killjoy,Omen,Jett,KAY/O","Sova,Killjoy,Omen,Jett,KAY/O"
Haven,Bedwars Lions,Akatsuki Aimers,13,8,4,5,3,9,"Killjoy,Viper,Omen,Jett,Skye","Breach,Sova,Killjoy,Omen,Jett"
Sunset,FIU Varsity,Raiders of the Knight,5,13,4,8,5,1,"Breach,Raze,Cypher,Omen,Gekko","Raze,Cypher,Omen,Gekko,Iso"
Lotus,Sad Green,Dolbaebi,11,13,5,7,6,6,"Breach,Raze,Cypher,Sova,Clove","Raze,Killjoy,Viper,Omen,Fade"
Lotus,Bedwars Lions,Akatsuki Aimers,8,13,6,3,10,2,"Breach,Raze,Cypher,Omen,Fade","Breach,Cypher,Omen,Neon,Fade"
Lotus,OverLoaded,the gnomes,11,13,8,4,9,3,"Breach,Cypher,Neon,Fade,Clove","Breach,Cypher,Omen,Neon,Gekko"
Sunset,Shake and Jake,EarnYourMedal,13,8,8,4,4,5,"Breach,Raze,Cypher,Omen,Gekko","Cypher,Reyna,KAY/O,Gekko,Clove"
Icebox,NIGERIA 96,LRNJ,13,8,7,5,3,6,"Sova,Killjoy,Viper,Jett,Harbor","Sova,Killjoy,Viper,Jett,Harbor"
Haven,MIBR GC,Team Liquid Brazil,13,15,9,5,10,4,"Breach,Sova,Killjoy,Omen,Jett","Cypher,Sova,Omen,Yoru,Iso"
Icebox,Dolbaebi,the gnomes,13,1,2,0,1,11,"Sova,Killjoy,Viper,Reyna,Jett","Sova,Killjoy,Viper,Harbor,Gekko"
Icebox,Sad Green,the gnomes,13,1,2,0,1,11,"Sova,Killjoy,Viper,Reyna,Jett","Sova,Killjoy,Viper,Harbor,Gekko"
Haven,Purpose Gaming,Akatsuki Aimers,8,13,4,8,5,4,"Breach,Cypher,Sova,Omen,Neon","Sova,Reyna,Jett,Chamber,Clove"
Haven,Bedwars Lions,wadadaa,13,11,7,5,6,6,"Killjoy,Viper,Omen,Jett,Skye","Cypher,Reyna,Omen,Jett,Neon"
Sunset,FIU Varsity,EarnYourMedal,8,13,6,6,7,2,"Cypher,Sova,Omen,Neon,Gekko","Cypher,Reyna,KAY/O,Gekko,Clove"
Sunset,NIGERIA 96,LRNJ,9,13,4,6,7,5,"Viper,Sage,Omen,KAY/O,Gekko","Cypher,Sova,Omen,KAY/O,Neon"
Ascent,RD E-SPORTS,NoOrg9,1,13,0,2,11,1,"Sova,Killjoy,Omen,Jett,KAY/O","Sova,Killjoy,Omen,Jett,KAY/O"
Haven,Agropesca Jacare,Team YOSO,14,12,7,6,6,7,"Cypher,Sova,Omen,Yoru,Iso","Breach,Cypher,Sova,Omen,Neon"
Bind,MIBR GC,Team Liquid Brazil,16,18,8,9,9,8,"Raze,Viper,Brimstone,Fade,Gekko","Raze,Cypher,Viper,Brimstone,Skye"
Abyss,Machine Esports,Purpose Gaming,12,14,9,4,10,3,"Cypher,Sova,Omen,Jett,Iso","Sova,Killjoy,Viper,Yoru,Astra"
Haven,Dolbaebi,the gnomes,11,13,8,4,9,3,"Breach,Sova,Killjoy,Omen,Jett","Breach,Sova,Killjoy,Omen,Jett"
Haven,Sad Green,the gnomes,11,13,8,4,9,3,"Breach,Sova,Killjoy,Omen,Jett","Breach,Sova,Killjoy,Omen,Jett"
Lotus,Omnipotence,Akatsuki Aimers,7,13,5,3,10,2,"Raze,Cypher,Omen,Fade,Deadlock","Breach,Cypher,Omen,Neon,Fade"
Lotus,FIU Varsity,EarnYourMedal,13,11,6,6,5,7,"Raze,Omen,Skye,Chamber,Gekko","Breach,Killjoy,Reyna,Omen,Skye"
Lotus,RD E-SPORTS,NoOrg9,13,6,5,2,4,8,"Raze,Killjoy,Viper,Omen,Skye","Raze,Killjoy,Viper,Omen,Fade"
Sunset,Agropesca Jacare,Team YOSO,13,6,4,3,3,9,"Breach,Raze,Cypher,Sova,Astra","Breach,Cypher,Sova,Omen,Neon"
Sunset,Shake and Jake,Raiders of the Knight,14,12,5,8,4,9,"Breach,Raze,Cypher,Omen,Gekko","Raze,Omen,Chamber,Gekko,Iso"
Lotus,Weber State University,wadadaa,17,19,13,5,14,4,"Breach,Raze,Killjoy,Omen,Gekko","Raze,Cypher,Omen,Skye,Deadlock"
Icebox,Death be Happen,Bedwars Lions,6,13,0,0,7,3,"Sova,Killjoy,Viper,Jett,Gekko","Killjoy,Viper,Jett,KAY/O,Gekko"
Sunset,Event Horizon,The Villans,13,8,6,3,5,7,"Raze,Cypher,Sova,Omen,Neon","Breach,Cypher,Sova,Omen,Neon"
Lotus,NIGERIA 96,LRNJ,17,15,8,8,7,9,"Breach,Cypher,Omen,Neon,Fade","Breach,Raze,Cypher,Omen,Fade"
Ascent,Dolbaebi,OverLoaded,13,6,4,3,3,9,"Sova,Killjoy,Omen,Jett,KAY/O","Cypher,Sova,Omen,Yoru,Fade"
Abyss,Machine Esports,Yucky Aim,13,7,5,3,4,8,"Cypher,Sova,Omen,Jett,Iso","Breach,Cypher,Jett,Astra,Gekko"
Haven,blend,Akatsuki Aimers,7,13,4,4,9,3,"Breach,Cypher,Sova,Omen,Jett","Sova,Reyna,Jett,Chamber,Clove"
Bind,Sad Green,the gnomes,13,6,8,4,2,5,"Raze,Viper,Brimstone,Skye,Deadlock","Raze,Viper,Brimstone,Skye,Gekko"
Bind,Dolbaebi,the gnomes,13,6,8,4,2,5,"Raze,Viper,Brimstone,Skye,Deadlock","Raze,Viper,Brimstone,Skye,Gekko"
Lotus,MIBR GC,Team Liquid Brazil,13,5,7,5,0,6,"Raze,Killjoy,Viper,Omen,Fade","Raze,Killjoy,Viper,Omen,Fade"
Icebox,Death be Happen,AKIMBO,13,1,11,1,0,2,"Sova,Killjoy,Viper,Jett,Gekko","Sova,Killjoy,Viper,Jett,Gekko"
Icebox,FIU Varsity,EarnYourMedal,8,13,3,6,7,5,"Sova,Killjoy,Viper,Jett,Chamber","Sova,Killjoy,Viper,Jett,KAY/O"
Haven,Senchigami,wadadaa,5,13,2,4,9,3,"Breach,Sova,Killjoy,Omen,Jett","Cypher,Reyna,Omen,Jett,Neon"
Ascent,Shake and Jake,Raiders of the Knight,13,2,10,2,0,3,"Sova,Killjoy,Omen,Jett,KAY/O","Sova,Killjoy,Omen,Jett,KAY/O"
Haven,Purpose Gaming,patty flippers,13,4,10,2,2,3,"Breach,Cypher,Sova,Omen,Neon","Cypher,Sova,Reyna,Omen,Jett"
Lotus,Vortex VTX,Omnipotence,0,13,0,12,1,0,"Breach,Cypher,Viper,Omen,Neon","Raze,Cypher,Omen,Fade,Deadlock"
Lotus,Event Horizon,The Villans,13,2,10,2,0,3,"Breach,Raze,Cypher,Omen,Fade","Breach,Raze,Cypher,Omen,Gekko"
Haven,Bedwars Lions,Event Horizon Red,13,8,6,6,2,7,"Killjoy,Viper,Omen,Jett,Skye","Sova,Killjoy,Omen,Jett,Neon"
Haven,Dolbaebi,OverLoaded,13,4,4,1,3,9,"Breach,Cypher,Sova,Jett,Clove","Killjoy,Viper,Omen,Jett,Skye"
Bind,Goon that jawn,#flyaway,13,8,3,6,2,10,"Breach,Raze,Skye,Deadlock,Clove","Raze,Brimstone,Reyna,Yoru,Gekko"
Haven,RD E-SPORTS,NoOrg9,15,17,11,5,12,4,"Breach,Sova,Killjoy,Omen,Jett","Breach,Cypher,Sova,Omen,Jett"
Lotus,SSJ de Óculos,Agropesca Jacare,6,13,2,5,8,4,"Raze,Killjoy,Viper,Omen,Fade","Raze,Omen,Chamber,Fade,Clove"
Haven,SYN,Weber State University,2,13,2,10,3,0,"Killjoy,Viper,Omen,Jett,Skye","Breach,Cypher,Sova,Omen,Jett"
Haven,Azure Bears,LRNJ,4,13,1,4,9,3,"Breach,Sova,Killjoy,Omen,Neon","Breach,Cypher,Sova,Omen,Jett"
Lotus,Akatsuki Aimers,Yumi Tanuki,13,1,2,0,1,11,"Breach,Cypher,Omen,Neon,Fade","Breach,Raze,Killjoy,Omen,Fade"
Haven,Ibreon Esports Amethyst,Event Horizon Red,4,13,0,5,8,4,"Breach,Sova,Killjoy,Omen,Jett","Sova,Killjoy,Omen,Jett,Neon"
Ascent,Cardboard Dragons,AKIMBO,7,13,2,10,3,5,"Sova,Killjoy,Omen,Jett,KAY/O","Sova,Killjoy,Omen,Jett,KAY/O"
Abyss,Omnipotence,Guardian Esports,13,4,10,2,2,3,"Breach,Sova,Killjoy,Omen,Jett","Cypher,Sova,Omen,Jett,KAY/O"
Haven,Bedwars Lions,OutGoing Esports,13,4,5,0,4,8,"Killjoy,Viper,Omen,Jett,Skye","Breach,Sova,Killjoy,Omen,Jett"
Lotus,Paranoia Boys,Yucky Aim,12,14,6,7,7,6,"Breach,Raze,Cypher,Omen,Gekko","Killjoy,Viper,Omen,Jett,Gekko"
Ascent,Purpose Gaming,JabootyModeGaming,13,3,4,0,3,9,"Sova,Killjoy,Omen,Jett,KAY/O","Sova,Killjoy,Brimstone,Jett,Skye"
Haven,ColdFront Esports,blend,4,13,1,11,2,3,"Breach,Sova,Killjoy,Omen,Jett","Breach,Cypher,Sova,Omen,Jett"
Abyss,wadadaa,Raven Esports,13,4,8,4,0,5,"Cypher,Reyna,Omen,Jett,Neon","Sova,Omen,Jett,Harbor,Deadlock"
Ascent,Team YOSO,lanchonete do gerso,13,8,7,2,6,6,"Sova,Killjoy,Omen,Jett,KAY/O","Sova,Killjoy,Omen,Jett,KAY/O"
Sunset,DRACC,NIGERIA 96,3,13,2,10,3,1,"Breach,Cypher,Omen,Neon,Deadlock","Viper,Sage,Omen,KAY/O,Gekko"
Haven,Goon that jawn,#flyaway,13,11,6,6,5,7,"Cypher,Sova,Omen,Yoru,Iso","Breach,Sova,Killjoy,Omen,Jett"
Haven,SAIDEIRA ESPORTS,Team Liquid Brazil,10,13,5,6,7,5,"Breach,Sova,Killjoy,Omen,Jett","Cypher,Sova,Omen,Yoru,Iso"
Lotus,NoOrg9,Vex Dragons,13,6,5,2,4,8,"Raze,Killjoy,Viper,Omen,Fade","Raze,Killjoy,Omen,Fade,Deadlock"
Lotus,RD E-SPORTS,Os Bate Laje,13,9,8,2,7,5,"Raze,Killjoy,Viper,Omen,Skye","Breach,Killjoy,Omen,Jett,Gekko"
Haven,Event Horizon,uhhhhh,7,13,3,9,4,4,"Breach,Sova,Killjoy,Omen,Jett","Breach,Sova,Killjoy,Omen,Jett"
Icebox,Azure Bears,LRNJ,14,12,8,5,7,6,"Omen,KAY/O,Harbor,Gekko,Clove","Sova,Killjoy,Viper,Jett,Harbor"
Bind,SSJ de Óculos,Agropesca Jacare,13,9,8,4,5,5,"Raze,Viper,Skye,Gekko,Clove","Raze,Cypher,Viper,Brimstone,Skye"
Lotus,SAIDEIRA ESPORTS,Team Liquid Brazil,5,13,2,4,9,3,"Raze,Killjoy,Viper,Omen,Fade","Raze,Killjoy,Viper,Omen,Fade"
Bind,DRACC,NIGERIA 96,14,12,8,5,7,6,"Cypher,Brimstone,Skye,Neon,Deadlock","Raze,Viper,Omen,Skye,Harbor"
Haven,MIBR GC,Valoriza,13,6,3,4,2,10,"Breach,Sova,Killjoy,Omen,Jett","Breach,Cypher,Omen,Neon,Fade"
Haven,RD E-SPORTS,Os Bate Laje,13,4,8,4,0,5,"Breach,Sova,Killjoy,Omen,Jett","Breach,Sova,Killjoy,Omen,Jett"
Haven,Team YOSO,lanchonete do gerso,15,17,10,6,11,5,"Breach,Cypher,Sova,Omen,Neon","Breach,Omen,Jett,Chamber,Fade"
Lotus,Event Horizon,uhhhhh,13,11,6,6,5,7,"Breach,Raze,Cypher,Omen,Fade","Raze,Cypher,Omen,Gekko,Iso"
Lotus,#flyaway,The Villans,13,5,8,4,1,5,"Cypher,Neon,Deadlock,Iso,Clove","Raze,Cypher,Omen,Fade,Iso"
Haven,Burger Boyz 2.0,F5 Esports,13,11,9,3,8,4,"Breach,Sova,Killjoy,Omen,Neon","Breach,Sova,Killjoy,Jett,Astra"
Lotus,Azure Bears,LRNJ,8,13,6,3,10,2,"Breach,Cypher,Omen,Neon,Fade","Breach,Raze,Cypher,Omen,Fade"
Abyss,ROSE,Reign Above,13,5,5,1,4,8,"Cypher,Sova,Omen,Yoru,Deadlock","Cypher,Sova,Omen,Jett,Yoru"
Bind,NoOrg9,Vex Dragons,13,8,8,1,7,5,"Raze,Viper,Brimstone,Skye,Gekko","Raze,Cypher,Brimstone,Skye,Deadlock"
Lotus,MIBR GC,Valoriza,13,0,12,0,0,1,"Raze,Killjoy,Viper,Omen,Fade","Raze,Cypher,Omen,Fade,Deadlock"
Sunset,SSJ de Óculos,Agropesca Jacare,11,13,5,7,6,6,"Breach,Cypher,Sova,Omen,Neon","Breach,Raze,Cypher,Sova,Astra"
Bind,SAIDEIRA ESPORTS,Team Liquid Brazil,13,8,3,6,2,10,"Raze,Viper,Brimstone,Fade,Gekko","Raze,Cypher,Viper,Brimstone,Skye"
Lotus,DRACC,NIGERIA 96,3,13,3,9,4,0,"Breach,Killjoy,Omen,Neon,Deadlock","Breach,Cypher,Omen,Neon,Fade"
Sunset,Team YOSO,lanchonete do gerso,13,3,10,2,1,3,"Breach,Cypher,Sova,Omen,Neon","Raze,Cypher,Omen,Gekko,Deadlock"
Ascent,Event Horizon,uhhhhh,8,13,1,8,5,7,"Sova,Killjoy,Omen,Jett,KAY/O","Sova,Killjoy,Reyna,Omen,Jett"
Lotus,ROSE,Reign Above,13,1,2,0,1,11,"Raze,Killjoy,Viper,Omen,Fade","Breach,Killjoy,Omen,Neon,Fade"
Icebox,#flyaway,The Villans,13,5,5,1,4,8,"Sova,Viper,Sage,Jett,Chamber","Killjoy,Viper,Omen,KAY/O,Gekko"
Lotus,Burger Boyz 2.0,F5 Esports,13,8,8,4,4,5,"Breach,Raze,Cypher,Gekko,Clove","Breach,Cypher,Neon,Fade,Clove"
Bind,ROSE,Burger Boyz 2.0,13,4,3,2,2,10,"Raze,Brimstone,Skye,Gekko,Deadlock","Raze,Cypher,Viper,Brimstone,Skye"
Bind,uhhhhh,The Villans,13,8,3,6,2,10,"Raze,Skye,Deadlock,Iso,Clove","Raze,Viper,Astra,Fade,Gekko"
Haven,Neira Esports,STRIX,11,13,6,6,7,5,"Breach,Cypher,Sova,Brimstone,Jett","Breach,Cypher,Omen,Jett,Skye"
Lotus,F5 Esports,Reign Above,13,4,11,1,3,2,"Breach,Cypher,Neon,Fade,Clove","Breach,Killjoy,Omen,Neon,Fade"
Icebox,ROSE,Burger Boyz 2.0,13,6,4,3,3,9,"Killjoy,Viper,Sage,Jett,Gekko","Sova,Killjoy,Viper,Jett,Gekko"
Lotus,Goon that jawn,Event Horizon,13,5,3,3,2,10,"Breach,Cypher,Neon,Fade,Clove","Breach,Raze,Cypher,Omen,Fade"
Icebox,FBU ESPORTS,PARABELLUM,2,13,0,3,10,2,"Sova,Viper,Sage,Jett,Gekko","Sova,Killjoy,Viper,Jett,KAY/O"
Lotus,uhhhhh,The Villans,10,13,4,8,5,6,"Breach,Raze,Killjoy,Omen,Gekko","Breach,Raze,Cypher,Omen,Gekko"
Haven,Goon that jawn,Event Horizon,13,6,3,4,2,10,"Cypher,Sova,Omen,Yoru,Iso","Breach,Sova,Killjoy,Omen,Jett"
Ascent,F5 Esports,Reign Above,13,5,4,2,3,9,"Sova,Killjoy,Omen,Jett,KAY/O","Sova,Killjoy,Omen,Jett,KAY/O"
Haven,ROSE,Burger Boyz 2.0,8,13,2,7,6,6,"Sova,Killjoy,Yoru,Astra,Neon","Breach,Sova,Killjoy,Omen,Neon"
Ascent,uhhhhh,The Villans,13,7,9,3,4,4,"Sova,Killjoy,Reyna,Omen,Jett","Cypher,Sova,Omen,Jett,Deadlock"
Haven,Vixen Esports,Bilgi Esports,14,12,5,8,4,9,"Breach,Sova,Killjoy,Omen,Jett","Breach,Sova,Killjoy,Omen,Jett"
Haven,Burger Boyz 2.0,Reign Above,13,3,3,1,2,10,"Breach,Sova,Killjoy,Omen,Neon","Breach,Sova,Killjoy,Omen,Jett"
Lotus,F5 Esports,ROSE,11,13,8,4,9,3,"Breach,Cypher,Neon,Fade,Clove","Raze,Killjoy,Viper,Omen,Fade"
Bind,#flyaway,Event Horizon,13,5,10,2,3,3,"Raze,Brimstone,Reyna,Yoru,Gekko","Raze,Viper,Brimstone,Fade,Gekko"
Haven,ARTHEA,SNIPE Esports,13,4,4,1,3,9,"Breach,Sova,Killjoy,Omen,Jett","Breach,Cypher,Sova,Omen,Jett"
Abyss,Burger Boyz 2.0,Reign Above,13,11,6,6,5,7,"Breach,Cypher,Sova,Omen,Jett","Cypher,Sova,Omen,Jett,Yoru"
Ascent,Goon that jawn,uhhhhh,13,9,6,6,3,7,"Sova,Killjoy,Omen,Yoru,Iso","Sova,Killjoy,Omen,Jett,KAY/O"
Haven,F5 Esports,ROSE,11,13,6,6,7,5,"Breach,Sova,Killjoy,Jett,Astra","Sova,Killjoy,Yoru,Astra,Neon"
Ascent,Burger Boyz 2.0,Reign Above,11,13,5,7,6,6,"Cypher,Sova,Omen,Jett,Deadlock","Sova,Killjoy,Omen,Jett,KAY/O"
Lotus,#flyaway,Event Horizon,13,9,8,2,7,5,"Raze,Cypher,Gekko,Deadlock,Clove","Breach,Raze,Cypher,Omen,Fade"
Lotus,FNATIC,Bilibili Gaming,13,4,3,2,2,10,"Raze,Killjoy,Viper,Omen,Fade","Breach,Cypher,Omen,Neon,Fade"
Bind,FNATIC,Bilibili Gaming,13,9,6,4,5,7,"Raze,Viper,Astra,Fade,Gekko","Raze,Cypher,Viper,Brimstone,Skye"
Bind,DRX,KRÜ Esports,13,6,4,3,3,9,"Raze,Viper,Brimstone,Fade,Gekko","Raze,Viper,Brimstone,Fade,Gekko"
Abyss,DRX,KRÜ Esports,13,6,5,2,4,8,"Cypher,Sova,Omen,Jett,KAY/O","Cypher,Sova,Omen,KAY/O,Harbor"
Haven,DRX,KRÜ Esports,2,13,2,10,3,0,"Breach,Cypher,Sova,Omen,Jett","Breach,Cypher,Sova,Omen,Neon"
Ascent,LazerrFreeks Ivy,Envee Sapphire GC,13,6,8,4,2,5,"Sova,Killjoy,Omen,Jett,KAY/O","Sova,Killjoy,Omen,Jett,KAY/O"
Lotus,SaD FROST,minions united GC,13,10,6,5,5,7,"Breach,Cypher,Neon,Gekko,Clove","Breach,Raze,Killjoy,Omen,Fade"
Sunset,SaD FROST,Charmers GC,13,6,8,4,2,5,"Breach,Raze,Cypher,Fade,Clove","Breach,Raze,Cypher,Omen,Fade"
Ascent,Coalesce,Hidden Horizon,13,8,5,7,1,8,"Cypher,Sova,Phoenix,Omen,Jett","Sova,Killjoy,Omen,Jett,KAY/O"
Icebox,Coalesce,Hidden Horizon,13,5,4,2,3,9,"Sova,Killjoy,Viper,Reyna,Jett","Sova,Killjoy,Viper,Jett,Gekko"
Lotus,Requiem,Jabba Enjoyers,13,9,8,2,7,5,"Cypher,Viper,Omen,Neon,Fade","Breach,Raze,Killjoy,Omen,Fade"
Icebox,Requiem,Jabba Enjoyers,13,8,6,3,5,7,"Killjoy,Viper,Jett,KAY/O,Gekko","Sova,Killjoy,Viper,Jett,Deadlock"
Lotus,FunPlus Phoenix,Team Heretics,13,15,6,8,7,7,"Raze,Viper,Omen,Astra,Gekko","Raze,Killjoy,Viper,Omen,Fade"
Bind,FunPlus Phoenix,Team Heretics,13,9,5,5,4,8,"Viper,Omen,Yoru,Chamber,Fade","Raze,Viper,Brimstone,Fade,Gekko"
Abyss,FunPlus Phoenix,Team Heretics,12,14,8,5,9,4,"Cypher,Viper,Omen,Yoru,Fade","Cypher,Sova,Jett,Astra,Gekko"
Ascent,Gen.G Esports,Sentinels,13,7,8,4,3,5,"Sova,Killjoy,Omen,Jett,KAY/O","Cypher,Sova,Omen,Jett,Deadlock"
Haven,Gen.G Esports,Sentinels,13,8,6,3,5,7,"Killjoy,Viper,Omen,Jett,Skye","Breach,Cypher,Sova,Omen,Jett"
Sunset,minions united GC,Tenax GC,13,6,9,3,3,4,"Breach,Raze,Cypher,Omen,Gekko","Cypher,Omen,KAY/O,Neon,Fade"
Sunset,LazerrFreeks Ivy,Tenax GC,14,12,5,8,4,9,"Raze,Cypher,Fade,Gekko,Clove","Cypher,Omen,KAY/O,Neon,Fade"
Haven,K7 Esports GC,Bon Bon Bum Contra GC,9,13,2,8,5,7,"Breach,Cypher,Sova,Omen,Jett","Breach,Cypher,Sova,Omen,Deadlock"
Sunset,K7 Esports GC,Bon Bon Bum Contra GC,7,13,3,9,4,4,"Cypher,Sova,Omen,Jett,KAY/O","Breach,Sova,Sage,Omen,Gekko"
Lotus,M80,TSM,13,2,2,1,1,11,"Cypher,Sage,Omen,Fade,Deadlock","Breach,Cypher,Omen,Neon,Gekko"
Haven,University War GC,Zen eSports GC,13,11,10,2,9,3,"Breach,Cypher,Sova,Omen,Neon","Breach,Sova,Killjoy,Omen,Jett"
Sunset,M80,TSM,13,8,4,5,3,9,"Breach,Cypher,Omen,Yoru,Gekko","Breach,Cypher,Omen,Neon,Gekko"
Sunset,University War GC,Zen eSports GC,13,10,8,4,6,5,"Breach,Raze,Cypher,Omen,Fade","Breach,Cypher,Sova,Omen,Neon"
Haven,KPI Gaming,CGN Esports,6,13,5,7,6,1,"Breach,Sova,Killjoy,Omen,Jett","Sova,Phoenix,Omen,Jett,Deadlock"
Ascent,KPI Gaming,CGN Esports,11,13,3,9,4,8,"Sova,Killjoy,Omen,Jett,KAY/O","Sova,Killjoy,Phoenix,Jett,Astra"
Lotus,KPI Gaming,CGN Esports,9,13,7,3,10,2,"Raze,Viper,Omen,Chamber,Fade","Raze,Sova,Killjoy,Omen,Gekko"
Ascent,NAOS Esports,ZOL Esports,14,12,7,6,6,7,"Cypher,Sova,Omen,Jett,Deadlock","Sova,Killjoy,Omen,Jett,KAY/O"
Lotus,NAOS Esports,ZOL Esports,12,14,7,6,8,5,"Breach,Raze,Cypher,Omen,Fade","Breach,Raze,Killjoy,Sage,Omen"
Bind,NAOS Esports,ZOL Esports,10,13,5,7,6,5,"Raze,Cypher,Viper,Brimstone,Skye","Raze,Cypher,Brimstone,Skye,Gekko"
Haven,NAOS Esports,ZOL Esports,13,3,4,0,3,9,"Breach,Cypher,Sova,Omen,Neon","Sova,Killjoy,Reyna,Omen,Yoru"
Icebox,NAOS Esports,ZOL Esports,15,13,9,5,8,6,"Sova,Killjoy,Viper,Jett,Harbor","Sova,Killjoy,Viper,Jett,KAY/O"
Bind,KS Esports GC,Akave Esports Black,10,13,6,5,8,4,"Raze,Viper,Brimstone,Skye,Gekko","Raze,Cypher,Viper,Brimstone,Skye"
Ascent,KS Esports GC,Akave Esports Black,9,13,7,5,8,2,"Cypher,Sova,Omen,Jett,Deadlock","Cypher,Sova,Omen,Jett,KAY/O"
Icebox,Leviatán GC,9z Team GC,4,13,4,8,5,0,"Killjoy,Viper,Jett,KAY/O,Clove","Killjoy,Viper,Jett,KAY/O,Gekko"
Bind,TBS GC,Team Leveling,12,14,6,7,7,6,"Viper,Brimstone,Neon,Fade,Gekko","Raze,Viper,Brimstone,Skye,Gekko"
Haven,Leviatán GC,9z Team GC,6,13,3,4,9,3,"Breach,Cypher,Viper,Omen,Neon","Breach,Cypher,Omen,Neon,Gekko"
Icebox,TBS GC,Team Leveling,7,13,2,10,3,5,"Sova,Killjoy,Viper,Jett,Gekko","Killjoy,Viper,KAY/O,Gekko,Iso"
Haven,Moist x Shopify,TSM,7,13,3,9,4,4,"Breach,Sova,Killjoy,Omen,Jett","Breach,Cypher,Sova,Omen,Neon"
Sunset,Leviatán GC,9z Team GC,13,11,7,5,6,6,"Breach,Cypher,Omen,Neon,Fade","Breach,Omen,Neon,Gekko,Deadlock"
Haven,TBS GC,Team Leveling,13,10,4,7,3,9,"Breach,Sova,Killjoy,Omen,Jett","Breach,Cypher,Sova,Omen,Neon"
Ascent,Moist x Shopify,TSM,9,13,3,9,4,6,"Cypher,Sova,Omen,Jett,Deadlock","Cypher,Sova,Omen,Jett,KAY/O"
Lotus,LOUD GC,REVOADA,13,7,10,2,5,3,"Cypher,Omen,KAY/O,Neon,Fade","Raze,Killjoy,Viper,Omen,Fade"
Lotus,Galakticos,CGN Esports,6,13,3,4,9,3,"Breach,Raze,Sova,Omen,Chamber","Raze,Sova,Killjoy,Omen,Gekko"
Sunset,Moist x Shopify,TSM,14,12,8,5,7,6,"Cypher,Sova,Omen,KAY/O,Neon","Breach,Cypher,Omen,Neon,Gekko"
Icebox,LOUD GC,REVOADA,13,4,10,2,2,3,"Killjoy,Viper,Jett,KAY/O,Gekko","Sova,Killjoy,Viper,Jett,Gekko"
Bind,Galakticos,CGN Esports,13,6,8,4,2,5,"Raze,Viper,Brimstone,Fade,Gekko","Viper,Phoenix,Brimstone,Yoru,Deadlock"
Ascent,Galakticos,CGN Esports,7,13,2,6,7,5,"Cypher,Sova,Omen,Jett,KAY/O","Sova,Killjoy,Phoenix,Jett,Astra"
Lotus,KPI Gaming,Valiant,13,11,8,4,7,5,"Raze,Viper,Omen,Chamber,Fade","Raze,Cypher,Omen,Fade,Deadlock"
Ascent,KPI Gaming,Valiant,6,13,1,6,7,5,"Sova,Killjoy,Omen,Jett,KAY/O","Sova,Killjoy,Omen,Jett,KAY/O"
Icebox,KPI Gaming,Valiant,13,2,10,2,0,3,"Killjoy,Viper,Jett,KAY/O,Gekko","Sova,Killjoy,Viper,Jett,Gekko"
Abyss,MYVRA,FUSION X,8,13,6,6,7,2,"Breach,Raze,Cypher,Sova,Astra","Breach,Cypher,Omen,Jett,Gekko"
Haven,MYVRA,FUSION X,13,8,4,5,3,9,"Breach,Raze,Killjoy,Astra,Fade","Cypher,Sova,Astra,Gekko,Iso"
Icebox,Charmers GC,Envee Sapphire GC,13,5,9,3,2,4,"Sova,Killjoy,Viper,Jett,Gekko","Sova,Killjoy,Viper,Reyna,Jett"
Bind,MYVRA,FUSION X,3,13,0,4,9,3,"Raze,Cypher,Brimstone,Skye,Fade","Raze,Cypher,Brimstone,Skye,Gekko"
Haven,MIBR GC,LOUD GC,13,10,4,7,3,9,"Breach,Sova,Killjoy,Omen,Jett","Breach,Cypher,Sova,Omen,Neon"
Bind,Oxygen Esports,TSM,10,13,5,7,6,5,"Brimstone,Omen,Yoru,Fade,Deadlock","Raze,Brimstone,Skye,Gekko,Deadlock"
Lotus,FiRePOWER GC,KRÜ BLAZE,7,13,2,6,7,5,"Breach,Cypher,Omen,Neon,Fade","Raze,Killjoy,Viper,Omen,Fade"
Bind,MIBR GC,LOUD GC,13,9,8,4,5,5,"Raze,Viper,Brimstone,Fade,Gekko","Raze,Brimstone,Omen,Skye,Neon"
Sunset,Oxygen Esports,TSM,12,14,8,5,9,4,"Breach,Raze,Cypher,Omen,KAY/O","Breach,Cypher,Omen,Neon,Gekko"
Sunset,FiRePOWER GC,KRÜ BLAZE,5,13,5,7,6,0,"Breach,Cypher,Sova,Omen,Neon","Breach,Cypher,Sova,Omen,Neon"
Sunset,Team Liquid Brazil,TBS GC,13,8,8,1,7,5,"Breach,Raze,Cypher,Omen,Gekko","Breach,Cypher,Omen,Neon,Gekko"
Icebox,Team Liquid Brazil,TBS GC,10,13,5,6,7,5,"Killjoy,Viper,Omen,KAY/O,Gekko","Sova,Killjoy,Viper,Jett,Gekko"
Abyss,SweetNsour,NOVO Esports,12,14,7,6,8,5,"Cypher,Sova,Omen,Jett,KAY/O","Cypher,Sova,Yoru,Astra,Harbor"
Icebox,Moist x Shopify,M80,12,14,6,7,7,6,"Killjoy,Viper,Reyna,KAY/O,Gekko","Killjoy,Viper,Omen,KAY/O,Gekko"
Ascent,SweetNsour,NOVO Esports,13,8,9,3,5,4,"Sova,Killjoy,Omen,Jett,KAY/O","Cypher,Sova,Omen,Jett,Deadlock"
Lotus,Moist x Shopify,M80,9,13,2,8,5,7,"Raze,Cypher,Viper,Omen,Fade","Cypher,Sage,Omen,Fade,Deadlock"
Bind,Team Liquid Brazil,TBS GC,13,8,8,1,7,5,"Raze,Cypher,Viper,Brimstone,Skye","Viper,Brimstone,Neon,Fade,Gekko"
Icebox,SweetNsour,NOVO Esports,8,13,5,4,9,3,"Killjoy,Viper,Jett,KAY/O,Gekko","Killjoy,Viper,Jett,KAY/O,Gekko"
Sunset,Team Colt,Requiem,10,13,7,4,9,3,"Cypher,Omen,KAY/O,Neon,Gekko","Raze,Cypher,Omen,KAY/O,Gekko"
Bind,Salmans,Siko Esports,6,13,4,8,5,2,"Raze,Viper,Brimstone,Fade,Gekko","Raze,Viper,Brimstone,Skye,Gekko"
Lotus,Team Colt,Requiem,5,13,5,7,6,0,"Breach,Killjoy,Omen,Neon,Fade","Raze,Cypher,Viper,Omen,Fade"
Ascent,Salmans,Siko Esports,13,10,8,4,6,5,"Cypher,Sova,Omen,Jett,Deadlock","Cypher,Sova,Omen,Jett,KAY/O"
Ascent,Valiant,NOVO Esports,13,8,5,7,1,8,"Sova,Killjoy,Omen,Jett,KAY/O","Cypher,Sova,Omen,Jett,Deadlock"
Sunset,Salmans,Siko Esports,8,13,3,6,7,5,"Raze,Cypher,Omen,KAY/O,Gekko","Breach,Raze,Cypher,Sova,Omen"
Bind,Valiant,NOVO Esports,13,2,10,2,0,3,"Raze,Viper,Brimstone,Skye,Gekko","Viper,Brimstone,Skye,Yoru,Gekko"
Haven,Valiant,NOVO Esports,8,13,7,5,8,1,"Breach,Cypher,Sova,Omen,Neon","Breach,Cypher,Sova,Omen,Neon"
Lotus,SweetNsour,Valiant,8,13,4,5,8,4,"Breach,Raze,Cypher,Omen,Fade","Raze,Cypher,Omen,Fade,Deadlock"
Bind,SweetNsour,Valiant,13,15,7,7,8,6,"Raze,Viper,Brimstone,Fade,Gekko","Raze,Viper,Brimstone,Skye,Gekko"
Ascent,All Knights,E-Xolos LAZER,13,7,9,3,4,4,"Cypher,Sova,Omen,Jett,KAY/O","Cypher,Sova,Omen,Jett,Deadlock"
Bind,All Knights,E-Xolos LAZER,5,13,3,9,4,2,"Raze,Viper,Brimstone,Fade,Gekko","Raze,Viper,Brimstone,Skye,Gekko"
Ascent,The7,Galorys,7,13,2,6,7,5,"Cypher,Sova,Omen,Yoru,Iso","Cypher,Sova,Omen,Jett,Deadlock"
Lotus,All Knights,E-Xolos LAZER,13,11,3,9,2,10,"Breach,Cypher,Omen,Neon,Fade","Breach,Raze,Cypher,Omen,Fade"
Split,The7,Galorys,6,13,4,8,5,2,"Breach,Cypher,Omen,Neon,Iso","Raze,Viper,Omen,Jett,Skye"
Sunset,All Knights,E-Xolos LAZER,13,5,9,3,2,4,"Breach,Cypher,Omen,Neon,Fade","Breach,Cypher,Sova,Omen,Neon"
Bind,SweetNsour,KPI Gaming,11,13,8,4,9,3,"Raze,Viper,Brimstone,Fade,Gekko","Viper,Brimstone,Yoru,Fade,Gekko"
Bind,The7,Galorys,8,13,6,6,7,2,"Breach,Neon,Fade,Iso,Clove","Raze,Viper,Brimstone,Fade,Gekko"
Haven,All Knights,E-Xolos LAZER,5,13,3,3,10,2,"Breach,Cypher,Sova,Astra,Neon","Breach,Cypher,Sova,Omen,Neon"
Lotus,CGN Esports,NOVO Esports,13,10,6,5,5,7,"Raze,Sova,Killjoy,Omen,Gekko","Breach,Cypher,Sova,Omen,Neon"
Icebox,SweetNsour,KPI Gaming,9,13,3,7,6,6,"Killjoy,Viper,Jett,KAY/O,Gekko","Killjoy,Viper,Jett,KAY/O,Gekko"
Lotus,Valiant,Galakticos,5,13,1,5,8,4,"Breach,Raze,Cypher,Omen,Fade","Breach,Raze,Sova,Omen,Chamber"
Lotus,The7,Galorys,13,11,8,4,7,5,"Breach,Omen,Neon,Fade,Iso","Raze,Cypher,Omen,Fade,Clove"
Abyss,CGN Esports,NOVO Esports,13,10,8,4,6,5,"Cypher,Sova,Phoenix,Omen,Jett","Cypher,Sova,Omen,Jett,KAY/O"
Lotus,R8 Esports,SweetNsour,6,13,5,7,6,1,"Raze,Killjoy,Viper,Omen,Skye","Breach,Raze,Cypher,Omen,Fade"
Icebox,Valiant,Galakticos,10,13,6,6,7,4,"Sova,Killjoy,Viper,Jett,Gekko","Sova,Killjoy,Viper,Jett,KAY/O"
Ascent,R8 Esports,SweetNsour,10,13,5,6,7,5,"Cypher,Sova,Omen,Yoru,Deadlock","Sova,Killjoy,Omen,Jett,KAY/O"
Sunset,NOVO Esports,PPP,16,14,9,6,8,7,"Cypher,Sova,Omen,KAY/O,Neon","Cypher,Sova,Omen,KAY/O,Neon"
Bind,Diamant Esports,Valiant,7,13,5,3,10,2,"Raze,Brimstone,Sage,Skye,Deadlock","Raze,Viper,Brimstone,Skye,Gekko"
Haven,NOVO Esports,PPP,13,5,7,5,0,6,"Breach,Cypher,Sova,Omen,Neon","Killjoy,Viper,Omen,Jett,Skye"
Icebox,R8 Esports,SweetNsour,13,11,7,5,6,6,"Killjoy,Viper,Sage,Reyna,Gekko","Killjoy,Viper,Jett,KAY/O,Gekko"
Icebox,Diamant Esports,Valiant,13,15,6,8,7,7,"Breach,Killjoy,Viper,Jett,Gekko","Sova,Killjoy,Viper,Jett,Gekko"
Lotus,NOVO Esports,PPP,9,13,6,6,7,3,"Breach,Cypher,Sova,Omen,Neon","Breach,Cypher,Sova,Omen,Neon"
Haven,KPI Gaming,R8 Esports,13,6,3,4,2,10,"Breach,Sova,Killjoy,Omen,Jett","Raze,Sova,Killjoy,Omen,Astra"
Lotus,Galakticos,Diamant Esports,7,13,4,8,5,3,"Breach,Raze,Sova,Omen,Chamber","Raze,Killjoy,Omen,Skye,Astra"
Haven,Galakticos,Diamant Esports,9,13,1,9,4,8,"Breach,Cypher,Sova,Omen,Jett","Raze,Killjoy,Omen,Astra,Fade"
Lotus,KPI Gaming,R8 Esports,13,10,4,7,3,9,"Raze,Viper,Omen,Chamber,Fade","Raze,Killjoy,Omen,Skye,Astra"
Sunset,PPP,CGN Esports,7,13,1,7,6,6,"Cypher,Sova,Omen,KAY/O,Neon","Raze,Cypher,Sova,Phoenix,Omen"
Haven,Fancy United Esports,Rapid Lofi,10,13,4,7,6,6,"Cypher,Omen,KAY/O,Neon,Fade","Cypher,Sova,Sage,Omen,Jett"
Sunset,Galakticos,Diamant Esports,13,8,8,4,4,5,"Raze,Cypher,Omen,KAY/O,Gekko","Raze,Killjoy,Omen,Astra,Fade"
Ascent,PPP,CGN Esports,7,13,2,6,7,5,"Cypher,Sova,Omen,Jett,Deadlock","Sova,Killjoy,Phoenix,Jett,Astra"
Bind,Alter Ego,BOOM Esports,5,13,3,9,4,2,"Raze,Cypher,Viper,Omen,Skye","Raze,Cypher,Viper,Brimstone,Skye"
Bind,Fancy United Esports,Rapid Lofi,13,2,3,0,2,10,"Raze,Cypher,Omen,KAY/O,Deadlock","Raze,Cypher,Viper,Brimstone,Skye"
Abyss,Alter Ego,BOOM Esports,11,13,4,8,5,7,"Breach,Raze,Cypher,Omen,KAY/O","Cypher,Sova,Omen,Jett,KAY/O"
Icebox,RIDDLE ORDER,FENNEL,13,9,6,4,5,7,"Killjoy,Viper,Jett,KAY/O,Gekko","Sova,Killjoy,Viper,Omen,KAY/O"
Ascent,Fancy United Esports,Rapid Lofi,10,13,6,5,8,4,"Cypher,Omen,Jett,KAY/O,Deadlock","Cypher,Sova,Sage,Omen,Jett"
Sunset,Alter Ego,BOOM Esports,13,11,3,9,2,10,"Breach,Raze,Cypher,Omen,Gekko","Breach,Raze,Cypher,Omen,Gekko"
Ascent,RIDDLE ORDER,FENNEL,14,12,6,7,5,8,"Sova,Killjoy,Omen,Jett,KAY/O","Sova,Killjoy,Omen,Jett,KAY/O"
Haven,Mir Gaming GC,URACHACHA,13,7,6,2,5,7,"Breach,Sova,Killjoy,Omen,Jett","Breach,Killjoy,Omen,Jett,Neon"
Ascent,Alter Ego,BOOM Esports,9,13,2,8,5,7,"Raze,Sova,Killjoy,Omen,KAY/O","Sova,Killjoy,Omen,Jett,KAY/O"
Sunset,Vatles Esports,Rub n' Pug,6,13,1,6,7,5,"Raze,Sova,Omen,Gekko,Deadlock","Raze,Cypher,Omen,Gekko,Iso"
Lotus,iPGN,BOBO,4,13,2,10,3,2,"Breach,Raze,Cypher,Omen,Fade","Raze,Cypher,Viper,Omen,Fade"
Haven,Made in Thailand,FULL SENSE,8,13,7,5,8,1,"Breach,Sova,Killjoy,Jett,Astra","Breach,Sova,Killjoy,Omen,Neon"
Icebox,Fancy United Esports,Rapid Lofi,11,13,7,5,8,4,"Cypher,Viper,KAY/O,Gekko,Clove","Killjoy,Viper,Sage,KAY/O,Gekko"
Bind,RIDDLE ORDER,FENNEL,13,11,7,5,6,6,"Raze,Viper,Brimstone,Fade,Gekko","Raze,Viper,Brimstone,Fade,Gekko"
Sunset,Mir Gaming GC,URACHACHA,7,13,3,9,4,4,"Breach,Cypher,Omen,Neon,Gekko","Cypher,Sova,Omen,Jett,Deadlock"
Ascent,iPGN,BOBO,2,13,0,12,1,2,"Sova,Killjoy,Omen,Jett,KAY/O","Sova,Killjoy,Omen,Jett,KAY/O"
Haven,Xipto Esports,sisu,13,9,6,6,3,7,"Breach,Sova,Killjoy,Omen,Jett","Breach,Cypher,Sova,Astra,Neon"
Bind,Vatles Esports,Rub n' Pug,10,13,7,5,8,3,"Raze,Brimstone,Fade,Gekko,Deadlock","Raze,Cypher,Brimstone,Skye,Iso"
Bind,Made in Thailand,FULL SENSE,7,13,7,5,8,0,"Raze,Cypher,Brimstone,Skye,Deadlock","Raze,Viper,Brimstone,Fade,Gekko"
Icebox,Mir Gaming GC,URACHACHA,13,8,8,4,4,5,"Sova,Killjoy,Viper,Jett,Gekko","Killjoy,Viper,Jett,KAY/O,Clove"
Bind,Xipto Esports,sisu,13,5,9,3,2,4,"Raze,Viper,Brimstone,Fade,Gekko","Raze,Skye,Harbor,Gekko,Clove"
Haven,Alter Ego,BOOM Esports,13,8,8,4,4,5,"Breach,Raze,Sova,Killjoy,Omen","Breach,Sova,Killjoy,Omen,Jett"
Ascent,Made in Thailand,FULL SENSE,5,13,1,5,8,4,"Cypher,Sova,Omen,Jett,Iso","Sova,Killjoy,Omen,Jett,KAY/O"
Ascent,Mir Gaming GC,URACHACHA,13,4,11,1,3,2,"Sova,Killjoy,Omen,Jett,KAY/O","Sova,Killjoy,Omen,Jett,KAY/O"
Icebox,Xipto Esports,sisu,13,2,12,0,2,1,"Killjoy,Viper,Jett,KAY/O,Gekko","Killjoy,Viper,Jett,KAY/O,Gekko"
Sunset,RIDDLE ORDER,FENNEL,8,13,5,7,6,3,"Breach,Raze,Cypher,Omen,Gekko","Raze,Cypher,Sage,Omen,Fade"
Ascent,URACHACHA,Nuclear GC,13,9,9,3,6,4,"Sova,Killjoy,Omen,Jett,KAY/O","Sova,Killjoy,Omen,Jett,KAY/O"
Split,Xipto Esports,sisu,11,13,5,7,6,6,"Raze,Viper,Omen,Jett,Skye","Cypher,Skye,Astra,Neon,Iso"
Icebox,Made in Thailand,FULL SENSE,13,11,4,8,3,9,"Sova,Killjoy,Viper,Jett,Gekko","Sova,Killjoy,Viper,Jett,KAY/O"
Haven,RIDDLE ORDER,FENNEL,8,13,3,6,7,5,"Cypher,Viper,Omen,Iso,Clove","Breach,Cypher,Sova,Omen,Neon"
Lotus,URACHACHA,Nuclear GC,13,7,7,1,6,6,"Raze,Killjoy,Omen,Astra,Fade","Raze,Killjoy,Viper,Omen,Fade"
Abyss,RETA Esports,All Knights,13,9,5,5,4,8,"Cypher,Sova,Omen,Jett,Harbor","Cypher,Sova,Omen,Jett,KAY/O"
Haven,bricknodes,Event Horizon Red,9,13,6,6,7,3,"Breach,Cypher,Sova,Omen,Jett","Breach,Sova,Killjoy,Omen,Jett"
Icebox,bricknodes,Event Horizon Red,6,13,2,5,8,4,"Sova,Killjoy,Viper,Reyna,Jett","Sova,Viper,Sage,Jett,Gekko"
Ascent,RETA Esports,All Knights,13,10,5,7,3,8,"Sova,Killjoy,Omen,Jett,KAY/O","Cypher,Sova,Omen,Jett,KAY/O"
Lotus,bricknodes,Event Horizon Red,13,8,7,5,3,6,"Breach,Raze,Cypher,Omen,Gekko","Breach,Cypher,Omen,Neon,Gekko"
Bind,RETA Esports,All Knights,13,8,7,5,3,6,"Raze,Viper,Brimstone,Skye,Gekko","Raze,Viper,Brimstone,Fade,Gekko"
Haven,One Tap Gaming,Event Horizon Red,11,13,5,7,6,6,"Breach,Sova,Killjoy,Omen,Jett","Breach,Sova,Killjoy,Omen,Jett"
Lotus,RETA Esports,All Knights,7,13,4,8,5,3,"Raze,Killjoy,Viper,Omen,Fade","Breach,Cypher,Omen,Neon,Fade"
Haven,5 pogo,bricknodes,13,15,10,4,11,3,"Breach,Cypher,Neon,Harbor,Iso","Breach,Cypher,Sova,Omen,Jett"
Ascent,Harmony Plasma,One Tap Gaming,5,13,3,9,4,2,"Sova,Killjoy,Omen,Jett,KAY/O","Sova,Killjoy,Omen,Jett,KAY/O"
Icebox,Event Horizon Red,Death be Happen,13,5,8,4,1,5,"Sova,Viper,Sage,Jett,Gekko","Sova,Killjoy,Viper,Jett,Harbor"
Haven,RETA Esports,All Knights,7,13,5,7,6,2,"Breach,Sova,Killjoy,Omen,Jett","Breach,Cypher,Sova,Astra,Neon"
Sunset,5 pogo,VZN E-SPORTS,13,1,11,1,0,2,"Breach,Raze,Cypher,Gekko,Clove","Raze,Cypher,Omen,KAY/O,Gekko"
Lotus,BRIMMYBOYS,bricknodes,10,13,7,4,9,3,"Raze,Omen,Fade,Deadlock,Clove","Breach,Raze,Cypher,Omen,Gekko"
Lotus,RME Summit,Harmony Plasma,12,14,9,4,10,3,"Breach,Cypher,Omen,Neon,Fade","Raze,Killjoy,Omen,Fade,Gekko"
Lotus,Alpha Esports,5 pogo,6,13,4,8,5,2,"Breach,Raze,Killjoy,Omen,Fade","Breach,Cypher,Neon,Fade,Clove"
Icebox,Event Horizon Red,AKIMBO,13,11,7,5,6,6,"Sova,Killjoy,Viper,Jett,Gekko","Sova,Killjoy,Viper,Jett,Gekko"
Lotus,BRIMMYBOYS,Ibreon Esports Amethyst,13,0,1,0,0,12,"Raze,Omen,Fade,Deadlock,Clove","Breach,Killjoy,Omen,Neon,Fade"
Breeze,Galorys,2Game Esports,13,11,4,8,3,9,"Cypher,Sova,Viper,Jett,KAY/O","Cypher,Sova,Viper,Yoru,Iso"
Lotus,Coconut Eaters,Harmony Plasma,9,13,3,9,4,6,"Raze,Cypher,Viper,Omen,Gekko","Raze,Killjoy,Omen,Skye,Fade"
Ascent,5 pogo,UFO MINIONS,13,6,8,4,2,5,"Sova,Killjoy,Jett,KAY/O,Clove","Cypher,Sova,Omen,Jett,Deadlock"
Sunset,Nephillium BLACK,Death be Happen,3,13,3,9,4,0,"Raze,Cypher,Omen,KAY/O,Fade","Raze,Gekko,Deadlock,Iso,Clove"
Sunset,bricknodes,Omnipotence,13,10,8,3,7,5,"Breach,Raze,Cypher,Omen,Gekko","Breach,Raze,Cypher,Sova,Omen"
Lotus,Ibreon Esports Amethyst,Omni Magnetic,13,3,9,3,0,4,"Breach,Killjoy,Omen,Neon,Fade","Raze,Jett,Gekko,Deadlock,Clove"
Ascent,ABG luvrs,VZN E-SPORTS,11,13,6,6,7,5,"Cypher,Sova,Omen,Yoru,Deadlock","Sova,Killjoy,Omen,Jett,KAY/O"
Ascent,AKIMBO,Nightwatch Gaming,13,2,10,2,0,3,"Sova,Killjoy,Omen,Jett,KAY/O","Sova,Killjoy,Omen,KAY/O,Gekko"
Haven,One Tap Gaming,Comet Esports Club,13,3,4,0,3,9,"Breach,Sova,Killjoy,Omen,Jett","Breach,Sova,Killjoy,Omen,Neon"
Abyss,9z Team,E-Xolos LAZER,11,13,7,5,8,4,"Cypher,Sova,Omen,Jett,Yoru","Sova,Killjoy,Omen,Jett,Astra"
Sunset,Galorys,2Game Esports,13,6,8,4,2,5,"Breach,Cypher,Sova,Omen,Neon","Cypher,Sova,Omen,KAY/O,Neon"
Bind,9z Team,E-Xolos LAZER,13,5,9,3,2,4,"Raze,Brimstone,Omen,Skye,Neon","Raze,Brimstone,Omen,Skye,Gekko"
Sunset,STAKERS,Nexum EC,5,13,1,5,8,4,"Breach,Cypher,Sova,Omen,Jett","Breach,Raze,Cypher,Omen,Gekko"
Sunset,SZK Esports,Grow uP eSports,13,3,4,0,3,9,"Breach,Raze,Cypher,Omen,Gekko","Breach,Raze,Cypher,Omen,Fade"
Sunset,Solar Flare,SPACEGLID3RS,13,6,4,3,3,9,"Breach,Raze,Cypher,Gekko,Clove","Breach,Raze,Cypher,Reyna,Omen"
Sunset,AMBYS Team,KHORE GAMING,3,13,0,4,9,3,"Breach,Raze,Cypher,Omen,Gekko","Cypher,Sova,Omen,KAY/O,Neon"
Sunset,IAPEsports,GMBLERS Esports,13,5,10,2,3,3,"Breach,Cypher,Omen,Yoru,Neon","Breach,Raze,Cypher,Omen,Gekko"
Sunset,InTenZive,Zeniths,13,7,7,1,6,6,"Breach,Raze,Cypher,Omen,Gekko","Breach,Raze,Cypher,Omen,Neon"
Sunset,bazinga esports,INCOGNITO,10,13,6,6,7,4,"Breach,Cypher,Sova,Omen,Neon","Breach,Cypher,Omen,Neon,Gekko"
Haven,9z Team,E-Xolos LAZER,9,13,3,7,6,6,"Breach,Cypher,Sova,Omen,Neon","Cypher,Viper,Omen,Skye,Neon"
Lotus,GoNext Esports,Diamant Esports,13,11,9,3,8,4,"Breach,Cypher,Sova,Omen,Neon","Raze,Killjoy,Omen,Skye,Astra"
Sunset,SZK Esports,GMBLERS Esports,13,5,5,1,4,8,"Breach,Raze,Cypher,Omen,Gekko","Breach,Raze,Cypher,Omen,Iso"
Sunset,bazinga esports,Zeniths,14,12,5,8,4,9,"Breach,Cypher,Sova,Omen,Neon","Breach,Raze,Cypher,Omen,Yoru"
Sunset,Grow uP eSports,AMBYS Team,13,2,3,0,2,10,"Breach,Raze,Cypher,Omen,Fade","Breach,Raze,Cypher,Omen,Gekko"
Sunset,SPACEGLID3RS,InTenZive,12,14,9,4,10,3,"Breach,Raze,Cypher,Omen,Gekko","Breach,Raze,Cypher,Omen,Gekko"
Sunset,Odyssey Gaming,Solar Flare,1,13,1,11,2,0,"Cypher,Sova,Omen,KAY/O,Neon","Breach,Raze,Cypher,Gekko,Clove"
Sunset,Nexum EC,IAPEsports,11,13,9,3,10,2,"Breach,Raze,Cypher,Omen,Gekko","Breach,Cypher,Omen,Yoru,Neon"
Sunset,STAKERS,INCOGNITO,3,13,2,10,3,1,"Breach,Cypher,Sova,Omen,Jett","Breach,Cypher,Omen,Neon,Gekko"
Ascent,GoNext Esports,Diamant Esports,13,9,8,4,5,5,"Sova,Killjoy,Omen,Jett,KAY/O","Raze,Sage,Omen,Fade,Deadlock"
Icebox,GoNext Esports,Diamant Esports,13,7,6,6,1,7,"Sova,Killjoy,Viper,Sage,Jett","Breach,Killjoy,Viper,Jett,Gekko"
Bind,GoNext Esports,Diamant Esports,3,13,1,3,10,2,"Raze,Viper,Brimstone,Skye,Gekko","Raze,Brimstone,Sage,Skye,Deadlock"
Ascent,Rapid Lofi,Team Flash,17,15,9,7,8,8,"Cypher,Sova,Omen,Yoru,Clove","Sova,Killjoy,Omen,Jett,KAY/O"
Bind,Rapid Lofi,Team Flash,13,6,8,4,2,5,"Raze,Cypher,Viper,Brimstone,Skye","Sova,Viper,Omen,Jett,Skye"
Icebox,Rapid Lofi,Team Flash,9,13,5,7,6,4,"Killjoy,Viper,Jett,KAY/O,Gekko","Killjoy,Viper,Jett,KAY/O,Gekko"
Bind,FULL SENSE,XERXIA Esports,13,4,4,1,3,9,"Raze,Viper,Brimstone,Fade,Gekko","Raze,Viper,Brimstone,Skye,Gekko"
Abyss,Sin Prisa Gaming,Nongshim RedForce,13,10,8,3,7,5,"Breach,Cypher,Sova,Omen,Jett","Killjoy,Viper,Omen,Yoru,Fade"
Bind,Sin Prisa Gaming,Nongshim RedForce,5,13,1,5,8,4,"Raze,Cypher,Skye,Astra,Deadlock","Cypher,Sova,Omen,Yoru,Iso"
Lotus,Rapid Lofi,Team Flash,13,8,4,5,3,9,"Raze,Killjoy,Omen,Fade,Clove","Breach,Omen,Chamber,Neon,Fade"
Lotus,FULL SENSE,XERXIA Esports,14,12,10,3,9,4,"Breach,Raze,Killjoy,Omen,Astra","Breach,Raze,Cypher,Omen,Fade"
Ascent,Rub n' Pug,Tiny Turtle Squad,13,7,7,5,2,6,"Sova,Killjoy,Omen,Jett,Iso","Sova,Killjoy,Omen,Yoru,Iso"
Sunset,Sin Prisa Gaming,Nongshim RedForce,13,5,11,1,4,2,"Breach,Cypher,Neon,Fade,Clove","Sova,Omen,Jett,KAY/O,Neon"
Bind,SGA Incheon,Nuclear GC,10,13,8,3,10,2,"Raze,Brimstone,Skye,Harbor,Gekko","Breach,Raze,Cypher,Brimstone,Skye"
Haven,Bandits OCE,BOBO,2,13,2,10,3,0,"Sova,Killjoy,Omen,Yoru,Iso","Breach,Cypher,Sova,Omen,Jett"
Haven,Rapid Lofi,Team Flash,5,13,1,5,8,4,"Breach,Cypher,Phoenix,Omen,Neon","Viper,Omen,Jett,Skye,Deadlock"
Bind,BOBA,sisu,16,14,10,5,9,6,"Raze,Viper,Brimstone,KAY/O,Gekko","Raze,Skye,Harbor,Gekko,Clove"
Haven,Sin Prisa Gaming,Nongshim RedForce,9,13,5,7,6,4,"Cypher,Sova,Omen,Yoru,Iso","Killjoy,Omen,Yoru,Fade,Iso"
Lotus,Sharper Esports,XERXIA Esports,8,13,4,5,8,4,"Breach,Raze,Cypher,Omen,Fade","Breach,Raze,Cypher,Omen,Fade"
Abyss,ARF TEAM,BOOM Esports,7,13,4,8,5,3,"Breach,Cypher,Sova,Astra,Neon","Cypher,Sova,Omen,Jett,KAY/O"
Sunset,Rub n' Pug,Tiny Turtle Squad,17,15,10,6,9,7,"Raze,Cypher,Omen,Gekko,Iso","Breach,Raze,Cypher,Omen,Gekko"
Abyss,SGA Incheon,Nuclear GC,13,8,5,4,4,8,"Breach,Omen,Jett,Harbor,Gekko","Breach,Cypher,Jett,Astra,Gekko"
Sunset,Sengoku Gaming,FENNEL,8,13,5,4,9,3,"Breach,Cypher,Sova,Omen,Neon","Raze,Cypher,Sage,Omen,Fade"
Lotus,Bandits OCE,BOBO,10,13,2,9,4,8,"Raze,Cypher,Omen,Yoru,Fade","Raze,Cypher,Viper,Omen,Fade"
Lotus,Sin Prisa Gaming,Nongshim RedForce,13,7,5,3,4,8,"Cypher,Viper,Omen,Neon,Fade","Omen,Jett,KAY/O,Neon,Fade"
Lotus,ARF TEAM,BOOM Esports,7,13,4,4,9,3,"Breach,Cypher,Omen,Neon,Fade","Raze,Killjoy,Viper,Omen,Fade"
Sunset,Sharper Esports,XERXIA Esports,10,13,6,5,8,4,"Breach,Raze,Sage,Omen,Gekko","Breach,Raze,Cypher,Omen,Gekko"
Haven,BOBA,sisu,12,14,8,5,9,4,"Breach,Sova,Killjoy,Omen,Neon","Breach,Cypher,Sova,Astra,Neon"
Lotus,Sengoku Gaming,FENNEL,6,13,2,5,8,4,"Raze,Killjoy,Viper,Omen,Fade","Breach,Cypher,Omen,Neon,Fade"
Lotus,SGA Incheon,Nuclear GC,14,16,9,6,10,5,"Breach,Raze,Omen,Jett,Skye","Raze,Killjoy,Viper,Omen,Fade"
Ascent,sisu,4Fun (PH),13,1,2,0,1,11,"Sova,Killjoy,Omen,Jett,KAY/O","Sova,Killjoy,Reyna,Jett,Clove"
Ascent,FULL SENSE,Made in Thailand,7,13,6,6,7,1,"Cypher,Sova,Omen,Jett,KAY/O","Cypher,Sova,Omen,Jett,Iso"
Sunset,ARF TEAM,BOOM Esports,8,13,5,7,6,3,"Breach,Raze,Cypher,Omen,Gekko","Breach,Raze,Cypher,Omen,Gekko"
Lotus,Mir Gaming GC,URACHACHA,15,13,9,5,8,6,"Raze,Killjoy,Viper,Omen,Fade","Raze,Killjoy,Omen,Astra,Fade"
Abyss,Sengoku Gaming,FENNEL,13,9,5,7,2,8,"Sova,Killjoy,Omen,Jett,Harbor","Viper,Sage,Omen,KAY/O,Gekko"
Lotus,sisu,4Fun (PH),13,11,6,6,5,7,"Raze,Killjoy,Omen,Neon,Fade","Raze,Jett,Chamber,Gekko,Clove"
Icebox,FULL SENSE,Made in Thailand,4,13,3,9,4,1,"Viper,Omen,Jett,KAY/O,Gekko","Sova,Killjoy,Viper,Jett,Gekko"
Ascent,Mir Gaming GC,URACHACHA,13,8,7,5,3,6,"Sova,Killjoy,Omen,Jett,KAY/O","Sova,Killjoy,Omen,Jett,KAY/O"
Split,Xipto Esports,BOBA,13,3,9,3,0,4,"Raze,Viper,Omen,Jett,Skye","Raze,Cypher,Viper,Omen,Skye"
Ascent,Sengoku Gaming,FENNEL,9,13,5,7,6,4,"Sova,Killjoy,Omen,Jett,KAY/O","Sova,Killjoy,Omen,Jett,KAY/O"
Lotus,Xipto Esports,BOBA,13,6,5,2,4,8,"Raze,Killjoy,Viper,Omen,Fade","Raze,Killjoy,Omen,Fade,Clove"
Lotus,Heavenly Sword Sect,Mickey Masters,13,11,9,3,8,4,"Raze,Killjoy,Omen,Fade,Gekko","Raze,Killjoy,Omen,Gekko,Iso"
Abyss,Omnipotence,Diddy Party,10,13,7,4,9,3,"Breach,Sova,Killjoy,Omen,Jett","Sova,Sage,Harbor,Iso,Clove"
Ascent,5 gecs,Heavenly Sword Sect,2,13,0,3,10,2,"Cypher,Sova,Omen,Jett,Deadlock","Cypher,Sova,Omen,Jett,Deadlock"
Lotus,Mickey Masters,Astane Anarchy,13,9,6,4,5,7,"Raze,Killjoy,Gekko,Iso,Clove","Breach,Raze,Cypher,Omen,Fade"
Lotus,Omnipotence,Diddy Party,7,13,3,9,4,4,"Raze,Killjoy,Omen,Fade,Deadlock","Raze,Killjoy,Omen,Fade,Deadlock"
Haven,5 gecs,winners circle,13,6,6,6,0,7,"Breach,Sova,Killjoy,Omen,Jett","Breach,Sova,Killjoy,Omen,Jett"
Haven,All Knights,E-Xolos LAZER,13,4,10,2,2,3,"Breach,Cypher,Sova,Astra,Neon","Cypher,Viper,Omen,Skye,Neon"
Icebox,Heavenly Sword Sect,Volcano Gang,13,6,9,3,3,4,"Sova,Killjoy,Viper,Reyna,Jett","Sova,Viper,Jett,Gekko,Deadlock"
Lotus,Astrocats,Astane Anarchy,11,13,6,6,7,5,"Breach,Raze,Cypher,Omen,Fade","Breach,Raze,Cypher,Omen,Fade"
Lotus,Mickey Masters,ST x WTP,13,3,2,2,1,11,"Raze,Killjoy,Gekko,Iso,Clove","Raze,Killjoy,Omen,Fade,Gekko"
Lotus,Yumi Tanuki,5 gecs,10,13,7,5,8,3,"Breach,Raze,Cypher,Omen,Fade","Raze,Cypher,Omen,Fade,Gekko"
Bind,USF Gold,Volcano Gang,6,13,3,9,4,3,"Raze,Brimstone,Skye,Yoru,Deadlock","Raze,Cypher,Brimstone,Skye,Gekko"
Sunset,The7,Galorys,13,10,9,2,8,4,"Breach,Cypher,Phoenix,Omen,Iso","Breach,Cypher,Sova,Omen,Neon"
Haven,Event Horizon Red,Omnipotence,20,22,8,13,9,12,"Breach,Sova,Killjoy,Omen,Jett","Breach,Sova,Killjoy,Omen,Neon"
Haven,Blinn Esports,TSM,10,13,3,8,5,7,"Breach,Omen,Chamber,Neon,Fade","Breach,Cypher,Sova,Omen,Jett"
Bind,Astrocats,OutGoing Esports,13,6,7,5,1,6,"Raze,Cypher,Viper,Brimstone,Skye","Raze,Viper,Brimstone,Skye,Gekko"
Bind,99 Stealers,Mickey Masters,4,13,4,8,5,0,"Raze,Brimstone,Omen,Skye,Gekko","Raze,Brimstone,Skye,Deadlock,Iso"
Sunset,Astane Anarchy,Goated,13,4,8,4,0,5,"Breach,Raze,Cypher,Omen,Fade","Raze,Cypher,Sova,Omen,Gekko"
Sunset,All Knights,E-Xolos LAZER,13,10,8,3,7,5,"Breach,Cypher,Omen,Neon,Fade","Breach,Cypher,Sova,Omen,Neon"
Ascent,ST x WTP,789,13,4,2,3,1,11,"Sova,Killjoy,Reyna,Omen,Jett","Cypher,Sova,Omen,Yoru,Deadlock"
Lotus,Sphinx GC,Deagle Ravagers,5,13,3,3,10,2,"Breach,Killjoy,Omen,Neon,Fade","Raze,Killjoy,Viper,Omen,Fade"
Icebox,Yumi Tanuki,Clemson Esports,13,10,7,5,5,6,"Sova,Killjoy,Viper,Reyna,Harbor","Sova,Killjoy,Viper,Jett,Harbor"
Haven,Heavenly Sword Sect,blend,13,8,7,2,6,6,"Cypher,Sova,Omen,Yoru,Iso","Breach,Cypher,Sova,Omen,Jett"
Haven,Diddy Party,RITUAL BLACK,14,12,6,7,5,8,"Breach,Sova,Killjoy,Omen,Jett","Breach,Sova,Killjoy,Omen,Jett"
Split,The7,Galorys,13,5,6,0,5,7,"Breach,Cypher,Omen,Neon,Iso","Raze,Viper,Omen,Jett,Skye"
Haven,Low Budget,Omnipotence,5,13,1,5,8,4,"Cypher,Sova,Omen,Yoru,Iso","Breach,Sova,Killjoy,Omen,Neon"
Lotus,USF Gold,Event Horizon Red,13,10,8,4,6,5,"Breach,Raze,Cypher,Omen,Fade","Breach,Cypher,Omen,Neon,Fade"
Ascent,winners circle,Akatsuki Aimers,13,8,6,3,5,7,"Sova,Killjoy,Omen,Jett,KAY/O","Sova,Killjoy,Omen,Jett,KAY/O"
Sunset,Okiezi's Kittens,Astane Anarchy,5,13,2,4,9,3,"Breach,Raze,Cypher,Omen,Gekko","Breach,Raze,Cypher,Omen,Fade"
Bind,Blinn Esports,TSM,4,13,3,2,11,1,"Raze,Viper,Brimstone,KAY/O,Gekko","Raze,Brimstone,Skye,Gekko,Deadlock"
Lotus,Astrocats,Cardboard Dragons,13,11,6,6,5,7,"Breach,Raze,Cypher,Omen,Fade","Raze,Killjoy,Omen,Gekko,Deadlock"
Sunset,The Warriors,99 Stealers,10,13,4,8,5,6,"Cypher,Sova,Omen,KAY/O,Neon","Breach,Raze,Cypher,Omen,Deadlock"
Haven,Coconut Eaters,ST x WTP,9,13,3,7,6,6,"Raze,Cypher,Omen,Jett,Skye","Breach,Sova,Killjoy,Jett,Clove"
Sunset,Event Horizon Red,AKIMBO,13,8,6,3,5,7,"Breach,Cypher,Sova,Omen,Neon","Raze,Cypher,Sova,Omen,Gekko"
Lotus,Astane Anarchy,NNO (New Order),13,0,12,0,0,1,"Breach,Raze,Cypher,Omen,Fade","Raze,Brimstone,Sage,Reyna,KAY/O"
Bind,On The Spectrum,Akatsuki Aimers,2,13,2,10,3,0,"Raze,Viper,Brimstone,Fade,Gekko","Raze,Cypher,Fade,Gekko,Clove"
Haven,Holy Moly Swimmington Swaggers,Mickey Masters,1,13,0,2,11,1,"Sova,Killjoy,Omen,Jett,Yoru","Sova,Killjoy,Omen,Jett,Iso"
Ascent,PSU Black,Clemson Esports,10,13,4,7,6,6,"Sova,Killjoy,Omen,Jett,KAY/O","Sova,Killjoy,Omen,Jett,KAY/O"
Lotus,Volcano Gang,RBL Anarchy,13,0,1,0,0,12,"Breach,Raze,Killjoy,Omen,Gekko","Breach,Raze,Killjoy,Omen,Gekko"
Haven,Le pug squad,Omnipotence,7,13,3,9,4,4,"Breach,Sova,Killjoy,Omen,Jett","Breach,Sova,Killjoy,Omen,Neon"
Haven,Harmony,blend,10,13,4,7,6,6,"Breach,Sova,Killjoy,Omen,Neon","Breach,Cypher,Sova,Omen,Jett"
Haven,Alphaware Olympians,Cardboard Dragons,5,13,4,8,5,1,"Breach,Cypher,Sova,Omen,Jett","Cypher,Sova,Omen,Jett,Iso"
Sunset,Goated,Rogue ES,13,7,8,4,3,5,"Raze,Cypher,Sova,Omen,Gekko","Cypher,Brimstone,Jett,Skye,Yoru"
Bind,Ibreon Esports Amethyst,99 Stealers,3,13,2,2,11,1,"Raze,Viper,Brimstone,Skye,Gekko","Raze,Brimstone,Omen,Skye,Gekko"
Ascent,5 pogo,winners circle,5,13,3,3,10,2,"Sova,Killjoy,Omen,Jett,KAY/O","Sova,Killjoy,Omen,Jett,KAY/O"
Haven,Sphinx GC,Deagle Ravagers,9,13,2,8,5,7,"Breach,Sova,Killjoy,Omen,Neon","Breach,Sova,Killjoy,Omen,Jett"
Lotus,Stellae Gaming,2Game Esports,11,13,7,5,8,4,"Breach,Cypher,Omen,Neon,Fade","Breach,Cypher,Omen,Neon,Fade"
Icebox,9z Team,RETA Esports,5,13,3,9,4,2,"Killjoy,Viper,Sage,Jett,KAY/O","Sova,Killjoy,Viper,Jett,Harbor"
Icebox,Oxygen Esports,DarkZero Esports,13,4,10,2,2,3,"Sova,Killjoy,Viper,Jett,Harbor","Sova,Killjoy,Viper,Reyna,Jett"
Sunset,Team Falcons,R8 Esports,13,11,5,7,4,8,"Breach,Raze,Cypher,Omen,Gekko","Breach,Raze,Cypher,Omen,Gekko"
Ascent,Stellae Gaming,2Game Esports,13,4,3,2,2,10,"Sova,Killjoy,Omen,Jett,KAY/O","Cypher,Sova,Omen,Jett,KAY/O"
Haven,9z Team,RETA Esports,5,13,1,5,8,4,"Breach,Cypher,Sova,Omen,Neon","Breach,Sova,Killjoy,Omen,Jett"
Sunset,Stellae Gaming,2Game Esports,9,13,4,6,7,5,"Breach,Cypher,Omen,Neon,Gekko","Cypher,Sova,Omen,KAY/O,Neon"
Lotus,Oxygen Esports,DarkZero Esports,20,18,11,8,10,9,"Raze,Brimstone,Omen,Fade,Deadlock","Breach,Raze,Killjoy,Omen,Fade"
Lotus,Team Falcons,R8 Esports,11,13,5,7,6,6,"Raze,Viper,Omen,Chamber,Gekko","Raze,Killjoy,Omen,Skye,Astra"
Icebox,Acend,Diamant Esports,3,13,2,10,3,1,"Killjoy,Viper,Jett,KAY/O,Gekko","Breach,Killjoy,Viper,Jett,Gekko"
Haven,Team Falcons,R8 Esports,13,9,5,5,4,8,"Cypher,Sova,Omen,Neon,Iso","Raze,Sova,Killjoy,Omen,Astra"
Abyss,Acend,Diamant Esports,13,3,9,3,0,4,"Cypher,Sova,Omen,Jett,KAY/O","Sage,Jett,Astra,Gekko,Deadlock"
Ascent,DSYRE,NOVO Esports,13,10,7,5,5,6,"Cypher,Sova,Omen,Jett,KAY/O","Cypher,Sova,Omen,Jett,Deadlock"
Sunset,PCIFIC Espor,HOWL Esports,13,9,6,6,3,7,"Breach,Raze,Cypher,Omen,Gekko","Breach,Raze,Cypher,Omen,Gekko"
Lotus,Acend,Diamant Esports,8,13,4,8,5,4,"Raze,Killjoy,Viper,Fade,Clove","Raze,Killjoy,Omen,Skye,Astra"
Bind,DSYRE,NOVO Esports,13,6,3,4,2,10,"Raze,Viper,Brimstone,Fade,Gekko","Viper,Brimstone,Skye,Yoru,Gekko"
Icebox,Team Falcons,R8 Esports,13,6,6,1,5,7,"Reyna,Omen,KAY/O,Harbor,Gekko","Killjoy,Viper,Sage,Reyna,Gekko"
Haven,Apeks,SweetNsour,13,7,7,1,6,6,"Breach,Sova,Killjoy,Omen,Jett","Breach,Sova,Killjoy,Omen,Jett"
Abyss,PCIFIC Espor,HOWL Esports,13,9,7,5,4,6,"Cypher,Sova,Omen,Jett,KAY/O","Cypher,Sova,Omen,Jett,KAY/O"
Abyss,Team Falcons,R8 Esports,6,13,2,5,8,4,"Cypher,Sova,Omen,Jett,KAY/O","Cypher,Sage,Yoru,Astra,Gekko"
Lotus,DSYRE,NOVO Esports,13,11,11,1,10,2,"Raze,Killjoy,Viper,Omen,Fade","Breach,Cypher,Sova,Omen,Neon"
Lotus,Apeks,SweetNsour,13,7,6,6,1,7,"Breach,Sova,Killjoy,Omen,Jett","Breach,Sova,Killjoy,Omen,Jett"
Bind,Acend,Diamant Esports,18,16,8,9,7,10,"Raze,Cypher,Astra,Fade,Iso","Raze,Brimstone,Sage,Skye,Deadlock"
Bind,PCIFIC Espor,HOWL Esports,11,13,4,8,5,7,"Breach,Viper,Brimstone,Yoru,Gekko","Raze,Viper,Brimstone,Skye,Gekko"
Sunset,Apeks,SweetNsour,13,10,7,4,6,6,"Viper,Sage,Omen,KAY/O,Gekko","Breach,Raze,Cypher,Omen,KAY/O"
Sunset,Acend,Diamant Esports,8,13,6,6,7,2,"Raze,Cypher,Omen,KAY/O,Gekko","Raze,Killjoy,Omen,Astra,Fade"
Haven,PCIFIC Espor,HOWL Esports,13,3,9,3,0,4,"Breach,Sova,Killjoy,Omen,Jett","Breach,Cypher,Omen,Jett,Gekko"
Abyss,Made in Thailand,XERXIA Esports,13,9,5,7,2,8,"Cypher,Sova,Omen,Jett,KAY/O","Breach,Cypher,Sova,Omen,Jett"
Bind,invincible gc,4Fun (PH),11,13,5,7,6,6,"Raze,Omen,Skye,Gekko,Clove","Raze,Cypher,Jett,Skye,Clove"
Bind,Made in Thailand,XERXIA Esports,13,8,6,6,2,7,"Raze,Cypher,Brimstone,Skye,Deadlock","Raze,Viper,Brimstone,Skye,Gekko"
Ascent,Nuclear GC,URACHACHA,10,13,5,7,6,5,"Sova,Killjoy,Omen,Jett,KAY/O","Sova,Killjoy,Omen,Jett,KAY/O"
Ascent,FULL SENSE,Sharper Esports,13,6,6,6,0,7,"Cypher,Sova,Omen,Jett,KAY/O","Sova,Killjoy,Omen,Jett,KAY/O"
Ascent,invincible gc,4Fun (PH),13,15,3,11,4,10,"Sova,Killjoy,Omen,Jett,KAY/O","Sova,Killjoy,Reyna,Jett,Clove"
Bind,Alter Ego,ARF TEAM,13,8,2,7,1,11,"Raze,Cypher,Viper,Omen,Skye","Raze,Cypher,Brimstone,Skye,Deadlock"
Lotus,Nuclear GC,URACHACHA,7,13,0,8,5,7,"Raze,Killjoy,Viper,Omen,Fade","Raze,Killjoy,Omen,Astra,Fade"
Icebox,Vatles Esports,EDGE (OCE),9,13,4,8,5,5,"Sova,Killjoy,Viper,Jett,Gekko","Sova,Killjoy,Viper,Sage,Iso"
Lotus,sisu,Cardboard Dinosaur,13,3,3,1,2,10,"Raze,Killjoy,Omen,Neon,Fade","Breach,Raze,Cypher,Omen,Fade"
Sunset,FULL SENSE,Sharper Esports,10,13,7,5,8,3,"Breach,Raze,Cypher,Sova,Omen","Breach,Raze,Sage,Omen,Gekko"
Ascent,iPGN,Peace & Love,11,13,7,5,8,4,"Sova,Killjoy,Omen,Jett,KAY/O","Sova,Killjoy,Omen,Jett,Neon"
Haven,Oasis Gaming,ZOL Esports,3,13,0,4,9,3,"Breach,Cypher,Sova,Omen,Neon","Sova,Killjoy,Reyna,Omen,Yoru"
Bind,Rub n' Pug,Koopa Troopas,13,11,3,9,2,10,"Raze,Cypher,Brimstone,Skye,Iso","Raze,Viper,Brimstone,Jett,Skye"
Ascent,Vatles Esports,EDGE (OCE),8,13,1,8,5,7,"Cypher,Sova,Phoenix,Omen,Deadlock","Sova,Killjoy,Omen,Jett,KAY/O"
Lotus,Mir Gaming GC,SGA Incheon,13,4,5,0,4,8,"Raze,Killjoy,Viper,Omen,Fade","Breach,Raze,Omen,Jett,Skye"
Haven,BOBO,Stacked Like Pancakes,14,12,9,4,8,5,"Breach,Cypher,Sova,Omen,Jett","Sova,Killjoy,Jett,KAY/O,Clove"
Sunset,Alter Ego,ARF TEAM,14,12,9,4,8,5,"Breach,Raze,Cypher,Omen,Gekko","Breach,Raze,Cypher,Omen,Gekko"
Lotus,Bandits OCE,E5 White,13,8,6,3,5,7,"Raze,Sage,Neon,Harbor,Clove","Breach,Killjoy,Omen,Neon,Fade"
Icebox,iPGN,Peace & Love,9,13,4,6,7,5,"Sova,Viper,Jett,Iso,Clove","Sova,Killjoy,Viper,Reyna,Neon"
Haven,sisu,Cardboard Dinosaur,13,8,5,4,4,8,"Breach,Sova,Killjoy,Omen,Jett","Breach,Sova,Killjoy,Omen,Jett"
Icebox,Bandits OCE,E5 White,13,3,4,0,3,9,"Sova,Killjoy,Viper,Reyna,Jett","Sova,Killjoy,Viper,Jett,Iso"
Sunset,Rub n' Pug,Koopa Troopas,13,10,6,5,5,7,"Raze,Cypher,Omen,Gekko,Iso","Breach,Raze,Cypher,Omen,Fade"
Lotus,BOBO,Stacked Like Pancakes,13,2,10,2,0,3,"Raze,Cypher,Viper,Omen,Fade","Breach,Raze,Killjoy,Omen,Gekko"
Icebox,Oasis Gaming,ZOL Esports,10,13,6,6,7,4,"Killjoy,Viper,Sage,Jett,KAY/O","Sova,Killjoy,Viper,Jett,KAY/O"
Bind,Vatles Esports,EDGE (OCE),13,9,5,5,4,8,"Raze,Brimstone,Fade,Gekko,Deadlock","Raze,Cypher,Sova,Brimstone,Skye"
Abyss,FULL SENSE,Sharper Esports,13,8,7,5,3,6,"Breach,Cypher,Omen,Jett,Gekko","Sova,Killjoy,Omen,Jett,Gekko"
Haven,Mir Gaming GC,SGA Incheon,13,5,10,2,3,3,"Breach,Sova,Killjoy,Omen,Jett","Breach,Sova,Killjoy,Omen,Jett"
Bind,Oasis Gaming,ZOL Esports,13,2,3,0,2,10,"Raze,Cypher,Viper,Brimstone,Skye","Raze,Cypher,Brimstone,Skye,Gekko"
Icebox,Bigetron Arctic,BOOM Esports,5,13,0,6,7,5,"Killjoy,Viper,Jett,KAY/O,Gekko","Killjoy,Viper,Jett,KAY/O,Gekko"
Sunset,Oasis Gaming,ZOL Esports,7,13,4,4,9,3,"Raze,Cypher,Sova,Omen,KAY/O","Cypher,Sova,Omen,KAY/O,Neon"
Sunset,Bigetron Arctic,BOOM Esports,4,13,3,9,4,1,"Breach,Raze,Cypher,Omen,Gekko","Breach,Raze,Cypher,Omen,Gekko"
Lotus,Barcelona Sporting X,No Sweat Blossom,13,4,8,4,0,5,"Killjoy,Viper,Omen,Neon,Fade","Breach,Raze,Killjoy,Omen,Iso"
Haven,Barcelona Sporting X,No Sweat Blossom,13,5,6,0,5,7,"Breach,Cypher,Omen,Jett,Fade","Breach,Cypher,Omen,Neon,Iso"
Sunset,SaD Esports,TSM,10,13,6,6,7,4,"Breach,Raze,Cypher,Sova,Omen","Breach,Cypher,Omen,Neon,Gekko"
Lotus,2Game Esports,TBK Esports,13,7,4,4,3,9,"Breach,Cypher,Omen,Neon,Fade","Raze,Killjoy,Viper,Omen,Fade"
Bind,SaD Esports,TSM,6,13,4,8,5,2,"Raze,Cypher,Viper,Brimstone,Skye","Raze,Brimstone,Skye,Gekko,Deadlock"
Icebox,2Game Esports,TBK Esports,13,8,5,7,1,8,"Sova,Killjoy,Viper,Omen,Gekko","Sova,Killjoy,Viper,Jett,Harbor"
Haven,SaD Esports,TSM,13,7,8,0,7,5,"Sova,Jett,Astra,Deadlock,Iso","Breach,Cypher,Sova,Omen,Jett"
Sunset,DarkZero Esports,FLUFFY AIMERS,13,3,10,2,1,3,"Breach,Raze,Cypher,Omen,Fade","Breach,Raze,Cypher,Omen,Skye"
Bind,Stellae Gaming,RED Canids,13,8,8,1,7,5,"Raze,Viper,Brimstone,Sage,Skye","Raze,Cypher,Viper,Brimstone,Skye"
Abyss,R8 Esports,NASR Esports,13,10,6,5,5,7,"Cypher,Sage,Yoru,Astra,Gekko","Cypher,Sova,Jett,Astra,KAY/O"
Lotus,Stellae Gaming,RED Canids,13,6,6,1,5,7,"Breach,Cypher,Omen,Neon,Fade","Breach,Cypher,Neon,Gekko,Clove"
Haven,DarkZero Esports,FLUFFY AIMERS,13,6,3,4,2,10,"Sova,Killjoy,Reyna,Omen,Jett","Cypher,Viper,Omen,Skye,Neon"
Ascent,R8 Esports,NASR Esports,4,13,0,5,8,4,"Cypher,Sova,Omen,Yoru,Deadlock","Cypher,Sova,Phoenix,Omen,Jett"
Icebox,Requiem,SweetNsour,7,13,4,8,5,3,"Killjoy,Omen,KAY/O,Harbor,Gekko","Killjoy,Viper,Jett,KAY/O,Gekko"
Abyss,Diamant Esports,trashcan,13,6,5,2,4,8,"Sage,Jett,Astra,Gekko,Deadlock","Cypher,Sova,Omen,Yoru,Harbor"
Lotus,R8 Esports,NASR Esports,13,9,5,5,4,8,"Raze,Killjoy,Omen,Skye,Astra","Breach,Cypher,Sova,Omen,Neon"
Haven,Diamant Esports,trashcan,13,4,3,2,2,10,"Raze,Killjoy,Omen,Astra,Fade","Cypher,Sova,Omen,Yoru,Iso"
Icebox,MAU ESPORTS,Hidden Horizon,10,13,5,7,6,5,"Sova,Killjoy,Viper,Jett,Gekko","Sova,Killjoy,Viper,Jett,Gekko"
Haven,Requiem,SweetNsour,13,11,8,4,7,5,"Killjoy,Viper,Omen,Jett,Skye","Breach,Sova,Killjoy,Omen,Jett"
Lotus,HOWL Esports,Galakticos,13,9,8,2,7,5,"Raze,Cypher,Viper,Omen,Fade","Breach,Raze,Sova,Omen,Chamber"
Haven,R8 Esports,NASR Esports,13,2,10,2,0,3,"Raze,Sova,Killjoy,Omen,Astra","Breach,Killjoy,Omen,Jett,Gekko"
Sunset,MAU ESPORTS,Hidden Horizon,10,13,6,6,7,4,"Cypher,Sova,Omen,KAY/O,Neon","Breach,Raze,Cypher,Omen,Gekko"
Bind,Acend,GoNext Esports,12,14,9,4,10,3,"Raze,Cypher,Astra,Fade,Iso","Raze,Viper,Brimstone,Skye,Gekko"
Bind,Requiem,SweetNsour,9,13,5,5,8,4,"Raze,Viper,Brimstone,Skye,Gekko","Raze,Viper,Brimstone,Fade,Gekko"
Haven,HOWL Esports,Galakticos,13,5,6,0,5,7,"Breach,Cypher,Omen,Jett,Gekko","Breach,Cypher,Sova,Omen,Neon"
Bind,R8 Esports,NASR Esports,11,13,4,8,5,7,"Raze,Viper,Brimstone,Skye,Chamber","Raze,Cypher,Viper,Brimstone,Skye"
Icebox,Acend,GoNext Esports,13,10,7,4,6,6,"Killjoy,Viper,Jett,KAY/O,Gekko","Sova,Killjoy,Viper,Sage,Jett"
Icebox,HOWL Esports,Galakticos,12,14,8,5,9,4,"Killjoy,Viper,Jett,Skye,Harbor","Sova,Killjoy,Viper,Jett,KAY/O"
Lotus,Acend,GoNext Esports,10,13,4,8,5,6,"Raze,Killjoy,Viper,Fade,Clove","Breach,Cypher,Sova,Omen,Neon"
Bind,HOWL Esports,Galakticos,13,5,7,5,0,6,"Raze,Viper,Brimstone,Skye,Gekko","Raze,Viper,Brimstone,Fade,Gekko"
Ascent,4Fun (PH),Avernus Esports,13,0,1,0,0,12,"Sova,Killjoy,Reyna,Jett,Clove","Sova,Killjoy,Omen,Jett,KAY/O"
Bind,4Fun (PH),Avernus Esports,14,12,11,2,10,3,"Raze,Cypher,Reyna,Skye,Clove","Raze,Cypher,Brimstone,Reyna,Skye"
Sunset,LILAX,Cardboard Dinosaur,10,13,2,9,4,8,"Breach,Raze,Cypher,Sova,Clove","Breach,Raze,Cypher,Omen,Gekko"
Lotus,LILAX,Cardboard Dinosaur,10,13,1,10,3,9,"Sova,Killjoy,Reyna,Fade,Clove","Breach,Raze,Cypher,Omen,Fade"
Bind,BOBO,Vatles Esports,9,13,7,5,8,2,"Raze,Viper,Brimstone,Skye,Gekko","Raze,Brimstone,Fade,Gekko,Deadlock"
Ascent,THE HERO DETA,Bigetron Arctic,7,13,3,9,4,4,"Sova,Killjoy,Omen,Jett,KAY/O","Sova,Killjoy,Omen,Jett,KAY/O"
Ascent,Tiny Turtle Squad,iPGN,10,13,7,5,8,3,"Sova,Killjoy,Omen,Yoru,Iso","Sova,Killjoy,Omen,Jett,KAY/O"
Icebox,LILAX,Cardboard Dinosaur,13,7,8,4,3,5,"Sova,Killjoy,Sage,Reyna,Clove","Sova,Killjoy,Viper,Reyna,Jett"
Haven,BOBO,Vatles Esports,13,8,6,3,5,7,"Breach,Cypher,Sova,Omen,Jett","Cypher,Sova,Omen,Neon,Deadlock"
Ascent,Peace & Love,Rub n' Pug,13,7,9,3,4,4,"Sova,Killjoy,Omen,Jett,Neon","Sova,Killjoy,Omen,Jett,Iso"
Lotus,DINGLE GOOGY and friends,Koopa Troopas,13,15,3,11,4,10,"Killjoy,Omen,Neon,Fade,Gekko","Raze,Viper,Omen,Chamber,Fade"
Ascent,EDGE (OCE),Bandits OCE,13,1,2,0,1,11,"Sova,Killjoy,Omen,Jett,KAY/O","Cypher,Sova,Omen,Yoru,Deadlock"
Sunset,Tiny Turtle Squad,iPGN,13,5,4,2,3,9,"Breach,Raze,Cypher,Omen,Gekko","Cypher,Sova,Omen,Jett,Iso"
Sunset,THE HERO DETA,Bigetron Arctic,7,13,1,7,6,6,"Breach,Raze,Cypher,Omen,Gekko","Breach,Raze,Cypher,Omen,Gekko"
Bind,Peace & Love,Rub n' Pug,13,7,4,4,3,9,"Raze,Cypher,Brimstone,Skye,Neon","Raze,Cypher,Brimstone,Skye,Iso"
Lotus,BOBO,Vatles Esports,11,13,4,8,5,7,"Raze,Cypher,Viper,Omen,Fade","Raze,Omen,Fade,Gekko,Deadlock"
Haven,Tiny Turtle Squad,iPGN,8,13,7,5,8,1,"Breach,Sova,Killjoy,Omen,Jett","Sova,Killjoy,Omen,Jett,Iso"
Sunset,DINGLE GOOGY and friends,Koopa Troopas,10,13,5,6,7,5,"Breach,Raze,Cypher,Gekko,Clove","Breach,Raze,Cypher,Omen,Fade"
Lotus,EDGE (OCE),Bandits OCE,13,9,11,1,8,2,"Raze,Killjoy,Omen,Fade,Harbor","Breach,Cypher,Omen,Neon,Fade"
Haven,sisu,BOBA,12,14,9,4,10,3,"Breach,Cypher,Sova,Omen,Jett","Breach,Sova,Killjoy,Omen,Neon"
Ascent,BOOM Esports,Cynical,13,11,5,7,4,8,"Sova,Killjoy,Omen,Jett,KAY/O","Sova,Killjoy,Omen,Jett,KAY/O"
Icebox,sisu,BOBA,9,13,4,8,5,5,"Killjoy,Viper,Jett,KAY/O,Gekko","Sova,Killjoy,Viper,Jett,Gekko"
Lotus,BOOM Esports,Cynical,13,4,4,1,3,9,"Raze,Killjoy,Viper,Omen,Fade","Breach,Raze,Cypher,Omen,Fade"
Sunset,sisu,BOBA,13,9,7,3,6,6,"Breach,Raze,Cypher,Omen,Gekko","Breach,Raze,Cypher,Astra,Clove"
Bind,ARF TEAM,THE HERO DETA,13,7,7,5,2,6,"Raze,Cypher,Brimstone,Skye,Deadlock","Raze,Cypher,Brimstone,Skye,Deadlock"
Sunset,ARF TEAM,THE HERO DETA,13,6,5,2,4,8,"Breach,Raze,Cypher,Omen,Gekko","Breach,Raze,Cypher,Omen,Gekko"
Icebox,Blinn Esports,Moist x Shopify,8,13,3,9,4,5,"Sova,Killjoy,Viper,Jett,Harbor","Killjoy,Viper,Reyna,KAY/O,Gekko"
Haven,Blinn Esports,Moist x Shopify,11,13,8,4,9,3,"Breach,Omen,Chamber,Neon,Fade","Breach,Sova,Killjoy,Omen,Jett"
Bind,Team Leveling,paprica picante,13,6,5,2,4,8,"Raze,Viper,Brimstone,Skye,Gekko","Viper,Brimstone,Skye,Neon,Gekko"
Icebox,water gun warriors,U4RIA Magnolia,5,13,5,7,6,0,"Sova,Killjoy,Viper,Jett,KAY/O","Sova,Killjoy,Viper,Reyna,Jett"
Haven,Team Leveling,paprica picante,13,2,3,0,2,10,"Breach,Cypher,Sova,Omen,Neon","Breach,Sova,Killjoy,Omen,Neon"
Haven,Team Falcons,R8 Esports,13,6,5,2,4,8,"Cypher,Sova,Omen,Neon,Iso","Raze,Sova,Killjoy,Omen,Astra"
Ascent,Oxygen Esports,M80,1,13,1,11,2,0,"Cypher,Sova,Omen,Jett,Deadlock","Cypher,Sova,Omen,Yoru,Deadlock"
Lotus,water gun warriors,U4RIA Magnolia,4,13,4,8,5,0,"Breach,Raze,Killjoy,Omen,Fade","Breach,Raze,Killjoy,Omen,Fade"
Ascent,Team Falcons,R8 Esports,4,13,2,10,3,2,"Sova,Killjoy,Omen,Jett,KAY/O","Cypher,Sova,Omen,Yoru,Deadlock"
Lotus,Catnappers,EbonyX GC,13,6,6,1,5,7,"Killjoy,Omen,Neon,Fade,Clove","Raze,Killjoy,Omen,Fade,Gekko"
Lotus,EbonyX GC,Catnappers,6,13,5,7,6,1,"Raze,Killjoy,Omen,Fade,Gekko","Killjoy,Omen,Neon,Fade,Clove"
Icebox,Team Leveling,paprica picante,7,13,4,8,5,3,"Killjoy,Viper,KAY/O,Gekko,Iso","Sova,Killjoy,Viper,Jett,Gekko"
Sunset,Oxygen Esports,M80,11,13,9,3,10,2,"Breach,Raze,Cypher,Omen,KAY/O","Breach,Cypher,Omen,Yoru,Gekko"
Sunset,water gun warriors,U4RIA Magnolia,13,6,9,3,3,4,"Breach,Raze,Cypher,Omen,Gekko","Breach,Raze,Cypher,Omen,Fade"
Haven,EbonyX GC,Catnappers,7,13,5,7,6,2,"Breach,Sova,Killjoy,Omen,Neon","Cypher,Sova,Omen,Yoru,Iso"
Icebox,PS5Patas,REVOADA,2,13,1,11,2,1,"Sova,Killjoy,Viper,Jett,Gekko","Sova,Killjoy,Viper,Jett,Gekko"
Lotus,Team Falcons,R8 Esports,16,14,9,6,8,7,"Raze,Viper,Omen,Chamber,Gekko","Raze,Killjoy,Omen,Skye,Astra"
Abyss,PCIFIC Espor,HOWL Esports,13,5,5,1,4,8,"Cypher,Sova,Omen,Jett,KAY/O","Cypher,Sova,Omen,Jett,KAY/O"
Lotus,Oxygen Esports,M80,16,14,11,4,10,5,"Raze,Brimstone,Omen,Fade,Deadlock","Cypher,Sage,Omen,Fade,Deadlock"
Haven,PS5Patas,REVOADA,9,13,1,9,4,8,"Breach,Sova,Killjoy,Jett,Astra","Breach,Sova,Killjoy,Omen,Neon"
Sunset,Easties,VCL REJECTS 2.0,13,4,9,3,1,4,"Breach,Raze,Cypher,Omen,Gekko","Cypher,Sova,Omen,KAY/O,Neon"
Haven,PCIFIC Espor,HOWL Esports,13,11,5,7,4,8,"Breach,Sova,Killjoy,Omen,Jett","Breach,Cypher,Omen,Jett,Gekko"
Ascent,NASR Esports,United Gaming,13,7,8,4,3,5,"Cypher,Sova,Phoenix,Omen,Jett","Breach,Cypher,Sova,Omen,Jett"
Ascent,Salmans,temptemp,13,11,5,7,4,8,"Cypher,Sova,Omen,Jett,Deadlock","Sova,Killjoy,Omen,Jett,KAY/O"
Ascent,Easties,VCL REJECTS 2.0,13,7,8,0,7,5,"Sova,Killjoy,Omen,Jett,KAY/O","Cypher,Sova,Omen,Jett,KAY/O"
Icebox,PCIFIC Espor,HOWL Esports,4,13,4,8,5,0,"Sova,Killjoy,Viper,Jett,Gekko","Killjoy,Viper,Jett,Skye,Harbor"
Icebox,Coalesce,Team Prolific,13,5,3,3,2,10,"Sova,Killjoy,Viper,Reyna,Jett","Sova,Killjoy,Viper,Reyna,Gekko"
Ascent,Jabba Enjoyers,Cognizant,13,7,6,6,1,7,"Sova,Killjoy,Omen,Jett,KAY/O","Breach,Sova,Omen,Chamber,Neon"
Haven,NASR Esports,United Gaming,10,13,3,9,4,7,"Breach,Killjoy,Omen,Neon,Gekko","Breach,Cypher,Sova,Omen,Jett"
Haven,Salmans,temptemp,13,11,8,4,7,5,"Breach,Cypher,Sova,Omen,Jett","Breach,Cypher,Sova,Omen,Neon"
Haven,Easties,VCL REJECTS 2.0,13,11,6,6,5,7,"Breach,Sova,Killjoy,Omen,Jett","Breach,Sova,Killjoy,Jett,Astra"
Abyss,Coalesce,Team Prolific,13,3,4,0,3,9,"Cypher,Sova,Omen,Jett,KAY/O","Sova,Jett,Harbor,Gekko,Iso"
Haven,Apeks,Requiem,13,2,10,2,0,3,"Breach,Sova,Killjoy,Omen,Jett","Killjoy,Viper,Omen,Jett,Skye"
Lotus,Salmans,temptemp,7,13,6,6,7,1,"Breach,Cypher,Omen,Neon,Fade","Breach,Cypher,Omen,Neon,Fade"
Lotus,Jabba Enjoyers,Cognizant,13,11,7,5,6,6,"Breach,Raze,Killjoy,Omen,Fade","Cypher,Omen,KAY/O,Neon,Gekko"
Icebox,Easties,VCL REJECTS 2.0,6,13,4,8,5,2,"Sova,Killjoy,Viper,Jett,KAY/O","Sova,Killjoy,Viper,Reyna,Jett"
Icebox,Apeks,Requiem,13,2,10,2,0,3,"Sova,Killjoy,Viper,Sage,Jett","Killjoy,Omen,KAY/O,Harbor,Gekko"
Sunset,NASR Esports,United Gaming,15,13,9,5,8,6,"Breach,Raze,Cypher,Omen,Fade","Breach,Raze,Cypher,Omen,Fade"
Haven,Galakticos,Galatasaray Esports,13,8,7,5,3,6,"Breach,Cypher,Sova,Omen,Neon","Cypher,Sova,Omen,Yoru,Iso"
Lotus,Easties,VCL REJECTS 2.0,10,13,6,6,7,4,"Breach,Raze,Killjoy,Omen,Gekko","Raze,Cypher,Viper,Omen,Fade"
Lotus,Galakticos,Galatasaray Esports,13,11,4,8,3,9,"Breach,Raze,Sova,Omen,Chamber","Raze,Cypher,Omen,Gekko,Iso"
Ascent,OnlyFins,SweetNsour,14,16,4,11,5,10,"Sova,Killjoy,Omen,Jett,KAY/O","Sova,Killjoy,Omen,Jett,KAY/O"
Icebox,OnlyFins,SweetNsour,5,13,3,9,4,2,"Killjoy,Viper,Jett,KAY/O,Gekko","Killjoy,Viper,Jett,KAY/O,Gekko"
Sunset,Galakticos,Galatasaray Esports,10,13,7,5,8,3,"Raze,Cypher,Omen,KAY/O,Gekko","Raze,Cypher,Omen,Gekko,Iso"
Abyss,BOOM Esports,Alter Ego,11,13,6,6,7,5,"Cypher,Sova,Omen,Jett,KAY/O","Breach,Raze,Cypher,Omen,KAY/O"
Haven,Dplus Esports,Nongshim RedForce,7,13,5,7,6,2,"Breach,Sova,Killjoy,Omen,Jett","Killjoy,Omen,Yoru,Fade,Iso"
Bind,BOOM Esports,Alter Ego,6,13,2,10,3,4,"Breach,Raze,Cypher,Brimstone,Deadlock","Raze,Cypher,Viper,Omen,Skye"
Abyss,Dplus Esports,Nongshim RedForce,13,9,9,1,8,4,"Cypher,Sova,Omen,Jett,KAY/O","Killjoy,Viper,Omen,Yoru,Fade"
Lotus,Koopa Troopas,Vatles Esports,7,13,3,5,8,4,"Raze,Killjoy,Viper,Omen,Fade","Raze,Omen,Fade,Gekko,Deadlock"
Bind,BOBO,DINGLE GOOGY and friends,13,5,9,3,2,4,"Raze,Viper,Skye,Gekko,Clove","Raze,Viper,Brimstone,Skye,Gekko"
Lotus,Xipto Esports,invincible gc,13,3,9,3,0,4,"Raze,Cypher,Reyna,Omen,Skye","Raze,Killjoy,Viper,Omen,Fade"
Bind,ZETA DIVISION GC,FENNEL GC,14,12,8,5,7,6,"Raze,Cypher,Viper,Skye,Clove","Raze,Sova,Viper,Omen,Skye"
Ascent,BOOM Esports,Alter Ego,13,9,6,4,5,7,"Sova,Killjoy,Omen,Jett,KAY/O","Raze,Sova,Killjoy,Omen,KAY/O"
Sunset,Rub n' Pug,Stacked Like Pancakes,13,9,8,4,5,5,"Raze,Cypher,Omen,Gekko,Iso","Cypher,Omen,Jett,Gekko,Clove"
Ascent,Koopa Troopas,Vatles Esports,14,12,5,8,4,9,"Sova,Killjoy,Phoenix,Omen,Jett","Cypher,Sova,Omen,Jett,Deadlock"
Haven,BOBO,DINGLE GOOGY and friends,13,4,5,0,4,8,"Breach,Cypher,Sova,Omen,Jett","Breach,Sova,Killjoy,Omen,Jett"
Ascent,EDGE (OCE),Neptune Esports,13,4,10,2,2,3,"Sova,Killjoy,Omen,Jett,KAY/O","Cypher,Sova,Omen,Jett,KAY/O"
Sunset,iPGN,E5 White,13,4,9,3,1,4,"Raze,Cypher,Sova,Iso,Clove","Breach,Cypher,Sova,Omen,Neon"
Sunset,Dplus Esports,Nongshim RedForce,17,19,5,13,6,12,"Cypher,Sova,Omen,Jett,KAY/O","Sova,Omen,Jett,KAY/O,Neon"
Bind,Xipto Esports,invincible gc,13,9,5,5,4,8,"Raze,Cypher,Brimstone,Skye,Deadlock","Raze,Omen,Skye,Gekko,Clove"
Sunset,ZETA DIVISION GC,FENNEL GC,13,11,8,4,7,5,"Breach,Raze,Cypher,Omen,Gekko","Breach,Raze,Cypher,Omen,Fade"
Sunset,THE HERO DETA,Cynical,13,3,11,1,2,2,"Breach,Raze,Cypher,Omen,Gekko","Raze,Cypher,Sova,Omen,KAY/O"
Bind,Rub n' Pug,Stacked Like Pancakes,13,9,7,3,6,6,"Raze,Cypher,Brimstone,Skye,Iso","Raze,Cypher,Brimstone,Sage,Gekko"
Haven,EDGE (OCE),Neptune Esports,13,5,8,4,1,5,"Breach,Sova,Killjoy,Omen,Jett","Cypher,Sova,Omen,Jett,Deadlock"
Lotus,BOBO,DINGLE GOOGY and friends,10,13,6,5,8,4,"Raze,Killjoy,Viper,Omen,Fade","Killjoy,Omen,Neon,Fade,Gekko"
Bind,Koopa Troopas,Vatles Esports,10,13,7,4,9,3,"Raze,Viper,Brimstone,Jett,Skye","Raze,Brimstone,Fade,Gekko,Deadlock"
Icebox,iPGN,E5 White,13,4,8,4,0,5,"Sova,Viper,Jett,Iso,Clove","Sova,Killjoy,Viper,Phoenix,Jett"
Ascent,Dplus Esports,Nongshim RedForce,3,13,2,10,3,1,"Sova,Killjoy,Omen,Jett,KAY/O","Sova,Viper,Omen,Jett,Yoru"
Lotus,ZETA DIVISION GC,FENNEL GC,7,13,6,6,7,1,"Breach,Raze,Cypher,Omen,Fade","Breach,Raze,Cypher,Omen,Fade"
Abyss,THE HERO DETA,Cynical,13,11,7,5,6,6,"Cypher,Sova,Omen,Jett,KAY/O","Breach,Raze,Cypher,Yoru,Astra"
Ascent,ZETA DIVISION GC,FENNEL GC,13,3,4,0,3,9,"Sova,Killjoy,Omen,Jett,KAY/O","Sova,Killjoy,Omen,Jett,KAY/O"
Haven,THE HERO DETA,Cynical,4,13,0,5,8,4,"Breach,Cypher,Sova,Omen,Jett","Breach,Sova,Killjoy,Omen,Jett"
Sunset,Bigetron Arctic,Alter Ego,5,13,4,8,5,1,"Breach,Cypher,Sova,Omen,Neon","Breach,Raze,Cypher,Omen,Gekko"
Icebox,Bigetron Arctic,Alter Ego,9,13,8,4,9,1,"Killjoy,Viper,Jett,KAY/O,Gekko","Raze,Killjoy,Viper,KAY/O,Gekko"
Ascent,FlyQuest RED,EbonyX GC,13,1,11,1,0,2,"Sova,Killjoy,Omen,Jett,KAY/O","Sova,Killjoy,Omen,Jett,KAY/O"
Bind,FlyQuest RED,EbonyX GC,13,0,12,0,0,1,"Raze,Viper,Skye,Astra,Gekko","Raze,Cypher,Viper,Brimstone,Skye"
Ascent,DarkZero Esports,Blinn Esports,5,13,4,8,5,1,"Cypher,Sova,Omen,Jett,Deadlock","Cypher,Sova,Omen,Yoru,Deadlock"
Icebox,Shopify Rebellion,water gun warriors,13,3,9,3,0,4,"Sova,Killjoy,Viper,Jett,Harbor","Sova,Killjoy,Viper,Jett,Gekko"
Bind,DarkZero Esports,Blinn Esports,13,8,8,1,7,5,"Viper,Brimstone,Sage,Neon,Gekko","Raze,Viper,Brimstone,KAY/O,Gekko"
Sunset,Shopify Rebellion,water gun warriors,13,4,10,2,2,3,"Breach,Raze,Cypher,Omen,Gekko","Breach,Raze,Cypher,Omen,Gekko"
Sunset,LOUD GC,paprica picante,13,2,10,2,0,3,"Raze,Cypher,Omen,KAY/O,Gekko","Breach,Cypher,Omen,Neon,Gekko"
Haven,DarkZero Esports,Blinn Esports,2,13,2,10,3,0,"Breach,Sova,Killjoy,Omen,Neon","Breach,Omen,Chamber,Neon,Fade"
Haven,Catnappers,EbonyX GC,11,13,8,4,9,3,"Cypher,Sova,Omen,Jett,Yoru","Breach,Sova,Killjoy,Omen,Neon"
Lotus,U4RIA Magnolia,water gun warriors,3,13,0,4,9,3,"Breach,Raze,Killjoy,Omen,Fade","Breach,Raze,Killjoy,Omen,Fade"
Haven,LOUD GC,paprica picante,13,7,6,6,1,7,"Breach,Cypher,Sova,Omen,Neon","Breach,Sova,Killjoy,Omen,Neon"
Sunset,U4RIA Magnolia,water gun warriors,3,13,0,4,9,3,"Breach,Raze,Cypher,Omen,Fade","Breach,Raze,Cypher,Omen,Gekko"
Ascent,Catnappers,EbonyX GC,16,14,9,6,8,7,"Sova,Killjoy,Omen,Jett,KAY/O","Sova,Killjoy,Omen,Jett,KAY/O"
Abyss,Moist x Shopify,FLUFFY AIMERS,13,8,8,4,4,5,"Cypher,Sova,Omen,Jett,Gekko","Breach,Raze,Sova,Viper,Omen"
Bind,MIBR GC,Team Leveling,13,6,9,3,3,4,"Raze,Viper,Brimstone,Fade,Gekko","Raze,Viper,Brimstone,Skye,Gekko"
Haven,Fire Flux Esports,Galatasaray Esports,10,13,7,4,9,3,"Breach,Sova,Killjoy,Omen,Jett","Cypher,Sova,Omen,Yoru,Iso"
Lotus,Moist x Shopify,FLUFFY AIMERS,13,7,6,2,5,7,"Raze,Cypher,Viper,Omen,Fade","Raze,Cypher,Omen,Skye,Deadlock"
Lotus,R8 Esports,United Gaming,13,6,8,4,2,5,"Raze,Killjoy,Omen,Skye,Astra","Breach,Raze,Cypher,Omen,Fade"
Abyss,MIBR GC,Team Leveling,13,4,4,1,3,9,"Cypher,Sova,Yoru,Astra,KAY/O","Breach,Omen,KAY/O,Neon,Deadlock"
Abyss,BalenciagaBriefs,VCL REJECTS 2.0,12,14,7,6,8,5,"Cypher,Sova,Omen,Jett,KAY/O","Breach,Cypher,Jett,Astra,Gekko"
Icebox,R8 Esports,United Gaming,13,8,7,2,6,6,"Killjoy,Viper,Sage,Reyna,Gekko","Sova,Killjoy,Viper,Jett,Harbor"
Bind,TBS GC,REVOADA,13,6,6,1,5,7,"Viper,Brimstone,Neon,Fade,Gekko","Raze,Viper,Brimstone,Skye,Gekko"
Ascent,Fire Flux Esports,Galatasaray Esports,13,8,6,6,2,7,"Sova,Killjoy,Omen,Jett,KAY/O","Cypher,Sova,Omen,Jett,Deadlock"
Ascent,BalenciagaBriefs,VCL REJECTS 2.0,9,13,2,8,5,7,"Sova,Killjoy,Omen,Jett,KAY/O","Cypher,Sova,Omen,Jett,KAY/O"
Abyss,SweetNsour,Requiem,10,13,8,4,9,2,"Cypher,Sova,Omen,Jett,KAY/O","Cypher,Sova,Omen,Jett,KAY/O"
Haven,TBS GC,REVOADA,13,9,5,5,4,8,"Breach,Sova,Killjoy,Omen,Jett","Breach,Sova,Killjoy,Omen,Neon"
Lotus,Fire Flux Esports,Galatasaray Esports,7,13,6,2,11,1,"Raze,Killjoy,Viper,Omen,Gekko","Raze,Cypher,Omen,Gekko,Iso"
Icebox,BalenciagaBriefs,VCL REJECTS 2.0,10,13,6,6,7,4,"Sova,Killjoy,Viper,Sage,Gekko","Sova,Killjoy,Viper,Reyna,Jett"
Abyss,Team Falcons,NASR Esports,13,6,7,0,6,6,"Cypher,Sova,Omen,Jett,KAY/O","Breach,Cypher,Sova,Omen,Jett"
Bind,SweetNsour,Requiem,8,13,5,7,6,3,"Raze,Viper,Brimstone,Fade,Gekko","Raze,Viper,Brimstone,Skye,Gekko"
Bind,BalenciagaBriefs,VCL REJECTS 2.0,13,5,5,1,4,8,"Raze,Cypher,Brimstone,Fade,Gekko","Raze,Viper,Brimstone,Fade,Gekko"
Haven,Team Falcons,NASR Esports,13,11,7,5,6,6,"Cypher,Sova,Omen,Neon,Iso","Breach,Killjoy,Omen,Neon,Gekko"
Lotus,SweetNsour,Requiem,14,12,10,3,9,4,"Breach,Raze,Cypher,Omen,Fade","Raze,Cypher,Viper,Omen,Fade"
Icebox,Papara SuperMassive,Galakticos,9,13,7,3,10,2,"Sova,Killjoy,Viper,Jett,Clove","Sova,Killjoy,Viper,Jett,KAY/O"
Haven,BalenciagaBriefs,VCL REJECTS 2.0,13,11,3,9,2,10,"Breach,Sova,Killjoy,Omen,Jett","Breach,Sova,Killjoy,Jett,Astra"
Abyss,Apeks,OnlyFins,13,7,8,0,7,5,"Cypher,Sova,Omen,Yoru,Astra","Cypher,Sova,Viper,Omen,Yoru"
Ascent,Papara SuperMassive,Galakticos,13,6,9,3,3,4,"Cypher,Sova,Omen,Jett,Deadlock","Cypher,Sova,Omen,Jett,KAY/O"
Haven,Apeks,OnlyFins,13,1,11,1,0,2,"Breach,Sova,Killjoy,Omen,Jett","Breach,Cypher,Sova,Omen,Neon"
Sunset,Metizport,NEANLATIYONBOLM,9,13,6,4,9,3,"Cypher,Sova,Omen,KAY/O,Neon","Breach,Raze,Cypher,Yoru,Clove"
Bind,Papara SuperMassive,Galakticos,10,13,5,6,7,5,"Raze,Cypher,Viper,Brimstone,Skye","Raze,Viper,Brimstone,Fade,Gekko"
Lotus,BOBA,Avernus Esports,13,3,4,0,3,9,"Breach,Neon,Fade,Iso,Clove","Breach,Raze,Killjoy,Omen,Gekko"
Haven,Metizport,NEANLATIYONBOLM,10,13,4,7,6,6,"Cypher,Sova,Omen,Neon,Iso","Sova,Killjoy,Omen,Jett,Yoru"
Bind,BOBA,Avernus Esports,13,5,6,0,5,7,"Cypher,Brimstone,Reyna,Skye,Deadlock","Raze,Cypher,Brimstone,Reyna,Skye"
Bind,JustUs,ZOL Esports,6,13,2,5,8,4,"Raze,Cypher,Brimstone,Reyna,Skye","Raze,Cypher,Brimstone,Skye,Gekko"
Lotus,FENNEL GC,Reignite Lily,13,5,9,3,2,4,"Breach,Raze,Cypher,Omen,Fade","Raze,Killjoy,Viper,Omen,Fade"
Ascent,JustUs,ZOL Esports,9,13,3,9,4,6,"Sova,Killjoy,Reyna,Omen,Jett","Sova,Killjoy,Omen,Jett,KAY/O"
Sunset,FENNEL GC,Reignite Lily,8,13,2,7,6,6,"Breach,Raze,Cypher,Omen,Fade","Cypher,Sova,Omen,KAY/O,Neon"
Lotus,sisu,4Fun (PH),13,6,7,5,1,6,"Raze,Killjoy,Omen,Neon,Fade","Breach,Omen,Chamber,Neon,Gekko"
Sunset,JustUs,ZOL Esports,13,10,6,5,5,7,"Raze,Cypher,Sova,Omen,Jett","Cypher,Sova,Omen,KAY/O,Neon"
Bind,FENNEL GC,Reignite Lily,13,7,9,3,4,4,"Raze,Sova,Viper,Omen,Skye","Raze,Viper,Brimstone,Skye,Gekko"
Ascent,sisu,4Fun (PH),13,6,4,3,3,9,"Sova,Killjoy,Omen,Jett,KAY/O","Sova,Killjoy,Reyna,Jett,Clove"
Ascent,Oasis Gaming,NAOS Esports,10,13,3,9,4,7,"Sova,Killjoy,Omen,Jett,KAY/O","Cypher,Sova,Omen,Jett,KAY/O"
Ascent,FENNEL GC,Reignite Lily,11,13,6,6,7,5,"Sova,Killjoy,Omen,Jett,KAY/O","Sova,Killjoy,Omen,Jett,KAY/O"
Haven,FENNEL GC,Reignite Lily,13,3,3,1,2,10,"Breach,Sova,Killjoy,Omen,Jett","Breach,Sova,Killjoy,Omen,Neon"
Bind,Oasis Gaming,NAOS Esports,6,13,4,8,5,2,"Raze,Cypher,Viper,Brimstone,Skye","Raze,Cypher,Viper,Brimstone,Skye"
Lotus,Legiowon Puff,No Sweat Blossom,6,13,4,8,5,2,"Breach,Raze,Killjoy,Omen,Gekko","Breach,Raze,Killjoy,Omen,Iso"
Haven,Legiowon Puff,No Sweat Blossom,13,7,10,2,5,3,"Breach,Killjoy,Omen,Jett,Deadlock","Breach,Cypher,Omen,Neon,Iso"
Bind,Legiowon Puff,No Sweat Blossom,4,13,1,4,9,3,"Raze,Cypher,Viper,Brimstone,Skye","Raze,Cypher,Brimstone,Gekko,Deadlock"
Sunset,Oxygen Esports,SaD Esports,13,7,6,2,5,7,"Breach,Raze,Cypher,Omen,KAY/O","Breach,Raze,Cypher,Sova,Omen"
Abyss,Oxygen Esports,SaD Esports,13,5,9,3,2,4,"Cypher,Sova,Omen,Jett,Harbor","Reyna,KAY/O,Harbor,Gekko,Clove"
Sunset,Team Liquid Brazil,PS5Patas,13,2,2,1,1,11,"Raze,Cypher,Omen,KAY/O,Gekko","Breach,Raze,Cypher,Omen,Fade"
Icebox,M80,TSM,14,12,5,8,4,9,"Killjoy,Viper,Omen,KAY/O,Gekko","Killjoy,Viper,Reyna,KAY/O,Gekko"
Haven,Team Liquid Brazil,PS5Patas,13,2,10,2,0,3,"Cypher,Sova,Omen,Yoru,Iso","Breach,Sova,Killjoy,Jett,Astra"
Lotus,M80,TSM,13,7,5,3,4,8,"Cypher,Sage,Omen,Fade,Deadlock","Breach,Cypher,Omen,Neon,Gekko"
Abyss,HOWL Esports,Papara SuperMassive,13,6,4,3,3,9,"Cypher,Sova,Omen,Jett,KAY/O","Sova,Omen,Yoru,Astra,Deadlock"
Haven,VCL REJECTS 2.0,Flame Hard,13,7,5,3,4,8,"Breach,Sova,Killjoy,Jett,Astra","Breach,Sova,Killjoy,Omen,Jett"
Icebox,VCL REJECTS 2.0,Flame Hard,13,10,4,8,2,9,"Sova,Killjoy,Viper,Reyna,Jett","Sova,Killjoy,Viper,Jett,KAY/O"
Sunset,HOWL Esports,Papara SuperMassive,13,15,9,5,10,4,"Breach,Raze,Cypher,Omen,Gekko","Cypher,Sova,Omen,KAY/O,Neon"
Lotus,VCL REJECTS 2.0,Flame Hard,9,13,2,8,5,7,"Raze,Cypher,Viper,Omen,Fade","Breach,Cypher,Sova,Omen,Neon"
Icebox,HOWL Esports,Papara SuperMassive,13,7,6,2,5,7,"Killjoy,Viper,Jett,Skye,Harbor","Sova,Killjoy,Viper,Reyna,Clove"
Haven,Easties,BalenciagaBriefs,13,9,9,3,6,4,"Breach,Sova,Killjoy,Omen,Jett","Breach,Sova,Killjoy,Omen,Jett"
Sunset,Easties,BalenciagaBriefs,13,9,5,7,2,8,"Breach,Raze,Cypher,Omen,Gekko","Breach,Cypher,Sova,Omen,Neon"
Lotus,Easties,BalenciagaBriefs,8,13,4,8,5,4,"Breach,Raze,Killjoy,Omen,Gekko","Breach,Raze,Killjoy,Omen,Fade"
Ascent,Fire Flux Esports,PCIFIC Espor,16,18,7,10,8,9,"Viper,Omen,Jett,Gekko,Deadlock","Sova,Killjoy,Omen,Jett,KAY/O"
Haven,Fire Flux Esports,PCIFIC Espor,7,13,1,11,2,6,"Breach,Cypher,Omen,Jett,Gekko","Breach,Sova,Killjoy,Omen,Jett"
Ascent,invincible gc,Cardboard Dinosaur,13,7,5,3,4,8,"Sova,Killjoy,Omen,Jett,KAY/O","Breach,Sova,Killjoy,Omen,Jett"
Sunset,invincible gc,Cardboard Dinosaur,13,10,7,5,5,6,"Breach,Raze,Cypher,Omen,Gekko","Breach,Raze,Cypher,Gekko,Clove"
Icebox,NAOS Esports,ZOL Esports,13,6,9,3,3,4,"Sova,Killjoy,Viper,Jett,Harbor","Sova,Killjoy,Viper,Jett,KAY/O"
Lotus,invincible gc,Cardboard Dinosaur,12,14,5,8,6,7,"Raze,Killjoy,Viper,Omen,Fade","Breach,Raze,Cypher,Omen,Fade"
Sunset,NAOS Esports,ZOL Esports,8,13,7,5,8,1,"Breach,Cypher,Sova,Omen,Neon","Cypher,Sova,Omen,KAY/O,Neon"
Split,Xipto Esports,LILAX,13,2,11,1,1,2,"Raze,Cypher,Omen,Jett,Skye","Raze,Cypher,Sage,Skye,Clove"
Haven,NAOS Esports,ZOL Esports,13,9,6,4,5,7,"Breach,Cypher,Sova,Omen,Neon","Sova,Killjoy,Reyna,Omen,Yoru"
Ascent,Xipto Esports,LILAX,13,1,2,0,1,11,"Sova,Killjoy,Reyna,Omen,Jett","Sova,Killjoy,KAY/O,Deadlock,Clove"
Ascent,Oasis Gaming,Just Us,13,11,6,6,5,7,"Sova,Killjoy,Omen,Jett,KAY/O","Sova,Killjoy,Reyna,Omen,Jett"
Lotus,Oasis Gaming,Just Us,16,14,7,8,6,9,"Raze,Killjoy,Viper,Omen,Fade","Killjoy,Omen,Jett,Skye,Fade"
Bind,Freaky Furries,Evil Genies,13,8,6,6,2,7,"Raze,Viper,Brimstone,Skye,Deadlock","Raze,Cypher,Viper,Brimstone,Skye"
Haven,"Fenrir ""White"" E-Club",No Sweat Blossom,12,14,4,9,5,8,"Breach,Sova,Killjoy,Omen,Neon","Breach,Cypher,Omen,Neon,Iso"
Ascent,Tenax GC,Envee Sapphire GC,13,4,8,4,0,5,"Sova,Killjoy,Omen,Jett,KAY/O","Sova,Killjoy,Omen,Jett,KAY/O"
Lotus,Freaky Furries,Evil Genies,13,9,6,6,3,7,"Raze,Killjoy,Viper,Omen,Fade","Breach,Raze,Cypher,Omen,Fade"
Lotus,"Fenrir ""White"" E-Club",No Sweat Blossom,6,13,3,4,9,3,"Breach,Killjoy,Phoenix,Omen,Neon","Breach,Raze,Killjoy,Omen,Iso"
Ascent,G2 Esports,Leviatán,4,13,0,5,8,4,"Sova,Killjoy,Omen,Jett,KAY/O","Cypher,Sova,Omen,Jett,Deadlock"
Bind,SUPERNOVA,Evil Genies,8,13,1,8,5,7,"Raze,Viper,Brimstone,Skye,Iso","Raze,Cypher,Viper,Brimstone,Skye"
Bind,G2 Esports,Leviatán,13,9,4,8,1,9,"Raze,Viper,Brimstone,Skye,Gekko","Raze,Viper,Brimstone,Fade,Gekko"
Icebox,SUPERNOVA,Evil Genies,13,10,7,4,6,6,"Sova,Killjoy,Viper,Jett,Gekko","Sova,Killjoy,Viper,Sage,Chamber"
Lotus,No Sweat Blossom,Azzy White,13,11,9,3,8,4,"Breach,Raze,Killjoy,Omen,Iso","Breach,Raze,Killjoy,Omen,Neon"
Haven,G2 Esports,Leviatán,14,16,6,9,7,8,"Breach,Sova,Killjoy,Omen,Jett","Breach,Cypher,Sova,Omen,Neon"
Abyss,Infiriumz Gaming GC,"Fenrir ""White"" E-Club",2,13,0,3,10,2,"Breach,Jett,Astra,Gekko,Deadlock","Breach,Jett,Astra,Neon,Deadlock"
Haven,SUPERNOVA,Evil Genies,9,13,3,7,6,6,"Cypher,Sova,Omen,Yoru,Iso","Breach,Cypher,Sova,Omen,Jett"
Lotus,ROSE,Freaky Furries,5,13,1,5,8,4,"Raze,Omen,Skye,Astra,Deadlock","Raze,Killjoy,Viper,Omen,Fade"
Haven,No Sweat Blossom,Azzy White,9,13,7,5,8,2,"Breach,Cypher,Omen,Neon,Iso","Breach,Killjoy,Phoenix,Jett,Clove"
Ascent,ROSE,Freaky Furries,6,13,2,5,8,4,"Cypher,Sova,Phoenix,Omen,Jett","Sova,Killjoy,Omen,Jett,KAY/O"
Lotus,Infiriumz Gaming GC,"Fenrir ""White"" E-Club",8,13,4,8,5,4,"Breach,Raze,Killjoy,Omen,Jett","Breach,Killjoy,Phoenix,Omen,Neon"
Sunset,No Sweat Blossom,Azzy White,13,2,11,1,1,2,"Breach,Raze,Cypher,Omen,Iso","Breach,Raze,Cypher,Omen,Gekko"
Haven,Evil Genies,Blue Otter,13,3,9,3,0,4,"Breach,Cypher,Sova,Omen,Jett","Breach,Sova,Killjoy,Omen,Jett"
Lotus,G2 Esports,Leviatán,13,15,6,8,7,7,"Raze,Killjoy,Viper,Omen,Fade","Breach,Cypher,Omen,Neon,Fade"
Sunset,Return of the Ashes,Deagle Ravagers,6,13,2,5,8,4,"Breach,Raze,Cypher,Omen,Gekko","Breach,Raze,Cypher,Omen,Gekko"
Haven,SUPERNOVA,SeanGares' Kittens,13,8,8,1,7,5,"Cypher,Sova,Omen,Yoru,Iso","Breach,Cypher,Sova,Omen,Jett"
Icebox,Evil Genies,Blue Otter,13,6,6,6,0,7,"Sova,Killjoy,Viper,Sage,Chamber","Sova,Killjoy,Viper,Jett,Gekko"
Ascent,overcook,Freaky Furries,4,13,2,3,10,2,"Sova,Killjoy,Jett,Deadlock,Clove","Sova,Killjoy,Omen,Jett,KAY/O"
Icebox,Non Verbal,ROSE,5,13,3,9,4,2,"Sova,Killjoy,Viper,Jett,Clove","Sova,Killjoy,Viper,Reyna,Jett"
Haven,overcook,Freaky Furries,6,13,3,4,9,3,"Breach,Sova,Killjoy,Omen,Jett","Cypher,Sova,Reyna,Omen,Jett"
Haven,BalenciagaBriefs,Flame Hard,13,11,5,7,4,8,"Breach,Sova,Killjoy,Omen,Jett","Breach,Sova,Killjoy,Omen,Jett"
Ascent,SUPERNOVA,SeanGares' Kittens,13,8,7,2,6,6,"Sova,Killjoy,Omen,Jett,KAY/O","Sova,Killjoy,Omen,Jett,KAY/O"
Lotus,Evil Genies,Blue Otter,8,13,4,5,8,4,"Breach,Raze,Cypher,Omen,Fade","Raze,Omen,Fade,Deadlock,Clove"
Haven,Non Verbal,ROSE,9,13,6,6,7,3,"Breach,Cypher,Sova,Omen,Jett","Cypher,Sova,Yoru,Astra,Iso"
Haven,Return of the Ashes,Deagle Ravagers,6,13,1,6,7,5,"Breach,Cypher,Sova,Omen,Jett","Breach,Sova,Killjoy,Omen,Jett"
Ascent,SAW,PPP,13,4,4,1,3,9,"Cypher,Sova,Omen,Jett,KAY/O","Sova,Killjoy,Omen,Jett,KAY/O"
Abyss,Papara SuperMassive,Galatasaray Esports,13,6,10,2,4,3,"Sova,Omen,Yoru,Astra,Deadlock","Sova,Sage,Reyna,Omen,Jett"
Lotus,BalenciagaBriefs,Flame Hard,13,6,6,1,5,7,"Breach,Raze,Killjoy,Omen,Fade","Breach,Cypher,Sova,Omen,Neon"
Icebox,Return of the Ashes,Deagle Ravagers,13,10,7,5,5,6,"Killjoy,Viper,Reyna,Harbor,Gekko","Sova,Killjoy,Viper,Jett,KAY/O"
Sunset,Formulation Gaming GC,Silly Weapons All Game,13,7,7,5,2,6,"Breach,Raze,Cypher,Omen,Gekko","Breach,Raze,Cypher,Omen,Gekko"
Bind,Joblife,Valiant,13,5,5,1,4,8,"Raze,Viper,Brimstone,Skye,Gekko","Raze,Viper,Brimstone,Skye,Gekko"
Haven,Papara SuperMassive,Galatasaray Esports,13,4,10,2,2,3,"Cypher,Sova,Omen,Yoru,Neon","Cypher,Sova,Omen,Yoru,Iso"
Sunset,BalenciagaBriefs,Flame Hard,8,13,4,5,8,4,"Breach,Raze,Cypher,Sova,Omen","Breach,Cypher,Sova,Omen,Neon"
Icebox,Formulation Gaming GC,Silly Weapons All Game,13,3,10,2,1,3,"Sova,Killjoy,Viper,Sage,Jett","Sova,Killjoy,Viper,Sage,Jett"
Bind,SAW,PPP,13,3,4,0,3,9,"Raze,Cypher,Brimstone,Skye,Deadlock","Raze,Viper,Brimstone,Fade,Gekko"
Haven,Easties,VCL REJECTS 2.0,13,7,9,3,4,4,"Breach,Sova,Killjoy,Omen,Jett","Breach,Cypher,Sova,Omen,Jett"
Sunset,Joblife,Valiant,13,6,3,4,2,10,"Breach,Cypher,Sova,Omen,Neon","Breach,Cypher,Sova,Omen,Neon"
Lotus,Formulation Gaming GC,Silly Weapons All Game,7,13,5,7,6,2,"Raze,Killjoy,Viper,Omen,Fade","Breach,Raze,Killjoy,Omen,Gekko"
Ascent,Easties,VCL REJECTS 2.0,8,13,2,7,6,6,"Sova,Killjoy,Omen,Jett,KAY/O","Cypher,Sova,Omen,Jett,KAY/O"
Haven,Joblife,Valiant,13,6,6,1,5,7,"Breach,Sova,Killjoy,Astra,Neon","Breach,Cypher,Sova,Omen,Neon"
Haven,SAW,PPP,13,4,5,0,4,8,"Cypher,Sova,Omen,Yoru,Iso","Breach,Cypher,Sova,Omen,Neon"
Abyss,PCIFIC Espor,Galakticos,13,7,5,7,0,8,"Cypher,Sova,Omen,Jett,KAY/O","Cypher,Sova,Viper,Omen,Yoru"
Abyss,Formulation Gaming GC,Silly Weapons All Game,13,1,11,1,0,2,"Breach,Cypher,Jett,Astra,Gekko","Breach,Cypher,Sova,Jett,Astra"
Sunset,Easties,VCL REJECTS 2.0,13,9,7,5,4,6,"Breach,Raze,Cypher,Omen,Gekko","Cypher,Sova,Omen,KAY/O,Neon"
Icebox,PCIFIC Espor,Galakticos,13,9,9,3,6,4,"Sova,Killjoy,Viper,Jett,Gekko","Sova,Killjoy,Viper,Jett,KAY/O"
Bind,PCIFIC Espor,Galakticos,7,13,5,3,10,2,"Raze,Cypher,Viper,Brimstone,KAY/O","Raze,Viper,Brimstone,Fade,Gekko"
Icebox,Gen.G Esports,DRX,13,6,6,1,5,7,"Killjoy,Viper,Jett,KAY/O,Gekko","Sova,Killjoy,Viper,Jett,Gekko"
Lotus,Jabba Enjoyers,EXO Clan,13,10,7,4,6,6,"Breach,Raze,Killjoy,Omen,Fade","Breach,Cypher,Omen,Neon,Fade"
Lotus,Gen.G Esports,DRX,14,12,8,5,7,6,"Raze,Killjoy,Viper,Omen,Fade","Breach,Omen,Chamber,Neon,Fade"
Ascent,Jabba Enjoyers,EXO Clan,13,5,9,3,2,4,"Sova,Killjoy,Omen,Jett,KAY/O","Sova,Killjoy,Omen,Jett,KAY/O"
Bind,Gen.G Esports,DRX,18,16,8,9,7,10,"Raze,Cypher,Viper,Brimstone,Skye","Raze,Viper,Brimstone,Fade,Gekko"
Haven,Gen.G Esports,DRX,6,13,4,3,10,2,"Killjoy,Viper,Omen,Jett,Skye","Breach,Cypher,Sova,Omen,Jett"
Abyss,Nuclear GC,FearX elite Academy,13,11,3,9,2,10,"Breach,Cypher,Jett,Astra,Gekko","Breach,Viper,Omen,Jett,Gekko"
Sunset,Nuclear GC,FearX elite Academy,13,9,8,2,7,5,"Breach,Cypher,Sova,Omen,Neon","Breach,Raze,Cypher,Omen,Gekko"
Lotus,Nuclear GC,FearX elite Academy,10,13,8,4,9,2,"Breach,Cypher,Omen,Jett,Neon","Raze,Killjoy,Viper,Omen,Fade"
Haven,잇뽕따닥,SGA Incheon,9,13,4,8,5,5,"Breach,Brimstone,Sage,Skye,Neon","Breach,Sova,Killjoy,Omen,Jett"
Abyss,Deception,Nuclear GC,8,13,5,4,9,3,"Breach,Phoenix,Reyna,Neon,Clove","Breach,Cypher,Jett,Astra,Gekko"
Bind,잇뽕따닥,SGA Incheon,5,13,3,3,10,2,"Raze,Omen,Astra,Gekko,Deadlock","Raze,Brimstone,Skye,Harbor,Gekko"
Sunset,Deception,Nuclear GC,1,13,0,2,11,1,"Raze,Sova,Chamber,Neon,Clove","Breach,Cypher,Sova,Omen,Neon"
Haven,"Fenrir ""White"" E-Club",New Combat Line GC,13,6,9,3,3,4,"Breach,Sova,Killjoy,Omen,Neon","Breach,Sova,Killjoy,Omen,Neon"
Haven,OK Gaming,Azzy White,1,13,1,11,2,0,"Breach,Cypher,Omen,Neon,Fade","Breach,Cypher,Phoenix,Jett,Clove"
Bind,"Fenrir ""White"" E-Club",New Combat Line GC,13,7,4,4,3,9,"Breach,Raze,Cypher,Brimstone,Deadlock","Raze,Viper,Brimstone,Skye,Gekko"
Icebox,Legiowon Puff,Barcelona Sporting X,2,13,2,10,3,0,"Killjoy,Viper,Omen,KAY/O,Gekko","Sova,Killjoy,Viper,Jett,Gekko"
Icebox,OK Gaming,Azzy White,13,6,5,2,4,8,"Killjoy,Viper,Jett,KAY/O,Clove","Killjoy,KAY/O,Chamber,Harbor,Gekko"
Abyss,OK Gaming,Azzy White,4,13,3,9,4,1,"Breach,Omen,Jett,Deadlock,Iso","Cypher,Sova,Omen,Jett,KAY/O"
Lotus,minions united GC,Envee Sapphire GC,13,2,10,2,0,3,"Breach,Raze,Sova,Killjoy,Omen","Breach,Raze,Killjoy,Omen,Fade"
Ascent,Legiowon Puff,Barcelona Sporting X,6,13,3,9,4,3,"Sova,Killjoy,Omen,Jett,KAY/O","Sova,Killjoy,Reyna,Omen,Jett"
Lotus,"Fenrir ""White"" E-Club",New Combat Line GC,8,13,2,7,6,6,"Breach,Killjoy,Phoenix,Omen,Neon","Breach,Cypher,Omen,Neon,Gekko"
Ascent,Leviatán,KRÜ Esports,13,10,8,4,6,5,"Cypher,Sova,Omen,Jett,Deadlock","Sova,Killjoy,Omen,Jett,KAY/O"
Abyss,SUPERNOVA,MORBIDLY OBESE,14,12,7,6,6,7,"Sova,Reyna,Yoru,Astra,Deadlock","Cypher,Sova,Sage,Jett,Astra"
Icebox,Blue Otter,LF8 Mythic,13,5,5,1,4,8,"Sova,Killjoy,Viper,Jett,Gekko","Sova,Killjoy,Viper,Sage,Jett"
Abyss,Leviatán,KRÜ Esports,13,10,5,6,4,8,"Cypher,Sova,Omen,Jett,Harbor","Cypher,Sova,Omen,Jett,KAY/O"
Ascent,Orangutan Gang,SeanGares' Kittens,11,13,3,9,4,8,"Sova,Killjoy,Omen,Jett,KAY/O","Sova,Killjoy,Omen,Jett,KAY/O"
Haven,Deagle Ravagers,rEVO GC,13,8,9,3,5,4,"Breach,Sova,Killjoy,Omen,Jett","Breach,Cypher,Sova,Omen,Jett"
Sunset,Blue Otter,LF8 Mythic,12,14,6,7,7,6,"Breach,Cypher,Sova,Omen,Neon","Breach,Raze,Cypher,Omen,Fade"
Icebox,SaD Purple,Non Verbal,9,13,1,9,4,8,"Sova,Killjoy,Viper,Reyna,Jett","Sova,Killjoy,Viper,Jett,Clove"
Sunset,Leviatán,KRÜ Esports,7,13,4,4,9,3,"Breach,Cypher,Sova,Omen,Neon","Breach,Cypher,Sova,Omen,Neon"
Ascent,SUPERNOVA,MORBIDLY OBESE,13,15,11,3,12,2,"Sova,Killjoy,Omen,Jett,KAY/O","Sova,Killjoy,Omen,Jett,KAY/O"
Sunset,Good Career,overcook,4,13,0,5,8,4,"Breach,Raze,Cypher,Omen,Gekko","Breach,Raze,Cypher,Omen,Jett"
Ascent,Freaky Furries,Heavenly Sword Sect,13,8,7,5,3,6,"Sova,Killjoy,Omen,Jett,KAY/O","Sova,Killjoy,Omen,Jett,KAY/O"
Icebox,New Combat Line GC,Castle Esports X,13,5,6,0,5,7,"Killjoy,Viper,Jett,Harbor,Gekko","Reyna,Omen,Chamber,Harbor,Gekko"
Ascent,Evil Genies,SR and Friends,13,11,4,8,3,9,"Cypher,Sova,Omen,Jett,KAY/O","Cypher,Sova,Omen,Jett,Deadlock"
Haven,ROSE,Nightblood Gaming,13,11,4,8,3,9,"Cypher,Sova,Yoru,Astra,Iso","Breach,Sova,Killjoy,Astra,Neon"
Haven,Blue Otter,LF8 Mythic,13,3,9,3,0,4,"Breach,Cypher,Sova,Omen,Jett","Killjoy,Viper,Omen,Jett,Skye"
Haven,FEK ESPORTS GC,Azzy White,5,13,0,6,7,5,"Breach,Sova,Killjoy,Omen,Jett","Breach,Cypher,Phoenix,Jett,Clove"
Icebox,Deagle Ravagers,rEVO GC,13,5,3,3,2,10,"Sova,Killjoy,Viper,Jett,KAY/O","Killjoy,Viper,Jett,Gekko,Iso"
Haven,SaD Purple,Non Verbal,13,11,6,6,5,7,"Breach,Sova,Killjoy,Omen,Jett","Breach,Cypher,Sova,Omen,Jett"
Bind,Orangutan Gang,SeanGares' Kittens,10,13,9,3,10,1,"Raze,Brimstone,KAY/O,Fade,Deadlock","Raze,Cypher,Brimstone,Skye,Gekko"
Haven,SUPERNOVA,MORBIDLY OBESE,13,10,4,7,3,9,"Cypher,Sova,Omen,Yoru,Iso","Breach,Cypher,Sova,Omen,Jett"
Haven,Leviatán,KRÜ Esports,11,13,4,8,5,7,"Breach,Cypher,Sova,Omen,Neon","Breach,Cypher,Sova,Omen,Neon"
Sunset,ROSE,Nightblood Gaming,13,6,3,4,2,10,"Raze,Cypher,Sova,Omen,Deadlock","Breach,Cypher,Sova,Omen,Neon"
Lotus,Good Career,overcook,10,13,6,6,7,4,"Breach,Raze,Killjoy,Omen,Gekko","Breach,Raze,Killjoy,Omen,Jett"
Ascent,New Combat Line GC,Castle Esports X,13,7,6,2,5,7,"Sova,Killjoy,Omen,Jett,KAY/O","Raze,Sova,Brimstone,Reyna,Harbor"
Lotus,Freaky Furries,Heavenly Sword Sect,11,13,6,6,7,5,"Raze,Viper,Omen,Chamber,Fade","Raze,Killjoy,Omen,Fade,Gekko"
Bind,BE esports,"Fenrir ""White"" E-Club",9,13,5,7,6,4,"Raze,Cypher,Viper,Gekko,Clove","Breach,Raze,Cypher,Brimstone,Deadlock"
Lotus,Evil Genies,SR and Friends,14,12,6,7,5,8,"Breach,Raze,Cypher,Omen,Fade","Breach,Raze,Cypher,Omen,Fade"
Haven,Aspyre x Swarm,LF8 Mythic,5,13,1,5,8,4,"Breach,Cypher,Sova,Omen,Jett","Killjoy,Viper,Omen,Jett,Skye"
Ascent,FEK ESPORTS GC,Azzy White,9,13,6,6,7,3,"Sova,Killjoy,Omen,Jett,Skye","Sova,Killjoy,Omen,Jett,KAY/O"
Sunset,OverLöaded,Orangutan Gang,4,13,2,10,3,2,"Breach,Cypher,Sova,Neon,Clove","Breach,Cypher,Sova,Omen,Neon"
Bind,The blockade,SeanGares' Kittens,6,13,2,10,3,4,"Raze,Viper,Fade,Gekko,Clove","Raze,Cypher,Brimstone,Skye,Gekko"
Icebox,Freaky Furries,Heavenly Sword Sect,13,5,7,5,0,6,"Sova,Killjoy,Viper,Reyna,Jett","Sova,Killjoy,Viper,Jett,Iso"
Lotus,SaD Purple,Non Verbal,12,14,7,6,8,5,"Raze,Killjoy,Viper,Omen,Fade","Raze,Cypher,Omen,Fade,Deadlock"
Lotus,ROSE,Nightblood Gaming,11,13,6,6,7,5,"Raze,Omen,Skye,Astra,Deadlock","Breach,Cypher,Sova,Astra,Neon"
Icebox,Leviatán,KRÜ Esports,13,3,11,1,2,2,"Sova,Killjoy,Viper,Jett,Harbor","Sova,Killjoy,Viper,Reyna,Gekko"
Lotus,SR and Friends,Retired as heck,13,2,3,0,2,10,"Breach,Raze,Cypher,Omen,Fade","Breach,Cypher,Omen,Yoru,Fade"
Lotus,Lemonade Stand,Good Career,11,13,4,8,5,7,"Raze,Omen,Fade,Deadlock,Clove","Breach,Raze,Killjoy,Omen,Gekko"
Haven,MORBIDLY OBESE,Coach Joe's Kids,15,13,11,3,10,4,"Breach,Cypher,Sova,Omen,Jett","Breach,Sova,Killjoy,Omen,Jett"
Ascent,OverLöaded,Orangutan Gang,13,8,9,3,5,4,"Cypher,Sova,Omen,Yoru,Fade","Sova,Killjoy,Omen,Jett,KAY/O"
Abyss,Nearest Airport,overcook,7,13,6,6,7,1,"Sova,Yoru,Astra,Neon,Deadlock","Breach,Cypher,Sova,Omen,Jett"
Lotus,The blockade,SeanGares' Kittens,11,13,7,5,8,4,"Raze,Killjoy,Viper,Fade,Clove","Breach,Killjoy,Neon,Gekko,Clove"
Icebox,Aspyre x Swarm,LF8 Mythic,11,13,7,5,8,4,"Sova,Killjoy,Viper,Jett,Gekko","Sova,Killjoy,Viper,Sage,Jett"
Icebox,Nightblood Gaming,Dexterity Gaming,13,2,2,1,1,11,"Sova,Killjoy,Viper,Omen,Jett","Killjoy,Viper,Jett,KAY/O,Gekko"
Bind,Evil Genies,Akatsuki Aimers,14,12,9,4,8,5,"Raze,Viper,Brimstone,Skye,Gekko","Raze,Cypher,Fade,Gekko,Clove"
Icebox,Heavenly Sword Sect,Sexy Gang,13,7,4,4,3,9,"Sova,Killjoy,Viper,Jett,Iso","Sova,Killjoy,Viper,Reyna,KAY/O"
Lotus,Non Verbal,Shifty505,13,6,5,2,4,8,"Raze,Cypher,Omen,Fade,Deadlock","Raze,Killjoy,Viper,Omen,Fade"
Ascent,SaD Purple,Moon (NA),13,5,8,4,1,5,"Sova,Killjoy,Omen,Jett,KAY/O","Cypher,Sova,Omen,Jett,Deadlock"
Haven,Freaky Furries,Una Ludio,13,6,5,2,4,8,"Cypher,Sova,Reyna,Omen,Jett","Cypher,Sova,Omen,Jett,Iso"
Haven,Blue Otter,Void,13,3,4,0,3,9,"Breach,Sova,Killjoy,Omen,Jett","Breach,Cypher,Sova,Omen,Neon"
Haven,SR and Friends,Retired as heck,12,14,6,7,7,6,"Breach,Sova,Killjoy,Omen,Jett","Breach,Sova,Killjoy,Omen,Jett"
Ascent,Lemonade Stand,Good Career,10,13,7,5,8,3,"Sova,Killjoy,Brimstone,Sage,KAY/O","Sova,Killjoy,Omen,Jett,KAY/O"
Sunset,SUPERNOVA,Team Digital,13,5,5,1,4,8,"Breach,Raze,Omen,Gekko,Deadlock","Breach,Raze,Cypher,Fade,Clove"
Haven,ROSE,ABG luvrs,13,11,8,4,7,5,"Cypher,Sova,Yoru,Astra,Iso","Cypher,Sova,Phoenix,Omen,Jett"
Icebox,Nearest Airport,overcook,2,13,0,3,10,2,"Killjoy,Viper,Jett,KAY/O,Gekko","Sova,Killjoy,Viper,Jett,Gekko"
Lotus,Nightblood Gaming,Dexterity Gaming,13,6,7,0,6,6,"Breach,Cypher,Sova,Astra,Neon","Raze,Killjoy,Viper,Omen,Fade"
Lotus,Evil Genies,Akatsuki Aimers,13,6,11,1,5,2,"Breach,Raze,Cypher,Omen,Fade","Breach,Cypher,Omen,Neon,Gekko"
Ascent,The blockade,SeanGares' Kittens,13,11,6,6,5,7,"Sova,Killjoy,Jett,KAY/O,Clove","Sova,Killjoy,Omen,Jett,KAY/O"
Lotus,Freaky Furries,Una Ludio,13,5,8,4,1,5,"Raze,Killjoy,Viper,Omen,Fade","Breach,Raze,Killjoy,Omen,Gekko"
Ascent,SR and Friends,Retired as heck,13,2,3,0,2,10,"Cypher,Sova,Omen,Jett,Deadlock","Sova,Killjoy,Omen,Jett,KAY/O"
Bind,OverLöaded,Orangutan Gang,10,13,5,6,7,5,"Raze,Viper,KAY/O,Fade,Clove","Raze,Brimstone,KAY/O,Fade,Deadlock"
Icebox,AMBYS Team,STAKERS,3,13,0,4,9,3,"Sova,Killjoy,Jett,Harbor,Deadlock","Sova,Killjoy,Viper,Jett,Gekko"
Icebox,Poverineeh,KHORE GAMING,13,11,5,7,4,8,"Sova,Killjoy,Viper,Jett,Iso","Sova,Killjoy,Viper,Jett,KAY/O"
Icebox,Grow uP eSports,SPACEGLID3RS,13,3,4,0,3,9,"Sova,Killjoy,Viper,Sage,Jett","Sova,Killjoy,Viper,Jett,Gekko"
Icebox,1000rr club,Nexum EC,13,11,7,5,6,6,"Sova,Killjoy,Viper,Reyna,Jett","Sova,Killjoy,Viper,Jett,Harbor"
Icebox,INCOGNITO,GMBLERS Esports,10,13,5,6,7,5,"Sova,Killjoy,Viper,Jett,Harbor","Sova,Killjoy,Viper,Reyna,Jett"
Icebox,InTenZive,bazinga esports,6,13,3,9,4,3,"Sova,Killjoy,Viper,Jett,Iso","Sova,Killjoy,Viper,Jett,Harbor"
Icebox,SZK Esports,IAPEsports,13,3,3,1,2,10,"Sova,Killjoy,Viper,Jett,Gekko","Sova,Killjoy,Viper,Jett,KAY/O"
Lotus,MORBIDLY OBESE,Coach Joe's Kids,14,12,5,8,4,9,"Cypher,Sova,Omen,Yoru,Fade","Breach,Raze,Killjoy,Omen,Fade"
Haven,SaD Purple,Moon (NA),13,4,4,1,3,9,"Breach,Sova,Killjoy,Omen,Jett","Breach,Sova,Killjoy,Omen,Jett"
Ascent,Blue Otter,Void,13,2,2,1,1,11,"Cypher,Sova,Omen,Yoru,Deadlock","Sova,Killjoy,Omen,Jett,KAY/O"
Bind,rEVO GC,XSOUL GC,13,11,7,5,6,6,"Raze,Cypher,Brimstone,Gekko,Iso","Cypher,Brimstone,Reyna,Jett,Skye"
Lotus,Dasein Club GC,Deagle Ravagers,8,13,3,9,4,5,"Breach,Cypher,Omen,Neon,Fade","Raze,Killjoy,Viper,Omen,Fade"
Haven,SUPERNOVA,Team Digital,13,4,5,0,4,8,"Cypher,Sova,Omen,Yoru,Iso","Omen,Yoru,Fade,Deadlock,Clove"
Abyss,Lemonade Stand,Good Career,13,4,8,4,0,5,"Raze,Sova,Omen,Deadlock,Clove","Sova,Omen,Jett,KAY/O,Deadlock"
Abyss,Heavenly Sword Sect,Sexy Gang,13,10,8,3,7,5,"Cypher,Sova,Omen,Jett,Iso","Sova,Killjoy,Sage,Omen,Yoru"
Ascent,Non Verbal,Shifty505,13,11,9,3,8,4,"Cypher,Sova,Omen,Jett,Deadlock","Sova,Killjoy,Omen,Jett,KAY/O"
Lotus,Aspyre x Swarm,LF8 Mythic,13,10,7,5,5,6,"Breach,Raze,Killjoy,Gekko,Clove","Raze,Killjoy,Viper,Omen,Fade"
Sunset,Nearest Airport,overcook,13,5,7,5,0,6,"Breach,Cypher,Omen,Neon,Gekko","Breach,Raze,Cypher,Omen,Gekko"
Bind,ROSE,ABG luvrs,13,10,8,4,6,5,"Raze,Viper,Brimstone,Reyna,Skye","Raze,Viper,Brimstone,Reyna,Skye"
Bind,FNATIC,Team Vitality,13,3,3,1,2,10,"Raze,Viper,Skye,Gekko,Clove","Raze,Viper,Omen,Fade,Gekko"
Lotus,rEVO GC,XSOUL GC,13,10,8,3,7,5,"Breach,Raze,Killjoy,Omen,Gekko","Breach,Raze,Cypher,Omen,Gekko"
Haven,Dasein Club GC,Deagle Ravagers,12,14,7,6,8,5,"Breach,Killjoy,Omen,Neon,Gekko","Breach,Sova,Killjoy,Omen,Jett"
Lotus,FNATIC,Team Vitality,13,9,5,5,4,8,"Raze,Killjoy,Viper,Omen,Fade","Breach,Raze,Cypher,Omen,Fade"
Lotus,Silly Weapons All Game,Anonymo GC,13,8,9,3,5,4,"Breach,Raze,Killjoy,Astra,Gekko","Raze,Sova,Omen,Yoru,Deadlock"
Sunset,EXO Clan,3.0 Hog eq,13,9,6,6,3,7,"Breach,Raze,Cypher,Omen,Gekko","Breach,Raze,Cypher,Omen,Gekko"
Icebox,Zeniths,SPACEGLID3RS,4,13,4,8,5,0,"Sova,Killjoy,Viper,Jett,KAY/O","Sova,Viper,Jett,Gekko,Clove"
Icebox,Poverineeh,Odyssey Gaming,13,7,5,3,4,8,"Cypher,Sova,Killjoy,Jett,Gekko","Killjoy,Viper,Jett,KAY/O,Gekko"
Icebox,Grow uP eSports,GMBLERS Esports,8,13,7,2,11,1,"Sova,Killjoy,Viper,Sage,Jett","Sova,Killjoy,Viper,Reyna,Jett"
Icebox,INCOGNITO,1000rr club,13,5,3,3,2,10,"Sova,Killjoy,Viper,Jett,Harbor","Sova,Killjoy,Viper,Reyna,Jett"
Icebox,Team Galaga,bazinga esports,15,13,9,5,8,6,"Sova,Killjoy,Viper,Reyna,Jett","Sova,Killjoy,Viper,Jett,Harbor"
Icebox,STAKERS,InTenZive,14,12,6,7,5,8,"Sova,Killjoy,Viper,Jett,Gekko","Sova,Killjoy,Viper,Jett,Iso"
Icebox,AMBYS Team,SZK Esports,7,13,4,8,5,3,"Sova,Killjoy,Jett,Harbor,Deadlock","Sova,Killjoy,Viper,Jett,Gekko"
Bind,Silly Weapons All Game,Anonymo GC,13,7,6,2,5,7,"Raze,Viper,Brimstone,Fade,Gekko","Breach,Raze,Cypher,Brimstone,Iso"
Haven,CGN Esports,MOUZ,11,13,5,7,6,6,"Cypher,Sova,Sage,Omen,Jett","Breach,Cypher,Sova,Omen,Jett"
Ascent,FNATIC,Team Vitality,9,13,5,5,8,4,"Cypher,Sova,Yoru,Astra,Iso","Sova,Killjoy,Omen,Jett,KAY/O"
Haven,EXO Clan,3.0 Hog eq,7,13,4,8,5,3,"Breach,Sova,Killjoy,Omen,Jett","Breach,Cypher,Sova,Omen,Jett"
Haven,FNATIC,Team Vitality,13,8,4,5,3,9,"Cypher,Sova,Omen,Yoru,Iso","Breach,Cypher,Sova,Omen,Jett"
Sunset,CGN Esports,MOUZ,6,13,4,8,5,2,"Raze,Cypher,Sova,Sage,Omen","Breach,Raze,Cypher,Sova,Omen"
Abyss,EXO Clan,3.0 Hog eq,13,6,3,4,2,10,"Breach,Sova,Sage,Jett,Astra","Breach,Cypher,Jett,Astra,Gekko"
Icebox,EOWYN GC,Anonymo GC,12,14,5,8,6,7,"Sova,Sage,Jett,Harbor,Gekko","Sova,Killjoy,Viper,Jett,Harbor"
Ascent,Zerance,Mandatory,13,4,3,2,2,10,"Sova,Killjoy,Reyna,Omen,Jett","Raze,Viper,KAY/O,Harbor,Gekko"
Abyss,CGN Esports,MOUZ,10,13,6,5,8,4,"Cypher,Sova,Sage,Omen,Jett","Cypher,Sova,Omen,Jett,KAY/O"
Bind,EOWYN GC,Anonymo GC,5,13,2,4,9,3,"Raze,Cypher,Skye,Deadlock,Clove","Breach,Raze,Cypher,Brimstone,Iso"
Sunset,Zerance,Mandatory,13,5,5,1,4,8,"Raze,Cypher,Sova,Omen,KAY/O","Breach,Raze,Cypher,Omen,Gekko"
Haven,Team Galaga,Melilla Titans,6,13,0,7,6,6,"Breach,Sova,Killjoy,Omen,Jett","Breach,Sova,Killjoy,Omen,Jett"
Bind,3.0 Hog eq,Elo and Muscle,13,4,9,3,1,4,"Raze,Viper,Brimstone,Skye,Gekko","Raze,Cypher,Viper,Brimstone,Skye"
Icebox,Team Galaga,Melilla Titans,10,13,2,9,4,8,"Sova,Killjoy,Viper,Jett,Harbor","Sova,Killjoy,Viper,Yoru,Harbor"
Lotus,CGN Esports,MOUZ,13,9,5,7,2,8,"Raze,Sova,Killjoy,Omen,Gekko","Breach,Cypher,Sova,Omen,Neon"
Haven,3.0 Hog eq,Elo and Muscle,13,6,5,2,4,8,"Breach,Cypher,Sova,Omen,Jett","Breach,Cypher,Sova,Omen,Jett"
Lotus,EXO Clan,Jabba Enjoyers,10,13,5,7,6,5,"Breach,Cypher,Omen,Neon,Fade","Breach,Raze,Killjoy,Omen,Fade"
Ascent,DRX,Paper Rex,13,7,7,5,2,6,"Sova,Killjoy,Omen,Jett,KAY/O","Raze,Reyna,Omen,Skye,Harbor"
Split,Team Galaga,Melilla Titans,13,8,6,3,5,7,"Raze,Cypher,Omen,Jett,Skye","Breach,Raze,Cypher,Omen,Gekko"
Ascent,EXO Clan,Jabba Enjoyers,10,13,5,6,7,5,"Sova,Killjoy,Omen,Jett,KAY/O","Sova,Killjoy,Omen,Jett,KAY/O"
Icebox,DRX,Paper Rex,13,10,6,6,4,7,"Sova,Killjoy,Viper,Jett,Gekko","Killjoy,Viper,Sage,Jett,KAY/O"
Sunset,Team Galaga,Melilla Titans,13,9,8,4,5,5,"Raze,Cypher,Omen,Gekko,Deadlock","Breach,Cypher,Sova,Omen,Neon"
Haven,City Wok,3.0 Hog eq,5,13,1,5,8,4,"Breach,Sova,Killjoy,Omen,Jett","Breach,Cypher,Sova,Omen,Jett"
Haven,Elo and Muscle,Cognizant,13,4,4,1,3,9,"Breach,Cypher,Sova,Omen,Jett","Cypher,Sova,Omen,KAY/O,Neon"
Ascent,ALTERNATE aTTaX Ruby,TOG Kitsune,13,11,5,7,4,8,"Sova,Killjoy,Omen,Jett,KAY/O","Sova,Killjoy,Omen,Jett,KAY/O"
Bind,DRX,Paper Rex,13,10,5,6,4,8,"Raze,Viper,Brimstone,Fade,Gekko","Raze,Viper,Omen,Yoru,Gekko"
Abyss,Nuclear GC,Deception,13,7,10,2,5,3,"Cypher,Omen,Jett,KAY/O,Gekko","Breach,Cypher,Jett,Astra,Gekko"
Lotus,Team Galaga,Melilla Titans,12,14,5,8,6,7,"Breach,Cypher,Omen,Neon,Gekko","Raze,Killjoy,Viper,Omen,Fade"
Abyss,City Wok,3.0 Hog eq,3,13,2,10,3,1,"Cypher,Omen,Jett,Gekko,Deadlock","Breach,Cypher,Jett,Astra,Gekko"
Lotus,Elo and Muscle,Cognizant,13,5,3,3,2,10,"Breach,Raze,Killjoy,Omen,Fade","Cypher,Omen,KAY/O,Neon,Gekko"
Sunset,ALTERNATE aTTaX Ruby,TOG Kitsune,13,6,4,3,3,9,"Breach,Raze,Cypher,Sova,Omen","Breach,Raze,Cypher,Omen,Gekko"
Lotus,DRX,Paper Rex,10,13,5,7,6,5,"Breach,Omen,Chamber,Neon,Fade","Omen,Jett,KAY/O,Neon,Fade"
Ascent,Nuclear GC,Deception,13,4,3,2,2,10,"Sova,Killjoy,Omen,Jett,KAY/O","Sova,Killjoy,Omen,Jett,KAY/O"
Ascent,SGA Incheon,잇뽕따닥,13,8,8,4,4,5,"Sova,Killjoy,Omen,Jett,KAY/O","Viper,Phoenix,Brimstone,Astra,Gekko"
Abyss,DRX,Paper Rex,7,13,1,7,6,6,"Cypher,Sova,Omen,Jett,KAY/O","Breach,Phoenix,Omen,KAY/O,Neon"
Lotus,Deception,FearX elite Academy,4,13,0,5,8,4,"Breach,Raze,Killjoy,Omen,Skye","Raze,Killjoy,Viper,Omen,Fade"
Abyss,SGA Incheon,잇뽕따닥,13,7,8,4,3,5,"Breach,Omen,Jett,Harbor,Gekko","Cypher,Reyna,Omen,Gekko,Deadlock"
Ascent,Deception,FearX elite Academy,10,13,5,7,6,5,"Sova,Killjoy,Omen,Jett,KAY/O","Sova,Killjoy,Omen,Jett,KAY/O"
Abyss,FearX elite Academy,Nuclear GC,10,13,2,9,4,8,"Breach,Viper,Omen,Jett,Gekko","Breach,Cypher,Jett,Astra,Gekko"
Sunset,Female Warriors,SGA Incheon,4,13,4,8,5,0,"Breach,Raze,Cypher,Omen,Fade","Breach,Raze,Cypher,Omen,Fade"
Lotus,FearX elite Academy,Nuclear GC,13,6,5,2,4,8,"Raze,Killjoy,Viper,Omen,Fade","Breach,Raze,Killjoy,Omen,Fade"
Sunset,FearX elite Academy,Nuclear GC,5,13,1,5,8,4,"Breach,Raze,Cypher,Omen,Gekko","Breach,Cypher,Sova,Omen,Neon"
Haven,Female Warriors,SGA Incheon,8,13,5,7,6,3,"Cypher,Sova,Omen,Yoru,Astra","Breach,Sova,Killjoy,Omen,Jett"
Lotus,Malecient Moon,PWN Esports,13,3,4,0,3,9,"Raze,Killjoy,Omen,Fade,Gekko","Breach,Raze,Killjoy,Omen,Fade"
Lotus,No Sweat Blossom,Legiowon Puff,12,14,5,8,6,7,"Killjoy,Omen,Neon,Gekko,Iso","Breach,Raze,Killjoy,Omen,Gekko"
Lotus,Infiriumz Gaming GC,Barcelona Sporting X,2,13,2,1,12,0,"Breach,Raze,Killjoy,Omen,Jett","Brimstone,Omen,Astra,Harbor,Clove"
Bind,Malecient Moon,PWN Esports,13,11,7,5,6,6,"Raze,Viper,Brimstone,Fade,Gekko","Raze,Cypher,Viper,Brimstone,Gekko"
Ascent,KRÜ Esports,100 Thieves,13,11,5,7,4,8,"Sova,Killjoy,Omen,Jett,KAY/O","Sova,Killjoy,Omen,Jett,KAY/O"
Ascent,No Sweat Blossom,Legiowon Puff,6,13,2,10,3,4,"Sova,Killjoy,Omen,Jett,KAY/O","Sova,Killjoy,Omen,Jett,KAY/O"
Icebox,Infiriumz Gaming GC,Barcelona Sporting X,1,13,1,11,2,0,"Sova,Killjoy,Reyna,Harbor,Gekko","Sova,Killjoy,Viper,Jett,Gekko"
Ascent,minions united GC,Charmers GC,13,0,12,0,0,1,"Sova,Killjoy,Omen,Jett,KAY/O","Sova,Killjoy,Omen,Jett,KAY/O"
Lotus,KRÜ Esports,100 Thieves,13,11,7,5,6,6,"Raze,Killjoy,Viper,Omen,Fade","Raze,Killjoy,Viper,Omen,Fade"
Icebox,Return of the Ashes,Sphinx GC,7,13,6,6,7,1,"Killjoy,Viper,Reyna,Harbor,Gekko","Sova,Killjoy,Viper,Jett,Clove"
Icebox,KRÜ Esports,100 Thieves,9,13,3,7,6,6,"Sova,Killjoy,Viper,Jett,KAY/O","Sova,Killjoy,Viper,Jett,Gekko"
Haven,Nekomata Galaxy,Deagle Ravagers,6,13,2,10,3,4,"Breach,Sova,Killjoy,Omen,Jett","Breach,Sova,Killjoy,Omen,Jett"
Lotus,XSOUL GC,Krows Corax,13,10,6,5,5,7,"Breach,Raze,Cypher,Omen,Gekko","Breach,Cypher,Neon,Gekko,Clove"
Lotus,Nekomata Galaxy,Deagle Ravagers,6,13,3,9,4,3,"Breach,Raze,Killjoy,Omen,Gekko","Raze,Killjoy,Viper,Omen,Fade"
Haven,Return of the Ashes,Sphinx GC,11,13,4,8,5,7,"Breach,Cypher,Sova,Omen,Jett","Breach,Sova,Killjoy,Omen,Neon"
Bind,Leviatán,G2 Esports,6,13,2,5,8,4,"Raze,Viper,Brimstone,Fade,Gekko","Raze,Viper,Brimstone,Skye,Gekko"
Ascent,XSOUL GC,Krows Corax,13,7,5,3,4,8,"Sova,Killjoy,Omen,Jett,KAY/O","Breach,Sova,Killjoy,Omen,Jett"
Lotus,Jabba Enjoyers,City Wok,13,9,8,4,5,5,"Breach,Raze,Killjoy,Omen,Fade","Breach,Raze,Cypher,Omen,Fade"
Icebox,Leviatán,G2 Esports,8,13,6,3,10,2,"Sova,Killjoy,Viper,Jett,Harbor","Sova,Killjoy,Viper,Harbor,Gekko"
Haven,3.0 Hog eq,Enhanced Aim,13,7,8,4,3,5,"Breach,Cypher,Sova,Omen,Jett","Cypher,Omen,Yoru,Fade,Deadlock"
Icebox,Jabba Enjoyers,City Wok,7,13,2,10,3,5,"Sova,Killjoy,Viper,Jett,Deadlock","Sova,Killjoy,Viper,Jett,Gekko"
Icebox,Coalesce,Cognizant,10,13,3,8,5,7,"Sova,Killjoy,Viper,Reyna,Jett","Sova,Killjoy,Viper,Jett,KAY/O"
Haven,EXO Clan,Elo and Muscle,13,8,7,5,3,6,"Breach,Sova,Killjoy,Omen,Jett","Breach,Cypher,Sova,Omen,Jett"
Ascent,3.0 Hog eq,Enhanced Aim,4,13,4,8,5,0,"Cypher,Sova,Omen,Jett,KAY/O","Cypher,Sova,Omen,Jett,Deadlock"
Ascent,Jabba Enjoyers,City Wok,13,2,2,1,1,11,"Sova,Killjoy,Omen,Jett,KAY/O","Cypher,Sova,Omen,Jett,KAY/O"
Bind,Coalesce,Cognizant,2,13,0,3,10,2,"Raze,Cypher,Brimstone,Skye,Gekko","Breach,Cypher,Brimstone,Neon,Gekko"
Lotus,EXO Clan,Elo and Muscle,13,3,3,1,2,10,"Breach,Cypher,Omen,Neon,Fade","Breach,Raze,Killjoy,Omen,Fade"
Bind,3.0 Hog eq,Enhanced Aim,13,5,4,2,3,9,"Raze,Viper,Brimstone,Skye,Gekko","Raze,Cypher,Omen,Skye,Deadlock"
Ascent,Jabba Enjoyers,Coalesce,13,5,9,3,2,4,"Sova,Killjoy,Omen,Jett,KAY/O","Sova,Killjoy,Omen,Jett,KAY/O"
Haven,Cognizant,City Wok,7,13,5,7,6,2,"Cypher,Sova,Omen,KAY/O,Neon","Breach,Sova,Killjoy,Omen,Jett"
Abyss,PURE GC,EOWYN GC,11,13,6,6,7,5,"Breach,Cypher,Sova,Omen,Jett","Breach,Cypher,Jett,Astra,Deadlock"
Haven,Team Vitality,Team Heretics,13,9,8,4,5,5,"Breach,Cypher,Sova,Omen,Jett","Breach,Cypher,Sova,Omen,Neon"
Ascent,Cursed Cats GC,Anonymo GC,3,13,0,4,9,3,"Sova,Killjoy,Omen,Jett,KAY/O","Sova,Killjoy,Phoenix,Omen,Jett"
Lotus,Team Vitality,Team Heretics,13,3,4,0,3,9,"Breach,Raze,Cypher,Omen,Fade","Breach,Cypher,Omen,Neon,Fade"
Haven,EXO Clan,3.0 Hog eq,14,12,10,3,9,4,"Breach,Sova,Killjoy,Omen,Jett","Breach,Cypher,Sova,Omen,Jett"
Icebox,Jabba Enjoyers,Coalesce,8,13,7,5,8,1,"Sova,Killjoy,Viper,Jett,Deadlock","Sova,Killjoy,Viper,Reyna,Jett"
Bind,PURE GC,EOWYN GC,9,13,3,7,6,6,"Raze,Cypher,Brimstone,Fade,Gekko","Raze,Cypher,Skye,Deadlock,Clove"
Lotus,Cognizant,City Wok,13,5,8,4,1,5,"Cypher,Sova,Omen,KAY/O,Neon","Breach,Raze,Cypher,Omen,Fade"
Sunset,Formulation Gaming GC,Silly Weapons All Game,13,11,8,4,7,5,"Breach,Raze,Cypher,Omen,Gekko","Breach,Raze,Cypher,Gekko,Clove"
Lotus,Enhanced Aim,Elo and Muscle,5,13,5,7,6,0,"Raze,Cypher,Omen,Fade,Deadlock","Breach,Raze,Killjoy,Omen,Fade"
Abyss,Cursed Cats GC,Anonymo GC,13,11,6,6,5,7,"Sova,Yoru,Astra,Deadlock,Iso","Cypher,Sova,Omen,Jett,KAY/O"
Sunset,Team Vitality,Team Heretics,13,4,5,0,4,8,"Cypher,Sova,Omen,KAY/O,Neon","Cypher,Sova,Omen,KAY/O,Neon"
Ascent,Cognizant,City Wok,6,13,6,6,7,0,"Breach,Sova,Omen,Chamber,Neon","Cypher,Sova,Omen,Jett,KAY/O"
Abyss,EXO Clan,3.0 Hog eq,13,11,8,4,7,5,"Breach,Sova,Sage,Jett,Astra","Breach,Cypher,Jett,Astra,Gekko"
Haven,Jabba Enjoyers,Coalesce,13,9,6,6,3,7,"Breach,Sova,Killjoy,Omen,Jett","Breach,Sova,Killjoy,Omen,Jett"
Haven,Enhanced Aim,Elo and Muscle,8,13,5,4,9,3,"Cypher,Omen,Yoru,Fade,Deadlock","Breach,Cypher,Sova,Omen,Jett"
Lotus,Cursed Cats GC,Anonymo GC,5,13,1,5,8,4,"Breach,Raze,Killjoy,Omen,Gekko","Raze,Sova,Omen,Yoru,Deadlock"
Lotus,PURE GC,EOWYN GC,15,13,8,6,7,7,"Breach,Raze,Cypher,Gekko,Clove","Breach,Raze,Killjoy,Omen,Gekko"
Icebox,Formulation Gaming GC,Silly Weapons All Game,13,10,4,8,2,9,"Sova,Killjoy,Viper,Sage,Jett","Sova,Killjoy,Viper,Sage,Jett"
Icebox,Team Vitality,Team Heretics,6,13,3,9,4,3,"Sova,Killjoy,Viper,Jett,Gekko","Sova,Killjoy,Viper,Neon,Gekko"
Sunset,Clique Esports,XRAVEL,10,13,6,5,8,4,"Raze,Cypher,Yoru,Gekko,Clove","Breach,Raze,Cypher,Reyna,Omen"
Icebox,Jabba Enjoyers,City Wok,13,10,5,6,4,8,"Sova,Killjoy,Viper,Jett,Deadlock","Sova,Killjoy,Viper,Reyna,Iso"
Sunset,Lost Puppies,Taz'dingo,4,13,3,2,11,1,"Breach,Raze,Cypher,Omen,Fade","Breach,Raze,Cypher,Omen,Fade"
Lotus,3.0 Hog eq,Enhanced Aim,7,13,5,7,6,2,"Breach,Raze,Cypher,Omen,Gekko","Raze,Cypher,Omen,Fade,Deadlock"
Lotus,Coalesce,Cognizant,6,13,1,6,7,5,"Raze,Cypher,Omen,Jett,Skye","Cypher,Omen,KAY/O,Neon,Gekko"
Bind,Fanta light brev,PUB AIM,9,13,2,10,3,7,"Raze,Viper,Skye,Deadlock,Clove","Raze,Viper,Brimstone,Fade,Gekko"
Ascent,Big Mort Resort,DarkLords,13,2,2,1,1,11,"Cypher,Sova,Phoenix,Jett,Clove","Cypher,Sova,Omen,Jett,Deadlock"
Bind,EXO Clan,Elo and Muscle,13,8,6,6,2,7,"Raze,Viper,Omen,Fade,Gekko","Raze,Viper,Brimstone,Skye,Chamber"
Abyss,Made in Thailand,FULL SENSE,13,9,8,2,7,5,"Sova,Killjoy,Reyna,Astra,Iso","Viper,Jett,Yoru,KAY/O,Clove"
Icebox,XRAVEL,GG GO BAR,13,2,10,2,0,3,"Sova,Killjoy,Viper,Reyna,Jett","Sova,Killjoy,Viper,Jett,Gekko"
Lotus,Clique Esports,EXO Clan,7,13,2,6,7,5,"Breach,Raze,Killjoy,Omen,Skye","Breach,Cypher,Omen,Neon,Fade"
Sunset,Taz'dingo,Team Coalesce Roses,13,0,12,0,0,1,"Breach,Raze,Cypher,Omen,Fade","Breach,Raze,Cypher,Sova,Omen"
Sunset,Fanta light brev,3.0 Hog eq,7,13,4,4,9,3,"Raze,Cypher,Viper,Omen,KAY/O","Breach,Raze,Cypher,Omen,Gekko"
Sunset,DarkLords,Catsmonke,13,9,7,5,4,6,"Cypher,KAY/O,Neon,Harbor,Clove","Breach,Cypher,Sova,Omen,Iso"
Icebox,Big Mort Resort,Coalesce,7,13,2,10,3,5,"Sova,Killjoy,Viper,Jett,Iso","Sova,Killjoy,Viper,Reyna,Jett"
Bind,Lost Puppies,Jabba Enjoyers,14,16,6,9,7,8,"Raze,Cypher,Brimstone,Skye,Fade","Raze,Viper,Brimstone,Fade,Gekko"
Lotus,Team Flash,Cyberking Esports,13,5,6,0,5,7,"Breach,Cypher,Omen,Neon,Fade","Raze,Killjoy,Viper,Gekko,Clove"
Lotus,Made in Thailand,FULL SENSE,11,13,8,4,9,3,"Breach,Cypher,Astra,Neon,Gekko","Chamber,Neon,Deadlock,Iso,Clove"
Ascent,GG GO BAR,Clique Esports,4,13,0,5,8,4,"Sova,Killjoy,Omen,Jett,KAY/O","Sova,Killjoy,Reyna,Omen,Jett"
Bind,Catsmonke,Big Mort Resort,3,13,3,9,4,0,"Cypher,Brimstone,Jett,Skye,Gekko","Breach,Raze,Cypher,Yoru,Clove"
Bind,XRAVEL,Elo and Muscle,12,14,6,7,7,6,"Raze,Viper,Brimstone,KAY/O,Gekko","Raze,Viper,Brimstone,Skye,Chamber"
Lotus,Taz'dingo,City Wok,9,13,4,8,5,5,"Raze,Killjoy,Viper,Omen,Fade","Breach,Raze,Cypher,Omen,Fade"
Haven,Team Flash,Cyberking Esports,13,1,11,1,0,2,"Killjoy,Viper,Omen,Jett,Skye","Breach,Cypher,Sova,Omen,Neon"
Haven,Team Coalesce Roses,Lost Puppies,1,13,1,11,2,0,"Breach,Cypher,Sova,Jett,Clove","Breach,Cypher,Sova,Omen,Jett"
Lotus,DarkLords,Cognizant,6,13,4,8,5,2,"Breach,Raze,Killjoy,Omen,Neon","Cypher,Omen,KAY/O,Neon,Gekko"
Bind,PUB AIM,Enhanced Aim,5,13,5,7,6,0,"Raze,Viper,Brimstone,Fade,Gekko","Raze,Cypher,Omen,Skye,Deadlock"
Haven,Made in Thailand,FULL SENSE,13,5,8,4,1,5,"Sova,Chamber,Neon,Gekko,Clove","Breach,Cypher,Reyna,Iso,Clove"
Icebox,Fancy United Esports,Rapid Lofi,13,8,3,6,2,10,"Cypher,Viper,KAY/O,Gekko,Clove","Killjoy,Viper,Jett,KAY/O,Gekko"
Ascent,Made in Thailand,FULL SENSE,13,9,4,6,3,9,"Sova,Reyna,Deadlock,Iso,Clove","Sova,Killjoy,Jett,Deadlock,Clove"
Lotus,GG GO BAR,EXO Clan,2,13,2,10,3,0,"Breach,Raze,Cypher,Omen,Fade","Breach,Cypher,Omen,Neon,Fade"
Icebox,Catsmonke,Coalesce,0,13,0,12,1,0,"Raze,Sova,Viper,Sage,Gekko","Sova,Killjoy,Viper,Reyna,Jett"
Haven,Clique Esports,Elo and Muscle,5,13,0,6,7,5,"Killjoy,Omen,Jett,Skye,Deadlock","Breach,Cypher,Sova,Omen,Jett"
Bind,Team Coalesce Roses,Jabba Enjoyers,0,13,0,1,12,0,"Breach,Raze,Cypher,Viper,Brimstone","Raze,Viper,Brimstone,Fade,Gekko"
Haven,Fanta light brev,Enhanced Aim,8,13,4,8,5,4,"Breach,Sova,Killjoy,Omen,Neon","Cypher,Omen,Yoru,Fade,Deadlock"
Lotus,Big Mort Resort,Cognizant,10,13,7,5,8,3,"Breach,Raze,Killjoy,Omen,Neon","Cypher,Omen,KAY/O,Neon,Gekko"
Lotus,Lost Puppies,City Wok,4,13,3,9,4,1,"Breach,Raze,Killjoy,Omen,Fade","Breach,Raze,Cypher,Omen,Fade"
Bind,OLD STINKY CAT,ZOL Esports,6,13,3,4,9,3,"Breach,Raze,Killjoy,Brimstone,Jett","Raze,Cypher,Brimstone,Skye,Gekko"
Bind,Fancy United Esports,Rapid Lofi,13,6,5,2,4,8,"Raze,Cypher,Omen,KAY/O,Deadlock","Raze,Cypher,Viper,Brimstone,Skye"
Haven,Coalesce,DarkLords,13,3,3,1,2,10,"Breach,Sova,Killjoy,Omen,Jett","Breach,Sova,Killjoy,Omen,Neon"
Ascent,3.0 Hog eq,PUB AIM,13,6,6,6,0,7,"Cypher,Sova,Omen,Jett,KAY/O","Cypher,Sova,Omen,Jett,Deadlock"
Bind,Cognizant,Catsmonke,13,0,12,0,0,1,"Raze,Cypher,Brimstone,KAY/O,Gekko","Cypher,Brimstone,Sage,Skye,KAY/O"
Lotus,Jabba Enjoyers,Taz'dingo,13,4,10,2,2,3,"Breach,Raze,Killjoy,Omen,Fade","Raze,Killjoy,Viper,Omen,Fade"
Lotus,EXO Clan,XRAVEL,13,4,4,1,3,9,"Breach,Cypher,Omen,Neon,Fade","Breach,Cypher,Omen,Neon,Deadlock"
Lotus,City Wok,Team Coalesce Roses,13,1,2,0,1,11,"Breach,Raze,Cypher,Omen,Fade","Breach,Raze,Killjoy,Neon,Clove"
Haven,Elo and Muscle,GG GO BAR,13,2,2,1,1,11,"Breach,Cypher,Sova,Omen,Jett","Cypher,Sova,Omen,Jett,Yoru"
Abyss,OLD STINKY CAT,ZOL Esports,8,13,3,6,7,5,"Cypher,Sova,Omen,Jett,KAY/O","Omen,Jett,Yoru,KAY/O,Harbor"
Ascent,JustUs,Carti World,13,7,7,5,2,6,"Sova,Killjoy,Reyna,Omen,Jett","Sova,Killjoy,Omen,Jett,KAY/O"
Lotus,JustUs,Carti World,13,11,7,5,6,6,"Killjoy,Omen,Jett,Skye,Fade","Raze,Killjoy,Viper,Omen,Fade"
Icebox,Malecient Moon,ONE BULLET GAMING GC,13,7,4,4,3,9,"Sova,Killjoy,Viper,Jett,Gekko","Killjoy,Viper,Jett,Gekko,Iso"
Bind,Legiowon Puff,BE esports,13,8,5,4,4,8,"Raze,Cypher,Viper,Brimstone,Skye","Raze,Cypher,Viper,Gekko,Clove"
Lotus,NovaCrew,Legion Nyx,8,13,4,5,8,4,"Breach,Raze,Killjoy,Omen,Fade","Breach,Raze,Cypher,Omen,Gekko"
Haven,FEK ESPORTS GC,Infiriumz Gaming GC,12,14,3,10,4,9,"Breach,Sova,Killjoy,Omen,Jett","Breach,Sova,Killjoy,Omen,Neon"
Lotus,New Combat Line GC,No Sweat Blossom,9,13,6,4,9,3,"Breach,Cypher,Omen,Neon,Gekko","Killjoy,Omen,Neon,Gekko,Iso"
Lotus,Azzy White,FIXAM,13,10,6,5,5,7,"Breach,Raze,Killjoy,Omen,Neon","Breach,Killjoy,Omen,Neon,Gekko"
Icebox,Barcelona Sporting X,OK Gaming,13,4,3,2,2,10,"Sova,Killjoy,Viper,Jett,Gekko","Killjoy,Viper,Jett,KAY/O,Clove"
Haven,Malecient Moon,ONE BULLET GAMING GC,13,3,9,3,0,4,"Killjoy,Omen,Jett,Fade,Gekko","Breach,Sova,Killjoy,Omen,Jett"
Icebox,Legiowon Puff,BE esports,13,11,7,5,6,6,"Killjoy,Viper,Omen,KAY/O,Gekko","Sova,Killjoy,Viper,Jett,Gekko"
Haven,NovaCrew,Legion Nyx,5,13,3,3,10,2,"Breach,Sova,Killjoy,Jett,Clove","Breach,Sova,Killjoy,Omen,Jett"
Icebox,FEK ESPORTS GC,Infiriumz Gaming GC,9,13,3,9,4,6,"Killjoy,Viper,Jett,Neon,Gekko","Sova,Killjoy,Reyna,Harbor,Gekko"
Lotus,Barcelona Sporting X,OK Gaming,13,1,11,1,0,2,"Killjoy,Viper,Omen,Neon,Fade","Breach,Raze,Cypher,Omen,Clove"
Abyss,Azzy White,FIXAM,13,7,6,6,1,7,"Cypher,Sova,Omen,Jett,KAY/O","Breach,Viper,Omen,Chamber,Neon"
Haven,New Combat Line GC,No Sweat Blossom,8,13,4,5,8,4,"Breach,Sova,Killjoy,Omen,Neon","Breach,Cypher,Omen,Neon,Iso"
Icebox,Return of the Ashes,Dasein Club GC,13,11,5,7,4,8,"Killjoy,Viper,Reyna,Harbor,Gekko","Killjoy,Viper,Jett,KAY/O,Gekko"
Abyss,G2 Esports,100 Thieves,13,10,6,5,5,7,"Sova,Killjoy,Viper,Yoru,Astra","Cypher,Sova,Omen,Jett,Gekko"
Lotus,rEVO GC,Sphinx GC,13,15,6,8,7,7,"Breach,Killjoy,Omen,Neon,Gekko","Breach,Killjoy,Omen,Neon,Fade"
Lotus,Nekomata Galaxy,Malecient Parasside,13,8,7,2,6,6,"Breach,Raze,Killjoy,Omen,Gekko","Omen,Jett,KAY/O,Neon,Fade"
Ascent,Return of the Ashes,Dasein Club GC,14,12,8,5,7,6,"Cypher,Sova,Omen,Jett,KAY/O","Sova,Killjoy,Omen,Jett,KAY/O"
Ascent,XSOUL GC,Seraphin,13,8,5,4,4,8,"Sova,Killjoy,Omen,Jett,KAY/O","Sova,Killjoy,Omen,Jett,KAY/O"
Lotus,G2 Esports,100 Thieves,13,5,6,0,5,7,"Raze,Killjoy,Viper,Omen,Fade","Raze,Killjoy,Viper,Omen,Fade"
Haven,Nekomata Galaxy,Malecient Parasside,13,9,8,4,5,5,"Breach,Sova,Killjoy,Omen,Jett","Cypher,Sova,Omen,Yoru,Iso"
Haven,Return of the Ashes,Dasein Club GC,5,13,0,6,7,5,"Breach,Cypher,Sova,Omen,Jett","Breach,Killjoy,Omen,Neon,Gekko"
Lotus,XSOUL GC,Seraphin,13,5,6,0,5,7,"Breach,Raze,Killjoy,Omen,Gekko","Breach,Killjoy,Omen,Jett,Gekko"
Haven,rEVO GC,Sphinx GC,11,13,9,3,10,2,"Breach,Cypher,Sova,Omen,Jett","Breach,Sova,Killjoy,Omen,Neon"
Sunset,Leviatán,KRÜ Esports,13,4,3,2,2,10,"Breach,Cypher,Sova,Omen,Neon","Breach,Cypher,Sova,Omen,Neon"
Icebox,Leviatán,KRÜ Esports,13,2,3,0,2,10,"Sova,Killjoy,Viper,Jett,Harbor","Sova,Killjoy,Viper,Jett,KAY/O"
Bind,EOWYN GC,Sakura Breeze GC,13,10,7,4,6,6,"Raze,Cypher,Skye,Deadlock,Clove","Raze,Viper,Brimstone,Skye,Gekko"
Icebox,Cursed Cats GC,Silly Weapons All Game,3,13,2,10,3,1,"Sova,Viper,Omen,Jett,Gekko","Sova,Killjoy,Viper,Sage,Jett"
Sunset,EOWYN GC,Sakura Breeze GC,13,2,3,0,2,10,"Breach,Raze,Cypher,Omen,Gekko","Breach,Raze,Cypher,Sova,Omen"
Lotus,Cursed Cats GC,Silly Weapons All Game,13,4,8,4,0,5,"Breach,Raze,Killjoy,Omen,Gekko","Breach,Raze,Killjoy,Astra,Gekko"
Abyss,PURE GC,Formulation Gaming GC,3,13,0,4,9,3,"Breach,Cypher,Sova,Omen,Jett","Breach,Cypher,Jett,Astra,Gekko"
Abyss,Anonymo GC,NOIR Aster,13,4,8,4,0,5,"Cypher,Sova,Omen,Jett,KAY/O","Breach,Killjoy,Jett,Astra,Gekko"
Lotus,EOWYN GC,Sakura Breeze GC,5,13,4,8,5,1,"Breach,Raze,Killjoy,Omen,Gekko","Breach,Raze,Killjoy,Omen,Gekko"
Lotus,PURE GC,Formulation Gaming GC,6,13,1,6,7,5,"Breach,Raze,Cypher,Omen,Gekko","Raze,Killjoy,Viper,Omen,Fade"
Ascent,Cursed Cats GC,Silly Weapons All Game,9,13,6,6,7,3,"Sova,Killjoy,Omen,Jett,KAY/O","Sova,Killjoy,Jett,Astra,KAY/O"
Icebox,Anonymo GC,NOIR Aster,13,0,1,0,0,12,"Sova,Killjoy,Viper,Jett,Harbor","Sova,Killjoy,Viper,Sage,Jett"
Sunset,XERXIA Esports,FULL SENSE,12,14,6,7,7,6,"Breach,Raze,Cypher,Omen,Gekko","Breach,Raze,Cypher,Sova,Omen"
Icebox,Cyberking Esports,Team Big BAAM,13,6,3,4,2,10,"Sova,Killjoy,Viper,Jett,Gekko","Killjoy,Viper,Jett,KAY/O,Gekko"
Lotus,Disguised,Reve Drift Arena,13,9,9,1,8,4,"Raze,Cypher,Omen,Neon,Fade","Raze,Cypher,Viper,Omen,Skye"
Abyss,Cyberking Esports,Team Big BAAM,13,10,6,5,5,7,"Cypher,Sova,Jett,Astra,KAY/O","Cypher,Sova,Omen,Jett,KAY/O"
Bind,XERXIA Esports,FULL SENSE,14,16,9,6,10,5,"Raze,Viper,Brimstone,Skye,Gekko","Raze,Viper,Brimstone,Fade,Gekko"
Icebox,Disguised,Reve Drift Arena,13,7,6,6,1,7,"Sova,Killjoy,Viper,Reyna,Jett","Sova,Killjoy,Viper,Jett,Gekko"
Haven,Cyberking Esports,Team Big BAAM,10,13,7,4,9,3,"Killjoy,Viper,Skye,Iso,Clove","Breach,Cypher,Sova,Omen,Neon"
Icebox,XERXIA Esports,FULL SENSE,13,10,9,2,8,4,"Killjoy,Viper,Jett,KAY/O,Gekko","Sova,Killjoy,Viper,Jett,KAY/O"
Lotus,SLT Seongam,Nongshim RedForce,13,15,6,8,7,7,"Raze,Killjoy,Viper,Omen,Fade","Omen,Jett,KAY/O,Neon,Fade"
Lotus,XERXIA Esports,FULL SENSE,10,13,3,9,4,7,"Breach,Raze,Cypher,Omen,Fade","Breach,Raze,Killjoy,Viper,Omen"
Ascent,Disguised,Reve Drift Arena,13,9,7,5,4,6,"Cypher,Sova,Omen,Jett,Iso","Cypher,Sova,Omen,Jett,KAY/O"
Haven,Team Flash,LAZY,13,6,6,6,0,7,"Killjoy,Viper,Omen,Jett,Skye","Breach,Cypher,Sova,Omen,Jett"
Ascent,Cyber Geek,Reignite Lily,10,13,7,4,9,3,"Breach,Brimstone,Sage,Omen,KAY/O","Sova,Killjoy,Omen,Jett,KAY/O"
Sunset,SLT Seongam,Nongshim RedForce,9,13,7,5,8,2,"Breach,Cypher,Sova,Omen,Neon","Sova,Omen,Jett,KAY/O,Neon"
Lotus,Team Flash,LAZY,13,1,11,1,0,2,"Breach,Cypher,Omen,Neon,Fade","Raze,Killjoy,Viper,Omen,Skye"
Sunset,Cyber Geek,Reignite Lily,12,14,6,7,7,6,"Breach,Raze,Cypher,Omen,Gekko","Cypher,Sova,Omen,KAY/O,Neon"
Sunset,Sin Prisa Gaming,Dplus Esports,13,10,8,4,6,5,"Raze,Cypher,Omen,Fade,Deadlock","Cypher,Sova,Omen,Jett,KAY/O"
Sunset,Tyrant Esports PH,ZOL Esports,6,13,2,5,8,4,"Raze,Cypher,Gekko,Iso,Clove","Cypher,Sova,Omen,KAY/O,Neon"
Lotus,ZETA DIVISION GC,FENNEL GC,13,4,4,1,3,9,"Breach,Raze,Cypher,Omen,Fade","Breach,Raze,Cypher,Omen,Fade"
Bind,Tyrant Esports PH,ZOL Esports,4,13,4,8,5,0,"Raze,Cypher,Skye,Iso,Clove","Raze,Cypher,Brimstone,Skye,Gekko"
Bind,Sin Prisa Gaming,Dplus Esports,11,13,4,8,5,7,"Raze,Cypher,Brimstone,Skye,Deadlock","Raze,Viper,Omen,KAY/O,Gekko"
Icebox,ZETA DIVISION GC,FENNEL GC,9,13,5,7,6,4,"Killjoy,Viper,Omen,KAY/O,Gekko","Killjoy,Viper,Reyna,Jett,Gekko"
Abyss,Tyrant Esports PH,ZOL Esports,13,11,8,4,7,5,"Cypher,Jett,Gekko,Iso,Clove","Omen,Jett,Yoru,KAY/O,Harbor"
Abyss,Sin Prisa Gaming,Dplus Esports,13,6,8,4,2,5,"Breach,Cypher,Omen,Jett,Gekko","Cypher,Sova,Omen,Jett,KAY/O"
Bind,ZETA DIVISION GC,FENNEL GC,13,8,8,4,4,5,"Raze,Cypher,Viper,Skye,Clove","Raze,Sova,Viper,Omen,Skye"
Ascent,Reignite Lily,DRX Changers,16,14,8,7,7,8,"Sova,Killjoy,Omen,Jett,KAY/O","Sova,Killjoy,Omen,Jett,KAY/O"
Bind,Malecient Moon,BE esports,5,13,4,8,5,1,"Raze,Cypher,Brimstone,Fade,Gekko","Raze,Cypher,Viper,Gekko,Clove"
Sunset,Reignite Lily,DRX Changers,13,4,8,4,0,5,"Cypher,Sova,Omen,KAY/O,Neon","Breach,Cypher,Sova,Omen,Neon"
Lotus,Malecient Moon,BE esports,13,7,7,5,2,6,"Raze,Killjoy,Omen,Fade,Gekko","Breach,Raze,Killjoy,Omen,Gekko"
Haven,"Fenrir ""White"" E-Club",Barcelona Sporting X,7,13,4,8,5,3,"Breach,Sova,Killjoy,Omen,Neon","Breach,Cypher,Omen,Jett,Fade"
Haven,No Sweat Blossom,Azzy White,13,8,5,4,4,8,"Breach,Cypher,Omen,Neon,Iso","Breach,Cypher,Phoenix,Jett,Clove"
Icebox,Malecient Moon,BE esports,6,13,5,7,6,1,"Killjoy,Viper,Sage,Jett,Gekko","Sova,Killjoy,Viper,Gekko,Iso"
Icebox,Legiowon Puff,PWN Esports,13,3,10,2,1,3,"Killjoy,Viper,Omen,KAY/O,Gekko","Sova,Killjoy,Viper,Gekko,Iso"
Lotus,SCARZ GC,Cyber Geek,11,13,6,6,7,5,"Raze,Killjoy,Viper,Omen,Fade","Breach,Cypher,Omen,Neon,Fade"
Lotus,Dark Abyss,New Combat Line GC,6,13,3,4,9,3,"Raze,Killjoy,Omen,Fade,Gekko","Breach,Cypher,Omen,Neon,Gekko"
Lotus,"Fenrir ""White"" E-Club",Barcelona Sporting X,13,7,7,5,2,6,"Breach,Killjoy,Phoenix,Omen,Neon","Killjoy,Omen,Neon,Fade,Clove"
Lotus,Legiowon Puff,PWN Esports,13,1,11,1,0,2,"Breach,Raze,Killjoy,Omen,Gekko","Breach,Raze,Killjoy,Omen,Fade"
Ascent,Sentinels,100 Thieves,10,13,6,5,8,4,"Cypher,Sova,Omen,Jett,Deadlock","Sova,Killjoy,Omen,Jett,KAY/O"
Sunset,Dark Abyss,New Combat Line GC,4,13,2,3,10,2,"Breach,Cypher,Omen,Neon,Gekko","Breach,Cypher,Omen,Neon,Fade"
Bind,SCARZ GC,Cyber Geek,5,13,3,9,4,2,"Raze,Viper,Brimstone,Fade,Gekko","Raze,Viper,Brimstone,Fade,Gekko"
Ascent,No Sweat Blossom,Azzy White,15,13,7,7,6,8,"Sova,Killjoy,Omen,Jett,KAY/O","Sova,Killjoy,Omen,Jett,KAY/O"
Ascent,"Fenrir ""White"" E-Club",Barcelona Sporting X,5,13,3,9,4,2,"Breach,Sova,Killjoy,Omen,Jett","Sova,Killjoy,Reyna,Jett,Clove"
Icebox,Deagle Ravagers,rEVO GC,10,13,5,7,6,5,"Sova,Killjoy,Viper,Jett,KAY/O","Killjoy,Viper,Jett,Gekko,Iso"
Haven,Sentinels,100 Thieves,7,13,4,4,9,3,"Breach,Sova,Killjoy,Omen,Jett","Cypher,Sova,Omen,Yoru,Iso"
Bind,SaD FROST,LazerrFreeks Ivy,13,6,4,3,3,9,"Raze,Viper,Chamber,Fade,Clove","Raze,Viper,Brimstone,Skye,Gekko"
Icebox,Nekomata Galaxy,Sphinx GC,10,13,6,6,7,4,"Sova,Reyna,Omen,Jett,KAY/O","Sova,Killjoy,Viper,Reyna,Jett"
Haven,KRÜ Esports,Cloud9,13,6,4,3,3,9,"Breach,Cypher,Sova,Omen,Neon","Breach,Sova,Killjoy,Omen,Jett"
Lotus,Deagle Ravagers,rEVO GC,10,13,6,6,7,4,"Raze,Killjoy,Viper,Omen,Fade","Breach,Killjoy,Omen,Neon,Gekko"
Ascent,Dasein Club GC,XSOUL GC,13,5,6,0,5,7,"Sova,Killjoy,Omen,Jett,KAY/O","Sova,Killjoy,Omen,Jett,KAY/O"
Sunset,Return of the Ashes,Krows Corax,13,9,5,5,4,8,"Raze,Cypher,Omen,KAY/O,Gekko","Breach,Cypher,Sova,Omen,Neon"
Sunset,Nekomata Galaxy,Sphinx GC,7,13,5,7,6,2,"Breach,Raze,Cypher,Omen,Gekko","Breach,Cypher,Omen,Neon,Fade"
Lotus,KRÜ Esports,Cloud9,11,13,10,2,11,1,"Raze,Killjoy,Viper,Omen,Fade","Raze,Killjoy,Omen,Gekko,Clove"
Lotus,Dasein Club GC,XSOUL GC,13,6,6,6,0,7,"Breach,Cypher,Omen,Neon,Fade","Breach,Raze,Killjoy,Omen,Gekko"
Bind,Deagle Ravagers,rEVO GC,13,10,7,5,5,6,"Breach,Raze,Viper,Brimstone,Gekko","Brimstone,Neon,Gekko,Deadlock,Iso"
Haven,Return of the Ashes,Krows Corax,13,4,8,4,0,5,"Breach,Cypher,Sova,Omen,Jett","Breach,Cypher,Sova,Omen,Neon"
Abyss,KRÜ Esports,Cloud9,13,11,6,6,5,7,"Cypher,Sova,Omen,Jett,KAY/O","Sova,Killjoy,Omen,Jett,KAY/O"
Sunset,Team Heretics,FUT Esports,13,11,8,4,7,5,"Cypher,Sova,Omen,KAY/O,Neon","Breach,Raze,Cypher,Omen,Gekko"
Haven,Critics Esports,BIG BANG Theory,13,11,7,5,6,6,"Breach,Cypher,Sova,Omen,Jett","Breach,Sova,Killjoy,Neon,Clove"
Abyss,Team Heretics,FUT Esports,13,10,6,6,4,7,"Breach,Raze,Cypher,Astra,Gekko","Cypher,Omen,Jett,Gekko,Deadlock"
Icebox,Critics Esports,BIG BANG Theory,13,11,6,6,5,7,"Sova,Viper,Jett,Gekko,Clove","Sova,Killjoy,Viper,Jett,Gekko"
Lotus,EOWYN GC,Crvena zvezda esports,13,4,8,4,0,5,"Breach,Raze,Killjoy,Omen,Gekko","Breach,Killjoy,Omen,Neon,Fade"
Sunset,Critics Esports,BIG BANG Theory,12,14,8,5,9,4,"Breach,Cypher,Omen,Neon,Gekko","Breach,Cypher,Neon,Gekko,Clove"
Sunset,Team Vitality,FNATIC,6,13,3,9,4,3,"Cypher,Sova,Omen,KAY/O,Neon","Breach,Raze,Cypher,Sova,Astra"
Lotus,NOIR Aster,Zyron Sadashi,13,10,8,3,7,5,"Breach,Raze,Killjoy,Omen,Deadlock","Breach,Raze,Killjoy,Omen,Gekko"
Lotus,Anonymo GC,Xravel CBRS,13,3,9,3,0,4,"Raze,Sova,Omen,Yoru,Deadlock","Raze,Killjoy,Viper,Omen,Fade"
Sunset,EOWYN GC,Crvena zvezda esports,13,6,10,2,4,3,"Breach,Raze,Cypher,Omen,Gekko","Breach,Raze,Cypher,Omen,Gekko"
Bind,Anonymo GC,Xravel CBRS,13,7,7,5,2,6,"Breach,Raze,Cypher,Brimstone,Iso","Raze,Viper,Brimstone,Gekko,Deadlock"
Ascent,Critics Esports,BIG BANG Theory,10,13,5,6,7,5,"Sova,Killjoy,Omen,Jett,KAY/O","Sova,Killjoy,Omen,Jett,KAY/O"
Sunset,NOIR Aster,Zyron Sadashi,13,10,8,4,6,5,"Breach,Raze,Cypher,Omen,Gekko","Breach,Raze,Cypher,Omen,Gekko"
Lotus,Team Vitality,FNATIC,11,13,7,5,8,4,"Breach,Raze,Cypher,Omen,Fade","Raze,Killjoy,Viper,Omen,Fade"
Abyss,Elevate (SG),Reve Drift Arena,11,13,7,5,8,4,"Sova,Killjoy,Jett,Astra,Harbor","Breach,Sova,Jett,Harbor,Clove"
Sunset,Elevate (SG),Reve Drift Arena,7,13,5,7,6,2,"Breach,Cypher,Sova,Omen,Neon","Raze,Cypher,Sova,Omen,Gekko"
Haven,Elevate (SG),Reve Drift Arena,13,11,8,4,7,5,"Breach,Sova,Killjoy,Omen,Jett","Breach,Sova,Jett,Chamber,Clove"
Haven,Team Flash,Rapid Lofi,10,13,3,8,5,7,"Raze,Killjoy,Viper,Omen,Skye","Breach,Cypher,Phoenix,Omen,Neon"
Lotus,Elevate (SG),Reve Drift Arena,13,11,6,6,5,7,"Breach,Raze,Cypher,Omen,Fade","Raze,Cypher,Viper,Omen,Skye"
Bind,Team Flash,Rapid Lofi,3,13,1,3,10,2,"Raze,Viper,Brimstone,Fade,Gekko","Raze,Cypher,Viper,Brimstone,Skye"
Sunset,Subversive,NAOS Esports,4,13,2,3,10,2,"Breach,Raze,Cypher,Sova,Omen","Raze,Cypher,Omen,KAY/O,Gekko"
Bind,Subversive,NAOS Esports,7,13,4,8,5,3,"Raze,Cypher,Brimstone,Skye,Deadlock","Raze,Cypher,Brimstone,Reyna,Skye"
Icebox,Elevate (SG),Reve Drift Arena,14,16,7,8,8,7,"Killjoy,Viper,Reyna,Jett,KAY/O","Sova,Killjoy,Viper,Jett,Gekko"
Icebox,Fancy United Esports,Cyberking Esports,13,5,4,2,3,9,"Cypher,Viper,KAY/O,Gekko,Clove","Viper,Sage,Gekko,Iso,Clove"
Bind,Avernus Esports,JustUs,3,13,1,11,2,2,"Raze,Cypher,Viper,Brimstone,Skye","Raze,Cypher,Brimstone,Reyna,Skye"
Haven,FENNEL GC,SCARZ GC,13,8,4,5,3,9,"Breach,Sova,Killjoy,Omen,Jett","Breach,Sova,Killjoy,Omen,Jett"
Ascent,Nongshim RedForce,VEC DAEJEON,13,6,6,1,5,7,"Cypher,Viper,Omen,Jett,KAY/O","Cypher,Omen,Jett,KAY/O,Fade"
Ascent,Fancy United Esports,Cyberking Esports,13,1,2,0,1,11,"Cypher,Omen,Jett,KAY/O,Deadlock","Sova,Killjoy,Omen,Jett,KAY/O"
Lotus,Avernus Esports,JustUs,5,13,3,9,4,2,"Breach,Raze,Killjoy,Omen,Gekko","Killjoy,Omen,Jett,Skye,Fade"
Bind,Nongshim RedForce,VEC DAEJEON,13,4,10,2,2,3,"Omen,Yoru,Fade,Gekko,Clove","Cypher,Brimstone,Jett,Skye,Yoru"
Ascent,FENNEL GC,SCARZ GC,15,13,10,4,9,5,"Sova,Killjoy,Omen,Jett,KAY/O","Sova,Killjoy,Omen,Jett,KAY/O"
Sunset,Carti World,Oasis Gaming,15,17,5,11,6,10,"Breach,Cypher,Sova,Omen,Neon","Raze,Cypher,Sova,Omen,KAY/O"
Lotus,SLT Seongam,Team IAM,13,2,2,1,1,11,"Raze,Killjoy,Viper,Omen,Fade","Raze,Killjoy,Viper,Omen,Fade"
Ascent,Reignite Lily,ZETA DIVISION GC,8,13,4,5,8,4,"Sova,Killjoy,Omen,Jett,KAY/O","Sova,Killjoy,Omen,Jett,KAY/O"
Bind,Carti World,Oasis Gaming,10,13,6,6,7,4,"Raze,Cypher,Reyna,Skye,Clove","Raze,Cypher,Viper,Brimstone,Skye"
Bind,Reignite Lily,ZETA DIVISION GC,4,13,0,5,8,4,"Raze,Viper,Brimstone,Skye,Gekko","Raze,Cypher,Viper,Skye,Clove"
Sunset,SLT Seongam,Team IAM,14,12,7,6,6,7,"Breach,Cypher,Sova,Omen,Neon","Breach,Raze,Cypher,Omen,Gekko"
Lotus,Carti World,Oasis Gaming,14,12,5,8,4,9,"Raze,Killjoy,Viper,Omen,Fade","Raze,Killjoy,Viper,Omen,Fade"
Lotus,DetonatioN FocusMe GC,DRX Changers,4,13,3,9,4,1,"Raze,Killjoy,Viper,Omen,Fade","Breach,Raze,Cypher,Omen,Fade"
Ascent,DetonatioN FocusMe GC,DRX Changers,10,13,7,4,9,3,"Sova,Killjoy,Omen,Jett,KAY/O","Sova,Killjoy,Omen,Jett,KAY/O"
Ascent,Meteor GC,Cyber Geek,7,13,4,4,9,3,"Cypher,Sova,Omen,Jett,KAY/O","Breach,Brimstone,Sage,Omen,KAY/O"
Icebox,ONE BULLET GAMING GC,FEK ESPORTS GC,3,13,0,4,9,3,"Sova,Killjoy,Viper,Reyna,Jett","Killjoy,Viper,Jett,Neon,Gekko"
Haven,Meteor GC,Cyber Geek,8,13,3,6,7,5,"Breach,Cypher,Sova,Omen,Jett","Breach,Cypher,Omen,Neon,Iso"
Lotus,Legion Nyx,New Combat Line GC,2,13,2,10,3,0,"Breach,Raze,Cypher,Fade,Clove","Breach,Cypher,Omen,Neon,Gekko"
Haven,ONE BULLET GAMING GC,FEK ESPORTS GC,8,13,7,5,8,1,"Breach,Sova,Killjoy,Jett,Astra","Breach,Sova,Killjoy,Omen,Jett"
Lotus,Barcelona Sporting X,FIXAM,13,2,12,0,2,1,"Killjoy,Viper,Omen,Neon,Fade","Breach,Killjoy,Omen,Neon,Gekko"
Icebox,Meteor GC,Cyber Geek,13,4,3,2,2,10,"Killjoy,Viper,Jett,KAY/O,Clove","Killjoy,Viper,Jett,KAY/O,Gekko"
Sunset,SaD FROST,Tenax GC,13,10,8,3,7,5,"Breach,Cypher,Neon,Fade,Clove","Raze,Cypher,Omen,KAY/O,Gekko"
Haven,Legion Nyx,New Combat Line GC,1,13,1,11,2,0,"Breach,Raze,Killjoy,Omen,Fade","Breach,Sova,Killjoy,Omen,Neon"
Lotus,LazerrFreeks Ivy,Charmers GC,13,9,7,5,4,6,"Raze,Killjoy,Omen,Fade,Gekko","Breach,Raze,Cypher,Omen,Fade"
Abyss,Barcelona Sporting X,FIXAM,13,3,3,1,2,10,"Omen,Jett,Yoru,Gekko,Deadlock","Breach,Viper,Omen,Chamber,Neon"
Ascent,The7,Stellae Gaming,13,8,7,5,3,6,"Cypher,Sova,Omen,Yoru,Iso","Sova,Killjoy,Omen,Jett,KAY/O"
Haven,Malecient Parasside,Krows Corax,4,13,1,4,9,3,"Breach,Cypher,Sova,Omen,Jett","Breach,Cypher,Sova,Omen,Neon"
Lotus,Lemonade Stand,Winthrop University,13,10,7,4,6,6,"Raze,Omen,Fade,Deadlock,Clove","Raze,Killjoy,Viper,Omen,Fade"
Bind,The7,Stellae Gaming,13,8,6,3,5,7,"Breach,Neon,Fade,Iso,Clove","Raze,Viper,Brimstone,Sage,Skye"
Lotus,Malecient Parasside,Krows Corax,5,13,4,8,5,1,"Killjoy,Jett,Skye,Gekko,Clove","Breach,Cypher,Neon,Gekko,Clove"
Haven,Lemonade Stand,Winthrop University,13,2,3,0,2,10,"Omen,Yoru,Fade,Deadlock,Clove","Breach,Cypher,Sova,Omen,Jett"
Ascent,rEVO GC,Seraphin,13,6,5,2,4,8,"Sova,Killjoy,Omen,Jett,KAY/O","Sova,Killjoy,Omen,Jett,KAY/O"
Sunset,The7,Stellae Gaming,12,14,4,9,5,8,"Breach,Cypher,Phoenix,Omen,Iso","Breach,Cypher,Omen,Neon,Gekko"
Sunset,Malecient Parasside,Krows Corax,13,10,9,3,7,4,"Breach,Raze,Cypher,Omen,KAY/O","Breach,Cypher,Sova,Omen,Neon"
Lotus,rEVO GC,Seraphin,13,3,3,1,2,10,"Breach,Killjoy,Omen,Neon,Gekko","Breach,Killjoy,Omen,Jett,Gekko"
Bind,Lemonade Stand,Winthrop University,11,13,6,6,7,5,"Raze,Viper,Brimstone,Skye,Gekko","Raze,Viper,Brimstone,Fade,Gekko"
Bind,2Game Esports,Galorys,13,15,9,5,10,4,"Raze,Brimstone,Omen,Skye,Neon","Raze,Viper,Brimstone,Fade,Gekko"
Bind,Dough Bros,Winthrop University,5,13,3,3,10,2,"Raze,Viper,Brimstone,Skye,Deadlock","Raze,Viper,Brimstone,Fade,Gekko"
Haven,FUT Esports,FNATIC,5,13,1,5,8,4,"Sova,Killjoy,Sage,Omen,Jett","Cypher,Sova,Omen,Yoru,Iso"
Haven,Dough Bros,Winthrop University,9,13,4,6,7,5,"Breach,Cypher,Sova,Omen,Neon","Breach,Cypher,Sova,Omen,Jett"
Icebox,2Game Esports,Galorys,11,13,6,6,7,5,"Sova,Killjoy,Viper,Omen,Gekko","Sova,Killjoy,Viper,Sage,Jett"
Sunset,FUT Esports,FNATIC,13,15,8,6,9,5,"Breach,Raze,Cypher,Omen,Gekko","Breach,Raze,Cypher,Sova,Astra"
Haven,BIG BANG Theory,OnDrugs,13,5,5,1,4,8,"Breach,Sova,Killjoy,Neon,Clove","Breach,Sova,Killjoy,Omen,Jett"
Bind,Team Heretics,Team Vitality,12,14,7,6,8,5,"Raze,Viper,Brimstone,Fade,Gekko","Raze,Viper,Omen,Fade,Gekko"
Ascent,BIG BANG Theory,OnDrugs,13,6,9,3,3,4,"Sova,Killjoy,Omen,Jett,KAY/O","Cypher,Sova,Omen,Jett,Yoru"
Lotus,EOWYN GC,Silly Weapons All Game,9,13,7,5,8,2,"Breach,Raze,Killjoy,Omen,Gekko","Breach,Raze,Killjoy,Astra,Gekko"
Icebox,PURE GC,NOIR Aster,13,11,6,6,5,7,"Sova,Killjoy,Viper,Jett,KAY/O","Sova,Killjoy,Viper,Sage,Jett"
Sunset,Team Heretics,Team Vitality,10,13,5,7,6,5,"Cypher,Sova,Omen,KAY/O,Neon","Cypher,Sova,Omen,KAY/O,Neon"
Icebox,Formulation Gaming GC,Anonymo GC,13,11,8,4,7,5,"Sova,Killjoy,Viper,Sage,Jett","Sova,Killjoy,Viper,Jett,Harbor"
Bind,Cursed Cats GC,Sakura Breeze GC,13,1,2,0,1,11,"Breach,Raze,Cypher,Brimstone,Gekko","Raze,Viper,Brimstone,Skye,Gekko"
Sunset,EOWYN GC,Silly Weapons All Game,9,13,1,9,4,8,"Breach,Raze,Cypher,Omen,Gekko","Breach,Raze,Cypher,Gekko,Clove"
Lotus,BIG BANG Theory,Rasht Gang,13,6,7,5,1,6,"Breach,Viper,Neon,Gekko,Clove","Breach,Omen,Jett,Chamber,Neon"
Haven,LaZe,Reve Drift Arena,11,13,4,8,5,7,"Cypher,Sova,Omen,Yoru,Iso","Breach,Sova,Jett,Chamber,Clove"
Lotus,PURE GC,NOIR Aster,13,5,11,1,4,2,"Raze,Killjoy,KAY/O,Gekko,Clove","Breach,Raze,Killjoy,Omen,Deadlock"
Abyss,Formulation Gaming GC,Anonymo GC,13,10,6,6,4,7,"Breach,Cypher,Jett,Astra,Gekko","Cypher,Sova,Omen,Jett,KAY/O"
Lotus,Cursed Cats GC,Sakura Breeze GC,13,5,9,3,2,4,"Breach,Raze,Killjoy,Omen,Gekko","Breach,Raze,Killjoy,Omen,Gekko"
Ascent,BIG BANG Theory,Rasht Gang,13,6,7,5,1,6,"Sova,Killjoy,Omen,Jett,KAY/O","Raze,Cypher,Sova,Omen,Jett"
Icebox,Team Heretics,Team Vitality,14,12,4,9,3,10,"Sova,Killjoy,Viper,Neon,Gekko","Sova,Killjoy,Viper,Jett,Gekko"
Bind,LaZe,Reve Drift Arena,11,13,7,5,8,4,"Raze,Viper,Brimstone,Fade,Gekko","Raze,Cypher,Brimstone,Skye,Gekko"
Lotus,LaZe,Reve Drift Arena,13,4,4,1,3,9,"Breach,Raze,Cypher,Sova,Omen","Cypher,Sova,Omen,Jett,Gekko"
Abyss,Elevate (SG),Disguised,3,13,3,9,4,0,"Sova,Killjoy,Jett,Astra,Harbor","Breach,Cypher,Omen,Jett,Neon"
Bind,Elevate (SG),Disguised,14,16,10,5,11,4,"Raze,Cypher,Viper,Brimstone,KAY/O","Raze,Viper,Omen,Skye,Yoru"
Icebox,Elevate (SG),Disguised,13,8,8,4,4,5,"Killjoy,Viper,Reyna,Jett,KAY/O","Sova,Killjoy,Viper,Jett,Iso"
Bind,DRX Changers,SCARZ GC,9,13,5,7,6,4,"Raze,Viper,Brimstone,Skye,Gekko","Raze,Viper,Brimstone,Fade,Gekko"
Lotus,DRX Changers,SCARZ GC,13,8,6,6,2,7,"Breach,Raze,Cypher,Omen,Fade","Raze,Killjoy,Viper,Omen,Fade"
Ascent,DRX Changers,SCARZ GC,8,13,2,7,6,6,"Sova,Killjoy,Omen,Jett,KAY/O","Sova,Killjoy,Omen,Jett,KAY/O"
Lotus,FENNEL GC,DetonatioN FocusMe GC,13,2,10,2,0,3,"Breach,Raze,Cypher,Omen,Fade","Raze,Killjoy,Viper,Omen,Fade"
Sunset,FENNEL GC,DetonatioN FocusMe GC,13,6,8,4,2,5,"Breach,Raze,Cypher,Omen,Fade","Breach,Raze,Cypher,Sova,Omen"
Icebox,ZETA DIVISION GC,Cyber Geek,13,7,5,3,4,8,"Killjoy,Viper,Omen,KAY/O,Gekko","Killjoy,Viper,Jett,KAY/O,Gekko"
Ascent,ZETA DIVISION GC,Cyber Geek,13,9,8,4,5,5,"Sova,Killjoy,Omen,Jett,KAY/O","Breach,Brimstone,Sage,Omen,KAY/O"
Haven,Meteor GC,Reignite Lily,10,13,4,8,5,6,"Breach,Cypher,Sova,Omen,Jett","Breach,Sova,Killjoy,Omen,Neon"
Abyss,Meteor GC,Reignite Lily,14,16,5,10,6,9,"Breach,Raze,Astra,Deadlock,Iso","Sova,Sage,Omen,Yoru,Astra"
Bind,TBK Esports,Stellae Gaming,10,13,6,5,8,4,"Raze,Viper,Brimstone,Sage,Skye","Raze,Viper,Brimstone,Sage,Skye"
Haven,Lemonade Stand,Ambrosia,4,13,2,10,3,2,"Omen,Yoru,Fade,Deadlock,Clove","Breach,Sova,Killjoy,Omen,Jett"
Haven,Ambrosia,Lemonade Stand,13,4,3,2,2,10,"Breach,Sova,Killjoy,Omen,Jett","Omen,Yoru,Fade,Deadlock,Clove"
Lotus,TBK Esports,Stellae Gaming,5,13,4,8,5,1,"Raze,Killjoy,Viper,Omen,Fade","Breach,Cypher,Omen,Neon,Fade"
Sunset,Ambrosia,Lemonade Stand,13,9,7,3,6,6,"Breach,Raze,Cypher,Omen,Deadlock","Raze,Cypher,Omen,KAY/O,Gekko"
Sunset,Lemonade Stand,Ambrosia,9,13,6,6,7,3,"Raze,Cypher,Omen,KAY/O,Gekko","Breach,Raze,Cypher,Omen,Deadlock"
Icebox,RED Canids,Galorys,12,14,8,5,9,4,"Sova,Killjoy,Viper,Sage,Jett","Sova,Killjoy,Viper,Sage,Jett"
Bind,Dough Bros,Lemonade Stand,4,13,4,8,5,0,"Raze,Viper,Brimstone,Skye,Deadlock","Raze,Viper,Brimstone,Skye,Gekko"
Icebox,Winthrop University,Ambrosia,5,13,5,7,6,0,"Sova,Killjoy,Viper,Jett,Clove","Sova,Killjoy,Viper,Jett,KAY/O"
Lotus,FNATIC,Karmine Corp,13,6,8,4,2,5,"Raze,Killjoy,Viper,Omen,Fade","Cypher,Sova,Omen,Yoru,Fade"
Lotus,Dough Bros,Lemonade Stand,13,6,8,4,2,5,"Raze,Omen,Fade,Deadlock,Clove","Breach,Raze,Omen,Chamber,Gekko"
Lotus,RED Canids,Galorys,13,11,7,5,6,6,"Breach,Cypher,Neon,Gekko,Clove","Raze,Cypher,Omen,Fade,Clove"
Sunset,Winthrop University,Ambrosia,10,13,9,3,10,1,"Breach,Raze,Cypher,Omen,Fade","Breach,Raze,Cypher,Omen,Deadlock"
Haven,Dough Bros,Lemonade Stand,8,13,6,3,10,2,"Breach,Cypher,Sova,Omen,Neon","Omen,Yoru,Fade,Deadlock,Clove"
Split,RED Canids,Galorys,5,13,1,5,8,4,"Raze,Killjoy,Viper,Skye,Astra","Raze,Viper,Omen,Jett,Skye"
Sunset,FNATIC,Karmine Corp,15,13,7,7,6,8,"Breach,Raze,Cypher,Sova,Astra","Breach,Raze,Cypher,Omen,Jett"
Icebox,FNATIC,Karmine Corp,7,13,5,7,6,2,"Sova,Killjoy,Viper,Gekko,Iso","Sova,Killjoy,Viper,Jett,Gekko"
Abyss,ACE Gaming,BIG BANG Theory,3,13,0,4,9,3,"Jett,Chamber,Gekko,Iso,Clove","Viper,Neon,Gekko,Deadlock,Clove"
Lotus,WebCam,Rasht Gang,12,14,5,8,6,7,"Killjoy,Omen,KAY/O,Gekko,Iso","Breach,Omen,Jett,Chamber,Neon"
Ascent,ACE Gaming,BIG BANG Theory,4,13,2,10,3,2,"Breach,Cypher,Sova,Jett,Clove","Sova,Killjoy,Omen,Jett,KAY/O"
Icebox,WebCam,Rasht Gang,6,13,3,9,4,3,"Sova,Viper,Chamber,Gekko,Iso","Sova,Viper,Sage,Jett,Gekko"
Sunset,NOIR Aster,Crvena zvezda esports,13,11,8,4,7,5,"Breach,Raze,Cypher,Omen,Gekko","Breach,Raze,Cypher,Gekko,Clove"
Ascent,Team Vitality,Natus Vincere,13,7,5,7,0,8,"Sova,Killjoy,Omen,Jett,KAY/O","Cypher,Sova,Omen,Jett,KAY/O"
Haven,Anonymo GC,Yappers GC,13,8,8,4,4,5,"Breach,Sova,Killjoy,Astra,Neon","Breach,Killjoy,Phoenix,Jett,Clove"
Lotus,Sakura Breeze GC,Xravel CBRS,13,9,9,3,6,4,"Breach,Raze,Killjoy,Omen,Gekko","Killjoy,Viper,Omen,Neon,Fade"
Sunset,Zyron Sadashi,Silly Weapons All Game,6,13,3,9,4,3,"Breach,Raze,Cypher,Omen,Gekko","Breach,Raze,Cypher,Deadlock,Clove"
Sunset,Team Vitality,Natus Vincere,13,5,10,2,3,3,"Cypher,Sova,Omen,KAY/O,Neon","Cypher,Sova,Omen,KAY/O,Neon"
Icebox,NOIR Aster,Crvena zvezda esports,13,9,6,6,3,7,"Sova,Killjoy,Viper,Sage,Jett","Sova,Viper,Reyna,Chamber,Iso"
Haven,OnDrugs,Critics Esports,12,14,2,11,3,10,"Cypher,Sova,Omen,Yoru,Iso","Breach,Cypher,Sova,Omen,Jett"
Lotus,Anonymo GC,Yappers GC,13,4,11,1,3,2,"Raze,Sova,Omen,Yoru,Deadlock","Breach,Raze,Killjoy,Phoenix,Clove"
Lotus,Zyron Sadashi,Silly Weapons All Game,3,13,1,3,10,2,"Breach,Raze,Killjoy,Omen,Gekko","Breach,Raze,Killjoy,Gekko,Clove"
Ascent,NOIR Aster,Crvena zvezda esports,3,13,1,3,10,2,"Breach,Sova,Killjoy,Omen,Jett","Sova,Killjoy,Phoenix,Omen,Iso"
Bind,OnDrugs,Critics Esports,10,13,7,5,8,3,"Raze,Cypher,Brimstone,Reyna,Fade","Raze,Omen,Skye,Deadlock,Clove"
Haven,Team Vitality,Natus Vincere,8,13,6,6,7,2,"Breach,Cypher,Sova,Omen,Jett","Cypher,Sova,Omen,Yoru,Neon"
Lotus,Sentinels,G2 Esports,9,13,4,8,5,5,"Raze,Cypher,Omen,Fade,Deadlock","Raze,Killjoy,Viper,Omen,Fade"
Ascent,Spare Time,SeanGares' Kittens,4,13,2,10,3,2,"Cypher,Sova,Omen,Jett,Deadlock","Sova,Killjoy,Omen,Jett,KAY/O"
Icebox,Tenax GC,Charmers GC,13,3,4,0,3,9,"Sova,Killjoy,Viper,Jett,Gekko","Sova,Killjoy,Viper,Jett,Gekko"
Lotus,Spare Time,SeanGares' Kittens,4,13,2,10,3,2,"Breach,Raze,Killjoy,Fade,Clove","Breach,Raze,Killjoy,Omen,Gekko"
Bind,Sentinels,G2 Esports,6,13,6,6,7,0,"Raze,Brimstone,Fade,Gekko,Deadlock","Raze,Viper,Brimstone,Skye,Gekko"
Icebox,nokE kittens,Spare Time,9,13,4,6,7,5,"Sova,Killjoy,Viper,Reyna,Jett","Sova,Killjoy,Viper,Reyna,Jett"
Lotus,goose creek freaks,Mickey Masters,12,14,5,8,6,7,"Raze,Killjoy,Omen,Jett,Gekko","Raze,Cypher,Reyna,Omen,Fade"
Lotus,LOUD,100 Thieves,13,10,6,5,5,7,"Breach,Raze,Cypher,Omen,Fade","Raze,Killjoy,Viper,Omen,Fade"
Bind,The GRID,SeanGares' Kittens,7,13,6,6,7,1,"Raze,Reyna,Harbor,Gekko,Clove","Raze,Viper,Brimstone,Skye,Gekko"
Bind,goose creek freaks,Mickey Masters,6,13,3,9,4,3,"Raze,Cypher,Viper,Brimstone,Gekko","Raze,Brimstone,Reyna,Skye,Deadlock"
Haven,Friends Over Everything,Lemonade Stand,9,13,5,7,6,4,"Cypher,Sova,Omen,Yoru,Iso","Omen,Yoru,Fade,Deadlock,Clove"
Ascent,WASTED TALENT,PEW PEW,13,5,10,2,3,3,"Cypher,Sova,Phoenix,Omen,Jett","Sova,Killjoy,Omen,Jett,KAY/O"
Ascent,ALTERNATE aTTaX Ruby,Zerance Mint,15,13,9,5,8,6,"Sova,Killjoy,Omen,Jett,KAY/O","Sova,Killjoy,Omen,Jett,KAY/O"
Ascent,nokE kittens,Spare Time,13,10,5,7,3,8,"Sova,Killjoy,Omen,Jett,KAY/O","Cypher,Sova,Omen,Jett,Deadlock"
Bind,LOUD,100 Thieves,13,8,6,6,2,7,"Raze,Brimstone,Omen,Skye,Gekko","Raze,Viper,Brimstone,Fade,Gekko"
Haven,The GRID,SeanGares' Kittens,10,13,2,9,4,8,"Sova,Killjoy,Omen,Yoru,Iso","Breach,Cypher,Sova,Omen,Jett"
Haven,nokE kittens,Spare Time,10,13,5,7,6,5,"Cypher,Sova,Reyna,Omen,Neon","Cypher,Sova,Omen,Jett,Iso"
Sunset,Friends Over Everything,Lemonade Stand,11,13,7,5,8,4,"Cypher,Sova,Omen,KAY/O,Neon","Raze,Cypher,Omen,KAY/O,Gekko"
Haven,goose creek freaks,WASTED TALENT,13,9,9,3,6,4,"Cypher,Sova,Omen,Jett,Gekko","Breach,Cypher,Sova,Omen,Jett"
Ascent,LOUD,100 Thieves,1,13,1,11,2,0,"Cypher,Sova,Omen,Jett,KAY/O","Sova,Killjoy,Omen,Jett,KAY/O"
Sunset,ALTERNATE aTTaX Ruby,Zerance Mint,9,13,6,6,7,3,"Breach,Raze,Cypher,Sova,Omen","Breach,Raze,Cypher,Sova,Omen"
Ascent,Mickey Masters,PEW PEW,13,1,11,1,0,2,"Cypher,Sova,Killjoy,Jett,Clove","Sova,Killjoy,Omen,Jett,KAY/O"
Lotus,The GRID,SeanGares' Kittens,13,8,9,3,5,4,"Raze,Cypher,Reyna,Gekko,Clove","Breach,Raze,Cypher,Omen,Gekko"
Lotus,Lotus 8 Esports,goose creek freaks,1,13,0,2,11,1,"Breach,Raze,Cypher,Omen,Fade","Raze,Killjoy,Omen,Jett,Gekko"
Icebox,Its time,Spare Time,6,13,4,3,10,2,"Sova,Killjoy,Viper,Reyna,Omen","Sova,Killjoy,Viper,Reyna,Jett"
Icebox,Friends Over Everything,Lemonade Stand,13,10,8,4,6,5,"Sova,Killjoy,Viper,Jett,Harbor","Omen,KAY/O,Harbor,Gekko,Clove"
Ascent,PEW PEW,CrashoutESports,13,6,2,5,1,11,"Sova,Killjoy,Omen,Jett,KAY/O","Cypher,Sova,Omen,Jett,KAY/O"
Bind,Forsaken Shadows,Mickey Masters,6,13,2,5,8,4,"Raze,Cypher,Brimstone,Skye,Iso","Raze,Brimstone,Reyna,Skye,Deadlock"
Haven,ACE Gaming,Luminners,13,7,5,7,0,8,"Cypher,Jett,Skye,Yoru,Clove","Breach,Cypher,Sova,Jett,Astra"
Sunset,GoNext Esports,trashcan,13,8,3,6,2,10,"Breach,Raze,Sage,Omen,Gekko","Raze,Cypher,Viper,Omen,Skye"
Haven,ALTERNATE aTTaX Ruby,Zerance Mint,13,11,7,5,6,6,"Breach,Cypher,Sova,Omen,Jett","Breach,Sova,Killjoy,Omen,Jett"
Bind,Revenge (NA),SeanGares' Kittens,9,13,7,5,8,2,"Raze,Viper,Skye,Deadlock,Clove","Raze,Viper,Brimstone,Skye,Gekko"
Bind,WebCam,NECOBA,13,11,8,4,7,5,"Sova,Killjoy,Omen,Chamber,Iso","Killjoy,Viper,Brimstone,Jett,Skye"
Bind,The GRID,The big show,13,4,9,3,1,4,"Raze,Reyna,Harbor,Gekko,Clove","Raze,Cypher,Viper,Brimstone,Skye"
Sunset,cruiser bros,Lotus 8 Esports,9,13,3,7,6,6,"Cypher,Sova,Jett,Gekko,Clove","Breach,Raze,Cypher,Omen,Deadlock"
Ascent,Its time,Spare Time,9,13,4,6,7,5,"Sova,Killjoy,Omen,Jett,KAY/O","Cypher,Sova,Omen,Jett,Deadlock"
Ascent,UBC Blue,PEW PEW,11,13,7,5,8,4,"Sova,Killjoy,Omen,Jett,KAY/O","Sova,Killjoy,Omen,Jett,KAY/O"
Ascent,WASTED TALENT,Goated,13,5,9,3,2,4,"Sova,Killjoy,Omen,Jett,KAY/O","Sova,Killjoy,Omen,Jett,KAY/O"
Bind,GoNext Esports,trashcan,13,3,11,1,2,2,"Raze,Viper,Brimstone,Skye,Gekko","Raze,Viper,Brimstone,Skye,Gekko"
Haven,Revenge (NA),SeanGares' Kittens,13,8,4,5,3,9,"Breach,Sova,Killjoy,Omen,Jett","Breach,Cypher,Sova,Omen,Jett"
Haven,nokE kittens,pasta fazool,13,7,9,3,4,4,"Cypher,Sova,Reyna,Omen,Neon","Breach,Sova,Killjoy,Omen,Jett"
Ascent,Forsaken Shadows,Team GOGO,13,10,6,5,5,7,"Sova,Killjoy,Omen,Jett,KAY/O","Sova,Killjoy,Omen,Jett,KAY/O"
Abyss,ACE Gaming,Luminners,12,14,7,6,8,5,"Jett,Chamber,Gekko,Iso,Clove","Jett,Astra,KAY/O,Gekko,Deadlock"
Icebox,WebCam,NECOBA,13,8,8,4,4,5,"Sova,Killjoy,Viper,Chamber,Iso","Sova,Killjoy,Viper,Reyna,Jett"
Haven,Mandatory,Valiant,8,13,4,5,8,4,"Cypher,Sova,Omen,Yoru,Iso","Breach,Cypher,Sova,Omen,Neon"
Ascent,The GRID,The big show,11,13,6,6,7,5,"Cypher,Sova,Omen,Jett,Deadlock","Sova,Killjoy,Omen,Jett,KAY/O"
Ascent,WASTED TALENT,NoPrac,13,1,2,0,1,11,"Cypher,Sova,Omen,Jett,KAY/O","Sova,Killjoy,Omen,Jett,KAY/O"
Bind,Living Nightmare,Mickey Masters,2,13,0,3,10,2,"Raze,Cypher,Brimstone,Skye,Fade","Raze,Gekko,Deadlock,Iso,Clove"
Ascent,Goated,GroundX,13,4,3,2,2,10,"Sova,Killjoy,Omen,Jett,KAY/O","Sova,Killjoy,Omen,Jett,KAY/O"
Split,Zerance Mint,BLVKHVND,14,12,9,4,8,5,"Breach,Raze,Cypher,Omen,Fade","Raze,Viper,Jett,Skye,Astra"
Lotus,goose creek freaks,les piments,13,5,10,2,3,3,"Raze,Killjoy,Omen,Jett,Gekko","Breach,Cypher,Omen,Neon,Gekko"
Haven,Its time,Spare Time,15,13,7,7,6,8,"Breach,Sova,Killjoy,Omen,Jett","Sova,Killjoy,Omen,Jett,Iso"
Icebox,CrashoutESports,E4E,14,12,9,4,8,5,"Sova,Killjoy,Viper,Jett,Harbor","Killjoy,Viper,Omen,Jett,KAY/O"
Icebox,nokE kittens,pasta fazool,13,6,9,3,3,4,"Sova,Killjoy,Viper,Reyna,Jett","Sova,Killjoy,Viper,Reyna,Gekko"
Lotus,Revenge (NA),SeanGares' Kittens,9,13,5,7,6,4,"Raze,Cypher,Omen,Fade,Deadlock","Breach,Raze,Cypher,Omen,Gekko"
Haven,The GRID,The big show,13,3,2,2,1,11,"Sova,Killjoy,Omen,Yoru,Iso","Breach,Cypher,Sova,Omen,Jett"
Icebox,GoNext Esports,trashcan,12,14,8,5,9,4,"Sova,Killjoy,Viper,Sage,Jett","Sova,Killjoy,Viper,Jett,KAY/O"
Icebox,Mandatory,Valiant,13,5,5,1,4,8,"Sova,Viper,Sage,Reyna,KAY/O","Sova,Killjoy,Viper,Reyna,Gekko"
Ascent,ACE Gaming,Luminners,13,9,6,6,3,7,"Cypher,Sova,Jett,KAY/O,Clove","Cypher,Sova,Jett,Astra,KAY/O"
Sunset,NOVO Esports,Outplayed,13,2,10,2,0,3,"Breach,Cypher,Sova,Omen,Neon","Breach,Raze,Cypher,Sova,Omen"
Icebox,Critics Esports,BIG BANG Theory,13,10,8,3,7,5,"Sova,Viper,Jett,Gekko,Clove","Sova,Killjoy,Viper,Reyna,Jett"
Lotus,ALTERNATE aTTaX Ruby,Valiant GC,3,13,1,11,2,2,"Breach,Raze,Cypher,Omen,Fade","Breach,Killjoy,Omen,Neon,Fade"
Sunset,Zerance Mint,BLVKHVND,14,16,6,9,7,8,"Breach,Raze,Cypher,Sova,Omen","Breach,Cypher,Sova,Omen,Neon"
Lotus,Acend,Diamant Esports,13,10,8,3,7,5,"Raze,Killjoy,Viper,Fade,Clove","Raze,Killjoy,Omen,Skye,Astra"
Sunset,evolutionSTARS,Skout Esports,5,13,4,8,5,1,"Breach,Cypher,Omen,Neon,Gekko","Breach,Raze,Cypher,Omen,Gekko"
Abyss,NOVO Esports,Outplayed,13,5,7,5,0,6,"Cypher,Sova,Yoru,Astra,Harbor","Breach,Viper,Omen,Yoru,Fade"
Split,Mandatory,Valiant,18,16,8,9,7,10,"Raze,Cypher,Viper,Omen,Skye","Breach,Raze,Cypher,Omen,Deadlock"
Haven,ALTERNATE aTTaX Ruby,Valiant GC,6,13,6,6,7,0,"Breach,Cypher,Sova,Omen,Jett","Breach,Sova,Killjoy,Omen,Jett"
Icebox,NOVO Esports,Outplayed,13,1,2,0,1,11,"Killjoy,Viper,KAY/O,Neon,Gekko","Sova,Killjoy,Viper,Sage,Omen"
Haven,Zerance Mint,BLVKHVND,13,9,6,6,3,7,"Breach,Sova,Killjoy,Omen,Jett","Breach,Cypher,Sova,Omen,Neon"
Bind,Acend,Diamant Esports,13,3,9,3,0,4,"Raze,Cypher,Astra,Fade,Iso","Raze,Viper,Omen,Skye,Fade"
Ascent,Critics Esports,BIG BANG Theory,13,9,9,1,8,4,"Cypher,Sova,Omen,Jett,KAY/O","Sova,Killjoy,Omen,Jett,KAY/O"
Lotus,evolutionSTARS,Skout Esports,13,9,10,2,7,3,"Breach,Killjoy,Omen,Neon,Fade","Breach,Cypher,Omen,Fade,Iso"
Ascent,Mandatory,Valiant,9,13,1,9,4,8,"Raze,Viper,KAY/O,Harbor,Gekko","Sova,Killjoy,Omen,Jett,KAY/O"
Sunset,Acend,Diamant Esports,8,13,8,4,9,0,"Raze,Cypher,Omen,KAY/O,Gekko","Raze,Killjoy,Omen,Astra,Fade"
Ascent,evolutionSTARS,Skout Esports,12,14,3,10,4,9,"Sova,Killjoy,Phoenix,Omen,Jett","Breach,Sova,Killjoy,Phoenix,Omen"
Lotus,Mandatory,Valiant,10,13,4,7,6,6,"Raze,Killjoy,Viper,Omen,Fade","Breach,Raze,Cypher,Omen,Fade"
Bind,evolutionSTARS,Skout Esports,8,13,5,7,6,3,"Raze,Cypher,Viper,Brimstone,Skye","Raze,Viper,Brimstone,Skye,Yoru"
Sunset,Paper Rex,Talon Esports,13,3,9,3,0,4,"Breach,Raze,Sage,Omen,Gekko","Breach,Cypher,Sova,Omen,Neon"
Ascent,Paper Rex,Talon Esports,13,3,3,1,2,10,"Raze,Reyna,Omen,Skye,Harbor","Sova,Killjoy,Omen,Jett,KAY/O"
Bind,Gen.G Esports,DRX,13,6,6,1,5,7,"Raze,Cypher,Viper,Brimstone,Skye","Raze,Cypher,Viper,Brimstone,Skye"
Haven,4Fun (PH),RIMA GC,13,5,4,2,3,9,"Sova,Killjoy,Reyna,Jett,Clove","Breach,Sova,Killjoy,Omen,Neon"
Sunset,Gen.G Esports,DRX,10,13,4,7,6,6,"Cypher,Sova,Omen,Jett,KAY/O","Breach,Cypher,Sova,Omen,Neon"
Bind,4Fun (PH),RIMA GC,7,13,4,4,9,3,"Raze,Cypher,Reyna,Skye,Clove","Breach,Raze,Cypher,Brimstone,Gekko"
Haven,LILAX,LILITH (TH),9,13,6,4,9,3,"Sova,Killjoy,Reyna,Jett,Clove","Breach,Killjoy,Reyna,Jett,Clove"
Haven,Gen.G Esports,DRX,13,9,4,6,3,9,"Killjoy,Viper,Omen,Jett,Skye","Breach,Cypher,Sova,Omen,Jett"
Split,Watermelon,BOBA,3,13,3,9,4,0,"Raze,Cypher,Omen,Skye,Deadlock","Breach,Raze,Reyna,Yoru,Clove"
Ascent,4Fun (PH),RIMA GC,13,4,8,4,0,5,"Sova,Killjoy,Reyna,Jett,Clove","Sova,Killjoy,Omen,KAY/O,Neon"
Ascent,LILAX,LILITH (TH),4,13,4,8,5,0,"Sova,Killjoy,Phoenix,KAY/O,Clove","Sova,Killjoy,Reyna,Jett,Clove"
Haven,Watermelon,BOBA,6,13,1,6,7,5,"Breach,Sova,Killjoy,Omen,Jett","Sova,Reyna,Chamber,Harbor,Clove"
Sunset,Panny Sitter,Cardboard Dinosaur,11,13,6,6,7,5,"Breach,Raze,Cypher,Gekko,Clove","Breach,Raze,Cypher,Gekko,Clove"
Haven,BAS.Kitsune,sisu,5,13,5,7,6,0,"Sova,Killjoy,Omen,Jett,Skye","Sova,Killjoy,Skye,Astra,Neon"
Lotus,Avernus Esports,BIGG Siren,14,12,5,8,4,9,"Breach,Raze,Killjoy,Omen,Gekko","Breach,Raze,Killjoy,Omen,Gekko"
Icebox,BAS.Kitsune,sisu,3,13,1,11,2,2,"Sova,Killjoy,Viper,Jett,Gekko","Viper,Sage,Reyna,Gekko,Iso"
Haven,Panny Sitter,Cardboard Dinosaur,10,13,5,7,6,5,"Breach,Sova,Killjoy,Omen,Jett","Breach,Sova,Killjoy,Omen,Jett"
Icebox,Avernus Esports,BIGG Siren,13,10,4,8,2,9,"Raze,Sova,Killjoy,Viper,Reyna","Sova,Killjoy,Viper,Jett,Gekko"
Bind,Waffle House,SaD FROST,3,13,3,9,4,0,"Raze,Viper,Sage,Omen,Skye","Raze,Viper,Skye,Chamber,Clove"
Haven,Lemonade Stand,Resonate,13,8,7,2,6,6,"Omen,Yoru,Fade,Deadlock,Clove","Breach,Sova,Killjoy,Astra,Neon"
Haven,Waffle House,SaD FROST,3,13,3,9,4,0,"Breach,Cypher,Sova,Omen,Neon","Breach,Sova,Killjoy,Neon,Clove"
Icebox,Leviatán,FURIA,13,6,6,1,5,7,"Sova,Killjoy,Viper,Jett,Harbor","Sova,Killjoy,Viper,Sage,Jett"
Sunset,Ambrosia,Friends Over Everything,13,5,9,3,2,4,"Breach,Raze,Cypher,Omen,Deadlock","Cypher,Sova,Omen,KAY/O,Neon"
Bind,grape booth,nokE kittens,10,13,8,4,9,2,"Raze,Viper,Brimstone,Skye,Gekko","Cypher,Brimstone,Reyna,Skye,Iso"
Icebox,Lemonade Stand,Resonate,10,13,6,5,8,4,"Omen,KAY/O,Harbor,Gekko,Clove","Sova,Killjoy,Viper,Sage,Jett"
Lotus,military boot camp,ABG luvrs,15,17,7,9,8,8,"Breach,Raze,Cypher,Brimstone,Fade","Breach,Killjoy,Yoru,Gekko,Clove"
Sunset,Leviatán,FURIA,13,6,8,4,2,5,"Breach,Cypher,Sova,Omen,Neon","Cypher,Sova,Omen,Jett,KAY/O"
Haven,Ambrosia,Friends Over Everything,13,7,7,5,2,6,"Breach,Sova,Killjoy,Omen,Jett","Cypher,Sova,Omen,Yoru,Iso"
Ascent,military boot camp,ABG luvrs,3,13,3,9,4,0,"Sova,Killjoy,Omen,Jett,Deadlock","Sova,Killjoy,Jett,KAY/O,Clove"
Ascent,grape booth,nokE kittens,15,13,4,10,3,11,"Sova,Killjoy,Omen,Jett,KAY/O","Sova,Killjoy,Omen,Jett,KAY/O"
Ascent,Lemonade Stand,Resonate,13,10,5,6,4,8,"Sova,Killjoy,Brimstone,Sage,KAY/O","Sova,Killjoy,Sage,Omen,Jett"
Sunset,pasta fazool,FREAK,13,11,7,5,6,6,"Breach,Raze,Cypher,Omen,Gekko","Breach,Raze,Cypher,Omen,Gekko"
Sunset,The big show,3/5ths Canadian,13,3,9,3,0,4,"Breach,Raze,Cypher,Sova,Omen","Breach,Raze,Cypher,Omen,Gekko"
Lotus,SaD FROST,Charmers GC,13,5,9,3,2,4,"Omen,Chamber,Neon,Fade,Deadlock","Breach,Raze,Cypher,Omen,Fade"
Bind,Skyline Dreamers GC,Waffle House,7,13,4,8,5,3,"Raze,Brimstone,Reyna,Skye,Harbor","Raze,Viper,Sage,Omen,Skye"
Lotus,Evil Geniuses,MIBR,2,13,0,3,10,2,"Breach,Cypher,Omen,Neon,Fade","Raze,Killjoy,Viper,Omen,Fade"
Haven,ABG luvrs,Die Hard,13,8,5,4,4,8,"Cypher,Sova,Phoenix,Omen,Jett","Breach,Cypher,Sova,Omen,Neon"
Ascent,The big show,3/5ths Canadian,13,6,9,3,3,4,"Sova,Killjoy,Omen,Jett,KAY/O","Sova,Killjoy,Omen,Jett,KAY/O"
Haven,BIG GRASS EATERS,Its time,9,13,4,6,7,5,"Breach,Sova,Killjoy,Omen,Neon","Breach,Sova,Killjoy,Omen,Jett"
Bind,pasta fazool,FREAK,13,7,6,2,5,7,"Raze,Cypher,Brimstone,Skye,Gekko","Raze,Brimstone,Omen,Skye,Gekko"
Icebox,grape booth,nokE kittens,12,14,5,8,6,7,"Sova,Killjoy,Viper,Jett,Clove","Sova,Killjoy,Viper,Reyna,Jett"
Haven,les piments,SeanGares' Kittens,5,13,3,3,10,2,"Breach,Sova,Killjoy,Omen,Jett","Breach,Sova,Killjoy,Omen,Jett"
Ascent,military boot camp,Space Rabbit Esports,13,2,3,0,2,10,"Sova,Killjoy,Brimstone,Jett,Deadlock","Sova,Killjoy,Omen,KAY/O,Neon"
Lotus,Skyline Dreamers GC,Waffle House,13,6,6,1,5,7,"Breach,Killjoy,Neon,Gekko,Clove","Breach,Cypher,Omen,Neon,Gekko"
Ascent,Resonate,DNADIFF,13,5,5,1,4,8,"Sova,Killjoy,Sage,Omen,Jett","Sova,Killjoy,Omen,Jett,KAY/O"
Lotus,The GRID,retired men,13,4,9,3,1,4,"Raze,Cypher,Reyna,Gekko,Clove","Raze,Cypher,Omen,Skye,Deadlock"
Lotus,les piments,SeanGares' Kittens,2,13,0,3,10,2,"Breach,Raze,Cypher,Omen,Gekko","Breach,Raze,Cypher,Omen,Gekko"
Ascent,Goated,ABG luvrs,11,13,8,4,9,3,"Sova,Killjoy,Omen,Jett,KAY/O","Sova,Killjoy,Omen,Jett,KAY/O"
Lotus,pasta fazool,FREAK,6,13,6,6,7,0,"Breach,Raze,Killjoy,Omen,Yoru","Breach,Raze,Cypher,Omen,Gekko"
Ascent,Special Grade,Lemonade Stand,2,13,2,10,3,0,"Sova,Killjoy,Omen,Jett,KAY/O","Sova,Killjoy,Brimstone,Sage,KAY/O"
Icebox,BIG GRASS EATERS,Its time,8,13,0,9,4,8,"Sova,Killjoy,Viper,Reyna,Jett","Sova,Killjoy,Viper,Omen,Jett"
Bind,Evil Geniuses,MIBR,9,13,4,6,7,5,"Raze,Brimstone,Omen,Skye,Gekko","Raze,Cypher,Brimstone,Skye,Deadlock"
Lotus,The big show,3/5ths Canadian,13,15,8,6,9,5,"Raze,Cypher,Omen,Fade,Gekko","Breach,Raze,Killjoy,Omen,Gekko"
Lotus,Status Red,Die Hard,10,13,6,5,8,4,"Breach,Raze,Killjoy,Omen,Fade","Breach,Cypher,Omen,Neon,Fade"
Lotus,Revenge (NA),The Warriors,13,4,9,3,1,4,"Raze,Cypher,Omen,Fade,Deadlock","Breach,Raze,Killjoy,Omen,Fade"
Haven,BRAND RISK,SaD FROST,3,13,1,3,10,2,"Breach,Cypher,Sova,Omen,Jett","Breach,Sova,Killjoy,Neon,Clove"
Breeze,Event Horizon Red,military boot camp,7,13,4,4,9,3,"Cypher,Sova,Viper,Jett,KAY/O","Cypher,Sova,Jett,Astra,Harbor"
Haven,The GRID,retired men,13,6,9,3,3,4,"Sova,Killjoy,Omen,Yoru,Iso","Cypher,Sova,Phoenix,Omen,Jett"
Haven,U18,ABG luvrs,3,13,3,9,4,0,"Breach,Sova,Killjoy,Omen,Yoru","Cypher,Sova,Phoenix,Omen,Jett"
Haven,Revenge (NA),The Warriors,13,3,9,3,0,4,"Breach,Sova,Killjoy,Omen,Jett","Breach,Cypher,Sova,Omen,Jett"
Bind,2AM,Mighty Monkeys,13,0,12,0,0,1,"Raze,Cypher,Brimstone,Skye,Iso","Sova,Brimstone,Reyna,Neon,Gekko"
Sunset,Space Rabbit Esports,Campfire Esports,13,0,1,0,0,12,"Cypher,Sova,Omen,Neon,Gekko","Breach,Raze,Cypher,Gekko,Clove"
Haven,Skyline Dreamers GC,Waffle House,13,15,7,7,8,6,"Breach,Killjoy,Omen,Jett,Gekko","Breach,Cypher,Sova,Omen,Neon"
Lotus,lyricals minions,Die Hard,2,13,0,3,10,2,"Breach,Raze,Cypher,Gekko,Clove","Breach,Cypher,Omen,Neon,Fade"
Sunset,BRAND RISK,SaD FROST,4,13,4,8,5,0,"Raze,Cypher,Sova,Omen,Gekko","Breach,Cypher,Neon,Fade,Clove"
Split,Resonate,DNADIFF,13,11,7,5,6,6,"Raze,Cypher,Sage,Omen,Jett","Raze,Cypher,Omen,Skye,Iso"
Icebox,Special Grade,Lemonade Stand,10,13,3,8,5,7,"Sova,Killjoy,Viper,Jett,Clove","Omen,KAY/O,Harbor,Gekko,Clove"
Haven,IAPEsports,1000rr club,10,13,3,8,5,7,"Breach,Cypher,Sova,Omen,Neon","Cypher,Sova,Omen,Jett,Iso"
Haven,bazinga esports,Odyssey Gaming,13,9,7,5,4,6,"Breach,Cypher,Sova,Omen,Jett","Breach,Sova,Killjoy,Omen,Jett"
Haven,90 Seconds,SPACEGLID3RS,12,14,3,10,4,9,"Breach,Cypher,Sova,Omen,Jett","Breach,Sova,Killjoy,Omen,Jett"
Haven,Grow uP eSports,InTenZive,13,3,11,1,2,2,"Breach,Sova,Killjoy,Omen,Neon","Breach,Cypher,Sova,Omen,Neon"
Haven,INCOGNITO,Team Galaga,13,10,4,7,3,9,"Sova,Killjoy,Phoenix,Omen,Jett","Breach,Sova,Killjoy,Omen,Jett"
Haven,STAKERS,GMBLERS Esports,10,13,7,5,8,3,"Breach,Sova,Killjoy,Jett,Astra","Breach,Sova,Killjoy,Omen,Jett"
Haven,Capacitanes,Nexum EC,12,14,6,7,7,6,"Breach,Cypher,Sova,Omen,Jett","Breach,Sova,Killjoy,Omen,Jett"
Haven,Zeniths,AMBYS Team,9,13,6,6,7,3,"Breach,Cypher,Sova,Omen,Neon","Breach,Sova,Killjoy,Omen,Jett"
Haven,SZK Esports,GATIT4S PEEK,13,5,8,4,1,5,"Breach,Sova,Killjoy,Omen,Jett","Breach,Cypher,Sova,Omen,Neon"
Bind,Reveal Multigaming,INF Esports,7,13,1,7,6,6,"Raze,Viper,Brimstone,Skye,Gekko","Breach,Viper,Yoru,Astra,Neon"
Bind,Zerance Mint,charbon,13,9,7,3,6,6,"Raze,Viper,Brimstone,Skye,Gekko","Breach,Raze,Cypher,Omen,Yoru"
Icebox,Zerance,Joblife,2,13,0,3,10,2,"Sova,Killjoy,Viper,Jett,Gekko","Sova,Killjoy,Viper,Reyna,Jett"
Lotus,MAD Lions KOI,BLVKHVND,5,13,3,3,10,2,"Breach,Sova,Omen,Chamber,Neon","Breach,Cypher,Sova,Omen,Neon"
Ascent,Reveal Multigaming,INF Esports,13,5,7,5,0,6,"Cypher,Sova,Killjoy,Omen,Jett","Sova,Killjoy,Omen,Jett,Neon"
Icebox,Zerance Mint,charbon,13,3,11,1,2,2,"Sova,Killjoy,Viper,Jett,Gekko","Sova,Killjoy,Viper,Sage,Jett"
Bind,MAD Lions KOI,BLVKHVND,7,13,3,9,4,4,"Raze,Viper,Brimstone,Fade,Gekko","Raze,Viper,Brimstone,Skye,Gekko"
Haven,Zerance,Joblife,9,13,4,6,7,5,"Cypher,Sova,Omen,Yoru,Iso","Breach,Sova,Killjoy,Astra,Neon"
Icebox,Chipi Chapa's,trashcan,11,13,6,6,7,5,"Sova,Killjoy,Viper,Yoru,Gekko","Sova,Killjoy,Viper,Jett,KAY/O"
Lotus,Reveal Multigaming,INF Esports,6,13,2,5,8,4,"Breach,Cypher,Sova,Omen,Neon","Breach,Cypher,Omen,Jett,Neon"
Haven,SPACEGLID3RS,TwentyStars,11,13,6,6,7,5,"Breach,Sova,Killjoy,Omen,Neon","Breach,Sova,Killjoy,Omen,Neon"
Haven,bazinga esports,Grow uP eSports,9,13,4,6,7,5,"Breach,Cypher,Sova,Omen,Jett","Breach,Sova,Killjoy,Omen,Neon"
Haven,GMBLERS Esports,90 Seconds,13,6,11,1,5,2,"Breach,Sova,Killjoy,Omen,Jett","Breach,Cypher,Sova,Omen,Jett"
Haven,STAKERS,SZK Esports,8,13,5,7,6,3,"Breach,Sova,Killjoy,Jett,Astra","Breach,Sova,Killjoy,Omen,Jett"
Haven,GATIT4S PEEK,IAPEsports,9,13,4,6,7,5,"Breach,Cypher,Sova,Omen,Neon","Breach,Sova,Omen,Neon,Harbor"
Haven,AMBYS Team,Capacitanes,5,13,3,3,10,2,"Breach,Sova,Killjoy,Omen,Jett","Breach,Cypher,Sova,Omen,Jett"
Haven,Team Galaga,InTenZive,13,9,7,5,4,6,"Breach,Sova,Killjoy,Omen,Jett","Breach,Cypher,Sova,Omen,Neon"
Haven,INCOGNITO,Nexum EC,13,11,7,5,6,6,"Sova,Killjoy,Phoenix,Omen,Jett","Breach,Sova,Killjoy,Omen,Jett"
Haven,Zeniths,Odyssey Gaming,7,13,3,5,8,4,"Breach,Cypher,Sova,Omen,Neon","Breach,Sova,Killjoy,Omen,Jett"
Lotus,charbon,NEON BLADE,13,6,4,3,3,9,"Breach,Omen,Neon,Gekko,Deadlock","Raze,Killjoy,Omen,Fade,Deadlock"
Bind,Zerance,Joblife,8,13,3,6,7,5,"Raze,Viper,Brimstone,Skye,Gekko","Raze,Viper,Brimstone,Skye,Gekko"
Haven,Ketçaplı Ruffles,BLVKHVND,6,13,2,5,8,4,"Breach,Sova,Omen,Jett,Chamber","Breach,Cypher,Sova,Omen,Neon"
Haven,Chipi Chapa's,trashcan,10,13,7,5,8,3,"Breach,Cypher,Sova,Omen,Jett","Cypher,Sova,Omen,Yoru,Iso"
Haven,Reveal Multigaming,INF Esports,13,9,7,5,4,6,"Breach,Sova,Killjoy,Omen,Jett","Breach,Sova,Killjoy,Omen,Jett"
Sunset,Ketçaplı Ruffles,BLVKHVND,2,13,2,10,3,0,"Cypher,Sova,Omen,Jett,KAY/O","Breach,Cypher,Sova,Omen,Neon"
Haven,charbon,NEON BLADE,13,8,8,4,4,5,"Breach,Sova,Astra,Neon,Deadlock","Breach,Sova,Killjoy,Omen,Jett"
Split,Zerance,Joblife,13,5,10,2,3,3,"Raze,Cypher,Viper,Omen,Skye","Breach,Raze,Cypher,Omen,Yoru"
Lotus,B8 Esports,trashcan,7,13,5,3,10,2,"Cypher,Omen,KAY/O,Neon,Fade","Raze,Killjoy,Viper,Omen,Fade"
Sunset,Tropadobagaço,Skout Esports,4,13,4,8,5,0,"Breach,Raze,Cypher,Omen,Gekko","Breach,Raze,Cypher,Omen,Gekko"
Abyss,Reveal Multigaming,INF Esports,9,13,6,4,9,3,"Breach,Cypher,Sova,Yoru,Astra","Breach,Jett,Astra,Chamber,Neon"
Sunset,B8 Esports,trashcan,6,13,4,8,5,2,"Breach,Cypher,Sova,Omen,Neon","Raze,Cypher,Viper,Omen,Skye"
Lotus,Tropadobagaço,Skout Esports,13,7,7,5,2,6,"Breach,Raze,Killjoy,Viper,Omen","Breach,Raze,Cypher,Omen,Skye"
Lotus,Diamant Esports,Chipi Chapa's,13,6,9,3,3,4,"Raze,Killjoy,Omen,Skye,Astra","Raze,Cypher,Omen,Fade,Deadlock"
Ascent,Tropadobagaço,Skout Esports,6,13,3,4,9,3,"Cypher,Sova,Phoenix,Omen,Jett","Breach,Sova,Killjoy,Phoenix,Omen"
Icebox,Diamant Esports,Chipi Chapa's,13,7,9,3,4,4,"Breach,Killjoy,Viper,Jett,Gekko","Sova,Killjoy,Viper,Yoru,Gekko"
Abyss,DRX,Talon Esports,13,4,5,0,4,8,"Cypher,Sova,Omen,Jett,KAY/O","Cypher,Sova,Omen,Neon,Iso"
Ascent,DRX,Talon Esports,13,8,7,5,3,6,"Sova,Killjoy,Omen,Jett,KAY/O","Sova,Killjoy,Omen,Jett,KAY/O"
Icebox,Paper Rex,Gen.G Esports,5,13,4,8,5,1,"Killjoy,Viper,Sage,Jett,KAY/O","Killjoy,Viper,Jett,KAY/O,Gekko"
Ascent,FULL SENSE PINK,Avernus Esports,8,13,3,6,7,5,"Cypher,Sova,Omen,Jett,KAY/O","Raze,Sova,Killjoy,Reyna,Omen"
Ascent,Xipto Esports,BIGG Siren,13,0,1,0,0,12,"Sova,Reyna,Omen,Jett,Chamber","Sova,Killjoy,Omen,Jett,KAY/O"
Icebox,BAS.Kitsune,Panny Sitter,11,13,7,5,8,4,"Sova,Killjoy,Viper,Reyna,Jett","Sova,Killjoy,Viper,Jett,Clove"
Ascent,Paper Rex,Gen.G Esports,10,13,3,9,4,7,"Raze,Sova,Reyna,Omen,Harbor","Sova,Killjoy,Omen,Jett,KAY/O"
Lotus,sisu,Cardboard Dinosaur,13,9,7,5,4,6,"Raze,Killjoy,Neon,Fade,Clove","Breach,Raze,Killjoy,Omen,Gekko"
Haven,FULL SENSE PINK,Avernus Esports,8,13,4,5,8,4,"Breach,Sova,Killjoy,Omen,Jett","Breach,Sova,Killjoy,Omen,Jett"
Bind,BAS.Kitsune,Panny Sitter,3,13,1,11,2,2,"Raze,Cypher,Brimstone,Reyna,Skye","Cypher,Brimstone,Jett,Skye,Gekko"
Split,Xipto Esports,BIGG Siren,13,3,4,0,3,9,"Raze,Cypher,Omen,Jett,Skye","Raze,Cypher,Omen,Jett,Skye"
Icebox,sisu,Cardboard Dinosaur,13,5,3,3,2,10,"Viper,Sage,Reyna,Jett,Gekko","Sova,Killjoy,Jett,Harbor,Clove"
Bind,FULL SENSE PINK,Avernus Esports,13,5,5,1,4,8,"Raze,Cypher,Viper,Skye,Clove","Raze,Cypher,Brimstone,Reyna,Skye"
Lotus,RIMA GC,invincible gc,11,13,9,3,10,2,"Breach,Raze,Omen,Chamber,Gekko","Raze,Killjoy,Viper,Omen,Fade"
Ascent,4Fun (PH),Livestrong Queens,13,1,2,0,1,11,"Sova,Killjoy,Reyna,Jett,Clove","Sova,Killjoy,Omen,Jett,KAY/O"
Sunset,RIMA GC,invincible gc,9,13,7,5,8,2,"Breach,Raze,Cypher,Omen,Gekko","Breach,Raze,Cypher,Omen,Gekko"
Split,BOBA,LILAX,13,10,8,4,6,5,"Raze,Sage,Skye,Iso,Clove","Cypher,Sage,Skye,Deadlock,Clove"
Icebox,Watermelon,LILITH (TH),13,11,6,6,5,7,"Sova,Killjoy,Viper,Reyna,Jett","Sova,Killjoy,Viper,Sage,Jett"
Bind,Skyline Dreamers GC,Envee Sapphire GC,13,6,7,5,1,6,"Raze,Brimstone,Reyna,Skye,Harbor","Raze,Cypher,Viper,Brimstone,Skye"
Bind,4Fun (PH),Livestrong Queens,13,9,8,2,7,5,"Raze,Cypher,Reyna,Skye,Clove","Breach,Raze,Cypher,Brimstone,Gekko"
Bind,RIMA GC,invincible gc,13,10,5,6,4,8,"Breach,Raze,Cypher,Brimstone,Gekko","Raze,Omen,Skye,Gekko,Clove"
Ascent,BOBA,LILAX,13,6,4,3,3,9,"Cypher,Sova,Sage,Yoru,Clove","Sova,Killjoy,Phoenix,KAY/O,Clove"
Lotus,Watermelon,LILITH (TH),13,2,3,0,2,10,"Breach,Raze,Killjoy,Omen,Fade","Breach,Raze,Killjoy,Omen,Jett"
Haven,Skyline Dreamers GC,Envee Sapphire GC,11,13,6,6,7,5,"Breach,Killjoy,Omen,Jett,Gekko","Cypher,Sova,Omen,Yoru,Iso"
Bind,Mickey Masters,Akatsuki Aimers,13,11,7,5,6,6,"Raze,Reyna,Skye,Deadlock,Clove","Raze,Cypher,Fade,Gekko,Clove"
Lotus,Skyline Dreamers GC,Envee Sapphire GC,13,3,9,3,0,4,"Breach,Killjoy,Neon,Gekko,Clove","Breach,Raze,Killjoy,Omen,Fade"
Lotus,Mickey Masters,Akatsuki Aimers,13,3,10,2,1,3,"Raze,Cypher,Reyna,Omen,Fade","Breach,Raze,Killjoy,Omen,Gekko"
Ascent,BRAND RISK,Sizzle GC,13,3,9,3,0,4,"Cypher,Sova,Omen,Jett,Deadlock","Sova,Killjoy,Omen,Jett,Skye"
Ascent,Charmers GC,Waffle House,8,13,5,4,9,3,"Sova,Killjoy,Omen,Jett,KAY/O","Sova,Killjoy,Omen,Jett,KAY/O"
Haven,Terps Esports,Skyline Dreamers GC,6,13,4,3,10,2,"Raze,Sova,Sage,Skye,Clove","Breach,Phoenix,Harbor,Iso,Clove"
Haven,SaD FROST,Prestige XOXO,13,2,10,2,0,3,"Sova,Killjoy,Jett,Iso,Clove","Omen,Jett,Fade,Gekko,Deadlock"
Lotus,The Warriors,Mickey Masters,9,13,3,7,6,6,"Breach,Raze,Killjoy,Omen,Fade","Raze,Killjoy,Omen,Fade,Clove"
Bind,BRAND RISK,Sizzle GC,13,1,2,0,1,11,"Raze,Viper,Brimstone,Skye,Gekko","Viper,Brimstone,Reyna,Jett,Gekko"
Sunset,Terps Esports,Skyline Dreamers GC,2,13,0,3,10,2,"Raze,Cypher,KAY/O,Gekko,Clove","Breach,Raze,Cypher,Omen,Gekko"
Split,Special Grade,Friends Over Everything,8,13,7,5,8,1,"Breach,Raze,Cypher,Omen,Yoru","Raze,Cypher,Viper,Omen,Skye"
Lotus,Charmers GC,Waffle House,7,13,6,2,11,1,"Breach,Raze,Cypher,Omen,Fade","Breach,Cypher,Omen,Neon,Gekko"
Lotus,SaD FROST,Prestige XOXO,13,2,11,1,1,2,"Raze,Omen,Fade,Gekko,Deadlock","Breach,Killjoy,Neon,Fade,Clove"
Bind,Team Atlantis,Akatsuki Aimers,7,13,6,2,11,1,"Breach,Raze,Cypher,Brimstone,Skye","Raze,Cypher,Fade,Gekko,Clove"
Split,Cloud9,KRÜ Esports,10,13,5,6,7,5,"Raze,Cypher,Viper,Omen,Skye","Raze,Cypher,Viper,Omen,Skye"
Ascent,Mickey Masters,Atlas Esports,13,9,8,4,5,5,"Cypher,Sova,Omen,Jett,Deadlock","Sova,Killjoy,Omen,Jett,KAY/O"
Lotus,Meowsters,BRAND RISK,3,13,3,9,4,0,"Breach,Raze,Cypher,Viper,Brimstone","Cypher,Omen,Skye,Neon,Deadlock"
Haven,DNADIFF,Sexy Gang,13,11,6,6,5,7,"Breach,Cypher,Sova,Omen,Jett","Breach,Sova,Omen,Chamber,Neon"
Lotus,Akatsuki Aimers,AURA Valorant,13,2,10,2,0,3,"Breach,Killjoy,Omen,Neon,Gekko","Breach,Raze,Killjoy,Omen,Gekko"
Icebox,Special Grade,Friends Over Everything,13,8,6,3,5,7,"Sova,Killjoy,Viper,Jett,Clove","Sova,Killjoy,Viper,Reyna,Gekko"
Lotus,每分钟一千个动作 有史以来最伟大的山羊,Team Atlantis,11,13,6,6,7,5,"Breach,Raze,Cypher,Omen,Gekko","Breach,Raze,Cypher,Omen,Jett"
Lotus,Resonate,Ambrosia,5,13,5,7,6,0,"Cypher,Sova,Omen,Yoru,Fade","Raze,Killjoy,Viper,Omen,Fade"
Ascent,Charmers GC,EbonyX GC,14,12,7,6,6,7,"Sova,Killjoy,Omen,Jett,KAY/O","Sova,Killjoy,Omen,Jett,KAY/O"
Ascent,Screags n Co,Lemonade Stand,8,13,0,9,4,8,"Sova,Killjoy,Sage,Omen,Jett","Sova,Killjoy,Brimstone,Sage,KAY/O"
Abyss,Pixy Chixs,Prestige XOXO,11,13,6,6,7,5,"Breach,Phoenix,Astra,Chamber,Deadlock","Breach,Sova,Neon,Deadlock,Clove"
Ascent,Meowsters,BRAND RISK,3,13,0,4,9,3,"Sova,Killjoy,Phoenix,Brimstone,Jett","Cypher,Sova,Omen,Jett,KAY/O"
Icebox,Cloud9,KRÜ Esports,7,13,2,6,7,5,"Sova,Killjoy,Viper,Reyna,Gekko","Sova,Killjoy,Viper,Jett,KAY/O"
Icebox,Okiezi's Kittens,Atlas Esports,10,13,6,6,7,4,"Sova,Reyna,Jett,Chamber,Clove","Sova,Killjoy,Viper,Jett,Gekko"
Sunset,Ankle Biters,Sizzle GC,8,13,5,4,9,3,"Breach,Raze,Cypher,Omen,Gekko","Breach,Raze,Cypher,Gekko,Clove"
Lotus,DNADIFF,Sexy Gang,13,11,8,4,7,5,"Breach,Raze,Killjoy,Fade,Clove","Breach,Omen,Skye,Chamber,Neon"
Ascent,Envee Sapphire GC,Labyrinth White,13,9,6,4,5,7,"Sova,Killjoy,Omen,Jett,KAY/O","Sova,Killjoy,Omen,Jett,KAY/O"
Bind,The Warriors,GFU Varsity,13,5,4,2,3,9,"Raze,Viper,Brimstone,Skye,Gekko","Raze,Cypher,Omen,Yoru,Gekko"
Haven,Special Grade,Friends Over Everything,8,13,4,5,8,4,"Breach,Cypher,Sova,Omen,Jett","Cypher,Sova,Omen,Yoru,Iso"
Icebox,PLS NA,Akatsuki Aimers,7,13,1,7,6,6,"Killjoy,Viper,Jett,KAY/O,Clove","Sova,Killjoy,Viper,Jett,Gekko"
Icebox,Screags n Co,Lemonade Stand,5,13,4,2,11,1,"Sova,Killjoy,Viper,Reyna,Jett","Omen,KAY/O,Harbor,Gekko,Clove"
Split,5 guys,Team Atlantis,1,13,1,11,2,0,"Raze,Cypher,Reyna,Omen,Deadlock","Raze,Cypher,Omen,Jett,Gekko"
Ascent,Team Aquila,Mickey Masters,0,13,0,1,12,0,"Breach,Raze,Sage,Yoru,Astra","Cypher,Sova,Jett,Deadlock,Clove"
Sunset,Resonate,Ambrosia,12,14,6,7,7,6,"Raze,Cypher,Omen,KAY/O,Gekko","Breach,Raze,Cypher,Omen,Deadlock"
Haven,Pixy Chixs,Prestige XOXO,7,13,2,6,7,5,"Breach,Sova,Killjoy,Omen,Jett","Omen,Jett,Fade,Gekko,Deadlock"
Abyss,Waffle House,Catnappers,13,5,9,3,2,4,"Breach,Omen,Chamber,Neon,Deadlock","Viper,Sage,Omen,Yoru,Fade"
Icebox,Charmers GC,EbonyX GC,13,9,6,6,3,7,"Sova,Killjoy,Viper,Jett,Gekko","Killjoy,Viper,KAY/O,Gekko,Clove"
Icebox,Alphaware Olympians,每分钟一千个动作 有史以来最伟大的山羊,3,13,1,3,10,2,"Sova,Killjoy,Jett,Harbor,Gekko","Sova,Killjoy,Viper,Reyna,Jett"
Lotus,Sho,The Warriors,2,13,2,10,3,0,"Raze,Killjoy,Viper,Omen,Fade","Breach,Raze,Killjoy,Omen,Fade"
Bind,Dreamstation,SaD FROST,3,13,2,10,3,1,"Raze,Viper,Brimstone,Fade,Gekko","Raze,Viper,Skye,Chamber,Clove"
Bind,Outlaw Empire,AURA Valorant,12,14,7,6,8,5,"Raze,Cypher,Viper,Brimstone,Gekko","Raze,Brimstone,Omen,Skye,Gekko"
Lotus,Ankle Biters,Sizzle GC,5,13,2,4,9,3,"Breach,Raze,Killjoy,Omen,Gekko","Raze,Killjoy,Omen,Fade,Gekko"
Lotus,Screags n Co,Lemonade Stand,13,11,9,3,8,4,"Breach,Raze,Cypher,Omen,Gekko","Raze,Viper,Omen,Astra,Gekko"
Haven,Resonate,Ambrosia,13,5,9,3,2,4,"Breach,Sova,Killjoy,Astra,Neon","Breach,Sova,Killjoy,Omen,Jett"
Sunset,Dreamstation,SaD FROST,1,13,0,2,11,1,"Breach,Raze,Cypher,Omen,Gekko","Breach,Cypher,Neon,Fade,Clove"
Lotus,Charmers GC,EbonyX GC,6,13,3,4,9,3,"Breach,Raze,Cypher,Omen,Fade","Breach,Raze,Killjoy,Omen,Fade"
Lotus,Envee Sapphire GC,Labyrinth White,15,13,8,6,7,7,"Breach,Raze,Killjoy,Omen,Fade","Raze,Killjoy,Viper,Omen,Gekko"
Bind,Pixy Chixs,Prestige XOXO,13,7,7,5,2,6,"Raze,Cypher,Viper,Brimstone,Gekko","Raze,Cypher,Viper,Brimstone,Skye"
Haven,Waffle House,Catnappers,14,12,9,4,8,5,"Breach,Cypher,Sova,Omen,Neon","Cypher,Sova,Omen,Jett,Yoru"
Bind,Friends Over Everything,Sexy Gang,13,9,6,6,3,7,"Raze,Viper,Brimstone,Skye,Gekko","Raze,Cypher,Brimstone,Skye,Gekko"
Sunset,Friends Over Everything,Sexy Gang,13,7,6,2,5,7,"Cypher,Sova,Omen,KAY/O,Neon","Cypher,Sova,Omen,KAY/O,Neon"
Sunset,Resonate,Screags n Co,13,5,5,1,4,8,"Raze,Cypher,Omen,KAY/O,Gekko","Cypher,Sova,Neon,Gekko,Clove"
Haven,DNADIFF,Special Grade,6,13,6,6,7,0,"Breach,Sova,Killjoy,Omen,Jett","Breach,Cypher,Sova,Omen,Jett"
Haven,Zerance Mint,Valiant GC,10,13,5,7,6,5,"Breach,Sova,Killjoy,Omen,Jett","Breach,Sova,Killjoy,Omen,Jett"
Ascent,ALTERNATE aTTaX Ruby,MAD Lions KOI,13,7,6,6,1,7,"Sova,Killjoy,Omen,Jett,KAY/O","Sova,Killjoy,Reyna,Omen,Iso"
Lotus,Resonate,Screags n Co,13,8,8,1,7,5,"Cypher,Sova,Omen,Yoru,Fade","Breach,Raze,Cypher,Omen,Gekko"
Lotus,Friends Over Everything,Sexy Gang,12,14,7,6,8,5,"Raze,Killjoy,Viper,Omen,Fade","Breach,Omen,Skye,Chamber,Neon"
Ascent,DNADIFF,Special Grade,8,13,3,6,7,5,"Sova,Killjoy,Omen,Jett,KAY/O","Sova,Killjoy,Omen,Jett,KAY/O"
Ascent,FOKUS Sakura,NEON BLADE,12,14,7,6,8,5,"Sova,Killjoy,Phoenix,Omen,Jett","Sova,Killjoy,Omen,Jett,Deadlock"
Ascent,Zerance Mint,Valiant GC,13,9,4,6,3,9,"Sova,Killjoy,Omen,Jett,KAY/O","Sova,Killjoy,Omen,Jett,KAY/O"
Bind,charbon,Gamax Lite,13,5,6,0,5,7,"Breach,Raze,Cypher,Omen,Yoru","Viper,Brimstone,Jett,Skye,Gekko"
Sunset,ALTERNATE aTTaX Ruby,MAD Lions KOI,8,13,2,7,6,6,"Breach,Raze,Cypher,Sova,Omen","Breach,Cypher,Sova,Omen,Neon"
Sunset,Ketçaplı Ruffles,On Sight,13,11,7,5,6,6,"Cypher,Sova,Omen,Jett,KAY/O","Cypher,Omen,KAY/O,Neon,Gekko"
Icebox,Chipi Chapa's,trashcan,13,6,7,5,1,6,"Sova,Killjoy,Viper,Yoru,Gekko","Sova,Killjoy,Viper,Jett,KAY/O"
Lotus,The Ultimates Odyssey,BLVKHVND,6,13,4,3,10,2,"Breach,Cypher,Sova,Omen,Neon","Breach,Cypher,Sova,Omen,Neon"
Icebox,FOKUS Sakura,NEON BLADE,13,11,4,8,3,9,"Sova,Killjoy,Viper,Reyna,Jett","Sova,Killjoy,Viper,Sage,Jett"
Bind,Zerance Mint,Valiant GC,6,13,6,6,7,0,"Raze,Viper,Brimstone,Skye,Gekko","Raze,Viper,Brimstone,Fade,Gekko"
Split,Ketçaplı Ruffles,On Sight,13,3,10,2,1,3,"Breach,Raze,Sage,Omen,Chamber","Raze,Viper,Omen,Skye,Chamber"
Bind,The Ultimates Odyssey,BLVKHVND,4,13,2,3,10,2,"Breach,Raze,Viper,Brimstone,Gekko","Raze,Viper,Brimstone,Skye,Gekko"
Haven,ALTERNATE aTTaX Ruby,MAD Lions KOI,13,10,6,6,4,7,"Breach,Cypher,Sova,Omen,Jett","Breach,Sova,Killjoy,Omen,Neon"
Haven,charbon,Gamax Lite,13,11,8,4,7,5,"Breach,Sova,Astra,Neon,Deadlock","Breach,Cypher,Sova,Jett,Astra"
Sunset,Chipi Chapa's,trashcan,10,13,6,5,8,4,"Breach,Raze,Cypher,Omen,Deadlock","Raze,Cypher,Viper,Omen,Skye"
Lotus,FOKUS Sakura,NEON BLADE,8,13,6,6,7,2,"Breach,Raze,Killjoy,Omen,Gekko","Raze,Killjoy,Omen,Fade,Deadlock"
Haven,Valiant GC,Ketçaplı Ruffles,13,8,7,5,3,6,"Breach,Sova,Killjoy,Omen,Jett","Breach,Sova,Omen,Jett,Chamber"
Ascent,Chipi Chapa's,trashcan,13,11,6,6,5,7,"Raze,Cypher,Sova,Omen,Deadlock","Sova,Killjoy,Sage,Omen,Jett"
Lotus,MAD Lions KOI,charbon,13,11,7,5,6,6,"Breach,Sova,Omen,Chamber,Neon","Breach,Omen,Neon,Gekko,Deadlock"
Bind,The Ultimates Odyssey,Zerance Mint,15,17,7,9,8,8,"Breach,Raze,Viper,Brimstone,Gekko","Raze,Viper,Brimstone,Skye,Gekko"
Lotus,ALTERNATE aTTaX Ruby,FOKUS Sakura,13,7,6,2,5,7,"Breach,Raze,Cypher,Omen,Fade","Breach,Raze,Killjoy,Omen,Gekko"
Icebox,Valiant GC,Ketçaplı Ruffles,13,6,8,4,2,5,"Sova,Killjoy,Viper,Sage,Jett","Sova,Killjoy,Viper,Jett,Gekko"
Haven,The Ultimates Odyssey,Zerance Mint,5,13,2,4,9,3,"Breach,Sova,Killjoy,Omen,Neon","Breach,Sova,Killjoy,Omen,Jett"
Bind,ALTERNATE aTTaX Ruby,FOKUS Sakura,13,2,12,0,2,1,"Raze,Omen,Yoru,Gekko,Clove","Raze,Viper,Omen,Skye,Chamber"
Icebox,MAD Lions KOI,charbon,13,7,7,5,2,6,"Sova,Killjoy,Viper,Harbor,Iso","Sova,Killjoy,Viper,Sage,Iso"
Lotus,Diamant Esports,B8 Esports,13,11,7,5,6,6,"Raze,Killjoy,Omen,Skye,Astra","Cypher,Omen,KAY/O,Neon,Fade"
Sunset,Diamant Esports,B8 Esports,13,6,11,1,5,2,"Raze,Killjoy,Omen,Astra,Fade","Breach,Cypher,Sova,Omen,Neon"
Lotus,BIGG Siren,FULL SENSE PINK,13,4,11,1,3,2,"Breach,Raze,Killjoy,Omen,Gekko","Raze,Killjoy,Viper,Omen,Fade"
Icebox,BIGG Siren,FULL SENSE PINK,13,11,7,5,6,6,"Sova,Killjoy,Viper,Jett,Gekko","Killjoy,Viper,Jett,KAY/O,Clove"
Haven,Cardboard Dinosaur,BAS.Kitsune,13,8,6,3,5,7,"Breach,Sova,Killjoy,Omen,Jett","Sova,Killjoy,Reyna,Omen,Jett"
Lotus,Panny Sitter,sisu,2,13,1,2,11,1,"Breach,Raze,Killjoy,Omen,Gekko","Raze,Killjoy,Neon,Fade,Clove"
Split,Avernus Esports,Xipto Esports,4,13,4,8,5,0,"Raze,Cypher,Omen,Jett,Skye","Raze,Cypher,Omen,Jett,Skye"
Lotus,Cardboard Dinosaur,BAS.Kitsune,13,6,5,2,4,8,"Breach,Raze,Killjoy,Omen,Gekko","Killjoy,Reyna,Omen,Jett,Gekko"
Bind,Panny Sitter,sisu,6,13,3,4,9,3,"Raze,Cypher,Brimstone,Reyna,Skye","Raze,Fade,Harbor,Gekko,Clove"
Bind,Avernus Esports,Xipto Esports,3,13,1,11,2,2,"Raze,Cypher,Brimstone,Reyna,Skye","Raze,Cypher,Phoenix,Brimstone,Skye"
Abyss,Team Secret,Talon Esports,11,13,5,7,6,6,"Cypher,Sova,Omen,Jett,KAY/O","Breach,Cypher,Sova,Omen,Jett"
Lotus,Team Secret,Talon Esports,11,13,5,7,6,6,"Cypher,Sova,Omen,Skye,Neon","Raze,Omen,Fade,Deadlock,Clove"
Bind,Gen.G Esports,Rex Regum Qeon,13,11,7,5,6,6,"Raze,Cypher,Viper,Brimstone,Skye","Raze,Cypher,Omen,Yoru,Deadlock"
Haven,Gen.G Esports,Rex Regum Qeon,13,8,6,3,5,7,"Killjoy,Viper,Omen,Jett,Skye","Breach,Cypher,Sova,Omen,Jett"
Haven,Moist x Shopify,M80,13,15,8,6,9,5,"Breach,Cypher,Sova,Omen,Neon","Breach,Sova,Killjoy,Omen,Jett"
Bind,QoR,Winthrop University,13,10,6,6,4,7,"Raze,Brimstone,Omen,Skye,Gekko","Raze,Viper,Brimstone,Fade,Gekko"
Ascent,Moist x Shopify,M80,10,13,4,7,6,6,"Cypher,Sova,Omen,Jett,Deadlock","Cypher,Sova,Omen,Yoru,Deadlock"
Sunset,XLD Gaming,Stellae Gaming,10,13,2,9,4,8,"Breach,Cypher,Sova,Omen,Neon","Breach,Cypher,Omen,Neon,Gekko"
Bind,GMBLERS Esports,TwentyStars,13,11,6,6,5,7,"Breach,Raze,Cypher,Brimstone,Yoru","Raze,Cypher,Viper,Brimstone,Skye"
Sunset,QoR,Winthrop University,13,6,8,4,2,5,"Breach,Raze,Cypher,Sova,Omen","Breach,Cypher,Omen,Neon,Fade"
Lotus,XLD Gaming,Stellae Gaming,10,13,1,11,2,9,"Breach,Cypher,Omen,Neon,Fade","Breach,Cypher,Omen,Neon,Fade"
Sunset,Team Vitality,Karmine Corp,14,12,6,7,5,8,"Cypher,Sova,Omen,KAY/O,Neon","Breach,Raze,Cypher,Omen,Jett"
Bind,Blinn Esports,Dough Bros,13,6,7,0,6,6,"Raze,Viper,Brimstone,KAY/O,Gekko","Raze,Viper,Brimstone,Skye,Deadlock"
Ascent,GMBLERS Esports,TwentyStars,13,10,4,7,3,9,"Sova,Killjoy,Omen,Jett,KAY/O","Sova,Killjoy,Omen,Jett,KAY/O"
Ascent,XLD Gaming,Stellae Gaming,6,13,4,8,5,2,"Sova,Killjoy,Omen,Jett,KAY/O","Sova,Killjoy,Omen,Jett,KAY/O"
Sunset,Blinn Esports,Dough Bros,13,3,10,2,1,3,"Breach,Cypher,Omen,Neon,Gekko","Breach,Raze,Cypher,Omen,Fade"
Lotus,Team Vitality,Karmine Corp,9,13,6,6,7,3,"Breach,Raze,Cypher,Omen,Fade","Cypher,Sova,Omen,Yoru,Fade"
Lotus,GMBLERS Esports,TwentyStars,13,15,7,7,8,6,"Breach,Raze,Killjoy,Omen,Jett","Breach,Sova,Killjoy,Omen,Jett"
Icebox,Team Vitality,Karmine Corp,13,4,4,1,3,9,"Sova,Killjoy,Viper,Jett,Gekko","Skye,KAY/O,Neon,Harbor,Gekko"
Haven,GMBLERS Esports,TwentyStars,13,9,6,4,5,7,"Breach,Sova,Killjoy,Omen,Jett","Breach,Sova,Killjoy,Omen,Jett"
Split,Natus Vincere,Gentle Mates,13,11,6,6,5,7,"Breach,Raze,Viper,Omen,Fade","Breach,Raze,Cypher,Omen,Yoru"
Sunset,GMBLERS Esports,TwentyStars,11,13,7,5,8,4,"Raze,Cypher,Omen,KAY/O,Iso","Breach,Cypher,Sova,Omen,Neon"
Ascent,Natus Vincere,Gentle Mates,8,13,6,6,7,2,"Cypher,Omen,Jett,KAY/O,Fade","Cypher,Sova,Omen,Jett,KAY/O"
Lotus,Made in Thailand,XERXIA Esports,13,8,8,4,4,5,"Raze,Killjoy,Viper,Omen,Gekko","Breach,Raze,Cypher,Omen,Fade"
Lotus,Reve Drift Arena,Kizuna Esports,13,10,7,5,5,6,"Cypher,Sova,Omen,Jett,Gekko","Breach,Sova,Killjoy,Omen,Jett"
Sunset,Natus Vincere,Gentle Mates,13,7,8,0,7,5,"Cypher,Sova,Omen,KAY/O,Neon","Cypher,Sova,Omen,KAY/O,Neon"
Abyss,Made in Thailand,XERXIA Esports,13,11,5,7,4,8,"Cypher,Sova,Omen,Jett,KAY/O","Breach,Cypher,Sova,Omen,Jett"
Icebox,Reve Drift Arena,Kizuna Esports,18,16,7,10,6,11,"Sova,Killjoy,Viper,Jett,Gekko","Sova,Killjoy,Viper,Jett,KAY/O"
Bind,Made in Thailand,XERXIA Esports,12,14,7,6,8,5,"Raze,Cypher,Viper,Brimstone,Skye","Raze,Viper,Brimstone,Skye,Gekko"
Bind,ONE Team Esports,Oblivion Force,9,13,6,6,7,3,"Raze,Brimstone,Omen,Skye,Gekko","Raze,Viper,Brimstone,Skye,Gekko"
Sunset,Livestrong Queens,RIMA GC,6,13,5,7,6,1,"Breach,Raze,Cypher,Omen,Gekko","Breach,Raze,Cypher,Omen,Gekko"
Lotus,LaZe,NEXGA,13,9,5,5,4,8,"Breach,Cypher,Sova,Omen,Neon","Breach,Sova,Killjoy,Omen,Jett"
Haven,Sharper Esports,FULL SENSE,7,13,2,10,3,5,"Breach,Killjoy,Omen,Neon,Gekko","Breach,Sova,Killjoy,Omen,Neon"
Haven,ONE Team Esports,Oblivion Force,13,7,6,6,1,7,"Breach,Sova,Killjoy,Omen,Jett","Breach,Cypher,Sova,Omen,Jett"
Ascent,Livestrong Queens,RIMA GC,13,9,4,6,3,9,"Sova,Killjoy,Omen,Jett,KAY/O","Sova,Killjoy,Omen,Jett,KAY/O"
Bind,invincible gc,4Fun (PH),13,10,5,7,3,8,"Raze,Omen,Skye,Gekko,Clove","Raze,Cypher,Brimstone,Skye,Iso"
Haven,LILITH (TH),BOBA,6,13,1,6,7,5,"Breach,Reyna,Jett,Iso,Clove","Sage,Reyna,Harbor,Iso,Clove"
Lotus,LILAX,Watermelon,13,9,9,1,8,4,"Killjoy,Reyna,Fade,Gekko,Clove","Breach,Raze,Killjoy,Omen,Fade"
Bind,LaZe,NEXGA,7,13,5,7,6,2,"Raze,Viper,Brimstone,Fade,Gekko","Raze,Cypher,Viper,Brimstone,Skye"
Lotus,Livestrong Queens,RIMA GC,3,13,0,4,9,3,"Breach,Raze,Killjoy,Omen,Gekko","Breach,Raze,Omen,Chamber,Gekko"
Bind,LILITH (TH),BOBA,1,13,1,11,2,0,"Raze,Cypher,Brimstone,Jett,Skye","Raze,Reyna,Neon,Fade,Clove"
Ascent,invincible gc,4Fun (PH),13,7,5,3,4,8,"Sova,Killjoy,Omen,Jett,KAY/O","Sova,Killjoy,Reyna,Omen,Jett"
Sunset,Avernus Esports,NAOS Esports,11,13,8,4,9,3,"Raze,Cypher,Sova,Omen,Gekko","Raze,Cypher,Omen,KAY/O,Gekko"
Bind,Sharper Esports,FULL SENSE,7,13,1,7,6,6,"Raze,Viper,Brimstone,Fade,Gekko","Raze,Viper,Brimstone,Fade,Gekko"
Ascent,LILAX,Watermelon,13,1,2,0,1,11,"Sova,Killjoy,Phoenix,KAY/O,Clove","Breach,Killjoy,Omen,Jett,Fade"
Split,ONE Team Esports,Oblivion Force,11,13,6,6,7,5,"Raze,Cypher,Viper,Omen,Skye","Raze,Cypher,Omen,Jett,Skye"
Split,Justice For Tomorrow,Arena Internet Cafe,13,4,5,0,4,8,"Cypher,Omen,Jett,Skye,Iso","Breach,Raze,Cypher,Skye,Astra"
Haven,Purr-fectionists,9to5 workers,13,10,9,2,8,4,"Breach,Sova,Killjoy,Omen,Jett","Breach,Sova,Killjoy,Omen,Neon"
Abyss,Dplus Esports,SLT Seongam,13,6,5,2,4,8,"Cypher,Sova,Omen,Jett,KAY/O","Sage,Omen,Jett,KAY/O,Gekko"
Lotus,Avernus Esports,NAOS Esports,11,13,8,4,9,3,"Breach,Raze,Killjoy,Omen,Gekko","Raze,Viper,Omen,Chamber,Fade"
Lotus,ONE Team Esports,Oblivion Force,6,13,2,10,3,4,"Breach,Cypher,Omen,Neon,Fade","Raze,Cypher,Viper,Omen,Fade"
Sunset,Sharper Esports,FULL SENSE,13,10,7,4,6,6,"Breach,Raze,Sage,Omen,Gekko","Breach,Raze,Cypher,Sova,Omen"
Sunset,LaZe,NEXGA,13,9,8,2,7,5,"Breach,Raze,Cypher,Sova,Omen","Breach,Raze,Cypher,Sova,Omen"
Haven,Justice For Tomorrow,Arena Internet Cafe,10,13,7,5,8,3,"Sova,Killjoy,Omen,Jett,Iso","Breach,Sova,Killjoy,Jett,Astra"
Sunset,Purr-fectionists,9to5 workers,13,10,3,8,2,10,"Breach,Raze,Cypher,Sova,Omen","Breach,Cypher,Sova,Omen,Neon"
Icebox,Dplus Esports,SLT Seongam,13,10,6,5,5,7,"Killjoy,Viper,Jett,KAY/O,Gekko","Killjoy,Viper,Jett,KAY/O,Deadlock"
Ascent,JustUs,Tyrant Esports PH,13,3,9,3,0,4,"Sova,Killjoy,Reyna,Omen,Jett","Sova,Killjoy,Omen,Jett,KAY/O"
Bind,BOOM Esports,ARF TEAM,13,6,8,4,2,5,"Breach,Raze,Cypher,Brimstone,Deadlock","Raze,Cypher,Brimstone,Reyna,Skye"
Lotus,Murash Gaming,FENNEL,13,15,6,8,7,7,"Breach,Killjoy,Brimstone,Neon,Fade","Breach,Raze,Cypher,Sova,Omen"
Ascent,Justice For Tomorrow,Arena Internet Cafe,13,7,6,2,5,7,"Sova,Killjoy,Omen,Jett,Iso","Sova,Killjoy,Omen,Jett,KAY/O"
Bind,Purr-fectionists,9to5 workers,13,6,5,2,4,8,"Raze,Viper,Brimstone,Skye,Gekko","Raze,Cypher,Viper,Brimstone,Skye"
Bind,JustUs,Tyrant Esports PH,7,13,6,6,7,1,"Raze,Cypher,Brimstone,Reyna,Skye","Breach,Raze,Cypher,Skye,Clove"
Icebox,BOOM Esports,ARF TEAM,13,8,5,4,4,8,"Killjoy,Viper,Jett,KAY/O,Clove","Killjoy,Viper,Jett,KAY/O,Gekko"
Ascent,Murash Gaming,FENNEL,8,13,3,6,7,5,"Sova,Killjoy,Omen,Jett,KAY/O","Sova,Killjoy,Omen,Jett,KAY/O"
Icebox,Justice For Tomorrow,Arena Internet Cafe,13,10,6,5,5,7,"Sova,Killjoy,Viper,Jett,Iso","Sova,Killjoy,Viper,Sage,Iso"
Abyss,Sin Prisa Gaming,Nongshim RedForce,13,6,8,4,2,5,"Cypher,Sova,Omen,Jett,Gekko","Jett,Astra,KAY/O,Harbor,Iso"
Lotus,JustUs,Tyrant Esports PH,13,9,6,4,5,7,"Killjoy,Omen,Jett,Fade,Gekko","Breach,Cypher,Omen,Neon,Fade"
Sunset,Alter Ego,Bigetron Arctic,9,13,4,6,7,5,"Breach,Raze,Cypher,Omen,Gekko","Breach,Raze,Cypher,Omen,Gekko"
Sunset,Sin Prisa Gaming,Nongshim RedForce,13,10,8,3,7,5,"Raze,Cypher,Omen,Fade,Deadlock","Raze,Phoenix,Omen,Fade,Clove"
Bind,RIDDLE ORDER,Sengoku Gaming,13,6,5,2,4,8,"Raze,Viper,Brimstone,Fade,Gekko","Raze,Viper,Brimstone,Sage,Skye"
Ascent,Rank El Cuties,Carti World,10,13,5,6,7,5,"Sova,Killjoy,Omen,Jett,KAY/O","Sova,Killjoy,Omen,Jett,KAY/O"
Bind,Alter Ego,Bigetron Arctic,12,14,8,5,9,4,"Raze,Viper,Brimstone,Omen,Skye","Raze,Viper,Brimstone,Skye,Gekko"
Icebox,RIDDLE ORDER,Sengoku Gaming,13,5,8,4,1,5,"Killjoy,Viper,Jett,KAY/O,Gekko","Sova,Killjoy,Jett,Harbor,Clove"
Ascent,Sin Prisa Gaming,Nongshim RedForce,10,13,7,5,8,3,"Cypher,Sova,Omen,Yoru,Iso","Sova,Viper,Omen,Jett,Yoru"
Haven,Rank El Cuties,Carti World,11,13,6,6,7,5,"Killjoy,Omen,Skye,Neon,Iso","Breach,Sova,Killjoy,Omen,Jett"
Sunset,Akave Esports Black,KS Esports GC,13,9,5,7,2,8,"Breach,Raze,Cypher,Omen,Gekko","Breach,Raze,Cypher,Omen,Gekko"
Ascent,Burger Boyz 2.0,Goon that jawn,10,13,5,6,7,5,"Sova,Killjoy,Omen,Jett,KAY/O","Sova,Killjoy,Reyna,Omen,Yoru"
Ascent,Akave Esports Black,KS Esports GC,13,10,5,7,3,8,"Cypher,Sova,Omen,Jett,KAY/O","Cypher,Sova,Omen,Jett,Deadlock"
Haven,Burger Boyz 2.0,Goon that jawn,7,13,2,6,7,5,"Breach,Sova,Killjoy,Omen,Neon","Breach,Cypher,Sova,Omen,Yoru"
Lotus,LazerrFreeks Ivy,Envee Sapphire GC,13,6,10,2,4,3,"Raze,Killjoy,Omen,Fade,Gekko","Breach,Raze,Killjoy,Omen,Fade"
Ascent,9z Team GC,FiRePOWER GC,13,5,4,2,3,9,"Sova,Killjoy,Omen,Jett,KAY/O","Sova,Killjoy,Omen,Jett,KAY/O"
Ascent,Burger Boyz 2.0,SaD Purple,13,7,9,3,4,4,"Sova,Killjoy,Omen,Jett,KAY/O","Sova,Killjoy,Omen,Jett,KAY/O"
Sunset,minions united GC,LazerrFreeks Ivy,13,7,7,5,2,6,"Breach,Raze,Cypher,Sova,Omen","Raze,Cypher,Fade,Gekko,Clove"
Lotus,Goon that jawn,Dough Bros,14,12,9,4,8,5,"Cypher,Viper,Neon,Fade,Clove","Raze,Omen,Fade,Deadlock,Clove"
Bind,Burger Boyz 2.0,SaD Purple,11,13,6,6,7,5,"Raze,Cypher,Viper,Brimstone,Skye","Raze,Cypher,Viper,Brimstone,Skye"
Icebox,Galorys,XLD Gaming,13,7,9,3,4,4,"Sova,Killjoy,Viper,Sage,Jett","Sova,Killjoy,Viper,Sage,Jett"
Bind,9z Team GC,FiRePOWER GC,13,10,8,3,7,5,"Viper,Brimstone,Skye,Neon,Deadlock","Raze,Viper,Brimstone,Skye,Gekko"
Haven,Goon that jawn,Dough Bros,13,7,6,6,1,7,"Breach,Cypher,Sova,Omen,Yoru","Breach,Cypher,Sova,Omen,Neon"
Breeze,Galorys,XLD Gaming,13,2,10,2,0,3,"Cypher,Sova,Viper,Jett,KAY/O","Cypher,Sova,Viper,Jett,KAY/O"
Icebox,Burger Boyz 2.0,SaD Purple,13,8,9,3,5,4,"Sova,Killjoy,Viper,Jett,Gekko","Sova,Killjoy,Viper,Reyna,Jett"
Icebox,9z Team GC,FiRePOWER GC,11,13,5,7,6,6,"Killjoy,Viper,Jett,KAY/O,Gekko","Sova,Killjoy,Harbor,Iso,Clove"
Haven,YFP Gaming,TSM,10,13,6,6,7,4,"Breach,Sova,Killjoy,Omen,Jett","Breach,Cypher,Sova,Omen,Neon"
Ascent,Hero Base,Stellae Gaming,9,13,3,9,4,6,"Breach,Viper,Omen,Jett,KAY/O","Sova,Killjoy,Omen,Jett,KAY/O"
Sunset,Friends Over Everything,Dough Bros,9,13,6,6,7,3,"Cypher,Sova,Omen,KAY/O,Neon","Breach,Raze,Cypher,Omen,Fade"
Lotus,YFP Gaming,TSM,7,13,1,7,6,6,"Breach,Cypher,Omen,Neon,Fade","Breach,Cypher,Omen,Neon,Gekko"
Lotus,Friends Over Everything,Dough Bros,10,13,4,8,5,6,"Raze,Killjoy,Viper,Omen,Fade","Raze,Omen,Fade,Deadlock,Clove"
Haven,FNATIC,Team Liquid,13,9,6,4,5,7,"Cypher,Sova,Omen,Yoru,Iso","Breach,Sova,Killjoy,Omen,Jett"
Sunset,Hero Base,Stellae Gaming,10,13,5,7,6,5,"Breach,Cypher,Omen,KAY/O,Neon","Breach,Cypher,Omen,Neon,Gekko"
Icebox,FNATIC,Team Liquid,13,2,3,0,2,10,"Sova,Killjoy,Viper,Gekko,Iso","Sova,Viper,Sage,Reyna,Chamber"
Haven,Team Heretics,KOI,13,10,8,3,7,5,"Breach,Cypher,Omen,Neon,Iso","Breach,Cypher,Sova,Omen,Jett"
Bind,Team Heretics,KOI,13,9,7,3,6,6,"Raze,Viper,Brimstone,Fade,Gekko","Raze,Viper,Brimstone,KAY/O,Gekko"
Icebox,Team Heretics,KOI,11,13,6,6,7,5,"Sova,Killjoy,Viper,Jett,KAY/O","Killjoy,Viper,Jett,KAY/O,Gekko"
Ascent,Disguised,LaZe,13,2,10,2,0,3,"Cypher,Sova,Omen,Jett,Iso","Cypher,Sova,Omen,Jett,KAY/O"
Ascent,FULL SENSE,XERXIA Esports,10,13,4,8,5,6,"Sova,Killjoy,Omen,Jett,KAY/O","Sova,Killjoy,Omen,Jett,KAY/O"
Bind,Team Kobolds,Oblivion Force,3,13,0,4,9,3,"Viper,Brimstone,Jett,Skye,Gekko","Raze,Viper,Brimstone,Skye,Gekko"
Haven,Disguised,LaZe,13,6,3,4,2,10,"Cypher,Sova,Omen,Yoru,Iso","Breach,Cypher,Sova,Omen,Jett"
Abyss,FULL SENSE,XERXIA Esports,9,13,8,4,9,1,"Breach,Cypher,Reyna,Omen,Jett","Breach,Cypher,Sova,Omen,Jett"
Sunset,Asmodeus Colosseum GC,9to5 workers,7,13,5,7,6,2,"Breach,Cypher,Sova,Omen,Neon","Breach,Cypher,Sova,Omen,Neon"
Ascent,OLD STINKY CAT,ZOL Esports,13,4,8,4,0,5,"Cypher,Sova,Omen,Jett,Deadlock","Sova,Killjoy,Omen,Jett,KAY/O"
Split,Team Kobolds,Oblivion Force,15,17,10,6,11,5,"Raze,Cypher,Omen,Jett,Skye","Raze,Cypher,Omen,Jett,Skye"
Haven,Elevate (SG),Reve Drift Arena,13,9,6,6,3,7,"Breach,Sova,Killjoy,Omen,Jett","Breach,Sova,Jett,Chamber,Clove"
Lotus,Made in Thailand,Sharper Esports,13,7,7,5,2,6,"Raze,Killjoy,Viper,Omen,Gekko","Breach,Raze,Cypher,Omen,Fade"
Bind,OLD STINKY CAT,ZOL Esports,6,13,1,6,7,5,"Raze,Viper,Brimstone,Skye,Gekko","Raze,Cypher,Brimstone,Skye,Gekko"
Haven,Asmodeus Colosseum GC,9to5 workers,12,14,6,7,7,6,"Breach,Sova,Killjoy,Omen,Neon","Breach,Sova,Killjoy,Omen,Neon"
Bind,VARREL,FENNEL,7,13,3,5,8,4,"Breach,Raze,Cypher,Astra,Deadlock","Raze,Viper,Brimstone,Fade,Gekko"
Lotus,SLT Seongam,VEC DAEJEON,13,8,7,5,3,6,"Raze,Killjoy,Viper,Omen,Fade","Breach,Raze,Viper,Omen,Skye"
Lotus,Team Kobolds,Oblivion Force,16,18,10,7,11,6,"Breach,Killjoy,Omen,Skye,Neon","Raze,Viper,Omen,Chamber,Fade"
Haven,OLD STINKY CAT,ZOL Esports,13,6,4,3,3,9,"Breach,Cypher,Omen,Neon,Iso","Breach,Sova,Killjoy,Omen,Neon"
Lotus,Elevate (SG),Reve Drift Arena,13,11,7,5,6,6,"Breach,Raze,Cypher,Omen,Fade","Cypher,Sova,Omen,Jett,Gekko"
Haven,Made in Thailand,Sharper Esports,14,12,7,6,6,7,"Breach,Sova,Killjoy,Jett,Astra","Breach,Killjoy,Omen,Neon,Gekko"
Ascent,BOOM Esports,Cynical,13,8,4,5,3,9,"Sova,Killjoy,Omen,Jett,KAY/O","Sova,Killjoy,Omen,Jett,KAY/O"
Sunset,VARREL,FENNEL,6,13,4,8,5,2,"Raze,Cypher,Omen,KAY/O,Neon","Raze,Cypher,Sage,Omen,Fade"
Sunset,Gang Gang,Purr-fectionists,8,13,8,4,9,0,"Breach,Raze,Cypher,Sova,Clove","Breach,Raze,Cypher,Sova,Omen"
Abyss,SLT Seongam,VEC DAEJEON,13,11,9,3,8,4,"Sage,Omen,Jett,KAY/O,Gekko","Cypher,Omen,KAY/O,Neon,Gekko"
Lotus,VARREL,FENNEL,13,7,6,2,5,7,"Breach,Sova,Omen,Chamber,Neon","Breach,Raze,Cypher,Sova,Omen"
Lotus,BOOM Esports,Cynical,13,7,5,3,4,8,"Raze,Killjoy,Viper,Omen,Fade","Breach,Raze,Cypher,Omen,Fade"
Ascent,Arena Internet Cafe,FOCUSGG,13,5,8,4,1,5,"Sova,Killjoy,Omen,Jett,KAY/O","Sova,Killjoy,Omen,Jett,KAY/O"
Lotus,Gang Gang,Purr-fectionists,3,13,1,11,2,2,"Breach,Raze,Killjoy,Omen,Iso","Raze,Killjoy,Viper,Omen,Fade"
Icebox,Tyrant Esports PH,NAOS Esports,11,13,3,9,4,8,"Sova,Killjoy,Viper,Sage,Jett","Killjoy,Viper,Jett,KAY/O,Gekko"
Breeze,Doa Ibu Selamanya,Le Crapaud,13,10,6,5,5,7,"Cypher,Sova,Viper,Jett,Yoru","Cypher,Sova,Viper,Jett,KAY/O"
Lotus,Arena Internet Cafe,FOCUSGG,13,7,3,5,2,10,"Breach,Killjoy,Omen,Skye,Neon","Raze,Killjoy,Viper,Omen,Fade"
Lotus,Tyrant Esports PH,NAOS Esports,10,13,5,7,6,5,"Breach,Cypher,Omen,Neon,Gekko","Raze,Viper,Omen,Chamber,Fade"
Haven,Nongshim RedForce,Team IAM,13,10,4,7,3,9,"Killjoy,Omen,Yoru,Fade,Iso","Killjoy,Viper,Omen,Jett,Skye"
Sunset,SCARZ,Murash Gaming,11,13,6,6,7,5,"Breach,Raze,Cypher,Omen,Gekko","Sova,Phoenix,Sage,Omen,Clove"
Ascent,Doa Ibu Selamanya,Le Crapaud,13,6,6,1,5,7,"Cypher,Sova,Omen,Jett,Deadlock","Sova,Killjoy,Omen,Jett,KAY/O"
Sunset,Nongshim RedForce,Team IAM,13,7,6,6,1,7,"Raze,Phoenix,Omen,Fade,Clove","Breach,Raze,Cypher,Omen,Gekko"
Ascent,SCARZ,Murash Gaming,13,1,11,1,0,2,"Sova,Killjoy,Omen,Jett,KAY/O","Sova,Killjoy,Omen,Jett,KAY/O"
Lotus,Doa Ibu Selamanya,Le Crapaud,8,13,8,4,9,0,"Raze,Killjoy,Omen,Fade,Gekko","Raze,Killjoy,Viper,Omen,Fade"
Icebox,Avernus Esports,Oasis Gaming,9,13,4,6,7,5,"Sova,Killjoy,Viper,Jett,Gekko","Sova,Killjoy,Viper,Jett,KAY/O"
Icebox,Ambrosia,SaD Purple,6,13,3,4,9,3,"Sova,Killjoy,Viper,Jett,KAY/O","Sova,Killjoy,Viper,Reyna,Jett"
Haven,SCARZ,Murash Gaming,6,13,1,6,7,5,"Breach,Sova,Killjoy,Omen,Jett","Breach,Sova,Killjoy,Omen,Neon"
Lotus,Nongshim RedForce,Team IAM,9,13,3,7,6,6,"Raze,Killjoy,Viper,Omen,Fade","Raze,Killjoy,Viper,Omen,Fade"
Haven,Avernus Esports,Oasis Gaming,7,13,2,6,7,5,"Breach,Killjoy,Omen,Neon,Fade","Breach,Cypher,Sova,Omen,Neon"
Sunset,Ambrosia,SaD Purple,13,15,4,10,5,9,"Breach,Raze,Cypher,Omen,Deadlock","Breach,Raze,Cypher,Omen,Gekko"
Lotus,Goon that jawn,mustahed mocking gaming,13,8,8,1,7,5,"Cypher,Viper,Neon,Fade,Clove","Raze,Killjoy,Omen,Fade,Gekko"
Haven,Ambrosia,SaD Purple,13,5,5,1,4,8,"Breach,Sova,Killjoy,Omen,Jett","Breach,Cypher,Sova,Omen,Jett"
Haven,Goon that jawn,mustahed mocking gaming,13,8,8,4,4,5,"Breach,Cypher,Sova,Omen,Yoru","Sova,Killjoy,Omen,Neon,Gekko"
Ascent,Goon that jawn,mustahed mocking gaming,8,13,5,7,6,3,"Sova,Killjoy,Omen,Jett,Yoru","Killjoy,Omen,Yoru,Fade,Deadlock"
Bind,wows little pugstars,Mickey Masters,5,13,0,6,7,5,"Raze,Brimstone,Yoru,Gekko,Deadlock","Raze,Brimstone,Reyna,Skye,Deadlock"
Ascent,Burger Boyz 2.0,Evil Genies,13,7,7,5,2,6,"Sova,Killjoy,Omen,Jett,KAY/O","Cypher,Sova,Omen,Jett,KAY/O"
Icebox,Blue Otter,Ambrosia,9,13,6,6,7,3,"Sova,Killjoy,Viper,Jett,Gekko","Sova,Killjoy,Viper,Jett,KAY/O"
Icebox,Friends Over Everything,Crashout Academy,13,9,8,2,7,5,"Killjoy,Viper,Jett,KAY/O,Gekko","Sova,Killjoy,Viper,Jett,Deadlock"
Bind,Burger Boyz 2.0,Evil Genies,13,6,9,3,3,4,"Raze,Cypher,Viper,Brimstone,Skye","Raze,Viper,Brimstone,Sage,Skye"
Sunset,Goon that jawn,Lemonade Stand,13,10,5,7,3,8,"Raze,Cypher,Sova,Omen,Yoru","Breach,Raze,Sage,Omen,Gekko"
Ascent,wows little pugstars,Mickey Masters,10,13,3,8,5,7,"Cypher,Sova,Omen,Jett,Deadlock","Sova,Killjoy,Omen,Jett,Deadlock"
Lotus,Blue Otter,Ambrosia,13,15,8,6,9,5,"Breach,Cypher,Omen,Yoru,Gekko","Raze,Killjoy,Viper,Omen,Fade"
Lotus,Friends Over Everything,Crashout Academy,9,13,5,5,8,4,"Breach,Raze,Killjoy,Omen,Fade","Raze,Cypher,Omen,Fade,Deadlock"
Lotus,Burger Boyz 2.0,Evil Genies,7,13,4,8,5,3,"Raze,Cypher,Viper,Omen,Fade","Breach,Raze,Cypher,Omen,Fade"
Icebox,Dexterity Gaming,Dough Bros,4,13,3,9,4,1,"Sova,Killjoy,Viper,Reyna,Jett","Sova,Killjoy,Viper,Omen,Jett"
Lotus,mustahed mocking gaming,yves saint laurent,13,6,6,6,0,7,"Raze,Killjoy,Omen,Fade,Gekko","Raze,Killjoy,Omen,Fade,Deadlock"
Haven,Shrek's Ogres,wows little pugstars,3,13,1,11,2,2,"Breach,Cypher,Sova,Omen,Jett","Breach,Cypher,Sova,Omen,Jett"
Bind,Goon that jawn,Lemonade Stand,13,11,7,5,6,6,"Raze,Cypher,Brimstone,Skye,Yoru","Raze,Viper,Brimstone,Skye,Gekko"
Lotus,SaD Purple,Troll's Kittens,13,6,5,2,4,8,"Breach,Raze,Omen,Fade,Deadlock","Breach,Raze,Omen,Chamber,Gekko"
Sunset,Friends Over Everything,Crashout Academy,13,5,9,3,2,4,"Cypher,Sova,Omen,KAY/O,Neon","Breach,Raze,Cypher,Sova,Omen"
Icebox,Mickey Masters,Event Horizon Red,13,10,5,7,3,8,"Sova,Killjoy,Viper,Reyna,Jett","Sova,Killjoy,Viper,Jett,Gekko"
Lotus,Tenax GC,minions united GC,13,9,5,7,2,8,"Raze,Killjoy,Omen,KAY/O,Gekko","Breach,Raze,Cypher,Sova,Omen"
Sunset,XLD Gaming,Stellae Gaming,13,8,8,4,4,5,"Breach,Cypher,Sova,Omen,Neon","Breach,Cypher,Omen,Neon,Gekko"
Sunset,Blue Otter,Ambrosia,13,9,6,6,3,7,"Breach,Cypher,Sova,Omen,Neon","Breach,Raze,Cypher,Omen,Deadlock"
Lotus,Dexterity Gaming,Dough Bros,5,13,5,7,6,0,"Breach,Cypher,Omen,Skye,Neon","Raze,Omen,Fade,Deadlock,Clove"
Haven,Evil Genies,Paranoia Vortex,13,7,9,3,4,4,"Breach,Cypher,Sova,Omen,Jett","Sova,Killjoy,Jett,Astra,Iso"
Lotus,FLUFFY AIMERS,DarkZero Esports,13,4,5,0,4,8,"Raze,Cypher,Omen,Skye,Deadlock","Breach,Raze,Killjoy,Omen,KAY/O"
Haven,mustahed mocking gaming,yves saint laurent,13,7,8,4,3,5,"Sova,Killjoy,Omen,Neon,Gekko","Sova,Omen,Jett,Deadlock,Iso"
Bind,SaD Purple,Troll's Kittens,13,5,3,3,2,10,"Raze,Cypher,Viper,Brimstone,Skye","Raze,Viper,Brimstone,Fade,Gekko"
Haven,Spate Esports,Shrek's Ogres,6,13,5,7,6,1,"Breach,Cypher,Sova,Neon,Clove","Breach,Cypher,Sova,Omen,Jett"
Ascent,Evil Genies,Paranoia Vortex,13,7,6,6,1,7,"Cypher,Sova,Omen,Jett,KAY/O","Sova,Killjoy,Omen,Yoru,Iso"
Icebox,XLD Gaming,Stellae Gaming,13,3,11,1,2,2,"Sova,Killjoy,Viper,Sage,Jett","Sova,Killjoy,Viper,Jett,Gekko"
Icebox,Burger Boyz 2.0,1337 (NA),13,10,7,4,6,6,"Sova,Killjoy,Viper,Jett,Gekko","Sova,Killjoy,Viper,Gekko,Clove"
Haven,FARMAKAS WORLDWIDE,Event Horizon Red,10,13,5,7,6,5,"Cypher,Viper,Omen,Jett,Skye","Breach,Cypher,Sova,Omen,Jett"
Ascent,Nightblood Gaming,yves saint laurent,2,13,2,10,3,0,"Cypher,Sova,Omen,Jett,Deadlock","Sova,Killjoy,Omen,Jett,KAY/O"
Haven,Ambrosia,Orangutan Gang,13,3,2,2,1,11,"Breach,Sova,Killjoy,Omen,Jett","Breach,Cypher,Sova,Omen,Jett"
Bind,Mickey Masters,ST x WTP,13,0,12,0,0,1,"Raze,Brimstone,Reyna,Skye,Deadlock","Raze,Cypher,Brimstone,Jett,Gekko"
Sunset,Crashout Academy,Shifty505,13,7,6,2,5,7,"Breach,Raze,Cypher,Sova,Omen","Breach,Raze,Cypher,Omen,Fade"
Bind,Spate Esports,DEEV AND PEEV,13,5,4,2,3,9,"Raze,Viper,Yoru,Gekko,Clove","Raze,Viper,Brimstone,Skye,Chamber"
Lotus,Outlast Gaming,wows little pugstars,10,13,6,6,7,4,"Raze,Cypher,Viper,Omen,Fade","Breach,Raze,Cypher,Omen,Fade"
Sunset,FLUFFY AIMERS,DarkZero Esports,12,14,4,9,5,8,"Breach,Raze,Cypher,Omen,Skye","Raze,Cypher,Harbor,Gekko,Clove"
Haven,Burger Boyz 2.0,1337 (NA),13,1,11,1,0,2,"Breach,Sova,Killjoy,Omen,Neon","Breach,Sova,Killjoy,Omen,Jett"
Ascent,ROSE,Troll's Kittens,6,13,3,9,4,3,"Sova,Killjoy,Omen,Jett,KAY/O","Cypher,Sova,Omen,Jett,KAY/O"
Bind,Dexterity Gaming,Mad Science,14,12,7,6,6,7,"Raze,Brimstone,Fade,Gekko,Deadlock","Viper,Omen,Yoru,Fade,Gekko"
Haven,Nearest Airport,Paranoia Vortex,9,13,2,10,3,7,"Breach,Cypher,Sova,Omen,Jett","Sova,Killjoy,Jett,Astra,Iso"
Haven,Mickey Masters,ONYX FERITY,13,2,3,0,2,10,"Cypher,Sova,Reyna,Jett,Astra","Breach,Sova,Killjoy,Omen,Jett"
Icebox,The Dealers,ST x WTP,3,13,2,2,11,1,"Sova,Killjoy,Viper,Harbor,Gekko","Sova,Killjoy,Viper,Reyna,Jett"
Lotus,Event Horizon Red,RME Summit,13,6,5,2,4,8,"Breach,Cypher,Omen,Neon,Gekko","Cypher,Viper,Omen,Jett,Gekko"
Lotus,XLD Gaming,Stellae Gaming,13,15,6,8,7,7,"Breach,Cypher,Omen,Neon,Fade","Breach,Cypher,Omen,Neon,Fade"
Lotus,Blue Otter,Awaken,13,10,8,4,6,5,"Breach,Cypher,Omen,Yoru,Gekko","Cypher,Omen,KAY/O,Neon,Gekko"
Ascent,Alphaware Olympians,Outlast Gaming,2,13,0,3,10,2,"Cypher,Sova,Omen,Jett,KAY/O","Sova,Killjoy,Omen,Jett,KAY/O"
Bind,Ambrosia,Orangutan Gang,10,13,3,8,5,7,"Raze,Cypher,Brimstone,Skye,Deadlock","Raze,Brimstone,KAY/O,Fade,Deadlock"
Icebox,Lemonade Stand,Prospects,16,14,6,9,5,10,"Omen,KAY/O,Harbor,Gekko,Clove","Sova,Killjoy,Viper,Reyna,Jett"
Lotus,FARMAKAS WORLDWIDE,The blockade,14,12,7,6,6,7,"Breach,Raze,Cypher,Omen,Chamber","Raze,Killjoy,Viper,Omen,Fade"
Haven,Shrek's Ogres,Natural Order,13,4,4,1,3,9,"Breach,Cypher,Sova,Omen,Jett","Breach,Cypher,Sova,Omen,Jett"
Haven,Crashout Academy,Shifty505,11,13,6,6,7,5,"Breach,Cypher,Sova,Omen,Jett","Breach,Cypher,Sova,Omen,Jett"
Bind,FLUFFY AIMERS,DarkZero Esports,13,6,4,3,3,9,"Raze,Viper,Omen,Skye,Deadlock","Viper,Brimstone,Sage,Neon,Gekko"
Lotus,Nearest Airport,Paranoia Vortex,13,4,10,2,2,3,"Breach,Raze,Cypher,Omen,Fade","Raze,Cypher,Omen,Skye,Fade"
Bind,ROSE,Troll's Kittens,5,13,5,7,6,0,"Raze,Viper,Brimstone,Skye,Gekko","Raze,Viper,Brimstone,Fade,Gekko"
Lotus,Dexterity Gaming,Mad Science,4,13,4,8,5,0,"Breach,Cypher,Omen,Skye,Neon","Raze,Cypher,Viper,Omen,Fade"
Sunset,1337 (NA),ShaBoingBoing Esports,13,7,5,3,4,8,"Raze,Cypher,Sova,Omen,KAY/O","Breach,Raze,Cypher,Omen,Fade"
Lotus,Dough Bros,SEN SHAHZAM,13,3,3,1,2,10,"Raze,Omen,Fade,Deadlock,Clove","Raze,Killjoy,Omen,Skye,Iso"
Bind,SaD Purple,grove street gang,13,8,12,0,8,1,"Raze,Brimstone,Reyna,Yoru,Gekko","Raze,Cypher,Brimstone,Gekko,Deadlock"
Ascent,mustahed mocking gaming,Canadia Compooters,13,8,5,4,4,8,"Killjoy,Omen,Yoru,Fade,Deadlock","Cypher,Sova,Omen,Jett,Yoru"
Haven,Evil Genies,Ahjin,13,2,10,2,0,3,"Breach,Cypher,Sova,Omen,Jett","Breach,Sova,Killjoy,Omen,Jett"
Haven,Nightblood Gaming,yves saint laurent,6,13,3,9,4,3,"Breach,Sova,Killjoy,Astra,Neon","Sova,Jett,Astra,Deadlock,Iso"
Bind,Goon that jawn,EarnYourMedal,13,3,4,0,3,9,"Reyna,Skye,Deadlock,Iso,Clove","Cypher,Jett,Skye,Deadlock,Clove"
Ascent,Blue Otter,Awaken,13,7,2,6,1,11,"Sova,Killjoy,Omen,Jett,KAY/O","Cypher,Sova,Omen,Jett,Deadlock"
Ascent,Crashout Academy,Shifty505,13,11,7,5,6,6,"Sova,Killjoy,Omen,Jett,KAY/O","Sova,Killjoy,Omen,Jett,KAY/O"
Haven,Dough Bros,SEN SHAHZAM,13,6,6,1,5,7,"Breach,Cypher,Sova,Omen,Neon","Breach,Sova,Omen,Jett,Deadlock"
Haven,Goon that jawn,EarnYourMedal,13,3,4,0,3,9,"Cypher,Sova,Reyna,Yoru,Clove","Cypher,Sova,Omen,Jett,Deadlock"
Sunset,Ambrosia,Orangutan Gang,13,10,6,6,4,7,"Breach,Raze,Cypher,Omen,Deadlock","Breach,Cypher,Sova,Omen,Neon"
Haven,mustahed mocking gaming,Canadia Compooters,13,4,8,4,0,5,"Sova,Killjoy,Omen,Yoru,Gekko","Breach,Cypher,Sova,Omen,Jett"
Lotus,Lemonade Stand,Prospects,13,11,9,3,8,4,"Raze,Viper,Omen,Astra,Gekko","Raze,Killjoy,Viper,Omen,Fade"
Haven,SaD Purple,grove street gang,13,4,10,2,2,3,"Breach,Cypher,Sova,Omen,Jett","Cypher,Sova,Omen,Yoru,Neon"
Lotus,Evil Genies,Ahjin,13,5,3,3,2,10,"Breach,Raze,Cypher,Omen,Fade","Breach,Cypher,Omen,Neon,Gekko"
Icebox,Nearest Airport,Paranoia Vortex,10,13,5,7,6,5,"Killjoy,Viper,Jett,KAY/O,Gekko","Sova,Killjoy,Viper,Reyna,Iso"
Haven,ROSE,Troll's Kittens,13,7,7,5,2,6,"Breach,Cypher,Sova,Omen,Jett","Breach,Cypher,Sova,Omen,Jett"
Ascent,Dexterity Gaming,Mad Science,13,7,8,4,3,5,"Cypher,Sova,Omen,Jett,KAY/O","Cypher,Sova,Omen,Yoru,Deadlock"
Bind,Nightblood Gaming,yves saint laurent,13,6,6,1,5,7,"Raze,Viper,Skye,Astra,Gekko","Raze,Phoenix,Brimstone,Skye,Deadlock"
Lotus,1337 (NA),ShaBoingBoing Esports,13,7,9,3,4,4,"Raze,Cypher,Omen,Fade,Deadlock","Breach,Cypher,Omen,Neon,Gekko"
Bind,Hero Base,Galorys,10,13,5,6,7,5,"Raze,Viper,Brimstone,Skye,Gekko","Raze,Viper,Brimstone,Fade,Gekko"
Lotus,Oxygen Esports,SaD Esports,13,6,6,1,5,7,"Breach,Raze,Cypher,Gekko,Clove","Breach,Raze,Cypher,Sova,Omen"
Ascent,Hero Base,Galorys,13,10,5,6,4,8,"Sova,Killjoy,Omen,Jett,KAY/O","Sova,Killjoy,Omen,Jett,KAY/O"
Sunset,Oxygen Esports,SaD Esports,13,8,6,3,5,7,"Breach,Raze,Cypher,Omen,KAY/O","Breach,Raze,Cypher,Sova,Omen"
Split,Hero Base,Galorys,9,13,3,7,6,6,"Breach,Raze,Cypher,Omen,Skye","Raze,Viper,Omen,Jett,Skye"
Haven,Oxygen Esports,SaD Esports,9,13,5,7,6,4,"Sova,Phoenix,Sage,Omen,Iso","Sova,Jett,Astra,Deadlock,Iso"
Lotus,FUT Esports,GIANTX,13,6,7,5,1,6,"Breach,Cypher,Viper,Omen,Jett","Killjoy,Omen,Skye,Neon,Fade"
Split,FUT Esports,GIANTX,13,4,2,3,1,11,"Breach,Raze,Cypher,Omen,Gekko","Breach,Raze,Cypher,Omen,Jett"
Split,Team Kobolds,ONE Team Esports,11,13,7,5,8,4,"Raze,Cypher,Omen,Jett,Skye","Raze,Cypher,Viper,Omen,Skye"
Lotus,Team Kobolds,ONE Team Esports,6,13,3,4,9,3,"Breach,Killjoy,Omen,Jett,Skye","Breach,Cypher,Omen,Neon,Fade"
Ascent,Team Kobolds,ONE Team Esports,13,11,4,8,3,9,"Sova,Killjoy,Omen,Jett,KAY/O","Sova,Killjoy,Omen,Jett,KAY/O"
Split,Five Ace e-Sports,Oblivion Force,10,13,7,4,9,3,"Raze,Cypher,Omen,Jett,Skye","Raze,Cypher,Omen,Jett,Skye"
Lotus,Five Ace e-Sports,Oblivion Force,7,13,6,6,7,1,"Killjoy,Viper,Omen,Neon,Fade","Raze,Viper,Omen,Chamber,Fade"
Bind,Shifty505,MTN DEW,13,10,7,4,6,6,"Raze,Viper,Brimstone,Fade,Gekko","Raze,Brimstone,Skye,Harbor,Gekko"
Icebox,Paranoia Vortex,M0 money,13,6,4,3,3,9,"Sova,Killjoy,Viper,Reyna,Jett","Killjoy,Viper,Jett,KAY/O,Gekko"
Sunset,Crashout Academy,Akatsuki Aimers,13,5,6,0,5,7,"Breach,Raze,Cypher,Sova,Omen","Breach,Raze,Cypher,Sova,Omen"
Sunset,Shifty505,MTN DEW,13,10,6,5,5,7,"Breach,Raze,Cypher,Omen,Fade","Breach,Raze,Cypher,Omen,Gekko"
Bind,Paranoia Vortex,M0 money,13,9,7,3,6,6,"Raze,Cypher,Sova,Brimstone,Reyna","Raze,Cypher,Viper,Brimstone,Skye"
Ascent,yves saint laurent,ABG luvrs,13,9,6,6,3,7,"Cypher,Sova,Omen,Jett,Deadlock","Sova,Killjoy,Omen,Jett,KAY/O"
Bind,Orangutan Gang,The blockade,13,6,6,1,5,7,"Raze,Brimstone,KAY/O,Fade,Deadlock","Raze,Viper,Reyna,Skye,Clove"
Icebox,Crashout Academy,Akatsuki Aimers,13,10,7,5,5,6,"Sova,Killjoy,Viper,Jett,Deadlock","Sova,Killjoy,Viper,Jett,Gekko"
Haven,we are retired,Mad Science,9,13,7,5,8,2,"Breach,Sova,Killjoy,Omen,Jett","Cypher,Sova,Omen,Jett,Fade"
Lotus,Event Horizon,Ahjin,11,13,5,7,6,6,"Breach,Raze,Killjoy,Omen,Gekko","Breach,Cypher,Omen,Neon,Gekko"
Abyss,Troll's Kittens,LazerrFreeks Mythic,13,5,8,4,1,5,"Breach,Cypher,Jett,Astra,KAY/O","Breach,Cypher,Sova,Jett,Astra"
Lotus,Prospects,OC Eagles,14,12,8,5,7,6,"Raze,Killjoy,Viper,Omen,Fade","Breach,Killjoy,Neon,Gekko,Clove"
Lotus,Shifty505,MTN DEW,9,13,8,4,9,1,"Breach,Raze,Omen,Jett,Skye","Raze,Cypher,Omen,Skye,Deadlock"
Lotus,gooning goblins,Canadia Compooters,13,15,9,5,10,4,"Raze,Cypher,Viper,Omen,Skye","Breach,Cypher,Neon,Gekko,Clove"
Haven,Dexterity Gaming,M0 money,13,7,6,2,5,7,"Breach,Cypher,Sova,Omen,Neon","Breach,Sova,Killjoy,Omen,Jett"
Sunset,ruh roh,ShaBoingBoing Esports,10,13,9,3,10,1,"Breach,Cypher,Sova,Neon,Clove","Breach,Raze,Cypher,Omen,Fade"
Lotus,yves saint laurent,ABG luvrs,13,11,10,2,9,3,"Raze,Killjoy,Omen,Fade,Deadlock","Breach,Killjoy,Yoru,Gekko,Clove"
Ascent,Orangutan Gang,The blockade,14,12,7,6,6,7,"Sova,Killjoy,Omen,Jett,KAY/O","Sova,Killjoy,Omen,Jett,KAY/O"
Haven,Event Horizon,Ahjin,10,13,4,7,6,6,"Breach,Sova,Killjoy,Omen,Jett","Breach,Sova,Killjoy,Omen,Jett"
Ascent,we are retired,Mad Science,10,13,4,7,6,6,"Sova,Killjoy,Omen,Jett,KAY/O","Cypher,Sova,Omen,Yoru,Deadlock"
Lotus,1337 (NA),Crashout Academy,13,7,7,1,6,6,"Raze,Cypher,Omen,Fade,Deadlock","Raze,Cypher,Omen,Fade,Deadlock"
Ascent,Troll's Kittens,LazerrFreeks Mythic,13,8,8,4,4,5,"Cypher,Sova,Omen,Jett,KAY/O","Cypher,Sova,Omen,Jett,KAY/O"
Lotus,grove street gang,BHOP Esports,13,3,9,3,0,4,"Yoru,Chamber,Gekko,Deadlock,Clove","Breach,Cypher,Omen,Neon,Gekko"
Bind,Prospects,OC Eagles,13,8,8,1,7,5,"Raze,Viper,Omen,Skye,Deadlock","Raze,Cypher,Brimstone,Skye,Gekko"
Ascent,gooning goblins,Canadia Compooters,10,13,5,6,7,5,"Sova,Killjoy,Omen,Jett,KAY/O","Cypher,Sova,Omen,Jett,Yoru"
Icebox,Big Back Baddies,EarnYourMedal,7,13,5,3,10,2,"Sova,Reyna,Jett,Chamber,Clove","Sova,Killjoy,Viper,Sage,Jett"
Icebox,Dexterity Gaming,M0 money,8,13,4,5,8,4,"Sova,Killjoy,Viper,Harbor,Gekko","Sova,Killjoy,Viper,Jett,Harbor"
Lotus,ruh roh,ShaBoingBoing Esports,9,13,5,7,6,4,"Breach,Cypher,Neon,Fade,Clove","Breach,Cypher,Omen,Neon,Gekko"
Sunset,Shifty505,Ambrosia,7,13,5,7,6,2,"Breach,Cypher,Omen,Neon,Fade","Breach,Raze,Cypher,Omen,Deadlock"
Bind,Event Horizon,Ahjin,13,6,3,4,2,10,"Raze,Viper,Brimstone,Fade,Gekko","Raze,Viper,Brimstone,Skye,Gekko"
Icebox,yves saint laurent,Nearest Airport,8,13,5,4,9,3,"Sova,Killjoy,Viper,Reyna,Jett","Killjoy,Viper,Jett,KAY/O,Gekko"
Ascent,grove street gang,BHOP Esports,13,6,9,3,3,4,"Sova,Killjoy,Reyna,Jett,Clove","Breach,Cypher,Sova,Omen,Neon"
Haven,Goated,Paranoia Vortex,7,13,3,5,8,4,"Killjoy,Phoenix,Omen,Jett,Fade","Sova,Killjoy,Reyna,Omen,Jett"
Lotus,Nightblood Gaming,Orangutan Gang,13,5,5,1,4,8,"Breach,Cypher,Sova,Astra,Neon","Breach,Raze,Cypher,Omen,Fade"
Ascent,SEN SHAHZAM,Team Digital,13,5,8,4,1,5,"Sova,Killjoy,Omen,Jett,KAY/O","Sova,Killjoy,Omen,Jett,KAY/O"
Haven,Goth Girl Sanctuary,Troll's Kittens,7,13,3,9,4,4,"Breach,Cypher,Sova,Omen,Jett","Breach,Cypher,Sova,Omen,Jett"
Lotus,Dough Bros,LazerrFreeks Mythic,13,6,6,1,5,7,"Raze,Omen,Fade,Deadlock,Clove","Raze,Killjoy,Viper,Omen,Fade"
Icebox,1337 (NA),Crashout Academy,11,13,8,4,9,3,"Sova,Killjoy,Viper,Reyna,Gekko","Sova,Killjoy,Viper,Jett,Deadlock"
Lotus,Big Back Baddies,EarnYourMedal,4,13,2,3,10,2,"Raze,Killjoy,Omen,Skye,Gekko","Killjoy,Viper,Reyna,Omen,Fade"
Haven,Evil Genies,we are retired,13,4,9,3,1,4,"Breach,Cypher,Sova,Omen,Neon","Breach,Cypher,Sova,Omen,Jett"
Sunset,Awaken,Nemesis GC,13,0,1,0,0,12,"Raze,Cypher,KAY/O,Fade,Clove","Breach,Raze,Cypher,Omen,Gekko"
Bind,Blue Otter,gooning goblins,13,9,8,4,5,5,"Raze,Viper,Brimstone,Skye,Yoru","Raze,Viper,Omen,Skye,Deadlock"
Abyss,Lemonade Stand,ruh roh,13,7,6,6,1,7,"Sova,Omen,Harbor,Gekko,Deadlock","Cypher,Sova,Viper,Reyna,Clove"
Haven,OTG,ABG luvrs,8,13,1,11,2,7,"Breach,Killjoy,Omen,Jett,KAY/O","Cypher,Sova,Phoenix,Omen,Jett"
Haven,Prospects,ROSE,8,13,3,6,7,5,"Breach,Sova,Killjoy,Omen,Neon","Breach,Cypher,Sova,Omen,Jett"
Haven,yves saint laurent,Nearest Airport,7,13,4,4,9,3,"Sova,Killjoy,Omen,Jett,Iso","Breach,Cypher,Sova,Omen,Jett"
Ascent,Shifty505,Ambrosia,13,9,5,7,2,8,"Sova,Killjoy,Omen,Jett,KAY/O","Sova,Killjoy,Omen,Jett,KAY/O"
Lotus,Dexterity Gaming,M0 money,13,10,7,5,5,6,"Breach,Cypher,Omen,Skye,Neon","Raze,Killjoy,Viper,Omen,Fade"
Ascent,MTN DEW,Teddy Tactics,13,9,6,6,3,7,"Sova,Killjoy,Omen,Yoru,KAY/O","Breach,Cypher,Sova,Omen,Jett"
Bind,Goated,Paranoia Vortex,5,13,4,8,5,1,"Raze,Cypher,Brimstone,Skye,Gekko","Raze,Cypher,Sova,Brimstone,Reyna"
Ascent,Harmony,The blockade,3,13,2,10,3,1,"Cypher,Sova,Omen,Jett,KAY/O","Sova,Killjoy,Omen,Jett,KAY/O"
Lotus,SEN SHAHZAM,Team Digital,13,8,6,6,2,7,"Breach,Raze,Killjoy,Fade,Clove","Raze,Viper,Omen,Fade,Deadlock"
Icebox,the pack,Akatsuki Aimers,4,13,2,3,10,2,"Sova,Killjoy,Viper,Jett,Gekko","Sova,Killjoy,Viper,Jett,Gekko"
Bind,breadwinners,ShaBoingBoing Esports,6,13,4,8,5,2,"Raze,Viper,Brimstone,Skye,Gekko","Raze,Viper,Brimstone,Fade,Gekko"
Lotus,Evil Genies,we are retired,13,6,9,3,3,4,"Breach,Raze,Cypher,Omen,Fade","Breach,Sova,Chamber,Neon,Clove"
Bind,Dough Bros,LazerrFreeks Mythic,13,4,3,2,2,10,"Raze,Viper,Brimstone,Skye,Deadlock","Raze,Cypher,Brimstone,Gekko,Deadlock"
Haven,Ahjin,RITUAL BLACK,13,11,9,3,8,4,"Breach,Sova,Killjoy,Omen,Jett","Sova,Killjoy,Viper,Jett,Harbor"
Abyss,Awaken,Nemesis GC,13,3,3,1,2,10,"Cypher,Sova,Omen,Jett,Deadlock","Sage,Reyna,Jett,Astra,Fade"
Ascent,OC Eagles,White Leopard Gaming,13,5,4,2,3,9,"Sova,Killjoy,Omen,Jett,KAY/O","Cypher,Sova,Omen,Jett,Deadlock"
Ascent,SaD FROST,Envee Sapphire GC,13,6,5,2,4,8,"Sova,Killjoy,Omen,Jett,KAY/O","Sova,Killjoy,Omen,Jett,KAY/O"
Bind,Nightblood Gaming,Orangutan Gang,13,11,8,4,7,5,"Raze,Viper,Skye,Astra,Gekko","Raze,Brimstone,KAY/O,Fade,Deadlock"
Sunset,Friends Over Everything,Event Horizon,13,6,9,3,3,4,"Cypher,Sova,Omen,KAY/O,Neon","Raze,Cypher,Sova,Omen,KAY/O"
Lotus,Goth Girl Sanctuary,Troll's Kittens,9,13,7,3,10,2,"Raze,Killjoy,Viper,Omen,Fade","Breach,Raze,Omen,Chamber,Gekko"
Bind,OTG,ABG luvrs,9,13,4,8,5,5,"Raze,Reyna,Skye,Gekko,Clove","Raze,Viper,Brimstone,Reyna,Skye"
Bind,Vibin Out Vex,EarnYourMedal,6,13,2,5,8,4,"Raze,Cypher,Brimstone,Yoru,Gekko","Cypher,Jett,Skye,Deadlock,Clove"
Lotus,Blue Otter,gooning goblins,13,6,6,6,0,7,"Breach,Cypher,Omen,Yoru,Gekko","Raze,Killjoy,Viper,Omen,Skye"
Ascent,Lemonade Stand,ruh roh,13,6,8,4,2,5,"Sova,Killjoy,Brimstone,Sage,KAY/O","Cypher,Sova,Omen,Jett,KAY/O"
Lotus,Team Atlantis,BHOP Esports,10,13,3,8,5,7,"Breach,Raze,Cypher,Omen,Jett","Breach,Cypher,Omen,Neon,Gekko"
Lotus,yves saint laurent,Nearest Airport,13,7,6,6,1,7,"Raze,Killjoy,Omen,Fade,Deadlock","Breach,Raze,Cypher,Omen,Fade"
Lotus,Harmony,The blockade,5,13,1,5,8,4,"Breach,Cypher,Omen,Neon,Fade","Raze,Killjoy,Viper,Omen,Fade"
Ascent,Goon that jawn,grove street gang,13,5,8,4,1,5,"Sova,Killjoy,Reyna,Omen,Yoru","Sova,Killjoy,Omen,Jett,KAY/O"
Lotus,MTN DEW,Teddy Tactics,13,7,7,1,6,6,"Breach,Raze,Cypher,Omen,Gekko","Breach,Cypher,Omen,Neon,Fade"
Lotus,Shifty505,Ambrosia,9,13,3,9,4,6,"Breach,Raze,Omen,Jett,Skye","Raze,Killjoy,Viper,Omen,Fade"
Haven,breadwinners,ShaBoingBoing Esports,3,13,3,9,4,0,"Breach,Cypher,Sova,Omen,Jett","Breach,Sova,Killjoy,Omen,Jett"
Sunset,Prospects,ROSE,11,13,5,7,6,6,"Breach,Cypher,Omen,Neon,Gekko","Cypher,Omen,Skye,Yoru,Neon"
Bind,the pack,Akatsuki Aimers,5,13,2,10,3,3,"Raze,Viper,Brimstone,Skye,Gekko","Raze,Cypher,Brimstone,Fade,Gekko"
Lotus,SaD Purple,SEN SHAHZAM,13,5,7,5,0,6,"Raze,Cypher,Viper,Omen,Fade","Breach,Killjoy,Neon,Fade,Clove"
Haven,1337 (NA),Crashout Academy,17,15,9,7,8,8,"Breach,Sova,Killjoy,Omen,Jett","Breach,Cypher,Sova,Omen,Jett"
Ascent,Paranoia Vortex,M0 money,12,14,8,5,9,4,"Sova,Killjoy,Omen,Jett,KAY/O","Sova,Killjoy,Omen,Jett,KAY/O"
Haven,Burger Boyz 2.0,Big Back Baddies,13,8,7,5,3,6,"Breach,Sova,Killjoy,Omen,Neon","Breach,Sova,Killjoy,Omen,Jett"
Bind,OC Eagles,White Leopard Gaming,13,6,5,2,4,8,"Raze,Cypher,Brimstone,Skye,Gekko","Raze,Brimstone,Omen,Skye,Gekko"
Haven,mustahed mocking gaming,Awaken,13,6,8,4,2,5,"Killjoy,Viper,Omen,Yoru,Gekko","Breach,Sova,Killjoy,Omen,Neon"
Haven,Team Atlantis,BHOP Esports,13,4,9,3,1,4,"Killjoy,Phoenix,Omen,Jett,Skye","Breach,Cypher,Sova,Omen,Neon"
Bind,Ahjin,RITUAL BLACK,13,11,6,6,5,7,"Raze,Viper,Brimstone,Skye,Gekko","Breach,Reyna,Omen,Skye,Neon"
Lotus,Friends Over Everything,Event Horizon,13,9,9,3,6,4,"Breach,Raze,Killjoy,Omen,Fade","Breach,Raze,Cypher,Omen,Fade"
Icebox,Vibin Out Vex,EarnYourMedal,8,13,4,8,5,4,"Sova,Viper,Jett,Chamber,Iso","Sova,Killjoy,Viper,Sage,Jett"
Haven,Petite Kittens,Team Digital,7,13,1,7,6,6,"Cypher,Reyna,Jett,Skye,Clove","Breach,Killjoy,Omen,Jett,Skye"
Haven,Lemonade Stand,ruh roh,11,13,2,10,3,9,"Breach,Sova,Killjoy,Omen,Jett","Breach,Cypher,Sova,Neon,Clove"
Sunset,Orangutan Gang,The blockade,13,4,4,1,3,9,"Breach,Cypher,Sova,Omen,Neon","Breach,Cypher,Omen,Neon,Gekko"
Haven,Blue Otter,Canadia Compooters,13,6,9,3,3,4,"Breach,Cypher,Sova,Omen,Jett","Breach,Cypher,Sova,Omen,Jett"
Abyss,breadwinners,ShaBoingBoing Esports,13,5,8,4,1,5,"Cypher,Astra,Neon,Harbor,Gekko","Cypher,Sova,Yoru,Astra,KAY/O"
Icebox,Nearest Airport,ABG luvrs,13,10,7,5,5,6,"Killjoy,Viper,Reyna,Jett,Gekko","Sova,Killjoy,Viper,Reyna,Gekko"
Sunset,Mad Science,we are retired,15,17,4,12,5,11,"Breach,Raze,Cypher,Sova,Omen","Breach,Cypher,Omen,Neon,Gekko"
Lotus,Burger Boyz 2.0,Big Back Baddies,13,4,9,3,1,4,"Raze,Cypher,Viper,Omen,Fade","Raze,Killjoy,Omen,Skye,Gekko"
Sunset,LazerrFreeks Mythic,Troll's Kittens,15,13,5,9,4,10,"Breach,Raze,Cypher,Omen,Fade","Breach,Raze,Cypher,Omen,Gekko"
Haven,Goon that jawn,grove street gang,15,13,8,6,7,7,"Breach,Cypher,Sova,Omen,Yoru","Breach,Cypher,Sova,Omen,Neon"
Ascent,Team Atlantis,BHOP Esports,5,13,0,6,7,5,"Sova,Killjoy,Omen,Jett,KAY/O","Breach,Cypher,Sova,Omen,Neon"
Haven,Shifty505,MTN DEW,13,6,4,3,3,9,"Breach,Cypher,Sova,Omen,Jett","Breach,Cypher,Sova,Omen,Jett"
Haven,SaD Purple,SEN SHAHZAM,13,10,6,6,4,7,"Breach,Cypher,Sova,Omen,Jett","Breach,Sova,Killjoy,Jett,Clove"
Icebox,mustahed mocking gaming,Awaken,13,9,9,1,8,4,"Raze,Sova,Killjoy,Viper,Jett","Sova,Killjoy,Viper,Gekko,Iso"
Lotus,1337 (NA),Akatsuki Aimers,13,9,4,6,3,9,"Raze,Cypher,Omen,Fade,Deadlock","Breach,Killjoy,Omen,Neon,Gekko"
Sunset,Petite Kittens,Team Digital,4,13,1,4,9,3,"Raze,Cypher,Jett,Skye,Clove","Breach,Raze,Cypher,Fade,Clove"
Lotus,Prospects,White Leopard Gaming,13,5,4,2,3,9,"Raze,Killjoy,Viper,Omen,Fade","Raze,Cypher,Omen,Fade,Deadlock"
Ascent,Evil Geniuses,100 Thieves,7,13,4,4,9,3,"Cypher,Sova,Omen,Jett,KAY/O","Sova,Killjoy,Omen,Jett,KAY/O"
Haven,ROSE,OC Eagles,13,11,8,4,7,5,"Breach,Cypher,Sova,Omen,Jett","Breach,Sova,Killjoy,Omen,Jett"
Bind,Orangutan Gang,The blockade,13,6,9,3,3,4,"Raze,Brimstone,KAY/O,Fade,Deadlock","Breach,Raze,Viper,Skye,Clove"
Sunset,Blue Otter,Canadia Compooters,13,7,9,3,4,4,"Breach,Cypher,Sova,Omen,Neon","Breach,Raze,Cypher,Omen,Gekko"
Haven,ruh roh,ShaBoingBoing Esports,13,5,9,3,2,4,"Breach,Cypher,Sova,Neon,Clove","Breach,Sova,Killjoy,Omen,Neon"
Haven,Paranoia Vortex,M0 money,17,15,7,9,6,10,"Sova,Killjoy,Reyna,Omen,Jett","Breach,Sova,Killjoy,Omen,Jett"
Bind,LazerrFreeks Mythic,Troll's Kittens,13,8,4,8,0,9,"Raze,Cypher,Brimstone,Gekko,Deadlock","Raze,Viper,Brimstone,Fade,Gekko"
Lotus,Mad Science,we are retired,13,10,8,4,6,5,"Raze,Cypher,Viper,Omen,Fade","Breach,Raze,Chamber,Gekko,Clove"
Lotus,Event Horizon,RITUAL BLACK,13,10,5,7,3,8,"Breach,Raze,Cypher,Omen,Fade","Breach,Raze,Omen,Skye,Chamber"
Bind,yves saint laurent,OTG,15,13,6,8,5,9,"Raze,Phoenix,Brimstone,Yoru,Deadlock","Raze,Skye,Chamber,Deadlock,Clove"
Haven,Burger Boyz 2.0,Vibin Out Vex,13,4,2,3,1,11,"Breach,Sova,Killjoy,Omen,Neon","Breach,Cypher,Sova,Jett,Clove"
Haven,EarnYourMedal,Big Back Baddies,9,13,4,8,5,5,"Breach,Killjoy,Omen,Jett,Iso","Breach,Sova,Killjoy,Omen,Jett"
Sunset,LOUD GC,TBS GC,13,1,11,1,0,2,"Raze,Cypher,Omen,KAY/O,Gekko","Breach,Cypher,Omen,Neon,Gekko"
Abyss,Nightblood Gaming,Harmony,13,7,8,4,3,5,"Cypher,Sova,Reyna,Omen,Harbor","Cypher,Omen,Gekko,Deadlock,Clove"
Ascent,Shifty505,MTN DEW,13,2,10,2,0,3,"Sova,Killjoy,Omen,Jett,KAY/O","Breach,Sova,Killjoy,Omen,Jett"
Lotus,Dexterity Gaming,Goated,13,4,3,2,2,10,"Breach,Cypher,Omen,Skye,Neon","Breach,Cypher,Omen,Neon,Fade"
Haven,BHOP Esports,grove street gang,2,13,2,10,3,0,"Breach,Cypher,Sova,Omen,Jett","Breach,Cypher,Sova,Omen,Neon"
Sunset,Friends Over Everything,Ahjin,13,2,10,2,0,3,"Cypher,Sova,Omen,KAY/O,Neon","Breach,Raze,Cypher,Sova,Omen"
Haven,Nearest Airport,ABG luvrs,17,15,6,10,5,11,"Breach,Cypher,Sova,Omen,Jett","Cypher,Sova,Phoenix,Omen,Jett"
Haven,Dough Bros,Goth Girl Sanctuary,13,5,9,3,2,4,"Breach,Cypher,Sova,Omen,Neon","Breach,Sova,Killjoy,Omen,Jett"
Icebox,Ambrosia,Teddy Tactics,13,8,4,5,3,9,"Sova,Killjoy,Viper,Jett,KAY/O","Sova,Killjoy,Viper,Sage,Jett"
Icebox,Lemonade Stand,breadwinners,13,2,3,0,2,10,"Omen,KAY/O,Harbor,Gekko,Clove","Sova,Killjoy,Viper,Reyna,Jett"
Sunset,SEN SHAHZAM,Team Digital,13,2,10,2,0,3,"Breach,Cypher,Sova,Neon,Clove","Breach,Raze,Cypher,Fade,Clove"
Sunset,Crashout Academy,the pack,13,3,2,2,1,11,"Breach,Raze,Cypher,Sova,Omen","Breach,Raze,Cypher,Omen,Gekko"
Ascent,Awaken,Nemesis GC,13,4,3,2,2,10,"Cypher,Sova,Omen,Jett,Deadlock","Sova,Killjoy,Omen,Jett,KAY/O"
Haven,gooning goblins,Relapse,13,7,5,3,4,8,"Breach,Cypher,Sova,Omen,Neon","Breach,Sova,Killjoy,Astra,Neon"
Sunset,Goon that jawn,Team Atlantis,13,8,6,6,2,7,"Raze,Cypher,Omen,Gekko,Iso","Breach,Raze,Cypher,Omen,Gekko"
Bind,SaD Purple,Petite Kittens,13,3,9,3,0,4,"Raze,Cypher,Brimstone,Skye,Deadlock","Raze,Cypher,Reyna,Skye,Clove"
Icebox,1337 (NA),Akatsuki Aimers,13,11,7,5,6,6,"Sova,Killjoy,Viper,Reyna,Gekko","Sova,Killjoy,Viper,Jett,Gekko"
Bind,Prospects,White Leopard Gaming,13,9,8,2,7,5,"Raze,Viper,Brimstone,Skye,Deadlock","Raze,Brimstone,Omen,Skye,Gekko"
Bind,Friends Over Everything,Ahjin,13,1,11,1,0,2,"Raze,Viper,Brimstone,Skye,Gekko","Raze,Viper,Brimstone,Skye,Gekko"
Ascent,BHOP Esports,grove street gang,4,13,3,9,4,1,"Sova,Killjoy,Omen,Jett,KAY/O","Sova,Killjoy,Omen,Jett,KAY/O"
Sunset,Paranoia Vortex,M0 money,11,13,5,7,6,6,"Breach,Cypher,Sova,Omen,Neon","Breach,Raze,Cypher,Omen,Gekko"
Lotus,Orangutan Gang,The blockade,11,13,6,6,7,5,"Breach,Raze,Cypher,Omen,Fade","Raze,Killjoy,Viper,Omen,Fade"
Haven,Mad Science,we are retired,7,13,3,9,4,4,"Killjoy,Omen,KAY/O,Neon,Fade","Breach,Cypher,Sova,Omen,Jett"
Sunset,yves saint laurent,OTG,13,8,7,5,3,6,"Raze,Cypher,Fade,Deadlock,Clove","Breach,Raze,Cypher,Omen,Gekko"
Bind,Evil Geniuses,100 Thieves,13,10,8,4,6,5,"Raze,Brimstone,Omen,Skye,Gekko","Raze,Viper,Brimstone,Fade,Gekko"
Abyss,ruh roh,ShaBoingBoing Esports,13,8,6,6,2,7,"Cypher,Sova,Viper,Reyna,Clove","Cypher,Sova,Omen,Yoru,KAY/O"
Ascent,Blue Otter,Canadia Compooters,11,13,3,9,4,8,"Sova,Killjoy,Omen,Jett,KAY/O","Cypher,Sova,Omen,Jett,Yoru"
Haven,LazerrFreeks Mythic,Troll's Kittens,11,13,5,7,6,6,"Breach,Sova,Killjoy,Omen,Jett","Breach,Cypher,Sova,Omen,Jett"
Lotus,Shifty505,MTN DEW,1,13,1,11,2,0,"Breach,Cypher,Omen,Neon,Fade","Breach,Raze,Cypher,Omen,Gekko"
Haven,Ambrosia,Teddy Tactics,13,1,2,0,1,11,"Breach,Sova,Killjoy,Omen,Jett","Breach,Cypher,Sova,Omen,Jett"
Icebox,Dexterity Gaming,Goated,13,3,3,1,2,10,"Sova,Killjoy,Viper,Harbor,Gekko","Sova,Killjoy,Viper,Jett,Gekko"
Lotus,Nightblood Gaming,Harmony,13,6,6,1,5,7,"Breach,Cypher,Sova,Astra,Neon","Breach,Killjoy,Omen,Neon,Fade"
Lotus,EarnYourMedal,Big Back Baddies,10,13,6,6,7,4,"Killjoy,Viper,KAY/O,Iso,Clove","Raze,Killjoy,Omen,Skye,Gekko"
Haven,SaD Purple,Petite Kittens,13,0,12,0,0,1,"Breach,Cypher,Sova,Omen,Jett","Sova,Killjoy,Jett,Astra,Neon"
Ascent,Goon that jawn,Team Atlantis,13,1,11,1,0,2,"Sova,Killjoy,Omen,Jett,Yoru","Sova,Killjoy,Omen,Jett,KAY/O"
Lotus,Dough Bros,Goth Girl Sanctuary,13,3,4,0,3,9,"Raze,Omen,Fade,Deadlock,Clove","Raze,Killjoy,Viper,Omen,Fade"
Lotus,Nearest Airport,ABG luvrs,7,13,2,6,7,5,"Breach,Raze,Cypher,Omen,Fade","Breach,Killjoy,Yoru,Gekko,Clove"
Ascent,Crashout Academy,the pack,13,1,2,0,1,11,"Sova,Killjoy,Omen,Jett,KAY/O","Sova,Killjoy,Omen,Jett,KAY/O"
Haven,Event Horizon,RITUAL BLACK,13,8,9,3,5,4,"Breach,Sova,Killjoy,Omen,Jett","Sova,Killjoy,Viper,Jett,Harbor"
Haven,Awaken,Nemesis GC,13,2,3,0,2,10,"Breach,Sova,Killjoy,Omen,Neon","Breach,Sova,Killjoy,Omen,Jett"
Haven,SEN SHAHZAM,Team Digital,13,2,2,1,1,11,"Breach,Sova,Killjoy,Jett,Clove","Breach,Cypher,Omen,Jett,Skye"
Lotus,gooning goblins,Relapse,13,3,11,1,2,2,"Raze,Killjoy,Viper,Omen,Skye","Breach,Killjoy,Omen,Neon,Gekko"
Ascent,Lemonade Stand,breadwinners,13,6,6,1,5,7,"Sova,Killjoy,Brimstone,Sage,KAY/O","Sova,Reyna,Jett,Deadlock,Clove"
Lotus,LOUD GC,TBS GC,13,7,7,1,6,6,"Raze,Killjoy,Viper,Omen,Fade","Breach,Cypher,Omen,Neon,Fade"
Icebox,LOUD GC,TBS GC,13,4,9,3,1,4,"Killjoy,Viper,Jett,KAY/O,Gekko","Sova,Killjoy,Viper,Jett,KAY/O"
Lotus,Evil Geniuses,100 Thieves,10,13,6,5,8,4,"Breach,Cypher,Omen,Neon,Fade","Raze,Killjoy,Viper,Omen,Fade"
Sunset,FOKUS Sakura,BLVKHVND,13,8,7,2,6,6,"Breach,Raze,Cypher,Omen,Yoru","Breach,Cypher,Sova,Omen,Neon"
Ascent,Reveal Multigaming,Exceptional Gaming,13,9,6,6,3,7,"Cypher,Sova,Killjoy,Omen,Jett","Sova,Killjoy,Omen,Jett,KAY/O"
Ascent,Ketçaplı Ruffles,Gamax Lite,13,9,5,5,4,8,"Sova,Killjoy,Omen,Jett,KAY/O","Sova,Killjoy,Omen,Jett,KAY/O"
Bind,FOKUS Sakura,BLVKHVND,2,13,1,2,11,1,"Raze,Viper,Omen,Skye,Chamber","Raze,Viper,Brimstone,Skye,Gekko"
Sunset,Diamant Esports,GoNext Esports,4,13,4,8,5,0,"Raze,Killjoy,Omen,Astra,Fade","Breach,Raze,Sage,Omen,Gekko"
Haven,Reveal Multigaming,Exceptional Gaming,13,10,3,9,1,10,"Breach,Sova,Killjoy,Omen,Neon","Breach,Cypher,Sova,Omen,Neon"
Split,Ketçaplı Ruffles,Gamax Lite,13,9,8,4,5,5,"Breach,Raze,Sage,Omen,Chamber","Breach,Cypher,Sage,Omen,Jett"
Lotus,FOKUS Sakura,BLVKHVND,13,9,8,4,5,5,"Breach,Raze,Killjoy,Omen,Gekko","Breach,Cypher,Sova,Omen,Neon"
Ascent,Diamant Esports,GoNext Esports,7,13,3,5,8,4,"Cypher,Sova,Omen,Jett,KAY/O","Sova,Killjoy,Omen,Jett,KAY/O"
Icebox,Eternal Fire,Papara SuperMassive,5,13,2,4,9,3,"Sova,Killjoy,Viper,Jett,KAY/O","Sova,Killjoy,Viper,Reyna,Clove"
Ascent,charbon,NEON BLADE,13,7,7,5,2,6,"Sova,Killjoy,Omen,Jett,KAY/O","Sova,Killjoy,Omen,Jett,KAY/O"
Lotus,On Sight,Zerance Mint,5,13,1,5,8,4,"Breach,Killjoy,Omen,Neon,Gekko","Raze,Killjoy,Viper,Omen,Gekko"
Sunset,Zero Tenacity,B8 Esports,6,13,4,8,5,2,"Raze,Cypher,Sova,Omen,KAY/O","Breach,Cypher,Sova,Omen,Neon"
Lotus,charbon,NEON BLADE,0,13,0,1,12,0,"Omen,KAY/O,Neon,Gekko,Deadlock","Raze,Killjoy,Omen,Fade,Deadlock"
Bind,Eternal Fire,Papara SuperMassive,9,13,6,6,7,3,"Sova,Omen,Jett,KAY/O,Deadlock","Raze,Viper,Omen,Fade,Deadlock"
Breeze,Zero Tenacity,B8 Esports,13,4,5,0,4,8,"Sova,Viper,Jett,Yoru,Astra","Cypher,Sova,Viper,Jett,Yoru"
Haven,On Sight,Zerance Mint,12,14,8,5,9,4,"Breach,Sova,Killjoy,Omen,Neon","Breach,Sova,Killjoy,Omen,Jett"
Haven,charbon,NEON BLADE,13,6,4,3,3,9,"Breach,Sova,Astra,Neon,Deadlock","Breach,Sova,Killjoy,Omen,Jett"
Lotus,Galakticos,Fenerbahçe Esports,13,4,5,0,4,8,"Breach,Raze,Sova,Omen,Chamber","Raze,Cypher,Omen,Fade,Deadlock"
Lotus,Zero Tenacity,B8 Esports,17,19,6,12,7,11,"Raze,Killjoy,Viper,Omen,Fade","Cypher,Omen,KAY/O,Neon,Fade"
Icebox,Galakticos,Fenerbahçe Esports,13,5,9,3,2,4,"Sova,Viper,Reyna,Jett,KAY/O","Sova,Killjoy,Viper,Sage,Jett"
Ascent,T1,Bleed Esports,13,8,7,5,3,6,"Sova,Killjoy,Omen,Jett,KAY/O","Sova,Killjoy,Omen,Jett,KAY/O"
Lotus,T1,Bleed Esports,9,13,3,7,6,6,"Raze,Viper,Omen,Chamber,Fade","Breach,Sova,Killjoy,Omen,Neon"
Bind,T1,Bleed Esports,13,11,3,9,2,10,"Raze,Viper,Brimstone,KAY/O,Gekko","Raze,Cypher,Brimstone,Skye,Deadlock"
Ascent,FUSION X,KS Esports GC,6,13,5,7,6,1,"Sova,Jett,Fade,Iso,Clove","Cypher,Sova,Omen,Jett,Deadlock"
Lotus,FUSION X,KS Esports GC,9,13,7,5,8,2,"Breach,Raze,Killjoy,Omen,Skye","Raze,Cypher,Viper,Omen,Fade"
Sunset,Tenax GC,SaD FROST,13,10,7,5,5,6,"Raze,Cypher,Omen,KAY/O,Gekko","Breach,Cypher,Omen,Neon,Fade"
Bind,FUSION X,KS Esports GC,13,7,6,2,5,7,"Raze,Cypher,Brimstone,Skye,Gekko","Raze,Brimstone,Sage,Fade,Gekko"
Sunset,NRG Esports,Cloud9,12,14,7,6,8,5,"Breach,Cypher,Omen,Neon,Fade","Raze,Cypher,Omen,Skye,Clove"
Sunset,University War GC,FiRePOWER GC,11,13,6,6,7,5,"Breach,Raze,Cypher,Omen,Fade","Breach,Cypher,Omen,Neon,Fade"
Icebox,NRG Esports,Cloud9,10,13,7,5,8,3,"Sova,Killjoy,Viper,Jett,KAY/O","Sova,Killjoy,Viper,Reyna,Gekko"
Icebox,University War GC,FiRePOWER GC,7,13,3,5,8,4,"Sova,Killjoy,Viper,Sage,Chamber","Sova,Killjoy,Harbor,Iso,Clove"
Ascent,NRG Esports,Cloud9,13,3,9,3,0,4,"Cypher,Sova,Omen,Jett,KAY/O","Sova,Killjoy,Omen,Jett,KAY/O"
Ascent,asians n shotup,grape booth,13,7,5,7,0,8,"Sova,Killjoy,Reyna,Omen,Jett","Cypher,Sova,Jett,KAY/O,Clove"
Icebox,MIBR,FURIA,7,13,3,9,4,4,"Sova,Killjoy,Viper,Jett,Gekko","Sova,Killjoy,Viper,Sage,Jett"
Ascent,University War GC,FiRePOWER GC,18,16,11,6,10,7,"Sova,Killjoy,Omen,Jett,KAY/O","Sova,Killjoy,Omen,Jett,KAY/O"
Ascent,The GRID,Evil Genies,3,13,0,12,1,3,"Sova,Killjoy,Omen,Jett,Deadlock","Cypher,Sova,Omen,Jett,KAY/O"
Split,Twisted Minds Orchid,Gamax Lite,13,11,5,7,4,8,"Breach,Cypher,Sage,Omen,Jett","Breach,Raze,Cypher,Viper,Omen"
Sunset,asians n shotup,grape booth,8,13,5,4,9,3,"Breach,Raze,Cypher,Omen,Gekko","Breach,Cypher,Sova,Neon,Clove"
Bind,Eintracht Frankfurt,MOUZ,12,14,5,8,6,7,"Raze,Viper,Yoru,Gekko,Clove","Breach,Raze,Brimstone,Omen,Gekko"
Lotus,The GRID,Evil Genies,13,15,5,9,6,8,"Raze,Cypher,Omen,Fade,Deadlock","Breach,Raze,Cypher,Omen,Gekko"
Sunset,MIBR,FURIA,10,13,6,6,7,4,"Breach,Raze,Cypher,Omen,Gekko","Cypher,Sova,Omen,Jett,KAY/O"
Split,Mandatory,Solary,13,6,6,1,5,7,"Raze,Cypher,Viper,Omen,Skye","Raze,Viper,Omen,Jett,Skye"
Sunset,Permitta Unicorns GC,BLVKHVND,5,13,3,3,10,2,"Breach,Raze,Cypher,Sova,Omen","Breach,Cypher,Sova,Omen,Neon"
Lotus,Valiant GC,charbon,18,16,11,6,10,7,"Breach,Killjoy,Omen,Neon,Fade","Omen,KAY/O,Neon,Gekko,Deadlock"
Sunset,Twisted Minds Orchid,Gamax Lite,12,14,4,9,5,8,"Breach,Cypher,Jett,Astra,Gekko","Breach,Raze,Cypher,Omen,Gekko"
Split,Eintracht Frankfurt,MOUZ,13,8,7,5,3,6,"Raze,Cypher,Sage,Omen,Skye","Breach,Raze,Cypher,Omen,Skye"
Lotus,asians n shotup,grape booth,16,14,8,7,7,8,"Raze,Killjoy,Viper,Omen,Fade","Breach,Cypher,Yoru,Gekko,Clove"
Split,Acend,trashcan,14,12,5,8,4,9,"Raze,Cypher,Reyna,Omen,Jett","Cypher,Viper,Omen,Jett,Skye"
Ascent,fentinels,The GRID,5,13,4,8,5,1,"Sova,Killjoy,Omen,Jett,KAY/O","Sova,Killjoy,Omen,Jett,Deadlock"
Haven,FOKUS Sakura,The Ultimates Odyssey,4,13,2,10,3,2,"Breach,Sova,Killjoy,Omen,Jett","Breach,Sova,Killjoy,Omen,Neon"
Bind,Zerance Mint,LUA Gaming,13,10,4,7,3,9,"Raze,Viper,Brimstone,Skye,Gekko","Breach,Viper,Brimstone,Yoru,Fade"
Icebox,Mandatory,Solary,8,13,3,6,7,5,"Sova,Viper,Sage,Jett,KAY/O","Sova,Killjoy,Viper,Sage,Jett"
Lotus,Permitta Unicorns GC,BLVKHVND,7,13,3,5,8,4,"Raze,Cypher,Omen,Fade,Deadlock","Breach,Cypher,Sova,Omen,Neon"
Ascent,ALTERNATE aTTaX Ruby,Ketçaplı Ruffles,13,5,5,1,4,8,"Sova,Killjoy,Omen,Jett,KAY/O","Sova,Killjoy,Omen,Jett,KAY/O"
Haven,Valiant GC,charbon,11,13,3,9,4,8,"Breach,Sova,Killjoy,Omen,Jett","Breach,Sova,Astra,Neon,Deadlock"
Ascent,Twisted Minds Orchid,Gamax Lite,13,11,7,5,6,6,"Sova,Killjoy,Omen,Jett,KAY/O","Sova,Killjoy,Omen,Jett,KAY/O"
Ascent,Sissi State Punks,Exceptional Gaming,13,11,4,8,3,9,"Sova,Killjoy,Omen,Jett,KAY/O","Sova,Killjoy,Omen,Jett,KAY/O"
Bind,Acend,trashcan,13,6,4,3,3,9,"Raze,Killjoy,Astra,Fade,Iso","Raze,Viper,Brimstone,Skye,Gekko"
Lotus,fentinels,The GRID,8,13,3,6,7,5,"Breach,Raze,Cypher,Omen,Fade","Raze,Cypher,Omen,Fade,Deadlock"
Lotus,LA RUE,INF Esports,11,13,6,6,7,5,"Breach,Raze,Cypher,Sova,Omen","Breach,Cypher,Omen,Jett,Neon"
Lotus,NEON BLADE,SK Nebula,13,5,9,3,2,4,"Raze,Killjoy,Omen,Fade,Deadlock","Breach,Raze,Cypher,Viper,Omen"
Haven,Zerance Mint,LUA Gaming,13,6,9,3,3,4,"Breach,Sova,Killjoy,Omen,Jett","Breach,Sova,Killjoy,Omen,Jett"
Lotus,Eintracht Frankfurt,MOUZ,12,14,4,9,5,8,"Breach,Cypher,Sova,Omen,Neon","Breach,Cypher,Sova,Omen,Neon"
Haven,Ambrosia,Evil Genies,11,13,5,7,6,6,"Breach,Sova,Killjoy,Omen,Jett","Breach,Cypher,Sova,Omen,Jett"
Ascent,evolutionSTARS,Tropadobagaço,13,8,6,6,2,7,"Sova,Killjoy,Phoenix,Omen,Jett","Sova,Killjoy,Omen,Jett,KAY/O"
Bind,REVOADA,TBS GC,6,13,6,6,7,0,"Raze,Viper,Brimstone,Skye,Gekko","Sova,Viper,Brimstone,Neon,Gekko"
Lotus,Canadia Compooters,grape booth,6,13,3,4,9,3,"Breach,Cypher,Neon,Gekko,Clove","Breach,Cypher,Yoru,Gekko,Clove"
Sunset,asians n shotup,5 Little Piggies,13,7,7,5,2,6,"Breach,Raze,Cypher,Omen,Gekko","Breach,Raze,Cypher,Sova,Omen"
Icebox,FOKUS Sakura,The Ultimates Odyssey,11,13,9,3,10,2,"Sova,Killjoy,Viper,Reyna,Jett","Killjoy,Viper,Jett,KAY/O,Gekko"
Haven,ALTERNATE aTTaX Ruby,Ketçaplı Ruffles,8,13,6,6,7,2,"Breach,Cypher,Sova,Omen,Jett","Breach,Sova,Omen,Jett,Chamber"
Lotus,Galatasaray Esports,Fenerbahçe Esports,10,13,8,4,9,2,"Raze,Killjoy,Yoru,Astra,Fade","Raze,Cypher,Omen,Fade,Deadlock"
Split,MAD Lions KOI,On Sight,13,9,6,6,3,7,"Raze,Cypher,Viper,Omen,Skye","Raze,Viper,Omen,Skye,Chamber"
Lotus,Sissi State Punks,Exceptional Gaming,13,4,5,0,4,8,"Breach,Raze,Sova,Killjoy,Omen","Breach,Cypher,Sova,Omen,Neon"
Sunset,Mandatory,Solary,16,14,10,5,9,6,"Breach,Raze,Cypher,Omen,Gekko","Raze,Cypher,Sova,Omen,KAY/O"
Haven,TOG Kitsune,Permitta Unicorns GC,14,16,4,11,5,10,"Breach,Cypher,Sova,Jett,Clove","Breach,Cypher,Sova,Omen,Jett"
Icebox,Gamax Lite,Celestials GC,13,2,12,0,2,1,"Killjoy,Sage,Reyna,KAY/O,Clove","Killjoy,Sage,KAY/O,Harbor,Gekko"
Icebox,asians n shotup,5 Little Piggies,13,3,2,2,1,11,"Sova,Killjoy,Viper,Reyna,Jett","Sova,Killjoy,Viper,Reyna,Jett"
Haven,Canadia Compooters,grape booth,3,13,1,3,10,2,"Breach,Cypher,Omen,Neon,Gekko","Breach,Cypher,Sova,Jett,Clove"
Icebox,Acend,trashcan,10,13,4,8,5,6,"Killjoy,Viper,Jett,KAY/O,Gekko","Sova,Killjoy,Viper,Jett,KAY/O"
Haven,fentinels,The GRID,14,12,6,7,5,8,"Breach,Cypher,Sova,Omen,Neon","Sova,Killjoy,Omen,Yoru,Iso"
Icebox,NEON BLADE,SK Nebula,13,5,5,1,4,8,"Sova,Killjoy,Viper,Sage,Jett","Sova,Killjoy,Viper,Sage,Jett"
Lotus,Ambrosia,Evil Genies,10,13,7,4,9,3,"Breach,Raze,Killjoy,Omen,Gekko","Breach,Raze,Cypher,Omen,Gekko"
Bind,Valiant GC,charbon,13,11,8,4,7,5,"Raze,Viper,Brimstone,Fade,Gekko","Breach,Raze,Cypher,Omen,Yoru"
Haven,LA RUE,INF Esports,11,13,7,5,8,4,"Breach,Sova,Killjoy,Omen,Jett","Breach,Sova,Killjoy,Omen,Jett"
Ascent,FOKUS Sakura,The Ultimates Odyssey,13,5,4,2,3,9,"Sova,Killjoy,Phoenix,Omen,Jett","Sova,Killjoy,Omen,Jett,KAY/O"
Sunset,HGE Esports,Outplayed,11,13,4,8,5,7,"Cypher,Sova,Omen,KAY/O,Neon","Breach,Raze,Cypher,Sova,Omen"
Bind,evolutionSTARS,Tropadobagaço,13,10,6,6,4,7,"Raze,Cypher,Brimstone,Jett,Skye","Raze,Cypher,Brimstone,Skye,Gekko"
Icebox,REVOADA,TBS GC,11,13,4,8,5,7,"Sova,Killjoy,Viper,Jett,Gekko","Sova,Killjoy,Viper,Jett,Gekko"
Lotus,LUA Gaming,LXT Esports GC,13,5,4,2,3,9,"Breach,Sova,Killjoy,Omen,Neon","Raze,Killjoy,Viper,Omen,Fade"
Haven,MAD Lions KOI,On Sight,13,3,9,3,0,4,"Breach,Sova,Killjoy,Omen,Neon","Breach,Cypher,Sova,Omen,Neon"
Sunset,ALTERNATE aTTaX Ruby,Ketçaplı Ruffles,13,6,4,3,3,9,"Breach,Raze,Cypher,Sova,Omen","Cypher,Sova,Omen,KAY/O,Neon"
Bind,Sissi State Punks,Exceptional Gaming,9,13,6,4,9,3,"Raze,Cypher,Brimstone,Skye,Gekko","Raze,Cypher,Brimstone,Skye,Gekko"
Haven,Galatasaray Esports,Fenerbahçe Esports,11,13,5,7,6,6,"Breach,Sova,Killjoy,Omen,Neon","Breach,Cypher,Sova,Omen,Jett"
Sunset,TOG Kitsune,Permitta Unicorns GC,13,8,7,5,3,6,"Breach,Raze,Cypher,Omen,Gekko","Breach,Raze,Cypher,Sova,Omen"
Split,DVM Esport,Akroma,13,11,4,8,3,9,"Raze,Viper,Jett,Skye,Astra","Sage,Skye,Astra,Neon,Deadlock"
Haven,MOUZ,FOKUS,13,11,7,5,6,6,"Breach,Sova,Killjoy,Omen,Jett","Killjoy,Omen,Yoru,Astra,Fade"
Lotus,Gamax Lite,Celestials GC,8,13,6,6,7,2,"Breach,Cypher,Jett,Gekko,Clove","Raze,Cypher,KAY/O,Gekko,Clove"
Icebox,LUA Gaming,LXT Esports GC,6,13,2,5,8,4,"Sova,Killjoy,Viper,Jett,Harbor","Killjoy,Viper,Jett,KAY/O,Gekko"
Lotus,evolutionSTARS,Tropadobagaço,6,13,3,9,4,3,"Breach,Raze,Killjoy,Omen,Fade","Raze,Killjoy,Viper,Omen,Fade"
Lotus,Lootcifer,INF Esports,6,13,2,5,8,4,"Breach,Cypher,Omen,KAY/O,Neon","Breach,Cypher,Omen,Jett,Neon"
Ascent,NEON BLADE,RIZON Sugar,13,10,7,5,5,6,"Sova,Killjoy,Omen,Jett,KAY/O","Sova,Killjoy,Omen,Jett,KAY/O"
Haven,HGE Esports,Outplayed,10,13,2,10,3,8,"Breach,Sova,Killjoy,Omen,Jett","Breach,Sova,Killjoy,Omen,Jett"
Lotus,SK Nebula,last second,13,4,3,2,2,10,"Breach,Raze,Cypher,Viper,Omen","Breach,Raze,Killjoy,Omen,Fade"
Ascent,NOM Esports,Incognito,13,11,7,5,6,6,"Sova,Killjoy,Omen,Jett,KAY/O","Sova,Killjoy,Phoenix,Jett,Clove"
Ascent,Reveal Multigaming,BÖSE BUBEN,13,2,10,2,0,3,"Cypher,Sova,Killjoy,Omen,Jett","Sova,Killjoy,Omen,Jett,KAY/O"
Bind,LA RUE,Novita Esports,13,9,4,6,3,9,"Raze,Sova,Brimstone,Sage,Gekko","Raze,Viper,Skye,Gekko,Clove"
Bind,BLVKHVND,ForsaKen GC,13,11,8,4,7,5,"Raze,Viper,Brimstone,Skye,Gekko","Breach,Raze,Cypher,Omen,Gekko"
Sunset,Twisted Minds Orchid,BLAZE GC,13,5,9,3,2,4,"Breach,Raze,Cypher,Omen,Gekko","Cypher,Omen,Yoru,Fade,Harbor"
Bind,DVM Esport,Akroma,13,1,2,0,1,11,"Raze,Viper,Fade,Gekko,Clove","Raze,Viper,Omen,Skye,Gekko"
Sunset,LOUD GC,paprica picante,13,5,4,2,3,9,"Raze,Cypher,Omen,KAY/O,Gekko","Breach,Raze,Cypher,Omen,Gekko"
Bind,Zerance Mint,Formulation Gaming GC,13,7,7,1,6,6,"Raze,Viper,Brimstone,Skye,Gekko","Raze,Cypher,Viper,Brimstone,Skye"
Icebox,PCIFIC Espor,Istanbul Wildcats,13,2,3,0,2,10,"Sova,Killjoy,Viper,Jett,Gekko","Killjoy,Jett,KAY/O,Harbor,Gekko"
Sunset,MOUZ,FOKUS,6,13,4,8,5,2,"Breach,Raze,Cypher,Sova,Omen","Cypher,Sage,Omen,KAY/O,Gekko"
Sunset,Lootcifer,INF Esports,8,13,3,6,7,5,"Cypher,Sova,Omen,Chamber,Clove","Cypher,Sova,Omen,Jett,Neon"
Ascent,Gamax Lite,Celestials GC,13,10,8,3,7,5,"Sova,Killjoy,Omen,Jett,KAY/O","Breach,Jett,KAY/O,Deadlock,Clove"
Icebox,Reveal Multigaming,BÖSE BUBEN,13,10,6,6,4,7,"Sova,Killjoy,Viper,Jett,Clove","Sova,Killjoy,Viper,Jett,Clove"
Lotus,LOUD GC,paprica picante,13,2,12,0,2,1,"Raze,Killjoy,Viper,Omen,Fade","Raze,Killjoy,Viper,Omen,Fade"
Lotus,NEON BLADE,RIZON Sugar,13,7,6,6,1,7,"Raze,Killjoy,Omen,Fade,Deadlock","Breach,Raze,Killjoy,Omen,Fade"
Split,NOM Esports,Incognito,11,13,1,11,2,10,"Raze,Cypher,Sage,Omen,Skye","Breach,Raze,Astra,Neon,Deadlock"
Haven,Zerance Mint,Formulation Gaming GC,13,2,10,2,0,3,"Breach,Sova,Killjoy,Omen,Jett","Breach,Cypher,Sova,Omen,Jett"
Sunset,LUA Gaming,LXT Esports GC,13,2,3,0,2,10,"Breach,Raze,Cypher,Sova,Omen","Raze,Cypher,Omen,KAY/O,Gekko"
Sunset,SK Nebula,last second,13,8,6,3,5,7,"Raze,Cypher,Viper,Omen,Fade","Breach,Raze,Cypher,Omen,Gekko"
Ascent,TOG Kitsune,Permitta Unicorns GC,16,18,10,7,11,6,"Sova,Killjoy,Omen,Jett,KAY/O","Breach,Cypher,Sova,Omen,Jett"
Haven,Twisted Minds Orchid,BLAZE GC,13,5,5,1,4,8,"Breach,Sova,Omen,Chamber,Neon","Breach,Cypher,Sova,Omen,Jett"
Sunset,BLVKHVND,ForsaKen GC,13,5,5,1,4,8,"Breach,Cypher,Sova,Omen,Neon","Breach,Raze,Cypher,Omen,Gekko"
Bind,HGE Esports,Outplayed,10,13,5,7,6,5,"Sova,Viper,Omen,Yoru,Gekko","Raze,Cypher,Viper,Brimstone,Skye"
Icebox,DVM Esport,Akroma,5,13,1,5,8,4,"Raze,Viper,Sage,Reyna,Fade","Sova,Killjoy,Viper,Jett,Gekko"
Sunset,PCIFIC Espor,Istanbul Wildcats,13,9,8,4,5,5,"Breach,Raze,Cypher,Omen,Gekko","Breach,Cypher,Sova,Omen,Neon"
Haven,LA RUE,Novita Esports,14,12,5,8,4,9,"Breach,Sova,Killjoy,Omen,Neon","Killjoy,Viper,Omen,Jett,Skye"
Abyss,Lootcifer,INF Esports,13,11,6,6,5,7,"Cypher,Sova,Astra,Harbor,Gekko","Breach,Jett,Astra,Chamber,Neon"
Bind,Reveal Multigaming,BÖSE BUBEN,6,13,6,6,7,0,"Raze,Viper,Brimstone,Skye,Gekko","Raze,Viper,Brimstone,Skye,Yoru"
Sunset,NOM Esports,Incognito,13,9,5,7,2,8,"Breach,Raze,Cypher,Omen,Fade","Breach,Raze,Cypher,Sova,Omen"
Icebox,EX0TIK GAMING,PPP,2,13,2,10,3,0,"Sova,Killjoy,Viper,Jett,Gekko","Sova,Killjoy,Viper,Reyna,Gekko"
Split,MOUZ,FOKUS,15,13,7,7,6,8,"Reyna,Skye,Astra,Deadlock,Iso","Raze,Omen,Yoru,Astra,Fade"
Haven,OnlyFins,Requiem,5,13,1,5,8,4,"Breach,Cypher,Sova,Neon,Clove","Killjoy,Viper,Omen,Jett,Skye"
Ascent,PCIFIC Espor,Istanbul Wildcats,9,13,5,7,6,4,"Sova,Killjoy,Omen,Jett,KAY/O","Cypher,Sova,Omen,Jett,KAY/O"
Split,EX0TIK GAMING,PPP,5,13,3,9,4,2,"Raze,Viper,Omen,Jett,Skye","Breach,Raze,Cypher,Omen,Iso"
Lotus,OnlyFins,Requiem,5,13,1,5,8,4,"Raze,Killjoy,Fade,Gekko,Clove","Raze,Cypher,Viper,Omen,Fade"
Sunset,Fire Flux Esports,HOWL Esports,13,4,8,4,0,5,"Breach,Raze,Cypher,Omen,Gekko","Breach,Raze,Cypher,Omen,Gekko"
Sunset,Paper Rex,ZETA DIVISION,13,4,5,0,4,8,"Breach,Raze,Sage,Omen,Gekko","Breach,Raze,Cypher,Omen,Gekko"
Lotus,Paper Rex,ZETA DIVISION,13,8,11,1,7,2,"Omen,Jett,KAY/O,Neon,Fade","Raze,Killjoy,Viper,Omen,Fade"
Lotus,Fire Flux Esports,HOWL Esports,15,13,11,3,10,4,"Breach,Raze,Cypher,Omen,Gekko","Raze,Cypher,Viper,Omen,Fade"
Ascent,Paper Rex,ZETA DIVISION,9,13,7,5,8,2,"Omen,Jett,KAY/O,Fade,Clove","Sova,Killjoy,Omen,Jett,KAY/O"
Lotus,Sasanqua,SCARZ GC,7,13,1,7,6,6,"Breach,Raze,Killjoy,Omen,Fade","Raze,Killjoy,Viper,Omen,Fade"
Ascent,DRX Changers,PAL GC,13,5,4,2,3,9,"Sova,Killjoy,Omen,Jett,KAY/O","Sova,Killjoy,Omen,Jett,KAY/O"
Split,Cyber Geek,Soleil Gaming,13,9,6,4,5,7,"Raze,Viper,Omen,Jett,Skye","Breach,Cypher,Omen,Yoru,Iso"
Haven,FENNEL GC,ArcoBaleNO IRIS,13,9,8,4,5,5,"Breach,Sova,Killjoy,Omen,Jett","Cypher,Sova,Omen,Jett,Deadlock"
Ascent,DetonatioN FocusMe GC,GEM DIANA,13,6,9,3,3,4,"Sova,Killjoy,Omen,Jett,KAY/O","Sova,Killjoy,Omen,Jett,KAY/O"
Ascent,Reignite Lily,O2esports GC,13,2,11,1,1,2,"Sova,Killjoy,Omen,Jett,KAY/O","Sova,Killjoy,Omen,Jett,KAY/O"
Icebox,Siko Esports,BLX CORP X BCG,13,11,9,3,8,4,"Sova,Killjoy,Viper,KAY/O,Clove","Killjoy,Viper,Reyna,Gekko,Iso"
Split,Meteor GC,NIX VISION GC,13,4,9,3,1,4,"Breach,Cypher,Omen,Yoru,Clove","Breach,Raze,Cypher,Omen,Skye"
Split,Gen.G Esports,Team Secret,12,14,3,10,4,9,"Raze,Cypher,Viper,Omen,Skye","Raze,Cypher,Viper,Omen,Skye"
Ascent,Sasanqua,SCARZ GC,9,13,6,6,7,3,"Sova,Killjoy,Omen,Jett,KAY/O","Sova,Killjoy,Omen,Jett,KAY/O"
Lotus,DetonatioN FocusMe GC,GEM DIANA,13,4,8,4,0,5,"Raze,Killjoy,Viper,Omen,Fade","Breach,Raze,Killjoy,Omen,Fade"
Ascent,Cyber Geek,Soleil Gaming,13,5,6,0,5,7,"Breach,Brimstone,Sage,Omen,KAY/O","Sova,Killjoy,Omen,Jett,KAY/O"
Haven,DRX Changers,PAL GC,13,9,9,3,6,4,"Breach,Sova,Killjoy,Omen,Jett","Breach,Sova,Killjoy,Omen,Jett"
Icebox,Reignite Lily,O2esports GC,13,5,3,3,2,10,"Sova,Killjoy,Viper,Jett,Harbor","Sova,Killjoy,Viper,Jett,KAY/O"
Sunset,FENNEL GC,ArcoBaleNO IRIS,13,3,11,1,2,2,"Breach,Raze,Cypher,Omen,Fade","Raze,Cypher,Omen,Gekko,Deadlock"
Lotus,Meteor GC,NIX VISION GC,13,4,12,0,4,1,"Raze,Killjoy,Viper,Omen,Fade","Breach,Raze,Killjoy,Omen,Skye"
Lotus,Gen.G Esports,Team Secret,13,7,6,2,5,7,"Raze,Killjoy,Viper,Omen,Fade","Sova,Killjoy,Omen,Skye,Neon"
Lotus,Siko Esports,BLX CORP X BCG,13,2,10,2,0,3,"Raze,Killjoy,Viper,Omen,Fade","Breach,Raze,Killjoy,Omen,Gekko"
Sunset,Gen.G Esports,Team Secret,6,13,4,3,10,2,"Cypher,Sova,Omen,Jett,KAY/O","Breach,Cypher,Sova,Omen,Neon"
Bind,swaglord9000,raindrops,13,3,2,2,1,11,"Raze,Cypher,Viper,Brimstone,Skye","Raze,Viper,Brimstone,Fade,Gekko"
Icebox,swaglord9000,raindrops,13,7,6,6,1,7,"Sova,Killjoy,Viper,Jett,KAY/O","Sova,Killjoy,Viper,Reyna,Gekko"
Ascent,Ambrosia,BIG GRASS EATERS,13,3,4,0,3,9,"Sova,Killjoy,Omen,Jett,KAY/O","Sova,Killjoy,Omen,Iso,Clove"
Lotus,swaglord9000,raindrops,13,3,9,3,0,4,"Raze,Killjoy,Omen,Fade,Deadlock","Breach,Raze,Cypher,Sova,Omen"
Haven,Ambrosia,BIG GRASS EATERS,13,4,4,1,3,9,"Breach,Sova,Killjoy,Omen,Jett","Breach,Sova,Killjoy,Omen,Neon"
Icebox,Ambrosia,BIG GRASS EATERS,7,13,6,6,7,1,"Sova,Killjoy,Viper,Jett,KAY/O","Sova,Killjoy,Viper,Reyna,Jett"
Ascent,swaglord9000,raindrops,11,13,5,7,6,6,"Cypher,Sova,Omen,Yoru,Deadlock","Breach,Cypher,Sova,Omen,Jett"
Icebox,LOUD,Leviatán,6,13,4,8,5,2,"Sova,Killjoy,Omen,KAY/O,Harbor","Sova,Killjoy,Viper,Jett,Harbor"
Ascent,minions united GC,Envee Sapphire GC,13,4,8,4,0,5,"Sova,Killjoy,Omen,Jett,KAY/O","Sova,Killjoy,Omen,Jett,KAY/O"
Lotus,LOUD,Leviatán,11,13,3,9,4,8,"Breach,Raze,Cypher,Omen,Fade","Breach,Cypher,Omen,Neon,Fade"
Abyss,5 Little Piggies,IOUNL,13,9,8,2,7,5,"Cypher,Sova,Reyna,Jett,Astra","Cypher,Sova,Astra,Chamber,Harbor"
Haven,fentinels,nokE kittens,13,11,6,6,5,7,"Breach,Cypher,Sova,Omen,Neon","Cypher,Sova,Omen,Jett,Neon"
Icebox,5 Little Piggies,IOUNL,6,13,0,7,6,6,"Sova,Killjoy,Viper,Jett,Iso","Sova,Killjoy,Viper,Jett,Gekko"
Ascent,Revenge (NA),The GRID,4,13,3,9,4,1,"Sova,Killjoy,Omen,Jett,KAY/O","Sova,Killjoy,Omen,Jett,Deadlock"
Lotus,grape booth,The Hideout,13,3,4,0,3,9,"Breach,Cypher,Yoru,Gekko,Clove","Raze,Killjoy,Viper,Omen,Fade"
Split,G2 Esports,KRÜ Esports,13,5,9,3,2,4,"Breach,Raze,Viper,Omen,Fade","Raze,Cypher,Viper,Omen,Skye"
Icebox,fentinels,nokE kittens,13,1,11,1,0,2,"Sova,Killjoy,Viper,Jett,Gekko","Sova,Killjoy,Viper,Jett,Gekko"
Bind,BIG GRASS EATERS,Los Muchachos,13,11,5,7,4,8,"Sova,Brimstone,Jett,Skye,Deadlock","Raze,Cypher,Viper,Brimstone,Skye"
Haven,5 Little Piggies,IOUNL,13,9,5,5,4,8,"Breach,Sova,Killjoy,Omen,Jett","Sova,Killjoy,Phoenix,Omen,Jett"
Haven,Revenge (NA),The GRID,9,13,4,6,7,5,"Sova,Killjoy,Omen,Jett,Deadlock","Sova,Killjoy,Omen,Yoru,Iso"
Haven,Evil Genies,Dolbaebi,13,11,8,4,7,5,"Breach,Cypher,Sova,Omen,Neon","Breach,Sova,Killjoy,Jett,Clove"
Ascent,grape booth,The Hideout,13,9,6,4,5,7,"Cypher,Sova,Jett,KAY/O,Clove","Sova,Killjoy,Phoenix,Omen,Jett"
Haven,BIG GRASS EATERS,Los Muchachos,13,3,9,3,0,4,"Breach,Sova,Killjoy,Omen,Neon","Breach,Cypher,Omen,Jett,Gekko"
Lotus,Evil Genies,Dolbaebi,13,6,10,2,4,3,"Breach,Raze,Cypher,Omen,Gekko","Breach,Raze,Cypher,Gekko,Clove"
Haven,nokE kittens,Lotus 8 Black,15,13,8,6,7,7,"Cypher,Sova,Omen,Jett,Neon","Breach,Sova,Killjoy,Omen,Jett"
Ascent,G2 Esports,KRÜ Esports,16,14,8,7,7,8,"Sova,Killjoy,Omen,Jett,KAY/O","Sova,Killjoy,Omen,Jett,KAY/O"
Haven,IOUNL,Spare Time,13,11,7,5,6,6,"Sova,Killjoy,Phoenix,Omen,Jett","Breach,Sova,Killjoy,Omen,Jett"
Sunset,The Hideout,bricknodes,13,5,5,1,4,8,"Breach,Raze,Sage,Omen,Gekko","Breach,Raze,Cypher,Omen,Gekko"
Lotus,grape booth,PUGGERS (NA),13,1,2,0,1,11,"Breach,Cypher,Yoru,Gekko,Clove","Breach,Cypher,Neon,Iso,Clove"
Haven,BEAVER BUBS,Cataclysm Gaming,5,13,3,9,4,2,"Breach,Sova,Killjoy,Omen,Jett","Breach,Cypher,Phoenix,Omen,Neon"
Ascent,BIG GRASS EATERS,Los Muchachos,10,13,3,8,5,7,"Sova,Killjoy,Jett,KAY/O,Clove","Sova,Killjoy,Omen,Jett,KAY/O"
Ascent,The GRID,les piments,13,6,4,3,3,9,"Sova,Killjoy,Omen,Jett,Deadlock","Sova,Killjoy,Omen,Jett,KAY/O"
Ascent,The GRID,les piments,13,6,4,3,3,9,"Sova,Killjoy,Omen,Jett,Deadlock","Sova,Killjoy,Omen,Jett,KAY/O"
Sunset,Evil Genies,The Gangy,13,4,5,0,4,8,"Raze,Cypher,Omen,Jett,Gekko","Raze,Cypher,Omen,KAY/O,Gekko"
Ascent,nokE kittens,Lotus 8 Black,13,5,10,2,3,3,"Sova,Killjoy,Reyna,Omen,Jett","Sova,Killjoy,Omen,Jett,KAY/O"
Ascent,grape booth,PUGGERS (NA),13,0,1,0,0,12,"Cypher,Sova,KAY/O,Neon,Clove","Sova,Killjoy,Omen,Jett,KAY/O"
Lotus,The Hideout,bricknodes,13,2,10,2,0,3,"Raze,Killjoy,Reyna,Omen,Fade","Breach,Raze,Cypher,Omen,Gekko"
Ascent,NOVO GC,Permitta Unicorns GC,5,13,3,9,4,2,"Sova,Killjoy,Omen,Jett,KAY/O","Breach,Cypher,Sova,Omen,Jett"
Ascent,Revenge (NA),ASTS Gaming,13,6,9,3,3,4,"Sova,Killjoy,Omen,Jett,KAY/O","Sova,Killjoy,Omen,Jett,KAY/O"
Haven,5 Little Piggies,AntoL Kittens,13,5,5,1,4,8,"Breach,Sova,Killjoy,Omen,Jett","Breach,Sova,Killjoy,Omen,Jett"
Lotus,BEAVER BUBS,Cataclysm Gaming,3,13,3,9,4,0,"Raze,Cypher,Omen,Fade,Deadlock","Breach,Raze,Killjoy,Omen,Gekko"
Sunset,SaD FROST,minions united GC,13,9,6,6,3,7,"Breach,Cypher,Omen,Neon,Fade","Breach,Raze,Cypher,Sova,Omen"
Haven,Evil Genies,The Gangy,13,0,1,0,0,12,"Breach,Cypher,Sova,Omen,Neon","Cypher,Sova,Omen,Jett,Skye"
Haven,Dolbaebi,The Warriors,13,3,9,3,0,4,"Sova,Killjoy,Phoenix,Jett,Clove","Breach,Sova,Killjoy,Omen,Jett"
Sunset,IOUNL,Spare Time,13,11,7,5,6,6,"Cypher,Sova,Omen,KAY/O,Neon","Breach,Raze,Cypher,Gekko,Clove"
Bind,NYAN Esports,ForsaKen GC,12,14,4,9,5,8,"Breach,Cypher,Sova,Brimstone,Yoru","Breach,Raze,Cypher,Omen,Gekko"
Ascent,Canadia Compooters,Toronto Wasteyutes,13,10,9,3,7,4,"Cypher,Sova,Omen,Jett,Yoru","Breach,Sova,Killjoy,Omen,Jett"
Lotus,G2 Esports,KRÜ Esports,4,13,1,4,9,3,"Raze,Killjoy,Viper,Omen,Fade","Raze,Killjoy,Viper,Omen,Fade"
Lotus,NEON BLADE,charbon,5,13,1,5,8,4,"Breach,Raze,Killjoy,Omen,Fade","Omen,KAY/O,Neon,Gekko,Deadlock"
Bind,The Ultimates Odyssey,TOG Kitsune,13,9,8,4,5,5,"Breach,Raze,Viper,Brimstone,Gekko","Breach,Raze,Cypher,Brimstone,Fade"
Ascent,Dolbaebi,The Warriors,13,1,2,0,1,11,"Cypher,Sova,Phoenix,Omen,Jett","Sova,Killjoy,Phoenix,Omen,Jett"
Lotus,Revenge (NA),ASTS Gaming,13,6,8,4,2,5,"Raze,Cypher,Omen,Fade,Deadlock","Breach,Raze,Killjoy,Omen,Fade"
Icebox,F9 Wonders,last second,10,13,5,7,6,5,"Sova,Killjoy,Viper,Sage,Jett","Sova,Killjoy,Viper,Reyna,Jett"
Bind,Zerance Mint,On Sight,5,13,3,3,10,2,"Raze,Viper,Brimstone,Skye,Gekko","Raze,Viper,Brimstone,Skye,KAY/O"
Haven,Canadia Compooters,Toronto Wasteyutes,13,3,2,2,1,11,"Breach,Cypher,Omen,Neon,Gekko","Breach,Sova,Killjoy,Omen,Jett"
Sunset,Celestials GC,Lotus Karma,13,9,6,4,5,7,"Raze,Cypher,KAY/O,Harbor,Gekko","Breach,Cypher,Sova,Astra,Neon"
Icebox,FOKUS Sakura,BLVKHVND,13,6,6,1,5,7,"Sova,Killjoy,Viper,Reyna,Jett","Sova,Killjoy,Viper,Jett,Harbor"
Ascent,5 Little Piggies,AntoL Kittens,14,12,4,9,3,10,"Cypher,Sova,Omen,Jett,Deadlock","Sova,Killjoy,Omen,Jett,KAY/O"
Icebox,NOVO GC,Permitta Unicorns GC,13,11,5,7,4,8,"Sova,Killjoy,Viper,Sage,Jett","Killjoy,Viper,Reyna,Gekko,Clove"
Ascent,ALTERNATE aTTaX Ruby,Gamax Lite,13,11,6,6,5,7,"Sova,Killjoy,Omen,Jett,KAY/O","Sova,Killjoy,Omen,Jett,KAY/O"
Lotus,NYAN Esports,ForsaKen GC,7,13,5,7,6,2,"Breach,Cypher,Sova,Omen,Yoru","Breach,Raze,Cypher,Sova,Omen"
Icebox,Ketçaplı Ruffles,Twisted Minds Orchid,13,8,6,6,2,7,"Sova,Killjoy,Viper,Jett,Gekko","Sova,Viper,Sage,Reyna,Jett"
Haven,NEON BLADE,charbon,13,2,3,0,2,10,"Breach,Sova,Killjoy,Omen,Jett","Breach,Sova,Omen,Neon,Deadlock"
Haven,BLAZE GC,Silly Weapons All Game,13,6,9,3,3,4,"Breach,Cypher,Sova,Omen,Jett","Breach,Cypher,Sova,Omen,Jett"
Lotus,The Ultimates Odyssey,TOG Kitsune,13,7,6,2,5,7,"Breach,Cypher,Sova,Omen,Neon","Breach,Raze,Killjoy,Omen,Gekko"
Split,Barça eSports,UCAM Esports Club,13,9,4,6,3,9,"Raze,Cypher,Viper,Omen,Skye","Breach,Raze,Cypher,Omen,Fade"
Haven,Valiant GC,SK Nebula,13,10,8,4,6,5,"Breach,Sova,Killjoy,Omen,Jett","Breach,Cypher,Sova,Omen,Jett"
Haven,Zerance Mint,On Sight,13,10,7,5,5,6,"Breach,Sova,Killjoy,Omen,Jett","Breach,Cypher,Sova,Omen,Neon"
Lotus,Cicadas Gaming,Valiant,6,13,3,9,4,3,"Raze,Cypher,Omen,Jett,Skye","Raze,Cypher,Omen,Fade,Deadlock"
Haven,ALTERNATE aTTaX Ruby,Gamax Lite,4,13,3,9,4,1,"Breach,Cypher,Sova,Omen,Jett","Breach,Cypher,Sova,Jett,Astra"
Lotus,EMUs,RIZON Sugar,3,13,2,2,11,1,"Raze,Cypher,Omen,Fade,Deadlock","Breach,Raze,Killjoy,Omen,Fade"
Lotus,LXT Esports GC,Hex Esports,13,7,10,2,5,3,"Raze,Killjoy,Viper,Omen,Fade","Breach,Raze,Killjoy,Neon,Clove"
Lotus,NOVO GC,Permitta Unicorns GC,9,13,4,8,5,5,"Breach,Sova,Killjoy,Omen,Neon","Raze,Cypher,Omen,Fade,Deadlock"
Split,MAD Lions KOI,LUA Gaming,13,6,7,5,1,6,"Raze,Cypher,Viper,Omen,Skye","Breach,Raze,Cypher,Omen,Skye"
Haven,FOKUS Sakura,BLVKHVND,13,10,7,5,5,6,"Breach,Sova,Killjoy,Omen,Jett","Breach,Cypher,Sova,Omen,Neon"
Bind,SZK Esports,1000rr club,6,13,3,4,9,3,"Raze,Viper,Jett,Fade,Clove","Raze,Cypher,Reyna,Skye,Clove"
Bind,STAKERS,bazinga esports,14,12,5,8,4,9,"Breach,Raze,Cypher,Brimstone,Skye","Breach,Sova,Viper,Yoru,Clove"
Bind,Capacitanes,90 Seconds,13,11,6,6,5,7,"Raze,Cypher,Brimstone,Skye,Fade","Raze,Viper,Brimstone,Skye,Gekko"
Bind,Grow uP eSports,Team Galaga,11,13,3,9,4,8,"Raze,Brimstone,Fade,Gekko,Deadlock","Raze,Brimstone,Yoru,Fade,Deadlock"
Bind,Zeniths,IAPEsports,7,13,4,8,5,3,"Raze,Viper,Omen,Fade,Gekko","Raze,Viper,Brimstone,Fade,Gekko"
Bind,GATIT4S PEEK,INCOGNITO,13,6,5,2,4,8,"Viper,Brimstone,Yoru,Chamber,Gekko","Raze,Cypher,Yoru,Gekko,Clove"
Bind,Odyssey Gaming,InTenZive,11,13,5,7,6,6,"Raze,Viper,Brimstone,Fade,Gekko","Raze,Cypher,Brimstone,Skye,Gekko"
Bind,Nexum EC,AMBYS Team,13,8,5,4,4,8,"Raze,Viper,Omen,Skye,Gekko","Breach,Raze,Cypher,Brimstone,Fade"
Sunset,Formulation Gaming GC,Luminaria,13,7,6,6,1,7,"Breach,Raze,Cypher,Omen,Gekko","Breach,Cypher,Sova,Omen,Jett"
Ascent,Celestials GC,Lotus Karma,14,16,7,8,8,7,"Breach,Jett,KAY/O,Deadlock,Clove","Sova,Killjoy,Omen,Jett,KAY/O"
Haven,NYAN Esports,ForsaKen GC,13,7,8,4,3,5,"Sova,Killjoy,Viper,Yoru,Harbor","Breach,Cypher,Sova,Omen,Neon"
Lotus,Ketçaplı Ruffles,Twisted Minds Orchid,10,13,6,5,8,4,"Killjoy,Viper,Omen,Neon,Gekko","Breach,Cypher,Omen,Neon,Fade"
Split,NEON BLADE,charbon,10,13,2,9,4,8,"Raze,Cypher,Reyna,Omen,Jett","Raze,Cypher,Viper,Omen,Skye"
Ascent,F9 Wonders,last second,16,18,9,8,10,7,"Sova,Killjoy,Phoenix,Omen,Jett","Sova,Killjoy,Phoenix,Omen,Jett"
Ascent,BLAZE GC,Silly Weapons All Game,13,4,9,3,1,4,"Sova,Killjoy,Omen,Jett,KAY/O","Sova,Killjoy,Jett,Astra,KAY/O"
Sunset,The Ultimates Odyssey,TOG Kitsune,5,13,4,8,5,1,"Breach,Raze,Cypher,Omen,Gekko","Breach,Raze,Cypher,Omen,Gekko"
Breeze,Cicadas Gaming,Valiant,4,13,1,4,9,3,"Cypher,Sova,Viper,Jett,Yoru","Cypher,Sova,Viper,Jett,Yoru"
Ascent,LXT Esports GC,Hex Esports,13,1,11,1,0,2,"Sova,Killjoy,Omen,Jett,KAY/O","Killjoy,Omen,Jett,KAY/O,Neon"
Ascent,Barça eSports,UCAM Esports Club,13,11,8,4,7,5,"Killjoy,Viper,Omen,Jett,Skye","Sova,Killjoy,Omen,Jett,KAY/O"
Sunset,Zerance Mint,On Sight,11,13,8,4,9,3,"Breach,Raze,Cypher,Sova,Omen","Cypher,Omen,KAY/O,Neon,Gekko"
Bind,Papara SuperMassive,PCIFIC Espor,13,11,6,6,5,7,"Raze,Viper,Omen,Fade,Deadlock","Raze,Cypher,Viper,Brimstone,KAY/O"
Icebox,Valiant GC,SK Nebula,13,10,5,7,3,8,"Sova,Killjoy,Viper,Sage,Jett","Sova,Killjoy,Viper,Sage,Jett"
Sunset,MAD Lions KOI,LUA Gaming,13,6,5,2,4,8,"Breach,Cypher,Sova,Omen,Neon","Breach,Raze,Cypher,Sova,Omen"
Bind,FOKUS,ALTERNATE aTTaX,13,3,9,3,0,4,"Viper,Brimstone,Skye,Yoru,Gekko","Breach,Raze,Brimstone,Fade,Deadlock"
Lotus,Formulation Gaming GC,Luminaria,13,4,5,0,4,8,"Raze,Killjoy,Viper,Omen,Fade","Breach,Raze,Killjoy,Omen,Gekko"
Sunset,Skout Esports,Tropadobagaço,6,13,3,4,9,3,"Breach,Raze,Cypher,Omen,Gekko","Breach,Raze,Cypher,Omen,Gekko"
Sunset,ALTERNATE aTTaX Ruby,Gamax Lite,13,10,9,3,7,4,"Breach,Raze,Cypher,Sova,Omen","Breach,Cypher,Omen,Jett,Gekko"
Breeze,Zero Tenacity,Chipi Chapa's,6,13,4,8,5,2,"Sova,Viper,Jett,Yoru,Astra","Cypher,Sova,Viper,Omen,Yoru"
Icebox,Celestials GC,Lotus Karma,13,8,5,4,4,8,"Killjoy,Sage,KAY/O,Harbor,Gekko","Sova,Killjoy,Viper,Harbor,Gekko"
Haven,EMUs,RIZON Sugar,13,15,4,10,5,9,"Killjoy,Viper,Omen,Jett,Skye","Breach,Sova,Killjoy,Omen,Jett"
Sunset,BLAZE GC,Silly Weapons All Game,3,13,1,3,10,2,"Cypher,Omen,Jett,Fade,Harbor","Breach,Raze,Cypher,Gekko,Clove"
Icebox,FOKUS Sakura,Permitta Unicorns GC,13,2,10,2,0,3,"Sova,Killjoy,Viper,Reyna,Jett","Killjoy,Viper,Chamber,Gekko,Clove"
Haven,DSYRE,NOVO Esports,13,2,3,0,2,10,"Cypher,Sova,Omen,Yoru,Iso","Breach,Cypher,Sova,Omen,Neon"
Haven,Ketçaplı Ruffles,Twisted Minds Orchid,13,7,6,6,1,7,"Sova,Omen,Jett,Skye,Chamber","Breach,Sova,Omen,Chamber,Neon"
Haven,NEON BLADE,last second,13,3,4,0,3,9,"Breach,Sova,Killjoy,Omen,Jett","Breach,Cypher,Sova,Omen,Jett"
Sunset,Papara SuperMassive,PCIFIC Espor,13,2,3,0,2,10,"Cypher,Sova,Omen,KAY/O,Neon","Breach,Raze,Cypher,Omen,Gekko"
Lotus,Zerance,Joblife,13,4,5,0,4,8,"Raze,Cypher,Viper,Omen,Skye","Breach,Killjoy,Omen,Neon,Fade"
Lotus,The Ultimates Odyssey,ForsaKen GC,13,8,9,3,5,4,"Breach,Cypher,Sova,Omen,Neon","Breach,Raze,Cypher,Sova,Omen"
Sunset,Barça eSports,UCAM Esports Club,9,13,3,9,4,6,"Cypher,Sova,Omen,KAY/O,Neon","Breach,Cypher,Sova,Omen,Neon"
Sunset,LXT Esports GC,On Sight,7,13,4,8,5,3,"Raze,Cypher,Omen,KAY/O,Gekko","Cypher,Omen,KAY/O,Neon,Gekko"
Lotus,FOKUS,ALTERNATE aTTaX,14,12,8,5,7,6,"Cypher,Omen,KAY/O,Neon,Gekko","Breach,Raze,Sova,Killjoy,Omen"
Bind,Skout Esports,Tropadobagaço,9,13,5,7,6,4,"Raze,Cypher,Brimstone,Skye,Gekko","Raze,Cypher,Brimstone,Skye,Gekko"
Lotus,Requiem,NXT,13,4,8,4,0,5,"Raze,Cypher,Viper,Omen,Fade","Raze,Cypher,Omen,Fade,Deadlock"
Ascent,Zero Tenacity,Chipi Chapa's,8,13,1,8,5,7,"Cypher,Sova,Omen,Jett,Deadlock","Raze,Cypher,Sova,Omen,Deadlock"
Bind,GATIT4S PEEK,Signum Reges,13,7,5,3,4,8,"Viper,Brimstone,Yoru,Chamber,Gekko","Raze,Cypher,Viper,Brimstone,Yoru"
Bind,IAPEsports,Capacitanes,13,10,5,7,3,8,"Raze,Viper,Brimstone,Fade,Gekko","Raze,Cypher,Brimstone,Skye,Fade"
Bind,InTenZive,AMBYS Team,12,14,7,6,8,5,"Raze,Cypher,Brimstone,Skye,Gekko","Breach,Raze,Cypher,Brimstone,Fade"
Bind,Team Galaga,Odyssey Gaming,13,3,2,2,1,11,"Raze,Brimstone,Yoru,Fade,Deadlock","Raze,Viper,Brimstone,Fade,Gekko"
Bind,Zeniths,Nexum EC,7,13,6,6,7,1,"Raze,Viper,Phoenix,Brimstone,Gekko","Raze,Viper,Omen,Skye,Gekko"
Bind,1000rr club,STAKERS,13,4,3,2,2,10,"Raze,Cypher,Gekko,Iso,Clove","Breach,Raze,Cypher,Brimstone,Skye"
Bind,90 Seconds,TwentyStars,13,5,4,2,3,9,"Raze,Viper,Brimstone,Skye,Gekko","Cypher,Omen,Jett,Skye,Deadlock"
Bind,SZK Esports,INCOGNITO,7,13,5,7,6,2,"Raze,Skye,Chamber,Gekko,Clove","Raze,Cypher,Yoru,Gekko,Clove"
Bind,bazinga esports,Poverineeh,13,6,5,2,4,8,"Breach,Sova,Viper,Yoru,Clove","Breach,Raze,Cypher,Yoru,Clove"
Sunset,FOKUS Sakura,Permitta Unicorns GC,15,13,8,6,7,7,"Breach,Raze,Cypher,Omen,Yoru","Breach,Cypher,Sova,Reyna,Harbor"
Haven,MAD Lions KOI,Formulation Gaming GC,13,11,6,6,5,7,"Breach,Sova,Killjoy,Omen,Neon","Breach,Cypher,Sova,Omen,Jett"
Ascent,Valiant GC,RIZON Sugar,13,9,8,4,5,5,"Sova,Killjoy,Omen,Jett,KAY/O","Sova,Killjoy,Omen,Jett,KAY/O"
Lotus,Luminaria,LUA Gaming,12,14,4,9,5,8,"Breach,Raze,Killjoy,Omen,Gekko","Breach,Sova,Killjoy,Omen,Neon"
Sunset,TOG Kitsune,NYAN Esports,13,7,7,5,2,6,"Breach,Raze,Cypher,Omen,Gekko","Breach,Raze,Cypher,Omen,Yoru"
Sunset,DSYRE,NOVO Esports,13,11,8,4,7,5,"Viper,Sage,Omen,KAY/O,Gekko","Breach,Cypher,Sova,Omen,Neon"
Lotus,Zerance Mint,Hex Esports,13,9,9,3,6,4,"Raze,Killjoy,Viper,Omen,Gekko","Breach,Raze,Killjoy,Neon,Clove"
Ascent,Ketçaplı Ruffles,Lotus Karma,13,2,2,1,1,11,"Sova,Killjoy,Omen,Jett,KAY/O","Sova,Killjoy,Omen,Jett,KAY/O"
Ascent,Gamax Lite,BLAZE GC,13,11,8,4,7,5,"Sova,Killjoy,Omen,Jett,KAY/O","Sova,Killjoy,Omen,Jett,KAY/O"
Ascent,NEON BLADE,last second,11,13,5,7,6,6,"Sova,Killjoy,Omen,Jett,KAY/O","Sova,Killjoy,Phoenix,Omen,Jett"
Sunset,Twisted Minds Orchid,Celestials GC,13,11,7,5,6,6,"Breach,Raze,Cypher,Omen,Gekko","Raze,Cypher,KAY/O,Harbor,Gekko"
Ascent,The Ultimates Odyssey,ForsaKen GC,13,6,9,3,3,4,"Sova,Killjoy,Omen,Jett,KAY/O","Sova,Killjoy,Omen,Jett,KAY/O"
Haven,BLVKHVND,NOVO GC,13,0,1,0,0,12,"Breach,Cypher,Sova,Omen,Neon","Breach,Sova,Killjoy,Omen,Neon"
Bind,Zerance,Joblife,13,11,7,5,6,6,"Raze,Viper,Brimstone,Skye,Gekko","Raze,Viper,Brimstone,Skye,Gekko"
Bind,charbon,F9 Wonders,13,4,11,1,3,2,"Breach,Raze,Cypher,Omen,Yoru","Breach,Raze,Cypher,Brimstone,Yoru"
Lotus,ALTERNATE aTTaX Ruby,Silly Weapons All Game,13,2,10,2,0,3,"Breach,Raze,Cypher,Omen,Fade","Breach,Raze,Killjoy,Astra,Gekko"
Lotus,LXT Esports GC,On Sight,2,13,0,3,10,2,"Raze,Killjoy,Viper,Omen,Fade","Breach,Killjoy,Omen,Neon,Gekko"
Sunset,Galakticos,Fire Flux Esports,9,13,3,9,4,6,"Breach,Raze,Viper,Omen,Neon","Breach,Raze,Cypher,Omen,Gekko"
Bind,Barça eSports,UCAM Esports Club,13,6,4,3,3,9,"Cypher,Viper,Yoru,Gekko,Clove","Raze,Viper,Brimstone,Fade,Gekko"
Lotus,Skout Esports,Tropadobagaço,13,1,11,1,0,2,"Breach,Killjoy,Omen,Neon,Fade","Breach,Raze,Killjoy,Omen,Gekko"
Bind,EMUs,SK Nebula,8,13,5,7,6,3,"Raze,Brimstone,Yoru,Harbor,Gekko","Raze,Cypher,Viper,Brimstone,Skye"
Split,Requiem,NXT,13,8,3,6,2,10,"Raze,Cypher,Viper,Omen,Skye","Raze,Omen,Skye,Astra,Deadlock"
Haven,Gamax Lite,BLAZE GC,13,7,5,3,4,8,"Breach,Cypher,Sova,Jett,Astra","Breach,Cypher,Sova,Omen,Jett"
Sunset,ALTERNATE aTTaX Ruby,Silly Weapons All Game,13,1,11,1,0,2,"Breach,Raze,Cypher,Sova,Omen","Breach,Raze,Cypher,Gekko,Clove"
Icebox,Luminaria,LUA Gaming,6,13,3,4,9,3,"Sova,Killjoy,Viper,Gekko,Iso","Sova,Killjoy,Viper,Jett,Harbor"
Split,Eintracht Frankfurt,MOUZ,13,11,6,6,5,7,"Raze,Cypher,Sage,Omen,Skye","Reyna,Skye,Astra,Deadlock,Iso"
Icebox,BLVKHVND,NOVO GC,13,3,11,1,2,2,"Sova,Killjoy,Viper,Jett,Harbor","Sova,Killjoy,Viper,Sage,Jett"
Haven,Zerance Mint,Hex Esports,13,8,6,6,2,7,"Breach,Sova,Killjoy,Omen,Jett","Breach,Sova,Killjoy,Omen,Jett"
Lotus,Valiant GC,RIZON Sugar,13,7,7,5,2,6,"Breach,Killjoy,Omen,Neon,Fade","Breach,Raze,Killjoy,Omen,Fade"
Ascent,TOG Kitsune,NYAN Esports,13,6,6,1,5,7,"Sova,Killjoy,Omen,Jett,KAY/O","Cypher,Sova,Omen,Jett,Deadlock"
Ascent,LXT Esports GC,On Sight,13,4,9,3,1,4,"Sova,Killjoy,Omen,Jett,KAY/O","Sova,Killjoy,Omen,Jett,KAY/O"
Sunset,Ketçaplı Ruffles,Lotus Karma,13,5,6,0,5,7,"Cypher,Sova,Omen,KAY/O,Neon","Breach,Cypher,Omen,Neon,Gekko"
Bind,MAD Lions KOI,Formulation Gaming GC,13,10,7,4,6,6,"Raze,Viper,Brimstone,Fade,Gekko","Raze,Cypher,Viper,Brimstone,Skye"
Haven,The Ultimates Odyssey,ForsaKen GC,7,13,5,7,6,2,"Breach,Sova,Killjoy,Omen,Neon","Breach,Cypher,Sova,Omen,Neon"
Lotus,FOKUS Sakura,Permitta Unicorns GC,12,14,8,5,9,4,"Breach,Raze,Killjoy,Omen,Skye","Raze,Cypher,Omen,Fade,Deadlock"
Lotus,NEON BLADE,last second,13,7,11,1,6,2,"Breach,Raze,Killjoy,Omen,Fade","Breach,Killjoy,Omen,Neon,Gekko"
Ascent,EMUs,SK Nebula,2,13,2,1,12,0,"Cypher,Sova,Omen,Yoru,Deadlock","Sova,Killjoy,Omen,Jett,KAY/O"
Bind,Twisted Minds Orchid,Celestials GC,13,8,4,5,3,9,"Raze,Viper,Brimstone,Skye,Iso","Cypher,Reyna,Gekko,Iso,Clove"
Icebox,charbon,F9 Wonders,13,2,2,1,1,11,"Sova,Killjoy,Viper,Sage,Iso","Sova,Killjoy,Viper,Jett,Gekko"
Sunset,Zerance,Joblife,5,13,4,8,5,1,"Breach,Raze,Cypher,Sova,Omen","Breach,Cypher,Sova,Omen,Neon"
Icebox,DSYRE,NOVO Esports,13,10,5,6,4,8,"Sova,Killjoy,Viper,Sage,Jett","Killjoy,Viper,KAY/O,Neon,Gekko"
Ascent,ESC Gaming,B8 Esports,13,15,5,9,6,8,"Sova,Killjoy,Omen,Jett,KAY/O","Cypher,Sova,Phoenix,Omen,Jett"
Lotus,Galakticos,Fire Flux Esports,14,12,5,8,4,9,"Breach,Sova,Omen,Chamber,Neon","Breach,Raze,Cypher,Omen,Gekko"
Haven,Barça eSports,UCAM Esports Club,10,13,2,10,3,8,"Breach,Cypher,Sova,Omen,Neon","Breach,Cypher,Sova,Omen,Neon"
Sunset,PPP,SAW,5,13,2,10,3,3,"Breach,Cypher,Sova,Omen,Neon","Breach,Raze,Cypher,Omen,Gekko"
Sunset,BLX CORP X BCG,Royal Family eSports,13,6,5,2,4,8,"Breach,Raze,Cypher,Sova,Omen","Breach,Raze,Cypher,Omen,Gekko"
Sunset,ESC Gaming,B8 Esports,2,13,0,3,10,2,"Breach,Raze,Cypher,Omen,KAY/O","Breach,Cypher,Sova,Omen,Neon"
Icebox,OnlyFins,Metizport,13,10,5,6,4,8,"Killjoy,Viper,Jett,KAY/O,Gekko","Sova,Killjoy,Viper,Sage,Iso"
Sunset,Eintracht Frankfurt,MOUZ,15,13,8,6,7,7,"Breach,Cypher,Omen,Neon,Fade","Breach,Raze,Cypher,Sova,Omen"
Bind,Galakticos,Fire Flux Esports,11,13,9,3,10,2,"Breach,Brimstone,Omen,Jett,Yoru","Raze,Viper,Brimstone,Fade,Gekko"
Ascent,PPP,SAW,6,13,5,7,6,1,"Sova,Killjoy,Omen,Jett,KAY/O","Cypher,Sova,Omen,Jett,KAY/O"
Lotus,OnlyFins,Metizport,13,4,3,2,2,10,"Killjoy,Neon,Fade,Gekko,Clove","Raze,Killjoy,Viper,Omen,Fade"
Bind,Eintracht Frankfurt,MOUZ,5,13,4,8,5,1,"Raze,Viper,Yoru,Gekko,Clove","Breach,Raze,Brimstone,Omen,Gekko"
Icebox,BLX CORP X BCG,Royal Family eSports,13,9,6,4,5,7,"Killjoy,Viper,Reyna,Gekko,Iso","Sova,Killjoy,Viper,Jett,Deadlock"
Bind,Istanbul Wildcats,S2G Esports,6,13,2,5,8,4,"Breach,Raze,Cypher,Omen,Yoru","Raze,Brimstone,KAY/O,Gekko,Clove"
Lotus,ALTERNATE aTTaX,DIVIZON,13,7,6,2,5,7,"Breach,Raze,Sova,Killjoy,Omen","Breach,Raze,Killjoy,Omen,Fade"
Haven,ZETA DIVISION,Talon Esports,13,8,7,5,3,6,"Breach,Sova,Killjoy,Omen,Neon","Breach,Killjoy,Astra,Neon,Iso"
Icebox,Istanbul Wildcats,S2G Esports,11,13,8,4,9,3,"Killjoy,Jett,KAY/O,Harbor,Gekko","Sova,Killjoy,Viper,Jett,Clove"
Haven,ALTERNATE aTTaX,DIVIZON,13,4,3,2,2,10,"Breach,Cypher,Sova,Omen,Jett","Breach,Cypher,Sova,Omen,Jett"
Lotus,ZETA DIVISION,Talon Esports,8,13,2,7,6,6,"Raze,Killjoy,Viper,Omen,Fade","Breach,Cypher,Sova,Astra,Neon"
Lotus,O2esports GC,BT5,13,9,8,4,5,5,"Breach,Raze,Cypher,Omen,Fade","Breach,Raze,Killjoy,Omen,KAY/O"
Bind,Focus e-Sports Female,NIX VISION GC,10,13,7,5,8,3,"Raze,Cypher,Brimstone,Skye,Gekko","Raze,Cypher,Brimstone,Skye,Gekko"
Ascent,ZETA DIVISION,Talon Esports,13,6,4,3,3,9,"Sova,Killjoy,Omen,Jett,KAY/O","Sova,Phoenix,Sage,KAY/O,Clove"
Ascent,DXA Esports,raindrops,5,13,3,9,4,2,"Sova,Killjoy,Omen,Jett,KAY/O","Breach,Cypher,Sova,Omen,Jett"
Bind,O2esports GC,BT5,13,7,8,4,3,5,"Cypher,Skye,Astra,Neon,Gekko","Raze,Cypher,Brimstone,Skye,Deadlock"
Split,Focus e-Sports Female,NIX VISION GC,13,8,9,3,5,4,"Raze,Cypher,Omen,Jett,Skye","Raze,Cypher,Omen,Skye,Chamber"
Ascent,SCARZ GC,XFACTORS,13,3,10,2,1,3,"Sova,Killjoy,Omen,Jett,KAY/O","Sova,Killjoy,Omen,Jett,KAY/O"
Ascent,Soleil Gaming,NoNameRabbit,13,5,5,1,4,8,"Sova,Killjoy,Omen,Jett,KAY/O","Sova,Reyna,Omen,Jett,KAY/O"
Bind,PAL GC,Insomnia GC,13,4,3,2,2,10,"Raze,Viper,Brimstone,Skye,Gekko","Raze,Brimstone,Omen,Skye,Gekko"
Haven,DRX,DetonatioN FocusMe,13,2,10,2,0,3,"Breach,Cypher,Sova,Omen,Jett","Breach,Sova,Killjoy,Omen,Jett"
Bind,GEM DIANA,NEXUS (JP),14,12,7,6,6,7,"Raze,Viper,Brimstone,Skye,Gekko","Raze,Cypher,Viper,Skye,Harbor"
Bind,DXA Esports,raindrops,10,13,4,8,5,6,"Raze,Cypher,Viper,Brimstone,Skye","Raze,Viper,Brimstone,Fade,Gekko"
Ascent,ArcoBaleNO IRIS,俺の彼女がゲーマーなわけない,13,1,11,1,0,2,"Cypher,Sova,Omen,Jett,Deadlock","Sova,Killjoy,Omen,Jett,Deadlock"
Icebox,PAL GC,Insomnia GC,13,3,11,1,2,2,"Killjoy,Viper,Jett,KAY/O,Clove","Killjoy,Viper,Jett,KAY/O,Gekko"
Lotus,Focus e-Sports Female,NIX VISION GC,10,13,3,8,5,7,"Breach,Raze,Cypher,Omen,Fade","Breach,Raze,Killjoy,Omen,Skye"
Icebox,O2esports GC,BT5,17,19,8,10,9,9,"Sova,Killjoy,Viper,Jett,KAY/O","Sova,Killjoy,Viper,Reyna,Clove"
Sunset,Soleil Gaming,NoNameRabbit,13,10,6,6,4,7,"Breach,Raze,Cypher,Omen,Gekko","Breach,Raze,Cypher,Sova,Omen"
Haven,SCARZ GC,XFACTORS,13,10,8,4,6,5,"Breach,Sova,Killjoy,Omen,Jett","Breach,Sova,Killjoy,Omen,Jett"
Lotus,GEM DIANA,NEXUS (JP),13,4,10,2,2,3,"Breach,Raze,Killjoy,Omen,Fade","Breach,Raze,Cypher,Sova,Omen"
Ascent,DRX,DetonatioN FocusMe,6,13,5,7,6,1,"Cypher,Sova,Omen,Jett,KAY/O","Sova,Killjoy,Omen,Jett,KAY/O"
Haven,ArcoBaleNO IRIS,俺の彼女がゲーマーなわけない,13,4,5,0,4,8,"Cypher,Sova,Omen,Jett,Deadlock","Sova,Killjoy,Omen,Jett,Deadlock"
Lotus,DXA Esports,raindrops,13,4,5,0,4,8,"Breach,Raze,Cypher,Omen,Gekko","Raze,Cypher,Omen,Fade,Gekko"
Icebox,DRX,DetonatioN FocusMe,13,7,6,2,5,7,"Killjoy,Viper,Jett,KAY/O,Clove","Sova,Killjoy,Viper,Jett,Harbor"
Sunset,raindrops,VIXENS,13,6,6,1,5,7,"Breach,Raze,Cypher,Omen,Gekko","Breach,Raze,Cypher,Omen,Gekko"
Bind,raindrops,VIXENS,13,8,8,1,7,5,"Raze,Viper,Brimstone,Fade,Gekko","Raze,Viper,Brimstone,Fade,Gekko"
Lotus,MYVRA,KS Esports GC,3,13,1,3,10,2,"Breach,Cypher,Omen,Neon,Gekko","Raze,Cypher,Viper,Omen,Fade"
Icebox,Akave Esports Black,FUSION X,13,1,11,1,0,2,"Sova,Killjoy,Viper,Sage,Gekko","Killjoy,Sage,Jett,Harbor,Gekko"
Bind,MYVRA,KS Esports GC,10,13,7,4,9,3,"Breach,Raze,Cypher,Gekko,Clove","Raze,Brimstone,Sage,Fade,Gekko"
Ascent,University War GC,9z Team GC,5,13,1,11,2,4,"Sova,Killjoy,Omen,Jett,KAY/O","Sova,Killjoy,Omen,Jett,KAY/O"
Split,Akave Esports Black,FUSION X,13,7,6,6,1,7,"Raze,Cypher,Omen,Jett,Skye","Raze,Sage,Astra,Gekko,Deadlock"
Lotus,Envee Sapphire GC,Charmers GC,13,11,6,6,5,7,"Breach,Raze,Killjoy,Omen,Fade","Breach,Raze,Cypher,Omen,Fade"
Icebox,University War GC,9z Team GC,15,17,6,10,7,9,"Sova,Killjoy,Viper,Sage,Chamber","Killjoy,Viper,Jett,KAY/O,Gekko"
Sunset,Legacy,RED Canids,3,13,2,10,3,1,"Raze,Cypher,Sova,Omen,KAY/O","Breach,Raze,Cypher,Omen,KAY/O"
Bind,FiRePOWER GC,Zen eSports GC,13,3,11,1,2,2,"Raze,Viper,Brimstone,Skye,Gekko","Breach,Raze,Brimstone,Skye,Chamber"
Lotus,Legacy,RED Canids,7,13,3,5,8,4,"Raze,Cypher,Viper,Omen,Fade","Breach,Cypher,Neon,Gekko,Clove"
Sunset,University War GC,9z Team GC,16,14,8,7,7,8,"Breach,Raze,Cypher,Omen,Fade","Breach,Viper,Omen,Neon,Gekko"
Ascent,FiRePOWER GC,Zen eSports GC,13,10,6,5,5,7,"Sova,Killjoy,Omen,Jett,KAY/O","Sova,Killjoy,Omen,Jett,KAY/O"
Split,CGN Esports,Eintracht Frankfurt,13,10,6,6,4,7,"Raze,Viper,Sage,Omen,Jett","Raze,Cypher,Sage,Omen,Skye"
Lotus,Team Heretics,Gentle Mates,13,5,4,2,3,9,"Breach,Cypher,Omen,Neon,Fade","Cypher,Viper,Omen,Neon,Fade"
Bind,XLD Gaming,TBK Esports,11,13,8,4,9,3,"Brimstone,Omen,Skye,Neon,Gekko","Raze,Viper,Brimstone,Sage,Skye"
Ascent,CGN Esports,Eintracht Frankfurt,13,5,9,3,2,4,"Sova,Killjoy,Phoenix,Jett,Astra","Cypher,Sova,Sage,Omen,Jett"
Lotus,XLD Gaming,TBK Esports,5,13,2,4,9,3,"Cypher,Omen,Neon,Fade,Deadlock","Raze,Killjoy,Viper,Omen,Fade"
Icebox,Team Heretics,Gentle Mates,10,13,2,9,4,8,"Sova,Killjoy,Viper,Jett,KAY/O","Killjoy,Viper,Omen,KAY/O,Gekko"
Bind,CGN Esports,Eintracht Frankfurt,9,13,5,7,6,4,"Raze,Viper,Brimstone,Sage,Gekko","Raze,Viper,Yoru,Gekko,Clove"
Sunset,Team Heretics,Gentle Mates,13,7,8,4,3,5,"Cypher,Sova,Omen,KAY/O,Neon","Raze,Cypher,Omen,KAY/O,Neon"
Sunset,MOUZ,FOKUS,13,8,5,4,4,8,"Breach,Raze,Cypher,Sova,Omen","Cypher,Sage,Omen,KAY/O,Gekko"
Haven,The giornalisti,TwentyStars,14,16,3,12,4,11,"Cypher,Sova,Reyna,Omen,Jett","Breach,Sova,Killjoy,Omen,Jett"
Lotus,BBL Esports,Team Vitality,11,13,2,10,3,9,"Breach,Cypher,Omen,Neon,Fade","Breach,Raze,Cypher,Omen,Fade"
Icebox,The giornalisti,TwentyStars,13,9,7,5,4,6,"Sova,Killjoy,Viper,Reyna,Jett","Sova,Killjoy,Viper,Sage,Jett"
Haven,MOUZ,FOKUS,13,10,4,7,3,9,"Breach,Sova,Killjoy,Omen,Jett","Killjoy,Omen,Yoru,Astra,Fade"
Sunset,BBL Esports,Team Vitality,13,6,3,4,2,10,"Raze,Cypher,Omen,KAY/O,Gekko","Cypher,Sova,Omen,KAY/O,Neon"
Bind,MOUZ,FOKUS,9,13,5,5,8,4,"Breach,Raze,Viper,Brimstone,Gekko","Viper,Brimstone,Skye,Yoru,Gekko"
Ascent,BBL Esports,Team Vitality,7,13,5,7,6,2,"Cypher,Sova,Omen,Jett,KAY/O","Sova,Killjoy,Omen,Jett,KAY/O"
Icebox,AMORIS Lykos,Insomnia GC,3,13,1,11,2,2,"Sova,Killjoy,Viper,Reyna,Omen","Killjoy,Viper,Jett,KAY/O,Gekko"
Haven,Cyber Geek,Soleil Gaming,13,2,10,2,0,3,"Breach,Sova,Killjoy,Omen,Jett","Breach,Sova,Killjoy,Omen,Jett"
Split,AMORIS Lykos,Insomnia GC,4,13,2,3,10,2,"Cypher,Omen,Jett,Skye,Clove","Breach,Raze,Cypher,Sage,Omen"
Sunset,DRX Changers,PAL GC,13,11,5,7,4,8,"Breach,Cypher,Sova,Omen,Neon","Breach,Raze,Cypher,Omen,Gekko"
Ascent,DetonatioN FocusMe GC,GEM DIANA,13,8,4,5,3,9,"Sova,Killjoy,Omen,Jett,KAY/O","Sova,Killjoy,Omen,Jett,KAY/O"
Icebox,Cyber Geek,Soleil Gaming,13,6,8,4,2,5,"Killjoy,Viper,Jett,KAY/O,Gekko","Sova,Killjoy,Viper,Jett,Gekko"
Haven,NO SNOW,XFACTORS,7,13,6,6,7,1,"Breach,Sova,Killjoy,Omen,Jett","Breach,Sova,Killjoy,Omen,Jett"
Sunset,SCARZ GC,Sasanqua,11,13,6,6,7,5,"Raze,Cypher,Sova,Omen,KAY/O","Raze,Cypher,Sova,Phoenix,Omen"
Sunset,AMORIS Lykos,Insomnia GC,13,7,7,1,6,6,"Cypher,Sova,Reyna,Omen,Jett","Raze,Cypher,Sova,Omen,Clove"
Icebox,DRX Changers,PAL GC,13,9,8,2,7,5,"Sova,Killjoy,Viper,Jett,Harbor","Killjoy,Viper,Jett,KAY/O,Clove"
Sunset,TRO Gaming Lumirize,BT5,9,13,6,4,9,3,"Breach,Raze,Sage,Omen,Gekko","Breach,Raze,Cypher,Omen,KAY/O"
Lotus,DetonatioN FocusMe GC,GEM DIANA,15,13,8,6,7,7,"Raze,Killjoy,Viper,Omen,Fade","Breach,Raze,Killjoy,Omen,Fade"
Sunset,NO SNOW,XFACTORS,11,13,8,4,9,3,"Breach,Raze,Cypher,Sova,Clove","Raze,Cypher,Sova,Omen,Gekko"
Icebox,SCARZ GC,Sasanqua,9,13,7,3,10,2,"Sova,Killjoy,Viper,Jett,Harbor","Sova,Killjoy,Viper,Jett,Gekko"
Sunset,NoNameRabbit,Soleil Gaming,5,13,1,5,8,4,"Breach,Raze,Cypher,Sova,Omen","Breach,Raze,Cypher,Omen,Gekko"
Bind,GG WEGO,NIX VISION GC,7,13,3,5,8,4,"Raze,Viper,Skye,Astra,Gekko","Raze,Cypher,Brimstone,Skye,Gekko"
Sunset,Reignite Lily,O2esports GC,13,2,11,1,1,2,"Cypher,Sova,Omen,KAY/O,Neon","Cypher,Sova,Omen,KAY/O,Neon"
Ascent,Meteor GC,Focus e-Sports Female,13,4,10,2,2,3,"Sova,Killjoy,Omen,Jett,KAY/O","Sova,Killjoy,Omen,Jett,KAY/O"
Haven,FENNEL GC,ArcoBaleNO IRIS,13,4,9,3,1,4,"Breach,Sova,Killjoy,Omen,Jett","Cypher,Sova,Omen,Jett,Deadlock"
Lotus,TRO Gaming Lumirize,BT5,6,13,3,9,4,3,"Breach,Raze,Killjoy,Omen,Fade","Breach,Raze,Killjoy,Omen,KAY/O"
Ascent,Gen.G Esports,Global Esports,13,6,6,1,5,7,"Sova,Killjoy,Omen,Jett,KAY/O","Sova,Killjoy,Omen,Jett,KAY/O"
Lotus,Insomnia GC,PAL GC,10,13,5,7,6,5,"Raze,Killjoy,Viper,Omen,Fade","Raze,Killjoy,Viper,Omen,Fade"
Sunset,DetonatioN FocusMe GC,NEXUS (JP),13,4,4,1,3,9,"Breach,Raze,Cypher,Sova,Omen","Raze,Cypher,Sage,Omen,Fade"
Lotus,Reignite Lily,O2esports GC,13,2,3,0,2,10,"Raze,Killjoy,Viper,Omen,Fade","Breach,Raze,Cypher,Omen,Fade"
Haven,DRX Changers,AMORIS Lykos,13,5,9,3,2,4,"Breach,Sova,Killjoy,Omen,Jett","Sova,Killjoy,Reyna,Omen,Jett"
Lotus,GG WEGO,NIX VISION GC,11,13,7,5,8,4,"Breach,Sova,Killjoy,Omen,Neon","Breach,Raze,Killjoy,Omen,Skye"
Lotus,Meteor GC,Focus e-Sports Female,13,5,10,2,3,3,"Raze,Killjoy,Viper,Omen,Fade","Breach,Raze,Cypher,Omen,Fade"
Sunset,FENNEL GC,ArcoBaleNO IRIS,13,7,7,1,6,6,"Breach,Raze,Cypher,Omen,Fade","Raze,Cypher,Omen,Gekko,Deadlock"
Lotus,Gen.G Esports,Global Esports,13,1,2,0,1,11,"Raze,Killjoy,Viper,Omen,Fade","Breach,Cypher,Omen,Neon,Fade"
Sunset,Sasanqua,XFACTORS,13,8,7,5,3,6,"Raze,Cypher,Sova,Phoenix,Omen","Raze,Cypher,Sova,Omen,Gekko"
Icebox,Sasanqua,XFACTORS,13,6,8,4,2,5,"Sova,Killjoy,Viper,Jett,Gekko","Sova,Killjoy,Viper,Omen,Jett"
Icebox,SCARZ GC,NO SNOW,13,3,4,0,3,9,"Sova,Killjoy,Viper,Jett,Harbor","Sova,Killjoy,Viper,Jett,Gekko"
Haven,Focus e-Sports Female,NIX VISION GC,13,8,8,1,7,5,"Breach,Sova,Killjoy,Omen,Jett","Breach,Sova,Killjoy,Omen,Jett"
Lotus,BT5,O2esports GC,8,13,5,4,9,3,"Breach,Killjoy,Omen,Jett,KAY/O","Breach,Raze,Cypher,Omen,Fade"
Sunset,Paper Rex,Rex Regum Qeon,13,10,7,5,5,6,"Breach,Raze,Sage,Omen,Gekko","Breach,Raze,Cypher,Omen,Gekko"
Icebox,Reignite Lily,TRO Gaming Lumirize,13,3,10,2,1,3,"Sova,Killjoy,Viper,Jett,Harbor","Sova,Killjoy,Viper,Jett,Clove"
Ascent,ArcoBaleNO IRIS,俺の彼女がゲーマーなわけない,13,4,4,1,3,9,"Cypher,Sova,Omen,Jett,Deadlock","Raze,Sova,Killjoy,Omen,KAY/O"
Ascent,ArcoBaleNO IRIS,俺の彼女がゲーマーなわけない,13,4,4,1,3,9,"Cypher,Sova,Omen,Jett,Deadlock","Raze,Sova,Killjoy,Omen,KAY/O"
Ascent,Meteor GC,GG WEGO,13,7,9,3,4,4,"Sova,Killjoy,Omen,Jett,KAY/O","Sova,Killjoy,Omen,Jett,KAY/O"
Lotus,NoNameRabbit,Soleil Gaming,14,12,10,3,9,4,"Omen,Neon,Fade,Deadlock,Iso","Breach,Raze,Cypher,Omen,KAY/O"
Lotus,NoNameRabbit,Soleil Gaming,14,12,10,3,9,4,"Omen,Neon,Fade,Deadlock,Iso","Breach,Raze,Cypher,Omen,KAY/O"
Lotus,DetonatioN FocusMe GC,NEXUS (JP),13,3,4,0,3,9,"Raze,Killjoy,Viper,Omen,Fade","Breach,Raze,Cypher,Sova,Omen"
Ascent,DRX Changers,AMORIS Lykos,13,3,10,2,1,3,"Sova,Killjoy,Omen,Jett,KAY/O","Sova,Killjoy,Phoenix,Omen,Jett"
Lotus,SCARZ GC,NO SNOW,13,3,9,3,0,4,"Raze,Killjoy,Viper,Omen,Fade","Raze,Killjoy,Viper,Omen,Fade"
Bind,Insomnia GC,PAL GC,9,13,7,3,10,2,"Raze,Brimstone,Omen,Skye,Gekko","Raze,Viper,Brimstone,Skye,Gekko"
Icebox,BT5,O2esports GC,3,13,0,4,9,3,"Sova,Killjoy,Viper,Iso,Clove","Sova,Killjoy,Viper,Jett,KAY/O"
Lotus,Meteor GC,GG WEGO,13,1,11,1,0,2,"Raze,Killjoy,Viper,Omen,Fade","Breach,Sova,Killjoy,Omen,Neon"
Haven,Sasanqua,XFACTORS,9,13,6,4,9,3,"Breach,Sova,Killjoy,Omen,Jett","Breach,Sova,Killjoy,Omen,Jett"
Lotus,Focus e-Sports Female,NIX VISION GC,13,10,6,5,5,7,"Breach,Raze,Cypher,Omen,Fade","Breach,Raze,Killjoy,Omen,Skye"
Sunset,Reignite Lily,TRO Gaming Lumirize,13,3,10,2,1,3,"Cypher,Sova,Omen,KAY/O,Neon","Breach,Raze,Sage,Omen,Gekko"
Ascent,Paper Rex,Rex Regum Qeon,7,13,5,7,6,2,"Cypher,Sova,Omen,Jett,Clove","Sova,Killjoy,Omen,Jett,KAY/O"
Lotus,Paper Rex,Rex Regum Qeon,13,7,5,3,4,8,"Omen,Jett,KAY/O,Neon,Fade","Breach,Sova,Omen,Chamber,Neon"
Bind,Hero Base,2Game Esports,6,13,2,5,8,4,"Raze,Viper,Brimstone,Skye,Gekko","Raze,Brimstone,Omen,Skye,Neon"
Breeze,Hero Base,2Game Esports,13,15,4,10,5,9,"Cypher,Sova,Viper,Jett,KAY/O","Sova,Viper,Yoru,Astra,Iso"
Split,Hero Base,2Game Esports,13,8,8,4,4,5,"Breach,Raze,Cypher,Omen,Skye","Raze,Viper,Astra,Fade,Gekko"
Split,Galorys,SAGAZ,13,5,9,3,2,4,"Raze,Viper,Omen,Jett,Skye","Raze,Cypher,Viper,Omen,Skye"
Ascent,Stellae Gaming,The7,4,13,1,11,2,3,"Sova,Killjoy,Omen,Jett,KAY/O","Cypher,Sova,Omen,Yoru,Iso"
Ascent,Galorys,SAGAZ,13,7,8,4,3,5,"Sova,Killjoy,Omen,Jett,KAY/O","Sova,Killjoy,Omen,Jett,KAY/O"
Lotus,Stellae Gaming,The7,14,12,8,5,7,6,"Raze,Cypher,Viper,Omen,Fade","Breach,Neon,Fade,Iso,Clove"
Split,Stellae Gaming,The7,3,13,1,11,2,2,"Raze,Cypher,Viper,Omen,Skye","Breach,Cypher,Omen,Neon,Iso"
Sunset,Galorys,SAGAZ,5,13,4,8,5,1,"Breach,Cypher,Sova,Omen,Neon","Breach,Raze,Cypher,Omen,Gekko"
Sunset,Twisted Minds Orchid,Team Falcons Vega,10,13,6,6,7,4,"Breach,Raze,Cypher,Omen,Gekko","Breach,Raze,Cypher,Omen,Gekko"
Sunset,Team Liquid,Karmine Corp,13,2,10,2,0,3,"Viper,Sage,Omen,KAY/O,Gekko","Cypher,Sova,Omen,KAY/O,Neon"
Split,Twisted Minds Orchid,Team Falcons Vega,13,11,9,3,8,4,"Breach,Raze,Cypher,Viper,Omen","Breach,Raze,Cypher,Omen,Skye"
Bind,Team Liquid,Karmine Corp,13,11,6,6,5,7,"Raze,Viper,Skye,Astra,Fade","Sova,Omen,Yoru,Fade,Harbor"
Haven,GMBLERS Esports,Fishing Rods,13,4,4,1,3,9,"Breach,Sova,Killjoy,Omen,Jett","Breach,Sova,Killjoy,Omen,Jett"
Lotus,Twisted Minds Orchid,Team Falcons Vega,6,13,3,4,9,3,"Breach,Cypher,Omen,Neon,Fade","Killjoy,Viper,Omen,Neon,Gekko"
Lotus,GMBLERS Esports,Fishing Rods,13,6,5,2,4,8,"Breach,Raze,Killjoy,Omen,Jett","Raze,Killjoy,Viper,Omen,Skye"
Icebox,KOI,Natus Vincere,13,6,7,5,1,6,"Killjoy,Viper,Jett,KAY/O,Gekko","Cypher,Sova,Viper,Jett,Gekko"
Haven,Team Francisco (cr8),Team Cpt (cr8),13,10,7,4,6,6,"Breach,Sova,Killjoy,Omen,Jett","Breach,Sova,Killjoy,Omen,Jett"
Icebox,Twisted Minds Orchid,Team Falcons Vega,5,13,4,8,5,1,"Sova,Killjoy,Viper,Reyna,Jett","Sova,Killjoy,Viper,Jett,Gekko"
Split,KOI,Natus Vincere,13,10,9,3,7,4,"Breach,Raze,Viper,Omen,Fade","Raze,Cypher,Yoru,Astra,Fade"
Haven,Team VanilLa (cr8),Team SurugaMonkey (cr8),13,8,8,4,4,5,"Breach,Sova,Killjoy,Omen,Jett","Breach,Sova,Killjoy,Omen,Jett"
Haven,Team MOTHER3 (cr8),Team Clutch Fi (cr8),13,5,3,3,2,10,"Breach,Sova,Killjoy,Omen,Jett","Breach,Cypher,Sova,Omen,Jett"
Bind,Team Francisco (cr8),Team Cpt (cr8),10,13,2,9,4,8,"Raze,Viper,Brimstone,Skye,Gekko","Phoenix,Sage,Gekko,Iso,Clove"
Icebox,Disguised,Reve Drift Arena,12,14,6,7,7,6,"Sova,Killjoy,Viper,Jett,Iso","Sova,Killjoy,Viper,Jett,Gekko"
Ascent,Team VanilLa (cr8),Team SurugaMonkey (cr8),13,5,8,4,1,5,"Sova,Killjoy,Omen,Jett,KAY/O","Sova,Killjoy,Omen,Jett,KAY/O"
Bind,Team MOTHER3 (cr8),Team Clutch Fi (cr8),13,0,1,0,0,12,"Raze,Viper,Chamber,Gekko,Clove","Raze,Brimstone,Skye,Gekko,Clove"
Lotus,Team Francisco (cr8),Team Cpt (cr8),13,5,6,0,5,7,"Breach,Raze,Killjoy,Omen,Fade","Breach,Killjoy,Omen,Jett,Gekko"
Lotus,FULL SENSE,XERXIA Esports,13,8,8,1,7,5,"Breach,Killjoy,Sage,Omen,Neon","Breach,Raze,Cypher,Omen,Fade"
Haven,Disguised,Reve Drift Arena,7,13,2,6,7,5,"Cypher,Sova,Omen,Yoru,Iso","Breach,Sova,Jett,Chamber,Clove"
Split,FULL SENSE,XERXIA Esports,14,12,4,9,3,10,"Raze,Cypher,Sage,Omen,Skye","Raze,Cypher,Viper,Omen,Skye"
Haven,Team VanilLa (cr8),Team Clutch Fi (cr8),9,13,5,5,8,4,"Breach,Sova,Killjoy,Omen,Jett","Breach,Cypher,Sova,Omen,Jett"
Bind,Team Cpt (cr8),Team SurugaMonkey (cr8),13,11,8,4,7,5,"Phoenix,Sage,Gekko,Iso,Clove","Raze,Cypher,Brimstone,Skye,Gekko"
Ascent,Team Francisco (cr8),Team MOTHER3 (cr8),11,13,4,8,5,7,"Sova,Killjoy,Omen,Jett,KAY/O","Sova,Killjoy,Omen,Jett,Deadlock"
Bind,Disguised,Reve Drift Arena,15,13,8,6,7,7,"Raze,Viper,Omen,Skye,Yoru","Raze,Cypher,Brimstone,Skye,Gekko"
Lotus,FOCUSGG,JiJieHao Bonkers,13,4,4,1,3,9,"Raze,Killjoy,Viper,Omen,Fade","Breach,Raze,Cypher,Omen,Fade"
Haven,FearX,Team IAM,10,13,4,7,6,6,"Yoru,Astra,KAY/O,Neon,Gekko","Killjoy,Viper,Omen,Jett,Skye"
Ascent,Please Don't Fire,Ninjas in Galaxy,3,13,2,2,11,1,"Cypher,Sova,Omen,Jett,Iso","Sova,Killjoy,Omen,Jett,Iso"
Split,Team NKT, Santa Gang,13,8,3,6,2,10,"Breach,Raze,Viper,Omen,Fade","Raze,Cypher,Omen,Jett,Skye"
Split,Oblivion Force,PAPA ESPORTS,13,2,10,2,0,3,"Raze,Cypher,Omen,Jett,Skye","Raze,Cypher,Omen,Jett,Skye"
Lotus,Team MOTHER3 (cr8),Team Clutch Fi (cr8),13,8,6,3,5,7,"Raze,Viper,Omen,Chamber,Fade","Killjoy,Omen,Jett,Fade,Clove"
Ascent,Team Francisco (cr8),Team Cpt (cr8),14,12,7,6,6,7,"Sova,Killjoy,Omen,Jett,KAY/O","Cypher,Sova,Omen,Jett,KAY/O"
Abyss,Team VanilLa (cr8),Team SurugaMonkey (cr8),11,13,5,7,6,6,"Cypher,Sova,Omen,Jett,KAY/O","Breach,Cypher,Reyna,Astra,KAY/O"
Sunset,Please Don't Fire,Ninjas in Galaxy,8,13,5,4,9,3,"Cypher,Sova,Omen,Neon,Iso","Raze,Cypher,Omen,Gekko,Iso"
Bind,FOCUSGG,JiJieHao Bonkers,17,15,8,8,7,9,"Raze,Viper,Brimstone,Fade,Gekko","Raze,Cypher,Viper,Brimstone,Gekko"
Ascent,FearX,Team IAM,13,8,8,4,4,5,"Omen,Yoru,KAY/O,Neon,Gekko","Sova,Killjoy,Omen,Jett,KAY/O"
Icebox,Oblivion Force,PAPA ESPORTS,13,5,2,4,1,11,"Killjoy,Viper,Jett,KAY/O,Gekko","Sova,Killjoy,Viper,Reyna,Jett"
Bind,Team NKT, Santa Gang,13,8,7,5,3,6,"Reyna,Yoru,Astra,Harbor,Gekko","Raze,Viper,Brimstone,Skye,Gekko"
Ascent,Rank El Cuties,ZOL Esports,4,13,3,9,4,1,"Sova,Killjoy,Omen,Jett,KAY/O","Sova,Killjoy,Omen,Jett,KAY/O"
Haven,FOCUSGG,JiJieHao Bonkers,8,13,3,9,4,5,"Breach,Sova,Killjoy,Omen,Neon","Breach,Sova,Killjoy,Omen,Jett"
Abyss,Team Francisco (cr8),Team Clutch Fi (cr8),10,13,6,5,8,4,"Breach,Sova,Killjoy,Omen,Jett","Jett,Astra,Fade,Harbor,Gekko"
Lotus,Team MOTHER3 (cr8),Team SurugaMonkey (cr8),13,9,6,4,5,7,"Raze,Viper,Omen,Chamber,Fade","Breach,Raze,Killjoy,Omen,Fade"
Lotus,FearX,Team IAM,6,13,5,7,6,1,"Breach,Raze,Cypher,Omen,Skye","Raze,Killjoy,Viper,Omen,Fade"
Abyss,Team VanilLa (cr8),Team Cpt (cr8),13,11,9,3,8,4,"Cypher,Sova,Omen,Jett,KAY/O","Breach,Cypher,Jett,Astra,Gekko"
Lotus,BOOM Esports,Alter Ego,13,7,7,1,6,6,"Raze,Killjoy,Viper,Omen,Fade","Raze,Killjoy,Reyna,Omen,Fade"
Split,Arena Internet Cafe,Justice For Tomorrow,3,13,3,9,4,0,"Breach,Raze,Cypher,Skye,Astra","Cypher,Omen,Jett,Skye,Iso"
Lotus,Team Francisco (cr8),Team SurugaMonkey (cr8),16,14,9,6,8,7,"Breach,Raze,Killjoy,Omen,Fade","Breach,Raze,Killjoy,Omen,Fade"
Split,OLD STINKY CAT,JustUs,8,13,7,5,8,1,"Raze,Cypher,Omen,Jett,Skye","Raze,Cypher,Omen,Jett,Skye"
Haven,Team Cpt (cr8),Team Clutch Fi (cr8),11,13,4,8,5,7,"Breach,Sova,Killjoy,Omen,Jett","Breach,Cypher,Sova,Omen,Jett"
Bind,Team VanilLa (cr8),Team MOTHER3 (cr8),10,13,3,9,4,7,"Breach,Raze,Brimstone,Skye,Deadlock","Raze,Viper,Chamber,Gekko,Clove"
Lotus,Arena Internet Cafe,Justice For Tomorrow,9,13,3,9,4,6,"Breach,Killjoy,Omen,Skye,Neon","Raze,Cypher,Omen,Fade,Iso"
Lotus,Superfect Esports Academy,VEC DAEJEON,10,13,6,6,7,4,"Killjoy,Viper,Omen,Neon,Gekko","Breach,Raze,Viper,Omen,Skye"
Ascent,OLD STINKY CAT,JustUs,10,13,8,3,10,2,"Breach,Killjoy,Viper,Jett,Clove","Sova,Killjoy,Reyna,Omen,Jett"
Icebox,ARF TEAM,Cynical,13,7,6,2,5,7,"Killjoy,Viper,Jett,KAY/O,Gekko","Killjoy,Viper,Jett,KAY/O,Gekko"
Haven,Superfect Esports Academy,VEC DAEJEON,13,5,10,2,3,3,"Sova,Killjoy,Jett,Yoru,Astra","Breach,Sova,Killjoy,Omen,Jett"
Haven,Team SurugaMonkey (cr8),Team Clutch Fi (cr8),14,12,5,8,4,9,"Breach,Sova,Killjoy,Omen,Jett","Breach,Cypher,Sova,Omen,Jett"
Abyss,Team VanilLa (cr8),Team Francisco (cr8),13,7,7,5,2,6,"Cypher,Sova,Omen,Jett,KAY/O","Breach,Sova,Killjoy,Omen,Jett"
Lotus,Team MOTHER3 (cr8),Team Cpt (cr8),13,9,7,3,6,6,"Raze,Viper,Omen,Chamber,Fade","Breach,Killjoy,Omen,Jett,Gekko"
Split,ARF TEAM,Cynical,13,4,4,1,3,9,"Raze,Cypher,Sage,Omen,Skye","Raze,Cypher,Viper,Omen,Skye"
Ascent,Carti World,Subversive,13,6,8,4,2,5,"Sova,Killjoy,Omen,Jett,KAY/O","Sova,Killjoy,Omen,Jett,Yoru"
Sunset,Superfect Esports Academy,VEC DAEJEON,11,13,7,5,8,4,"Raze,Cypher,Sova,Omen,Yoru","Breach,Raze,Cypher,Omen,Fade"
Lotus,Carti World,Subversive,13,4,8,4,0,5,"Raze,Killjoy,Viper,Omen,Fade","Raze,Killjoy,Viper,Omen,Fade"
Ascent,KS Esports GC,FUSION X,7,13,2,10,3,5,"Cypher,Sova,Omen,Jett,Deadlock","Sova,Jett,Fade,Iso,Clove"
Bind,KS Esports GC,FUSION X,9,13,7,5,8,2,"Raze,Brimstone,Sage,Fade,Gekko","Raze,Cypher,Brimstone,Skye,Gekko"
Sunset,NRG Esports,KRÜ Esports,13,7,9,3,4,4,"Breach,Cypher,Omen,Neon,Fade","Raze,Cypher,Sova,Omen,KAY/O"
Lotus,Tenax GC,LazerrFreeks Ivy,13,11,9,3,8,4,"Raze,Killjoy,Omen,KAY/O,Gekko","Raze,Killjoy,Omen,Fade,Gekko"
Ascent,NRG Esports,KRÜ Esports,13,8,7,5,3,6,"Cypher,Sova,Omen,Jett,KAY/O","Sova,Killjoy,Omen,Jett,KAY/O"
Sunset,9z Team GC,Zen eSports GC,13,7,5,3,4,8,"Breach,Viper,Omen,Neon,Gekko","Breach,Raze,Cypher,Omen,Fade"
Sunset,LazerrFreeks Ivy,Charmers GC,13,11,7,5,6,6,"Raze,Cypher,Fade,Gekko,Clove","Raze,Cypher,Reyna,Omen,Gekko"
Icebox,Team Leveling,paprica picante,15,17,7,9,8,8,"Killjoy,Viper,KAY/O,Gekko,Iso","Sova,Killjoy,Viper,Jett,Gekko"
Lotus,9z Team GC,Zen eSports GC,13,8,6,3,5,7,"Breach,Cypher,Omen,Neon,Gekko","Raze,Killjoy,Viper,Omen,Fade"
Ascent,University War GC,FiRePOWER GC,14,12,6,7,5,8,"Sova,Killjoy,Omen,Jett,KAY/O","Sova,Killjoy,Omen,Jett,KAY/O"
Split,Akave Esports Black,MYVRA,13,7,3,5,2,10,"Raze,Cypher,Omen,Jett,Skye","Breach,Raze,Cypher,Omen,Skye"
Split,NRG Esports,KRÜ Esports,8,13,3,6,7,5,"Breach,Cypher,Omen,Yoru,Neon","Raze,Cypher,Viper,Omen,Skye"
Lotus,Team Leveling,paprica picante,11,13,7,5,8,4,"Breach,Killjoy,Omen,Neon,Fade","Raze,Killjoy,Viper,Omen,Fade"
Sunset,LOUD GC,Fourth Wall,13,9,10,2,7,3,"Raze,Cypher,Omen,KAY/O,Gekko","Raze,Cypher,Omen,Gekko,Iso"
Bind,Akave Esports Black,MYVRA,13,10,6,6,4,7,"Raze,Cypher,Viper,Brimstone,Skye","Breach,Raze,Cypher,Gekko,Clove"
Lotus,REVOADA,FURIA GC,13,2,12,0,2,1,"Raze,Killjoy,Viper,Omen,Fade","Breach,Raze,Killjoy,Omen,Gekko"
Ascent,9z Team GC,Zen eSports GC,12,14,7,6,8,5,"Sova,Killjoy,Omen,Jett,KAY/O","Sova,Killjoy,Omen,Jett,KAY/O"
Icebox,University War GC,FiRePOWER GC,13,7,6,2,5,7,"Sova,Killjoy,Viper,Sage,Chamber","Sova,Killjoy,Harbor,Iso,Clove"
Ascent,TBS GC,PS5Patas,14,12,3,10,2,11,"Sova,Killjoy,Omen,Jett,KAY/O","Sova,Killjoy,Omen,Jett,KAY/O"
Split,MIBR,100 Thieves,6,13,2,10,3,4,"Raze,Viper,Omen,Jett,Skye","Breach,Raze,Viper,Astra,Fade"
Icebox,LOUD GC,Fourth Wall,13,10,5,7,3,8,"Killjoy,Viper,Jett,KAY/O,Gekko","Sova,Killjoy,Viper,Jett,Gekko"
Bind,Team Leveling,paprica picante,13,11,8,4,7,5,"Raze,Viper,Brimstone,Skye,Gekko","Raze,Viper,Brimstone,Skye,Gekko"
Icebox,REVOADA,FURIA GC,13,6,3,4,2,10,"Sova,Killjoy,Viper,Jett,Gekko","Sova,Killjoy,Viper,Jett,Gekko"
Icebox,TBS GC,PS5Patas,13,8,6,3,5,7,"Sova,Killjoy,Viper,Jett,Gekko","Sova,Killjoy,Viper,Jett,Gekko"
Split,Team Falcons Vega,The Ultimates Odyssey,13,3,11,1,2,2,"Breach,Raze,Cypher,Omen,Skye","Breach,Raze,Cypher,Omen,Skye"
Icebox,MIBR,100 Thieves,5,13,3,9,4,2,"Sova,Killjoy,Viper,Jett,Gekko","Sova,Killjoy,Viper,Jett,Gekko"
Split,FUT Esports,Gentle Mates,13,4,3,2,2,10,"Breach,Raze,Cypher,Omen,Gekko","Breach,Raze,Cypher,Omen,Yoru"
Bind,Team Falcons Vega,The Ultimates Odyssey,13,7,6,2,5,7,"Raze,Viper,Brimstone,Skye,Gekko","Breach,Raze,Viper,Brimstone,Gekko"
Icebox,ARROW,Sissi State Punks Academy,13,9,6,4,5,7,"Sova,Killjoy,Viper,Neon,Harbor","Sova,Killjoy,Viper,Reyna,Gekko"
Sunset,FUT Esports,Gentle Mates,13,8,8,4,4,5,"Breach,Raze,Cypher,Omen,Gekko","Cypher,Sage,Omen,KAY/O,Neon"
Sunset,Team Falcons Vega,The Ultimates Odyssey,13,7,6,2,5,7,"Breach,Raze,Cypher,Omen,Gekko","Breach,Raze,Cypher,Omen,Gekko"
Lotus,ARROW,Sissi State Punks Academy,14,12,10,3,9,4,"Breach,Killjoy,Viper,Omen,Neon","Breach,Cypher,Sova,Omen,Neon"
Haven,Team Heretics,GIANTX,13,9,9,1,8,4,"Breach,Cypher,Omen,Neon,Iso","Breach,Sova,Killjoy,Omen,Neon"
Split,R8 Blues,Twisted Minds Orchid,3,13,1,3,10,2,"Raze,Killjoy,Reyna,Omen,Skye","Breach,Raze,Cypher,Viper,Omen"
Breeze,R8 Blues,Twisted Minds Orchid,3,13,3,9,4,0,"Sova,Viper,Phoenix,Chamber,Gekko","Cypher,Sova,Viper,Reyna,Jett"
Split,Team Heretics,GIANTX,13,15,8,6,9,5,"Breach,Cypher,Omen,Neon,Iso","Breach,Raze,Cypher,Omen,Jett"
Ascent,Exceptional Gaming,Sissi State Punks Academy,13,4,2,3,1,11,"Sova,Killjoy,Omen,Jett,KAY/O","Sova,Killjoy,Omen,Jett,KAY/O"
Icebox,Elevate (SG),LaZe,13,5,3,3,2,10,"Killjoy,Viper,Reyna,Jett,KAY/O","Sova,Killjoy,Viper,Jett,Gekko"
Icebox,Elevate (SG),LaZe,13,5,3,3,2,10,"Killjoy,Viper,Reyna,Jett,KAY/O","Sova,Killjoy,Viper,Jett,Gekko"
Haven,Exceptional Gaming,Sissi State Punks Academy,13,6,10,2,4,3,"Breach,Cypher,Sova,Omen,Neon","Breach,Cypher,Sova,Omen,Jett"
Lotus,R8 Blues,Twisted Minds Orchid,6,13,2,5,8,4,"Raze,Killjoy,Astra,Neon,Gekko","Breach,Cypher,Omen,Neon,Fade"
Bind,Team Heretics,GIANTX,13,9,7,3,6,6,"Raze,Viper,Brimstone,Fade,Gekko","Raze,Viper,Omen,Skye,Yoru"
Lotus,Made in Thailand,XOXO-01,13,5,8,4,1,5,"Raze,Killjoy,Viper,Omen,Gekko","Raze,Killjoy,Viper,Omen,Fade"
Sunset,Elevate (SG),LaZe,13,11,5,7,4,8,"Breach,Raze,Cypher,Omen,Gekko","Breach,Raze,Cypher,Sova,Omen"
Haven,ONE Team Esports,Five Ace e-Sports,13,7,6,2,5,7,"Breach,Sova,Killjoy,Omen,Jett","Sova,Killjoy,Omen,Neon,Iso"
Icebox,R8 Blues,Twisted Minds Orchid,13,9,6,4,5,7,"Killjoy,Viper,Neon,Gekko,Iso","Sova,Viper,Sage,Jett,Iso"
Split,Made in Thailand,XOXO-01,13,9,9,3,6,4,"Raze,Cypher,Sage,Skye,Astra","Raze,Cypher,Viper,Omen,Skye"
Ascent,ONE Team Esports,Five Ace e-Sports,13,3,4,0,3,9,"Sova,Killjoy,Omen,Jett,KAY/O","Sova,Killjoy,Omen,Jett,KAY/O"
Sunset,NEXGA,Kizuna Esports,10,13,4,7,6,6,"Breach,Raze,Cypher,Sova,Omen","Breach,Cypher,Sova,Omen,Jett"
Bind,Oblivion Force,Team Kobolds,5,13,3,9,4,2,"Raze,Viper,Omen,Skye,Gekko","Viper,Brimstone,Jett,Skye,Gekko"
Lotus,Barn nong chok,Sharper Esports,16,14,9,6,8,7,"Raze,Killjoy,Viper,Omen,Fade","Raze,Omen,Chamber,Neon,Gekko"
Lotus,NEXGA,Kizuna Esports,10,13,7,5,8,3,"Breach,Sova,Killjoy,Omen,Jett","Breach,Sova,Killjoy,Omen,Jett"
Haven,JiJieHao Bonkers,BOBO,13,2,10,2,0,3,"Breach,Sova,Killjoy,Omen,Jett","Cypher,Sova,Omen,Jett,Fade"
Split,Oblivion Force,Team Kobolds,13,9,6,6,3,7,"Raze,Cypher,Omen,Jett,Skye","Raze,Viper,Omen,Skye,Chamber"
Split,Barn nong chok,Sharper Esports,11,13,2,10,3,9,"Cypher,Omen,Jett,Skye,Iso","Raze,Cypher,Omen,Skye,Neon"
Icebox,Avernus Esports,Subversive,13,2,3,0,2,10,"Sova,Killjoy,Viper,Jett,Gekko","Sova,Killjoy,Viper,Reyna,Jett"
Icebox,JiJieHao Bonkers,BOBO,13,5,9,3,2,4,"Killjoy,Viper,Jett,KAY/O,Gekko","Sova,Killjoy,Viper,KAY/O,Iso"
Ascent,Oblivion Force,Team Kobolds,8,13,2,7,6,6,"Cypher,Sova,Omen,Jett,KAY/O","Sova,Killjoy,Omen,Jett,KAY/O"
Haven,NEXGA,Kizuna Esports,13,10,7,5,5,6,"Breach,Sova,Killjoy,Omen,Jett","Breach,Sova,Killjoy,Omen,Jett"
Lotus,Avernus Esports,Subversive,13,2,10,2,0,3,"Breach,Raze,Killjoy,Omen,Gekko","Raze,Killjoy,Viper,Omen,Gekko"
Ascent,Alter Ego,Le Crapaud,13,9,7,5,4,6,"Raze,Sova,Killjoy,Omen,KAY/O","Sova,Killjoy,Omen,Jett,KAY/O"
Ascent,Barn nong chok,Sharper Esports,13,9,9,3,6,4,"Cypher,Sova,Omen,Jett,Iso","Cypher,Sova,Omen,Jett,KAY/O"
Bind,Sin Prisa Gaming,SLT Seongam,14,12,8,5,7,6,"Raze,Cypher,Brimstone,Skye,Deadlock","Raze,Sova,Viper,Brimstone,Gekko"
Bind,FOCUSGG,iPGN,13,7,8,4,3,5,"Raze,Viper,Brimstone,Fade,Gekko","Raze,Viper,Brimstone,Fade,Gekko"
Split,Alter Ego,Le Crapaud,13,7,8,0,7,5,"Raze,Cypher,Omen,Jett,Skye","Raze,Cypher,Omen,Jett,Skye"
Sunset,Tyrant Esports PH,Oasis Gaming,8,13,3,6,7,5,"Raze,Cypher,Sova,Gekko,Clove","Raze,Cypher,Sova,Omen,KAY/O"
Sunset,FOCUSGG,iPGN,13,5,9,3,2,4,"Cypher,Sova,Omen,KAY/O,Neon","Breach,Raze,Cypher,Omen,Gekko"
Lotus,Sin Prisa Gaming,SLT Seongam,13,10,7,5,5,6,"Cypher,Viper,Omen,Neon,Fade","Raze,Killjoy,Viper,Omen,Fade"
Bind,Tyrant Esports PH,Oasis Gaming,3,13,1,3,10,2,"Raze,Cypher,Brimstone,Jett,Skye","Raze,Cypher,Viper,Brimstone,Skye"
Icebox,ARF TEAM,THE HERO DETA,13,11,5,7,4,8,"Killjoy,Viper,Jett,KAY/O,Gekko","Killjoy,Viper,Jett,KAY/O,Gekko"
Lotus,FOCUSGG,iPGN,6,13,2,5,8,4,"Raze,Killjoy,Viper,Omen,Fade","Breach,Raze,Killjoy,Omen,Fade"
Breeze,Tyrant Esports PH,Oasis Gaming,13,10,5,6,4,8,"Cypher,Sova,Viper,Reyna,Jett","Sova,Viper,Jett,Yoru,Astra"
Breeze,ARF TEAM,THE HERO DETA,10,13,3,8,5,7,"Cypher,Sova,Viper,Yoru,Astra","Cypher,Sova,Viper,Jett,Yoru"
Ascent,Dplus Esports,Nongshim RedForce,11,13,9,3,10,2,"Sova,Killjoy,Omen,Jett,KAY/O","Cypher,Viper,Omen,Jett,KAY/O"
Sunset,ARF TEAM,THE HERO DETA,13,10,9,2,8,4,"Breach,Raze,Cypher,Omen,Gekko","Breach,Raze,Cypher,Omen,Gekko"
Icebox,OLD STINKY CAT,NAOS Esports,11,13,5,7,6,6,"Killjoy,Viper,Jett,Gekko,Clove","Killjoy,Viper,Jett,KAY/O,Gekko"
Lotus,Dplus Esports,Nongshim RedForce,10,13,4,8,5,6,"Raze,Killjoy,Omen,KAY/O,Gekko","Raze,Killjoy,Viper,Omen,Fade"
Split,OLD STINKY CAT,NAOS Esports,6,13,1,6,7,5,"Raze,Cypher,Omen,Jett,Skye","Raze,Cypher,Omen,Jett,Skye"
Lotus,Bon Bon Bum Contra GC,MYVRA,5,13,4,8,5,1,"Breach,Raze,Cypher,Omen,Gekko","Breach,Cypher,Omen,Neon,Gekko"
Ascent,Bon Bon Bum Contra GC,MYVRA,11,13,4,8,5,7,"Breach,Raze,Sova,Killjoy,Omen","Breach,Sova,Killjoy,Jett,Clove"
Icebox,Barcelona Sporting X,FUSION X,8,13,4,8,5,4,"Sova,Killjoy,Viper,Reyna,Clove","Sova,Killjoy,Reyna,Jett,Harbor"
Bind,LOUD,FURIA,9,13,4,6,7,5,"Brimstone,Omen,Skye,Neon,Gekko","Raze,Viper,Brimstone,Sage,Skye"
Sunset,Bon Bon Bum Contra GC,MYVRA,13,10,8,3,7,5,"Breach,Sova,Sage,Omen,Gekko","Breach,Cypher,Sova,Omen,Neon"
Lotus,Barcelona Sporting X,FUSION X,7,13,7,5,8,0,"Raze,Killjoy,Viper,Omen,Skye","Breach,Raze,Killjoy,Omen,Skye"
Ascent,FURIA GC,Vila das Flores,14,12,9,4,8,5,"Sova,Killjoy,Omen,Jett,KAY/O","Sova,Killjoy,Omen,Jett,KAY/O"
Icebox,LOUD,FURIA,10,13,5,7,6,5,"Killjoy,Omen,KAY/O,Harbor,Gekko","Sova,Killjoy,Viper,Sage,Jett"
Ascent,PS5Patas,Athena's e-Sports,13,1,11,1,0,2,"Sova,Killjoy,Omen,Jett,KAY/O","Sova,Killjoy,Omen,Jett,KAY/O"
Icebox,FiRePOWER GC,OXEN GC,13,7,7,5,2,6,"Sova,Killjoy,Harbor,Iso,Clove","Sova,Killjoy,Viper,Reyna,Jett"
Lotus,TBS GC,bom dia sofia e amigas,13,3,11,1,2,2,"Breach,Killjoy,Omen,Neon,Fade","Breach,Raze,Killjoy,Omen,Fade"
Icebox,LOUD GC,TOTALE Talents,13,5,10,2,3,3,"Killjoy,Viper,Jett,KAY/O,Gekko","Sova,Killjoy,Viper,Sage,Jett"
Icebox,FURIA GC,Vila das Flores,13,11,8,4,7,5,"Sova,Killjoy,Viper,Reyna,Gekko","Killjoy,Viper,Reyna,KAY/O,Gekko"
Ascent,Team Leveling,4 aposentadas 1 nao,13,6,5,2,4,8,"Sova,Killjoy,Omen,Jett,KAY/O","Sova,Killjoy,Omen,Jett,KAY/O"
Lotus,LOUD GC,TOTALE Talents,13,0,12,0,0,1,"Raze,Killjoy,Viper,Omen,Fade","Cypher,Omen,Neon,Fade,Gekko"
Haven,LOUD,FURIA,13,11,8,4,7,5,"Cypher,Viper,Omen,Skye,Neon","Breach,Killjoy,Omen,Neon,Gekko"
Lotus,Deagle Ravagers,Zen eSports GC,9,13,7,5,8,2,"Breach,Cypher,Omen,Neon,Fade","Raze,Killjoy,Viper,Omen,Fade"
Lotus,FURIA GC,Vila das Flores,4,13,1,4,9,3,"Breach,Killjoy,Neon,Gekko,Clove","Breach,Cypher,Omen,Neon,Fade"
Icebox,TBS GC,bom dia sofia e amigas,13,5,9,3,2,4,"Sova,Killjoy,Viper,Jett,Gekko","Sova,Killjoy,Viper,Jett,Gekko"
Bind,FiRePOWER GC,OXEN GC,6,13,4,8,5,2,"Raze,Viper,Brimstone,Skye,Gekko","Raze,Cypher,Brimstone,Skye,Iso"
Icebox,PS5Patas,Athena's e-Sports,13,8,5,4,4,8,"Sova,Killjoy,Viper,Jett,Gekko","Sova,Killjoy,Viper,Jett,Harbor"
Icebox,Fourth Wall,MYSTIC Gaming,13,4,4,1,3,9,"Sova,Killjoy,Viper,Jett,Gekko","Sova,Killjoy,Viper,Reyna,Jett"
Bind,Team Leveling,4 aposentadas 1 nao,13,5,7,5,0,6,"Raze,Viper,Brimstone,Skye,Gekko","Raze,Cypher,Brimstone,Skye,Gekko"
Lotus,paprica picante,Karasuno Crows,13,9,7,5,4,6,"Raze,Killjoy,Viper,Omen,Fade","Killjoy,Viper,Omen,Neon,Fade"
Icebox,REVOADA,BLOOD Stars,13,5,8,4,1,5,"Sova,Killjoy,Viper,Jett,Gekko","Sova,Killjoy,Viper,Jett,Gekko"
Ascent,Fourth Wall,MYSTIC Gaming,13,6,5,2,4,8,"Sova,Killjoy,Omen,Jett,KAY/O","Sova,Killjoy,Omen,Jett,KAY/O"
Ascent,Deagle Ravagers,Zen eSports GC,8,13,1,8,5,7,"Sova,Killjoy,Omen,Jett,KAY/O","Sova,Killjoy,Omen,Jett,KAY/O"
Ascent,FiRePOWER GC,OXEN GC,13,7,5,3,4,8,"Sova,Killjoy,Omen,Jett,KAY/O","Cypher,Sova,Omen,Jett,KAY/O"
Sunset,Evil Geniuses,Leviatán,10,13,6,6,7,4,"Breach,Cypher,Omen,Neon,Fade","Breach,Cypher,Sova,Omen,Neon"
Lotus,REVOADA,BLOOD Stars,13,5,5,1,4,8,"Raze,Killjoy,Viper,Omen,Fade","Breach,Raze,Killjoy,Astra,Clove"
Icebox,paprica picante,Karasuno Crows,13,7,5,7,0,8,"Sova,Killjoy,Viper,Jett,Gekko","Sova,Killjoy,Viper,Sage,Jett"
Bind,Fourth Wall,MYSTIC Gaming,7,13,5,7,6,2,"Raze,Cypher,Brimstone,Skye,Iso","Raze,Viper,Brimstone,Yoru,Gekko"
Icebox,Evil Geniuses,Leviatán,5,13,5,7,6,0,"Sova,Killjoy,Sage,Harbor,Clove","Sova,Killjoy,Viper,Jett,Harbor"
Sunset,Requiem,SweetNsour,13,7,9,3,4,4,"Raze,Cypher,Omen,KAY/O,Gekko","Raze,Cypher,Omen,KAY/O,Gekko"
Haven,Barça eSports,KPI Gaming,13,10,8,4,6,5,"Breach,Cypher,Sova,Omen,Neon","Killjoy,Viper,Omen,Jett,Skye"
Sunset,RIZON,INF Esports,6,13,3,4,9,3,"Breach,Raze,Cypher,Omen,KAY/O","Breach,Raze,Cypher,Sova,Omen"
Haven,6TM ESPORTS,BALD BUFF,13,8,8,4,4,5,"Breach,Sova,Killjoy,Omen,Jett","Breach,Cypher,Sova,Omen,Jett"
Haven,TOG Kitsune,FOKUS Sakura,13,8,7,5,3,6,"Breach,Cypher,Sova,Jett,Clove","Breach,Sova,Killjoy,Omen,Jett"
Icebox,THE PUFFINS,RED KITES,13,5,11,1,4,2,"Sova,Killjoy,Viper,Jett,Iso","Cypher,Viper,Jett,KAY/O,Deadlock"
Icebox,Dortmund Esports,Novita Esports,6,13,0,7,6,6,"Breach,Killjoy,Viper,Omen,Neon","Killjoy,Viper,Jett,Gekko,Clove"
Lotus,PIRATES ESPORTS,TRIBAL ESPORTS,13,0,12,0,0,1,"Raze,Killjoy,Reyna,Omen,Fade","Breach,Raze,Killjoy,Jett,Clove"
Split,Barça eSports,KPI Gaming,6,13,0,7,6,6,"Raze,Cypher,Viper,Omen,Skye","Breach,Raze,Cypher,Omen,Skye"
Bind,Requiem,SweetNsour,13,5,5,1,4,8,"Raze,Viper,Brimstone,Skye,Gekko","Viper,Brimstone,Skye,Yoru,Gekko"
Ascent,BÖSE BUBEN,ARROW,13,8,7,2,6,6,"Sova,Killjoy,Phoenix,Omen,Jett","Sova,Killjoy,Omen,Jett,KAY/O"
Lotus,RIZON,INF Esports,5,13,4,8,5,1,"Breach,Raze,Killjoy,Omen,Gekko","Breach,Raze,Cypher,Omen,Fade"
Lotus,IMPERIUM,Reveal Multigaming Saphire,6,13,5,7,6,1,"Raze,Killjoy,Viper,Omen,Fade","Breach,Killjoy,Omen,Neon,Gekko"
Lotus,Diamant Esports,Zero Tenacity,13,5,4,2,3,9,"Killjoy,Omen,Skye,Astra,Neon","Raze,Killjoy,Viper,Omen,Fade"
Ascent,Reveal Multigaming,Sissi State Punks,11,13,4,8,5,7,"Cypher,Sova,Killjoy,Omen,Jett","Sova,Killjoy,Omen,Jett,KAY/O"
Haven,Dortmund Esports,Novita Esports,11,13,6,6,7,5,"Sova,Killjoy,Omen,Jett,Deadlock","Killjoy,Viper,Omen,Jett,Skye"
Bind,THE WOLFHOUNDS,RED KITES,13,1,2,0,1,11,"Raze,Viper,Omen,Jett,Iso","Raze,Cypher,Brimstone,Skye,Fade"
Lotus,6TM ESPORTS,BALD BUFF,11,13,6,6,7,5,"Breach,Raze,Cypher,Sova,Omen","Raze,Killjoy,Viper,Omen,Fade"
Sunset,TOG Kitsune,FOKUS Sakura,13,10,8,3,7,5,"Breach,Raze,Cypher,Omen,Gekko","Breach,Raze,Cypher,Omen,Yoru"
Sunset,Barça eSports,KPI Gaming,13,10,7,5,5,6,"Cypher,Sova,Omen,KAY/O,Neon","Breach,Cypher,Sova,Omen,Neon"
Ascent,PIT PONIES,TRIBAL ESPORTS,13,6,8,4,2,5,"Sova,Killjoy,Omen,Jett,KAY/O","Sova,Killjoy,Omen,Jett,Yoru"
Lotus,BÖSE BUBEN,ARROW,12,14,8,5,9,4,"Breach,Cypher,Sova,Omen,Neon","Breach,Killjoy,Viper,Omen,Neon"
Haven,IMPERIUM,Reveal Multigaming Saphire,3,13,1,11,2,2,"Breach,Sova,Killjoy,Omen,Neon","Breach,Cypher,Sova,Omen,Jett"
Lotus,MAJOR MONOGWAM,AKA HERO,14,16,9,6,10,5,"Breach,Raze,Killjoy,Reyna,Omen","Breach,Cypher,Sova,Omen,Neon"
Split,Diamant Esports,Zero Tenacity,13,8,5,4,4,8,"Raze,Sova,Viper,Omen,KAY/O","Raze,Cypher,Viper,Omen,Skye"
Lotus,Requiem,SweetNsour,16,18,9,8,10,7,"Raze,Cypher,Viper,Omen,Fade","Raze,Cypher,Viper,Omen,Fade"
Ascent,HOWL Esports,Galakticos,13,11,7,5,6,6,"Cypher,Sova,Omen,Jett,KAY/O","Sova,Omen,Jett,Astra,KAY/O"
Lotus,Reveal Multigaming,Sissi State Punks,10,13,6,6,7,4,"Breach,Cypher,Sova,Omen,Neon","Breach,Raze,Cypher,Sova,Omen"
Haven,RIZON,INF Esports,13,11,8,4,7,5,"Breach,Sova,Killjoy,Omen,Jett","Breach,Sova,Killjoy,Omen,Jett"
Sunset,6TM ESPORTS,BALD BUFF,13,10,7,5,5,6,"Raze,Cypher,Omen,KAY/O,Gekko","Cypher,Sova,Omen,KAY/O,Neon"
Ascent,MAJOR MONOGWAM,AKA HERO,1,13,1,11,2,0,"Sova,Killjoy,Omen,Jett,KAY/O","Cypher,Sova,Omen,Jett,KAY/O"
Icebox,Barça eSports,KPI Gaming,13,8,10,2,6,3,"Killjoy,Viper,Jett,KAY/O,Clove","Killjoy,Viper,Jett,KAY/O,Gekko"
Ascent,IMPERIUM,Reveal Multigaming Saphire,13,9,7,5,4,6,"Sova,Killjoy,Omen,Jett,KAY/O","Sova,Killjoy,Omen,Jett,KAY/O"
Bind,BÖSE BUBEN,ARROW,13,11,8,4,7,5,"Raze,Viper,Brimstone,Yoru,Gekko","Breach,Cypher,Brimstone,Skye,Neon"
Bind,TOG Kitsune,FOKUS Sakura,11,13,4,8,5,7,"Breach,Raze,Cypher,Brimstone,Gekko","Raze,Viper,Omen,Skye,Chamber"
Bind,trashcan,ESC Gaming,13,7,3,5,2,10,"Raze,Viper,Brimstone,Skye,Gekko","Raze,Cypher,Viper,Brimstone,Skye"
Bind,The Ultimates Odyssey,Dragons Esports GC,13,1,2,0,1,11,"Breach,Raze,Viper,Brimstone,Gekko","Raze,Viper,Brimstone,Skye,Gekko"
Lotus,HOWL Esports,Galakticos,13,5,4,2,3,9,"Raze,Cypher,Viper,Omen,Fade","Breach,Raze,Cypher,Omen,Fade"
Ascent,trashcan,ESC Gaming,13,3,9,3,0,4,"Sova,Killjoy,Sage,Omen,Jett","Sova,Killjoy,Omen,Jett,KAY/O"
Haven,Apinaorkesteri,Formulation Gaming,11,13,5,7,6,6,"Breach,Sova,Killjoy,Omen,Jett","Sova,Killjoy,Omen,Yoru,Iso"
Bind,Barça eSports,KPI Gaming,12,14,7,6,8,5,"Cypher,Viper,Yoru,Gekko,Clove","Raze,Cypher,Viper,Brimstone,Skye"
Sunset,The Ultimates Odyssey,Dragons Esports GC,13,8,3,6,2,10,"Breach,Raze,Cypher,Omen,Gekko","Breach,Raze,Cypher,Omen,Gekko"
Ascent,Eternal Fire,Fire Flux Esports,13,9,5,5,4,8,"Sova,Killjoy,Omen,Jett,KAY/O","Sova,Killjoy,Omen,Jett,KAY/O"
Lotus,Team MOTHER3 (cr8),Team SurugaMonkey (cr8),13,11,4,8,3,9,"Raze,Viper,Omen,Chamber,Fade","Breach,Raze,Killjoy,Omen,Fade"
Haven,PAPA ESPORTS,Five Ace e-Sports,8,13,4,5,8,4,"Phoenix,Reyna,Jett,Astra,Neon","Sova,Killjoy,Omen,Neon,Iso"
Sunset,B8 Esports,NOM Esports,13,8,7,5,3,6,"Breach,Cypher,Sova,Omen,Neon","Breach,Raze,Cypher,Omen,Fade"
Lotus,Apinaorkesteri,Formulation Gaming,11,13,6,6,7,5,"Breach,Sova,Killjoy,Omen,Jett","Breach,Raze,Cypher,Omen,Fade"
Ascent,Disguised,Please Don't Fire,13,5,9,3,2,4,"Cypher,Sova,Omen,Jett,Iso","Sova,Killjoy,Omen,Jett,Iso"
Ascent,Team Falcons Vega,Gamax Lite,13,1,2,0,1,11,"Sova,Killjoy,Omen,Jett,KAY/O","Cypher,Sova,Phoenix,Omen,Jett"
Bind,Eternal Fire,Fire Flux Esports,13,8,7,5,3,6,"Sova,Omen,Jett,KAY/O,Deadlock","Raze,Viper,Brimstone,Fade,Gekko"
Ascent,PAPA ESPORTS,Five Ace e-Sports,7,13,4,4,9,3,"Sova,Killjoy,Omen,Jett,KAY/O","Sova,Killjoy,Omen,Jett,KAY/O"
Lotus,Team Cpt (cr8),Team Clutch Fi (cr8),10,13,7,4,9,3,"Breach,Killjoy,Omen,Jett,Gekko","Raze,Killjoy,Omen,Fade,Clove"
Bind,Team MOTHER3 (cr8),Team SurugaMonkey (cr8),16,8,5,7,1,11,"Raze,Viper,Chamber,Gekko,Clove","Raze,Cypher,Viper,Brimstone,Skye"
Lotus,B8 Esports,NOM Esports,13,8,9,3,5,4,"Cypher,Omen,KAY/O,Neon,Fade","Raze,Killjoy,Viper,Omen,Fade"
Sunset,Apinaorkesteri,Formulation Gaming,13,7,5,3,4,8,"Cypher,Sova,Omen,Jett,KAY/O","Cypher,Sova,Omen,KAY/O,Neon"
Sunset,Team Falcons Vega,Gamax Lite,13,2,10,2,0,3,"Breach,Raze,Cypher,Omen,Gekko","Breach,Raze,Cypher,Fade,Clove"
Icebox,PAPA ESPORTS,Five Ace e-Sports,14,12,8,5,7,6,"Sova,Killjoy,Viper,Reyna,Jett","Sova,Killjoy,Viper,Jett,Iso"
Haven,Disguised,Please Don't Fire,17,15,10,6,9,7,"Cypher,Sova,Omen,Yoru,Iso","Breach,Killjoy,Omen,Neon,Iso"
Split,B8 Esports,NOM Esports,11,13,4,8,5,7,"Raze,Viper,Omen,Yoru,Fade","Raze,Cypher,Viper,Omen,Skye"
Lotus,Team Cpt (cr8),Team Francisco (cr8),14,12,4,9,3,10,"Breach,Killjoy,Omen,Jett,Gekko","Raze,Killjoy,Viper,Omen,Fade"
Ascent,Justice For Tomorrow,FOCUSGG,13,6,3,4,2,10,"Sova,Killjoy,Omen,Jett,Iso","Sova,Killjoy,Omen,Jett,KAY/O"
Ascent,LaZe,Reve Drift Arena,13,8,7,5,3,6,"Cypher,Sova,Omen,Jett,KAY/O","Breach,Cypher,Sova,Jett,Astra"
Haven,Team Cpt (cr8),Team Francisco (cr8),13,4,9,3,1,4,"Breach,Sova,Killjoy,Omen,Jett","Breach,Sova,Killjoy,Omen,Jett"
Ascent,Team Clutch Fi (cr8),Team MOTHER3 (cr8),10,14,2,10,4,8,"Sova,Killjoy,Omen,Jett,KAY/O","Sova,Killjoy,Omen,Jett,Deadlock"
Sunset,Team Kobolds, ROA,13,10,5,7,3,8,"Cypher,Sova,Omen,Jett,KAY/O","Breach,Cypher,Sova,Omen,Jett"
Bind,Justice For Tomorrow,FOCUSGG,9,13,5,5,8,4,"Cypher,Brimstone,Jett,Skye,Deadlock","Raze,Viper,Brimstone,Fade,Gekko"
Lotus,LaZe,Reve Drift Arena,14,12,4,9,3,10,"Breach,Cypher,Sova,Omen,Neon","Raze,Cypher,Viper,Omen,Skye"
Lotus,Team Kobolds, ROA,13,7,6,6,1,7,"Breach,Killjoy,Omen,Skye,Neon","Raze,Killjoy,Omen,Astra,Gekko"
Icebox,Justice For Tomorrow,FOCUSGG,13,8,6,6,2,7,"Sova,Killjoy,Viper,Jett,Iso","Sova,Killjoy,Viper,Jett,KAY/O"
Icebox,Arena Internet Cafe,JiJieHao Bonkers,13,4,8,4,0,5,"Sova,Killjoy,Viper,Sage,Jett","Killjoy,Viper,Jett,KAY/O,Gekko"
Bind,Arena Internet Cafe,JiJieHao Bonkers,13,8,6,6,2,7,"Raze,Viper,Brimstone,Skye,Gekko","Raze,Cypher,Viper,Brimstone,Gekko"
Split,Sentinels,Cloud9,13,8,6,6,2,7,"Raze,Cypher,Viper,Omen,Skye","Raze,Cypher,Viper,Omen,Skye"
Haven,Sentinels,Cloud9,13,5,7,5,0,6,"Breach,Sova,Killjoy,Omen,Jett","Breach,Killjoy,Omen,Jett,Gekko"
Bind,NRG Esports,G2 Esports,8,13,5,4,9,3,"Raze,Viper,Brimstone,Sage,Skye","Raze,Viper,Brimstone,Skye,Gekko"
Haven,NRG Esports,G2 Esports,7,13,3,5,8,4,"Omen,Yoru,Fade,Deadlock,Clove","Breach,Sova,Killjoy,Omen,Jett"
Icebox,ARROW,KONOHA,17,15,5,11,4,12,"Sova,Killjoy,Viper,Neon,Harbor","Sova,Killjoy,Viper,Jett,KAY/O"
Ascent,R8 Blues,The Ultimates Odyssey,14,12,10,3,9,4,"Astra,KAY/O,Chamber,Neon,Fade","Sova,Killjoy,Omen,Jett,KAY/O"
Haven,PCIFIC Espor,S2G Esports,13,9,4,6,3,9,"Breach,Sova,Killjoy,Omen,Jett","Sova,Killjoy,Omen,Neon,Iso"
Lotus,ARROW,KONOHA,13,11,5,7,4,8,"Breach,Killjoy,Viper,Omen,Neon","Breach,Killjoy,Omen,Neon,Gekko"
Sunset,NXT,OnlyFins,13,4,8,4,0,5,"Raze,Cypher,Sova,Omen,Yoru","Breach,Raze,Cypher,Omen,Gekko"
Lotus,R8 Blues,The Ultimates Odyssey,8,13,3,6,7,5,"Raze,Viper,Chamber,Gekko,Clove","Breach,Cypher,Sova,Omen,Neon"
Icebox,GoNext Esports,Chipi Chapa's,13,11,3,9,2,10,"Sova,Killjoy,Viper,Sage,Jett","Sova,Killjoy,Viper,Yoru,Gekko"
Sunset,UCAM Esports Club,Ramboot Club,13,8,8,4,4,5,"Breach,Cypher,Sova,Omen,Neon","Sova,Killjoy,Brimstone,Omen,Yoru"
Ascent,PCIFIC Espor,S2G Esports,14,12,6,7,5,8,"Sova,Killjoy,Omen,Jett,KAY/O","Cypher,Sova,Omen,Jett,Deadlock"
Bind,NXT,OnlyFins,13,7,7,5,2,6,"Raze,Viper,Brimstone,Fade,Gekko","Raze,Viper,Skye,Gekko,Clove"
Lotus,GoNext Esports,Chipi Chapa's,13,4,10,2,2,3,"Breach,Cypher,Sova,Omen,Neon","Breach,Raze,Cypher,Sova,Omen"
Split,Gamax Lite,Twisted Minds Orchid,6,13,4,8,5,2,"Raze,Cypher,Reyna,Omen,Fade","Breach,Raze,Cypher,Viper,Omen"
Ascent,ALTERNATE aTTaX Ruby,SK Nebula,13,10,6,5,5,7,"Sova,Killjoy,Omen,Jett,KAY/O","Sova,Killjoy,Omen,Jett,KAY/O"
Bind,PCIFIC Espor,S2G Esports,8,13,8,4,9,0,"Raze,Viper,Omen,Skye,Gekko","Raze,Brimstone,KAY/O,Gekko,Clove"
Ascent,AKA HERO,TeamOrangeGaming,13,5,5,1,4,8,"Cypher,Sova,Omen,Jett,KAY/O","Sova,Killjoy,Omen,Jett,KAY/O"
Icebox,R8 Blues,The Ultimates Odyssey,13,5,7,5,0,6,"Viper,Chamber,Neon,Gekko,Clove","Killjoy,Viper,Omen,KAY/O,Gekko"
Lotus,UCAM Esports Club,Ramboot Club,13,11,6,6,5,7,"Breach,Sova,Killjoy,Omen,Neon","Cypher,Sova,Omen,Yoru,Neon"
Sunset,Reveal Multigaming Saphire,ARROW,9,13,2,8,5,7,"Cypher,Sova,Omen,Jett,KAY/O","Breach,Cypher,Sova,Omen,Neon"
Split,Acend,Incognito,13,1,2,0,1,11,"Raze,Cypher,Reyna,Omen,Jett","Raze,Cypher,Omen,Jett,Skye"
Haven,NXT,OnlyFins,6,13,2,5,8,4,"Cypher,Sova,Omen,Jett,Yoru","Breach,Cypher,Sova,Neon,Clove"
Lotus,Gamax Lite,Twisted Minds Orchid,3,13,2,2,11,1,"Breach,Raze,Killjoy,Fade,Clove","Breach,Cypher,Omen,Neon,Fade"
Bind,Reveal Multigaming Saphire,ARROW,4,13,4,8,5,0,"Raze,Viper,Brimstone,Skye,Yoru","Breach,Cypher,Brimstone,Skye,Neon"
Lotus,ALTERNATE aTTaX Ruby,SK Nebula,14,12,9,4,8,5,"Breach,Raze,Cypher,Omen,Fade","Breach,Raze,Cypher,Viper,Omen"
Lotus,AKA HERO,TeamOrangeGaming,13,9,9,3,6,4,"Breach,Cypher,Sova,Omen,Neon","Breach,Raze,Cypher,Omen,Skye"
Haven,UCAM Esports Club,Ramboot Club,13,11,5,7,4,8,"Breach,Cypher,Sova,Omen,Neon","Cypher,Sova,Omen,Yoru,Iso"
Ascent,Acend,Incognito,13,8,4,5,3,9,"Viper,Phoenix,Sage,Jett,Astra","Sova,Killjoy,Jett,Iso,Clove"
Icebox,Papara SuperMassive,Galatasaray Esports,10,13,2,9,4,8,"Killjoy,Viper,KAY/O,Gekko,Iso","Sova,Killjoy,Viper,Jett,Harbor"
Icebox,Metizport,Apeks,10,13,6,6,7,4,"Sova,Killjoy,Viper,Sage,Iso","Sova,Killjoy,Viper,Sage,Jett"
Bind,Team Francisco (cr8),Team MOTHER3 (cr8),13,9,4,8,1,9,"Raze,Viper,Brimstone,Skye,Gekko","Raze,Viper,Chamber,Gekko,Clove"
Sunset,Acend,Incognito,7,13,5,7,6,2,"Raze,Cypher,Omen,KAY/O,Gekko","Breach,Raze,Cypher,Omen,Iso"
Bind,Dragons Esports GC,R8 Blues,11,13,8,4,9,3,"Raze,Viper,Brimstone,Skye,Gekko","Viper,Phoenix,Sage,Gekko,Clove"
Icebox,Twisted Minds Orchid,Team Falcons Vega,6,13,6,6,7,0,"Sova,Viper,Sage,Jett,Iso","Sova,Killjoy,Viper,Jett,Gekko"
Split,Papara SuperMassive,Galatasaray Esports,14,16,6,9,7,8,"Breach,Raze,Cypher,Omen,Skye","Raze,Viper,Omen,Jett,Skye"
Ascent,Team Francisco (cr8),Team MOTHER3 (cr8),13,10,9,3,7,4,"Sova,Killjoy,Omen,Jett,KAY/O","Sova,Killjoy,Omen,Jett,Deadlock"
Lotus,Metizport,Apeks,7,13,5,7,6,2,"Raze,Killjoy,Viper,Omen,Fade","Raze,Killjoy,Viper,Omen,Fade"
Ascent,Dragons Esports GC,R8 Blues,4,13,2,3,10,2,"Sova,Killjoy,Omen,Jett,KAY/O","Astra,KAY/O,Chamber,Neon,Fade"
Lotus,Twisted Minds Orchid,Team Falcons Vega,10,13,5,6,7,5,"Breach,Cypher,Omen,Neon,Fade","Killjoy,Viper,Omen,Neon,Gekko"
Haven,Team Francisco (cr8),Team Clutch Fi (cr8),7,13,3,5,8,4,"Breach,Sova,Killjoy,Omen,Jett","Breach,Cypher,Sova,Omen,Jett"
Icebox,DRX,Talon Esports,13,5,12,0,5,1,"Killjoy,Viper,Jett,KAY/O,Clove","Sova,Killjoy,Harbor,Iso,Clove"
Haven,DRX,Talon Esports,13,10,7,5,5,6,"Breach,Cypher,Sova,Omen,Jett","Breach,Killjoy,Astra,Neon,Iso"
Ascent,DRX,Talon Esports,11,13,8,4,9,3,"Cypher,Sova,Omen,Jett,KAY/O","Sova,Phoenix,Sage,KAY/O,Clove"
Sunset,Paper Rex,DetonatioN FocusMe,13,8,5,4,4,8,"Breach,Raze,Sage,Omen,Gekko","Breach,Raze,Cypher,Omen,Gekko"
Icebox,Paper Rex,DetonatioN FocusMe,13,4,10,2,2,3,"Killjoy,Viper,Sage,Jett,KAY/O","Sova,Killjoy,Viper,Jett,Harbor"
Sunset,Special Grade,SaD Esports,11,13,8,4,9,3,"Breach,Raze,Cypher,Omen,Gekko","Breach,Raze,Cypher,Sova,Omen"
Sunset,Akave Esports Black,FUSION X,13,9,6,6,3,7,"Breach,Raze,Cypher,Omen,Gekko","Raze,Cypher,Omen,KAY/O,Gekko"
Bind,MYVRA,KS Esports GC,2,13,1,11,2,1,"Breach,Raze,Cypher,Gekko,Clove","Raze,Brimstone,Sage,Fade,Gekko"
Icebox,Special Grade,SaD Esports,18,16,9,8,8,9,"Sova,Killjoy,Viper,Jett,Clove","Killjoy,Viper,Jett,KAY/O,Gekko"
Haven,Leviatán,100 Thieves,13,4,3,2,2,10,"Breach,Cypher,Sova,Omen,Neon","Sova,Killjoy,Omen,Jett,KAY/O"
Ascent,MYVRA,KS Esports GC,2,13,2,10,3,0,"Breach,Sova,Killjoy,Jett,Clove","Cypher,Sova,Omen,Jett,Deadlock"
Split,Akave Esports Black,FUSION X,13,7,6,6,1,7,"Raze,Cypher,Omen,Jett,Skye","Raze,Sage,Astra,Gekko,Deadlock"
Haven,Special Grade,SaD Esports,10,13,4,7,6,6,"Breach,Cypher,Sova,Omen,Jett","Sova,Jett,Astra,Deadlock,Iso"
Bind,Leviatán,100 Thieves,13,10,5,6,4,8,"Raze,Viper,Brimstone,Fade,Gekko","Raze,Viper,Brimstone,Fade,Gekko"
Lotus,Dasein Club GC,OXEN GC,9,13,4,6,7,5,"Breach,Cypher,Omen,Neon,Gekko","Breach,Killjoy,Omen,Neon,Gekko"
Bind,Goldie Oldies,Special Grade,8,13,6,3,10,2,"Raze,Cypher,Viper,Brimstone,Skye","Raze,Viper,Brimstone,Skye,Iso"
Ascent,Deagle Ravagers,Return of the Ashes,13,7,6,2,5,7,"Sova,Killjoy,Omen,Jett,KAY/O","Sova,Killjoy,Omen,Jett,KAY/O"
Breeze,Zen eSports GC,University War GC,6,13,3,4,9,3,"Cypher,Sova,Viper,Jett,KAY/O","Cypher,Sova,Viper,Jett,KAY/O"
Breeze,Zen eSports GC,University War GC,6,13,3,4,9,3,"Cypher,Sova,Viper,Jett,KAY/O","Cypher,Sova,Viper,Jett,KAY/O"
Sunset,LOUD,MIBR,13,9,7,3,6,6,"Breach,Cypher,Omen,Neon,Gekko","Breach,Raze,Cypher,Omen,Gekko"
Bind,FiRePOWER GC,9z Team GC,7,13,5,7,6,2,"Raze,Viper,Brimstone,Skye,Gekko","Viper,Brimstone,Skye,Neon,Deadlock"
Bind,Dasein Club GC,OXEN GC,13,10,6,6,4,7,"Viper,Brimstone,Skye,Neon,Iso","Raze,Cypher,Brimstone,Skye,Iso"
Lotus,Squishy Squabblers,fluffy kittens,7,13,5,7,6,2,"Breach,Raze,Omen,Gekko,Deadlock","Raze,Killjoy,Viper,Omen,Fade"
Ascent,Goldie Oldies,Special Grade,13,15,2,12,3,11,"Cypher,Sova,Omen,Jett,KAY/O","Sova,Killjoy,Omen,Jett,KAY/O"
Bind,yves saint laurent,SaD Esports,5,13,2,10,3,3,"Raze,Reyna,Skye,Chamber,Clove","Raze,Cypher,Viper,Brimstone,Skye"
Ascent,Zen eSports GC,University War GC,3,13,3,9,4,0,"Sova,Killjoy,Omen,Jett,KAY/O","Sova,Killjoy,Omen,Jett,KAY/O"
Ascent,Zen eSports GC,University War GC,3,13,3,9,4,0,"Sova,Killjoy,Omen,Jett,KAY/O","Sova,Killjoy,Omen,Jett,KAY/O"
Lotus,FiRePOWER GC,9z Team GC,8,13,6,6,7,2,"Cypher,Omen,Neon,Fade,Gekko","Breach,Cypher,Omen,Neon,Gekko"
Ascent,Dasein Club GC,OXEN GC,6,13,0,7,6,6,"Sova,Killjoy,Omen,Jett,KAY/O","Sova,Killjoy,Omen,Jett,KAY/O"
Icebox,Deagle Ravagers,Return of the Ashes,13,11,7,5,6,6,"Sova,Killjoy,Viper,Jett,KAY/O","Killjoy,Viper,Reyna,Harbor,Gekko"
Lotus,LOUD,MIBR,11,13,6,6,7,5,"Cypher,Omen,Neon,Fade,Gekko","Raze,Killjoy,Viper,Omen,Fade"
Haven,Squishy Squabblers,fluffy kittens,5,13,3,9,4,2,"Breach,Sova,Killjoy,Omen,Jett","Breach,Sova,Killjoy,Omen,Jett"
Lotus,Goldie Oldies,Special Grade,13,4,3,2,2,10,"Breach,Raze,Cypher,Omen,Fade","Breach,Raze,Killjoy,Omen,Gekko"
Haven,yves saint laurent,SaD Esports,10,13,8,4,9,2,"Sova,Killjoy,Reyna,Omen,Jett","Sova,Jett,Astra,Deadlock,Iso"
Sunset,Squishy Squabblers,fluffy kittens,5,13,4,8,5,1,"Breach,Raze,Cypher,Omen,Gekko","Breach,Raze,Cypher,Omen,Gekko"
Ascent,LOUD,MIBR,13,7,5,3,4,8,"Cypher,Sova,Omen,Jett,KAY/O","Sova,Killjoy,Omen,Jett,KAY/O"
Icebox,Special Grade,Friends Over Everything,13,7,7,5,2,6,"Sova,Killjoy,Viper,Jett,Clove","Killjoy,Viper,Jett,KAY/O,Gekko"
Ascent,Ions Day Care,Goldie Oldies,4,13,3,9,4,1,"Sova,Killjoy,Omen,Yoru,Iso","Cypher,Sova,Omen,Jett,KAY/O"
Sunset,Blue Otter,SaD Esports,10,13,4,7,6,6,"Breach,Cypher,Sova,Omen,Neon","Breach,Raze,Cypher,Sova,Omen"
Ascent,Special Grade,Friends Over Everything,13,0,12,0,0,1,"Sova,Killjoy,Omen,Jett,KAY/O","Cypher,Sova,Omen,Jett,Deadlock"
Icebox,Valiant,Joblife,8,13,5,7,6,3,"Killjoy,Viper,Jett,KAY/O,Gekko","Sova,Killjoy,Viper,Reyna,Jett"
Sunset,Ions Day Care,Goldie Oldies,13,5,6,0,5,7,"Raze,Cypher,Sova,Omen,Yoru","Breach,Raze,Cypher,Sova,Omen"
Ascent,yves saint laurent,SR and Friends,13,9,5,7,2,8,"Sova,Killjoy,Phoenix,Omen,Jett","Sova,Killjoy,Omen,Jett,KAY/O"
Icebox,Silly Weapons All Game,NOMAD GC,13,7,5,3,4,8,"Sova,Killjoy,Viper,Jett,Gekko","Sova,Killjoy,Jett,Harbor,Gekko"
Bind,Ions Day Care,Goldie Oldies,6,13,1,6,7,5,"Viper,Brimstone,Skye,Yoru,Deadlock","Raze,Cypher,Viper,Brimstone,Skye"
Sunset,Special Grade,Friends Over Everything,6,13,2,5,8,4,"Breach,Raze,Cypher,Omen,Gekko","Cypher,Sova,Omen,KAY/O,Neon"
Abyss,True Synergy Gaming,Eternal Focus Crimson,13,11,5,7,4,8,"Raze,Cypher,Harbor,Gekko,Clove","Cypher,Sova,Omen,Yoru,Harbor"
Icebox,yves saint laurent,SR and Friends,13,6,7,5,1,6,"Sova,Killjoy,Viper,Reyna,Jett","Sova,Killjoy,Viper,Harbor,Iso"
Haven,Blue Otter,SaD Esports,13,15,4,10,5,9,"Breach,Sova,Killjoy,Omen,Jett","Sova,Jett,Astra,Deadlock,Iso"
Sunset,Formulation Gaming GC,axolotls and chips,15,13,9,5,8,6,"Breach,Raze,Cypher,Sova,Omen","Breach,Cypher,Sova,Reyna,Harbor"
Icebox,Diamant Esports,trashcan,11,13,4,8,5,7,"Breach,Raze,Killjoy,Viper,Gekko","Sova,Killjoy,Viper,Jett,KAY/O"
Lotus,Last9,SK Nebula,15,17,9,7,10,6,"Breach,Raze,Cypher,Omen,Fade","Breach,Raze,Cypher,Viper,Omen"
Ascent,EMUs,NUXERIA GC,14,12,10,3,9,4,"Cypher,Sova,Omen,Yoru,Deadlock","Sova,Killjoy,Omen,Jett,KAY/O"
Ascent,Valiant,Joblife,6,13,1,6,7,5,"Sova,Killjoy,Omen,Jett,KAY/O","Sova,Killjoy,Omen,Jett,KAY/O"
Ascent,Celestials GC,Anonymo GC,13,4,8,4,0,5,"Breach,Jett,KAY/O,Deadlock,Clove","Sova,Killjoy,Phoenix,Omen,Jett"
Ascent,Fire Flux Esports,Fenerbahçe Esports,13,4,8,4,0,5,"Sova,Killjoy,Omen,Jett,KAY/O","Cypher,Sova,Omen,Jett,Deadlock"
Split,Team RA'AD,R8 Esports,7,13,3,9,4,4,"Raze,Cypher,Viper,Omen,Skye","Raze,Cypher,Viper,Omen,Skye"
Lotus,NYAN Esports,Veni eSports Venom,13,5,7,5,0,6,"Breach,Cypher,Sova,Omen,Yoru","Breach,Raze,Killjoy,Omen,Gekko"
Icebox,HGE Esports,Axolotl,13,8,8,4,4,5,"Sova,Killjoy,Viper,Sage,Jett","Killjoy,Viper,Reyna,Jett,Gekko"
Lotus,True Synergy Gaming,Eternal Focus Crimson,13,6,4,3,3,9,"Raze,Killjoy,Gekko,Iso,Clove","Breach,Raze,Cypher,Omen,Fade"
Bind,EMUs,NUXERIA GC,13,3,4,0,3,9,"Raze,Brimstone,Yoru,Harbor,Gekko","Raze,Cypher,Brimstone,Skye,Gekko"
Lotus,Diamant Esports,trashcan,5,13,4,2,11,1,"Killjoy,Omen,Skye,Astra,Neon","Raze,Killjoy,Viper,Omen,Fade"
Haven,Requiem,Formulation Gaming,13,7,7,1,6,6,"Killjoy,Viper,Omen,Jett,Skye","Sova,Killjoy,Omen,Yoru,Iso"
Lotus,Silly Weapons All Game,NOMAD GC,13,11,4,8,3,9,"Breach,Raze,Killjoy,Astra,Gekko","Breach,Raze,Killjoy,Omen,Fade"
Lotus,Formulation Gaming GC,axolotls and chips,13,8,6,6,2,7,"Raze,Killjoy,Viper,Omen,Fade","Raze,Cypher,Omen,Fade,Deadlock"
Sunset,Last9,SK Nebula,13,8,5,7,1,8,"Cypher,Sova,Omen,KAY/O,Neon","Raze,Cypher,Viper,Omen,Fade"
Ascent,SiXSENSE GC,Lotus Karma,7,13,2,6,7,5,"Breach,Sova,Killjoy,Omen,Jett","Sova,Killjoy,Omen,Jett,KAY/O"
Icebox,NYAN Esports,Veni eSports Venom,13,8,8,1,7,5,"Sova,Killjoy,Viper,Jett,Gekko","Sova,Killjoy,Viper,Reyna,Deadlock"
Lotus,Acient Freya,Hex Esports,11,13,8,4,9,3,"Breach,Killjoy,Omen,Neon,Gekko","Breach,Raze,Killjoy,Neon,Clove"
Sunset,CGN Esports,SK Gaming,13,3,4,0,3,9,"Raze,Cypher,Sova,Sage,Omen","Killjoy,Brimstone,Omen,Jett,Gekko"
Lotus,Fire Flux Esports,Fenerbahçe Esports,13,3,4,0,3,9,"Breach,Cypher,Omen,Neon,Gekko","Raze,Cypher,Omen,Fade,Deadlock"
Bind,Celestials GC,Anonymo GC,13,10,7,4,6,6,"Cypher,Reyna,Gekko,Iso,Clove","Breach,Raze,Cypher,Brimstone,Iso"
Lotus,DVM Esport,Zerance,11,13,5,7,6,6,"Raze,Cypher,Phoenix,Omen,Fade","Raze,Cypher,Viper,Omen,Skye"
Lotus,VX300 Gaming,LONETEAM,13,3,4,0,3,9,"Raze,Killjoy,Omen,Skye,Astra","Killjoy,Omen,Neon,Fade,Deadlock"
Sunset,Acient Freya,Hex Esports,6,13,1,6,7,5,"Breach,Cypher,Sova,Omen,Neon","Breach,Raze,Cypher,Gekko,Clove"
Sunset,Diamant Esports,trashcan,13,11,9,3,8,4,"Raze,Killjoy,Omen,Astra,Fade","Raze,Cypher,Viper,Omen,Skye"
Lotus,Team RA'AD,R8 Esports,14,16,6,9,7,8,"Raze,Omen,Fade,Deadlock,Clove","Raze,Killjoy,Omen,Skye,Astra"
Split,Formulation Gaming GC,axolotls and chips,11,13,7,5,8,4,"Raze,Cypher,Viper,Omen,Skye","Breach,Cypher,Omen,Jett,Deadlock"
Icebox,Last9,SK Nebula,8,13,2,7,6,6,"Sova,Killjoy,Viper,Jett,Gekko","Sova,Killjoy,Viper,Sage,Jett"
Icebox,SiXSENSE GC,Lotus Karma,9,13,6,6,7,3,"Sova,Killjoy,Viper,Jett,Clove","Sova,Killjoy,Viper,Harbor,Gekko"
Breeze,Celestials GC,Anonymo GC,6,13,4,8,5,2,"Cypher,Sova,Jett,Neon,Harbor","Cypher,Sova,Viper,Jett,Yoru"
Lotus,EMUs,NUXERIA GC,13,15,8,6,9,5,"Raze,Cypher,Omen,Fade,Deadlock","Breach,Raze,Killjoy,Omen,Gekko"
Sunset,Silly Weapons All Game,NOMAD GC,10,13,2,9,4,8,"Breach,Raze,Cypher,Gekko,Clove","Breach,Cypher,Sova,Omen,Jett"
Sunset,Requiem,Formulation Gaming,14,12,7,6,6,7,"Raze,Cypher,Omen,KAY/O,Gekko","Cypher,Sova,Omen,KAY/O,Neon"
Split,DVM Esport,Zerance,13,10,5,7,3,8,"Raze,Viper,Jett,Skye,Astra","Raze,Viper,Omen,Jett,Skye"
Sunset,HOWL Esports,Istanbul Wildcats,9,13,4,6,7,5,"Raze,Cypher,Omen,KAY/O,Gekko","Breach,Cypher,Sova,Omen,Neon"
Icebox,Team RA'AD,R8 Esports,6,13,1,6,7,5,"Killjoy,Viper,Sage,Gekko,Clove","Killjoy,Viper,Sage,Reyna,Gekko"
Ascent,ESC Gaming,NOM Esports,9,13,6,6,7,3,"Sova,Killjoy,Omen,Jett,KAY/O","Sova,Killjoy,Omen,Jett,KAY/O"
Bind,DSYRE,Outplayed,13,4,3,2,2,10,"Raze,Viper,Brimstone,Skye,Gekko","Raze,Cypher,Viper,Brimstone,Skye"
Sunset,DVM Esport,Zerance,8,13,5,4,9,3,"Raze,Cypher,Phoenix,Omen,Fade","Breach,Raze,Cypher,Sova,Omen"
Icebox,HOWL Esports,Istanbul Wildcats,10,13,5,7,6,5,"Killjoy,Viper,Jett,Skye,Harbor","Killjoy,Jett,KAY/O,Harbor,Gekko"
Sunset,ALTERNATE aTTaX,MOUZ,10,13,7,5,8,3,"Raze,Cypher,Omen,KAY/O,Gekko","Breach,Raze,Cypher,Sova,Omen"
Bind,Metizport,SweetNsour,12,14,6,7,7,6,"Raze,Viper,Skye,Astra,Deadlock","Viper,Brimstone,Skye,Yoru,Gekko"
Icebox,ESC Gaming,NOM Esports,11,13,6,6,7,5,"Killjoy,Viper,Jett,KAY/O,Gekko","Sova,Killjoy,Viper,Sage,Jett"
Sunset,EX0TIK GAMING,Impulse GW,13,6,7,5,1,6,"Breach,Raze,Cypher,Omen,Gekko","Viper,Sage,Omen,KAY/O,Gekko"
Haven,ALTERNATE aTTaX,MOUZ,2,13,0,3,10,2,"Breach,Cypher,Sova,Omen,Neon","Breach,Sova,Killjoy,Omen,Jett"
Bind,HOWL Esports,Istanbul Wildcats,13,11,7,5,6,6,"Raze,Viper,Brimstone,Skye,Gekko","Breach,Raze,Cypher,Omen,Yoru"
Bind,EX0TIK GAMING,Impulse GW,13,2,10,2,0,3,"Raze,Viper,Brimstone,Skye,Yoru","Raze,Viper,Brimstone,Skye,KAY/O"
Lotus,Metizport,SweetNsour,11,13,7,5,8,4,"Raze,Killjoy,Viper,Omen,Fade","Raze,Cypher,Viper,Omen,Fade"
Bind,Eintracht Frankfurt,XPERION NXT,13,11,6,6,5,7,"Raze,Viper,Yoru,Gekko,Clove","Raze,Viper,Brimstone,Fade,Gekko"
Icebox,Bleed Esports,Gen.G Esports,11,13,7,5,8,4,"Sova,Killjoy,Viper,Jett,KAY/O","Killjoy,Viper,Jett,KAY/O,Gekko"
Sunset,Eintracht Frankfurt,XPERION NXT,13,10,6,6,4,7,"Breach,Cypher,Omen,Neon,Fade","Raze,Cypher,Reyna,Omen,KAY/O"
Sunset,Bleed Esports,Gen.G Esports,13,10,8,3,7,5,"Cypher,Sova,Omen,Jett,KAY/O","Cypher,Sova,Omen,Jett,KAY/O"
Ascent,Bleed Esports,Gen.G Esports,6,13,6,6,7,0,"Sova,Killjoy,Omen,Jett,KAY/O","Sova,Killjoy,Omen,Jett,KAY/O"
Ascent,Global Esports,T1,8,13,6,6,7,2,"Sova,Killjoy,Omen,Jett,KAY/O","Sova,Killjoy,Omen,Jett,KAY/O"
Lotus,Global Esports,T1,8,13,4,8,5,4,"Breach,Cypher,Omen,Neon,Fade","Raze,Viper,Omen,Chamber,Fade"
Icebox,Global Esports,T1,13,10,6,5,5,7,"Killjoy,Viper,Sage,Jett,KAY/O","Viper,Jett,KAY/O,Chamber,Gekko"
Bind,Evergarden GC,VIXENS,3,13,1,3,10,2,"Raze,Cypher,Brimstone,Skye,Clove","Raze,Viper,Brimstone,Fade,Gekko"
Lotus,raindrops,Scissor Sisters,13,2,12,0,2,1,"Raze,Cypher,Omen,Fade,Gekko","Raze,Killjoy,Reyna,Omen,Skye"
Sunset,Evergarden GC,VIXENS,13,8,6,3,5,7,"Cypher,Sova,Phoenix,Omen,Neon","Breach,Raze,Cypher,Omen,Gekko"
Lotus,swaglord9000,DXA Esports,13,6,4,3,3,9,"Raze,Killjoy,Omen,Fade,Deadlock","Breach,Raze,Cypher,Gekko,Clove"
Ascent,KS Esports GC,Barcelona Sporting X,13,5,5,1,4,8,"Cypher,Sova,Omen,Jett,Deadlock","Sova,Killjoy,Omen,Jett,KAY/O"
Split,FUSION X,Bon Bon Bum Contra GC,13,4,5,0,4,8,"Raze,Sage,Astra,Gekko,Deadlock","Breach,Cypher,Omen,Gekko,Iso"
Sunset,raindrops,Scissor Sisters,13,5,4,2,3,9,"Breach,Raze,Cypher,Omen,Gekko","Breach,Raze,Cypher,Gekko,Clove"
Ascent,swaglord9000,DXA Esports,13,6,7,5,1,6,"Cypher,Sova,Omen,Yoru,Deadlock","Sova,Killjoy,Omen,Jett,KAY/O"
Icebox,Evergarden GC,VIXENS,4,13,4,8,5,0,"Raze,Killjoy,Viper,Yoru,Fade","Killjoy,Viper,Jett,KAY/O,Gekko"
Ascent,MYVRA,Ragnus Esports,13,2,2,1,1,11,"Breach,Sova,Killjoy,Jett,Clove","Breach,Sova,Killjoy,Omen,Jett"
Lotus,KS Esports GC,Barcelona Sporting X,11,13,6,6,7,5,"Raze,Cypher,Omen,Fade,Deadlock","Raze,Killjoy,Viper,Omen,Skye"
Sunset,FUSION X,Bon Bon Bum Contra GC,11,13,3,9,4,8,"Raze,Cypher,Omen,KAY/O,Gekko","Breach,Sova,Sage,Omen,Gekko"
Icebox,Akave Esports Black,New Combat Line GC,13,0,12,0,0,1,"Sova,Killjoy,Viper,Sage,Gekko","Sova,Killjoy,Viper,Jett,KAY/O"
Sunset,LAS FLAUTAS,Squishy Squabblers,10,13,4,8,5,6,"Raze,Cypher,Omen,KAY/O,Gekko","Breach,Raze,Cypher,Omen,Gekko"
Ascent,polar bear,Scissor Sisters,12,14,6,7,7,6,"Cypher,Sova,Phoenix,Omen,Iso","Cypher,Sova,Omen,Jett,KAY/O"
Bind,KS Esports GC,Barcelona Sporting X,13,5,3,3,2,10,"Raze,Brimstone,Sage,Fade,Gekko","Cypher,Brimstone,Jett,Skye,Yoru"
Icebox,Blossom,VIXENS,4,13,1,4,9,3,"Killjoy,Omen,Jett,Harbor,Gekko","Killjoy,Viper,Jett,KAY/O,Gekko"
Haven,DXA Esports,Evergarden GC,13,1,2,0,1,11,"Breach,Cypher,Sova,Omen,Jett","Sova,Killjoy,Omen,Yoru,Neon"
Lotus,raindrops,swaglord9000,11,13,6,6,7,5,"Raze,Cypher,Omen,Fade,Gekko","Raze,Killjoy,Omen,Fade,Deadlock"
Lotus,Akave Esports Black,New Combat Line GC,13,2,10,2,0,3,"Breach,Raze,Cypher,Omen,Gekko","Breach,Cypher,Omen,Neon,Gekko"
Lotus,FUSION X,Bon Bon Bum Contra GC,13,8,6,6,2,7,"Breach,Raze,Killjoy,Omen,Skye","Breach,Raze,Cypher,Omen,Gekko"
Ascent,winners circle,GG Only,13,4,4,1,3,9,"Sova,Killjoy,Omen,Jett,KAY/O","Sova,Killjoy,Omen,Jett,KAY/O"
Haven,BOTO BASHERS,fluffy kittens,5,13,2,10,3,3,"Breach,Killjoy,Omen,Jett,Gekko","Breach,Sova,Killjoy,Omen,Jett"
Lotus,LAS FLAUTAS,Squishy Squabblers,13,8,7,5,3,6,"Raze,Reyna,Omen,Jett,Astra","Breach,Raze,Omen,Gekko,Deadlock"
Sunset,polar bear,Scissor Sisters,4,13,2,3,10,2,"Sova,Sage,Reyna,Omen,Neon","Breach,Raze,Cypher,Gekko,Clove"
Ascent,raindrops,swaglord9000,1,13,0,2,11,1,"Cypher,Sova,Omen,Yoru,Deadlock","Cypher,Sova,Omen,Yoru,Deadlock"
Lotus,Blossom,VIXENS,6,13,1,6,7,5,"Breach,Raze,Killjoy,Omen,Fade","Breach,Raze,Cypher,Astra,Fade"
Ascent,DXA Esports,Evergarden GC,13,6,7,0,6,6,"Sova,Killjoy,Omen,Jett,KAY/O","Sova,Killjoy,Omen,Jett,Yoru"
Split,Sentinels,KRÜ Esports,13,10,8,4,6,5,"Raze,Cypher,Viper,Omen,Skye","Raze,Cypher,Viper,Omen,Skye"
Sunset,winners circle,GG Only,13,10,7,5,5,6,"Breach,Cypher,Omen,Jett,Neon","Breach,Raze,Cypher,Omen,Gekko"
Sunset,BOTO BASHERS,fluffy kittens,8,13,2,10,3,6,"Breach,Raze,Cypher,Omen,Gekko","Breach,Raze,Cypher,Omen,Gekko"
Haven,LAS FLAUTAS,Squishy Squabblers,8,13,3,6,7,5,"Breach,Sova,Killjoy,Omen,Neon","Breach,Sova,Killjoy,Omen,Jett"
Ascent,University War GC,Dasein Club GC,13,7,6,2,5,7,"Sova,Killjoy,Omen,Jett,KAY/O","Sova,Killjoy,Omen,Jett,KAY/O"
Lotus,Blue Otter,English or Spanish,15,13,7,7,6,8,"Breach,Raze,Cypher,Omen,Gekko","Breach,Raze,Omen,Chamber,Gekko"
Lotus,Zen eSports GC,OXEN GC,13,4,3,2,2,10,"Raze,Killjoy,Viper,Omen,Fade","Breach,Raze,Killjoy,Omen,Gekko"
Ascent,OutGoing Esports,LAS FLAUTAS,8,13,2,7,6,6,"Sova,Killjoy,Omen,Jett,KAY/O","Sova,Killjoy,Omen,Jett,KAY/O"
Sunset,Blue Otter,English or Spanish,13,5,9,3,2,4,"Breach,Cypher,Sova,Omen,Neon","Breach,Raze,Cypher,Omen,Gekko"
Bind,Goated,winners circle,8,13,4,8,5,4,"Raze,Cypher,Brimstone,Skye,Gekko","Raze,Cypher,Brimstone,Skye,Gekko"
Ascent,GG Only,RECR,14,12,7,6,6,7,"Sova,Killjoy,Omen,Jett,KAY/O","Sova,Killjoy,Omen,Jett,KAY/O"
Lotus,Sentinels,KRÜ Esports,13,11,8,4,7,5,"Breach,Raze,Cypher,Omen,Fade","Raze,Killjoy,Viper,Omen,Fade"
Icebox,9z Team GC,Deagle Ravagers,13,11,8,4,7,5,"Killjoy,Viper,Jett,KAY/O,Gekko","Sova,Killjoy,Viper,Jett,KAY/O"
Ascent,Goldie Oldies,IOUNL,13,7,2,6,1,11,"Cypher,Sova,Omen,Jett,KAY/O","Cypher,Sova,Omen,Jett,Deadlock"
Breeze,University War GC,Dasein Club GC,17,15,9,7,8,8,"Cypher,Sova,Viper,Jett,KAY/O","Cypher,Sova,Viper,Jett,Yoru"
Sunset,Eternal Focus Crimson,Lucky 7 Gaming,15,13,7,7,6,8,"Breach,Raze,Cypher,Omen,Fade","Breach,Raze,Cypher,Omen,Fade"
Sunset,Friends Over Everything,Aspyre x Swarm,13,9,7,5,4,6,"Cypher,Sova,Omen,KAY/O,Neon","Breach,Cypher,Omen,Neon,Gekko"
Ascent,Zen eSports GC,OXEN GC,13,7,7,5,2,6,"Sova,Killjoy,Omen,Jett,KAY/O","Sova,Killjoy,Omen,Jett,KAY/O"
Icebox,SR and Friends,Nightblood Gaming,13,7,9,3,4,4,"Sova,Killjoy,Viper,Sage,Iso","Sova,Killjoy,Viper,Omen,Jett"
Ascent,jasmins kittens,BOTO BASHERS,6,13,2,10,3,4,"Sova,Killjoy,Jett,Harbor,Clove","Sova,Killjoy,Omen,Jett,KAY/O"
Lotus,9z Team GC,Deagle Ravagers,13,4,4,1,3,9,"Breach,Cypher,Omen,Neon,Gekko","Breach,Cypher,Omen,Neon,Fade"
Lotus,Evil Geniuses,FURIA,13,4,3,2,2,10,"Breach,Cypher,Omen,Neon,Fade","Breach,Cypher,Omen,KAY/O,Neon"
Sunset,OutGoing Esports,LAS FLAUTAS,13,15,4,10,5,9,"Breach,Raze,Cypher,Sova,Omen","Breach,Raze,Cypher,Omen,Gekko"
Ascent,RECR,Ibreon Scarlet,14,12,5,8,4,9,"Sova,Killjoy,Omen,Jett,KAY/O","Sova,Killjoy,Omen,Jett,KAY/O"
Haven,Blue Otter,English or Spanish,9,13,3,7,6,6,"Breach,Sova,Killjoy,Omen,Jett","Breach,Cypher,Sova,Omen,Jett"
Bind,Goated,Omnipotence,13,10,5,6,4,8,"Raze,Cypher,Brimstone,Skye,Gekko","Raze,Cypher,Brimstone,Skye,Fade"
Haven,Appy Juice,Squishy Squabblers,5,13,3,3,10,2,"Breach,Cypher,Sova,Omen,Jett","Breach,Sova,Killjoy,Omen,Jett"
Ascent,Astane Anarchy,GG Only,4,13,2,10,3,2,"Sova,Killjoy,Omen,Jett,KAY/O","Sova,Killjoy,Omen,Jett,KAY/O"
Lotus,Dexterity Gaming,yves saint laurent,11,13,2,10,3,9,"Breach,Cypher,Omen,Skye,Neon","Raze,Killjoy,Fade,Deadlock,Clove"
Abyss,True Synergy Gaming,Luminescent Sapphire,13,3,11,1,2,2,"Raze,Cypher,Harbor,Gekko,Clove","Breach,Sova,Yoru,Astra,Harbor"
Ascent,Ions Day Care,Paranoia Vortex,14,12,7,6,6,7,"Sova,Killjoy,Omen,Yoru,Iso","Sova,Killjoy,Omen,Jett,Iso"
Sunset,fluffy kittens,Alliance Guardians,13,8,7,2,6,6,"Breach,Raze,Cypher,Omen,Gekko","Breach,Raze,Cypher,Omen,Gekko"
Haven,Goldie Oldies,IOUNL,13,11,6,6,5,7,"Breach,Cypher,Sova,Omen,Neon","Breach,Sova,Killjoy,Omen,Jett"
Haven,SR and Friends,Nightblood Gaming,13,7,8,4,3,5,"Breach,Sova,Killjoy,Omen,Jett","Breach,Sova,Killjoy,Omen,Jett"
Icebox,jasmins kittens,BOTO BASHERS,6,13,5,7,6,1,"Viper,Sage,Reyna,Deadlock,Iso","Sova,Killjoy,Viper,Jett,Gekko"
Breeze,winners circle,Eccentric,13,9,9,3,6,4,"Cypher,Sova,Viper,Reyna,Jett","Cypher,Viper,Jett,KAY/O,Iso"
Ascent,Dexterity Gaming,yves saint laurent,2,13,2,10,3,0,"Sova,Killjoy,Omen,Jett,KAY/O","Sova,Killjoy,Phoenix,Omen,Jett"
Lotus,SaD Esports,MadBandits,13,5,9,3,2,4,"Breach,Raze,Cypher,Sova,Omen","Breach,Raze,Omen,Jett,Skye"
Lotus,Friends Over Everything,Aspyre x Swarm,13,10,6,6,4,7,"Raze,Cypher,Omen,Fade,Deadlock","Breach,Cypher,Neon,Gekko,Clove"
Lotus,Eternal Focus Crimson,Lucky 7 Gaming,13,8,9,3,5,4,"Breach,Raze,Cypher,Omen,Fade","Raze,Killjoy,Viper,Omen,Fade"
Haven,OutGoing Esports,LAS FLAUTAS,14,12,8,5,7,6,"Breach,Sova,Killjoy,Omen,Jett","Sova,Killjoy,Omen,Jett,Fade"
Ascent,Echo Enforcers,Astane Anarchy,0,13,0,1,12,0,"Cypher,Killjoy,Jett,KAY/O,Clove","Breach,Phoenix,Yoru,Deadlock,Clove"
Lotus,Appy Juice,Squishy Squabblers,6,13,0,7,6,6,"Breach,Raze,Killjoy,Omen,Fade","Breach,Raze,Omen,Gekko,Deadlock"
Haven,Ions Day Care,Paranoia Vortex,13,6,7,5,1,6,"Breach,Cypher,Sova,Omen,Yoru","Sova,Killjoy,Omen,Jett,Iso"
Lotus,True Synergy Gaming,Luminescent Sapphire,13,8,6,6,2,7,"Raze,Killjoy,Reyna,Gekko,Clove","Breach,Chamber,Neon,Gekko,Clove"
Haven,fluffy kittens,Alliance Guardians,13,2,3,0,2,10,"Breach,Sova,Killjoy,Omen,Jett","Breach,Cypher,Sova,Omen,Neon"
Split,Goated,Atlas Esports,13,7,8,4,3,5,"Raze,Cypher,Omen,Skye,Clove","Breach,Raze,Cypher,Omen,Skye"
Ascent,English or Spanish,Full BIS Kit,13,1,2,0,1,11,"Cypher,Sova,Omen,Jett,KAY/O","Cypher,Sova,Omen,Jett,Deadlock"
Bind,Evil Geniuses,FURIA,13,5,9,3,2,4,"Raze,Brimstone,Omen,Skye,Gekko","Raze,Viper,Brimstone,Fade,Gekko"
Icebox,Twitch Whisperers,Predator X Gaming,13,6,4,3,3,9,"Sova,Killjoy,Viper,Jett,Clove","Killjoy,Viper,Reyna,KAY/O,Gekko"
Lotus,5 gecs,RECR,11,13,4,8,5,7,"Raze,Cypher,Omen,Fade,Gekko","Breach,Cypher,Sova,Astra,Neon"
Lotus,Goldie Oldies,IOUNL,7,13,2,6,7,5,"Breach,Raze,Cypher,Omen,Fade","Raze,Cypher,Omen,Fade,Deadlock"
Sunset,winners circle,RME Summit,13,8,6,6,2,7,"Breach,Cypher,Omen,Jett,Neon","Breach,Raze,Cypher,Omen,Gekko"
Sunset,Galakticos,PCIFIC Espor,10,13,9,2,11,1,"Raze,Cypher,Sova,Omen,Iso","Breach,Raze,Cypher,Omen,Gekko"
Lotus,plano gooners,Eccentric,1,13,0,2,11,1,"Raze,Cypher,Omen,Skye,Gekko","Breach,Raze,Killjoy,Omen,Gekko"
Lotus,Space Rabbit Esports,Omnipotence,7,13,3,9,4,4,"Killjoy,Omen,Skye,Neon,Gekko","Raze,Cypher,Killjoy,Omen,Fade"
Split,GG Only,EP HoneyBadgers,13,6,5,2,4,8,"Breach,Raze,Cypher,Omen,Yoru","Raze,Cypher,Viper,Omen,Skye"
Bind,Ibreon Scarlet,Status Red,13,9,7,5,4,6,"Raze,Cypher,Skye,Deadlock,Clove","Raze,Viper,Brimstone,Skye,Deadlock"
Bind,DIVIZON,FOKUS,11,13,4,8,5,7,"Viper,Omen,Yoru,Fade,Gekko","Viper,Brimstone,Skye,Yoru,Gekko"
Bind,yves saint laurent,Prospects,13,10,6,6,4,7,"Raze,Reyna,Skye,Chamber,Clove","Raze,Cypher,Brimstone,Yoru,Gekko"
Split,Akroma,Solary,13,11,3,9,2,10,"Sage,Skye,Astra,Neon,Deadlock","Raze,Cypher,Viper,Omen,Skye"
Sunset,Luminescent Sapphire,Empire Redux,13,3,9,3,0,4,"Raze,Cypher,Sova,Omen,Gekko","Breach,Sage,Omen,Yoru,Gekko"
Lotus,Twitch Whisperers,Predator X Gaming,13,4,5,0,4,8,"Raze,Omen,Chamber,Fade,Deadlock","Raze,Killjoy,Viper,Omen,Fade"
Lotus,English or Spanish,Full BIS Kit,11,13,6,6,7,5,"Breach,Raze,Omen,Chamber,Gekko","Raze,Cypher,Omen,Fade,Deadlock"
Haven,Paranoia Vortex,Event Horizon,13,3,4,0,3,9,"Sova,Killjoy,Omen,Jett,Iso","Breach,Sova,Killjoy,Omen,Jett"
Split,Galakticos,PCIFIC Espor,13,9,7,5,4,6,"Raze,Viper,Omen,Skye,Iso","Breach,Cypher,Omen,Jett,Iso"
Sunset,yves saint laurent,Prospects,14,12,8,5,7,6,"Raze,Cypher,Omen,Jett,Skye","Breach,Cypher,Omen,Neon,Gekko"
Lotus,Signum Reges,Capacitanes,14,12,9,4,8,5,"Breach,Raze,Cypher,Omen,Fade","Breach,Raze,Killjoy,Omen,Gekko"
Lotus,INCOGNITO,IAPEsports,13,8,8,4,4,5,"Breach,Neon,Gekko,Deadlock,Clove","Breach,Cypher,Omen,Yoru,Neon"
Lotus,Zeniths,Poverineeh,14,12,3,10,2,11,"Raze,Killjoy,Viper,Omen,Fade","Breach,Killjoy,Omen,Yoru,Neon"
Lotus,SZK Esports,InTenZive,13,5,9,3,2,4,"Breach,Sova,Killjoy,Omen,Jett","Breach,Killjoy,Omen,Neon,Gekko"
Lotus,GMBLERS Esports,SPACEGLID3RS,13,11,5,7,4,8,"Breach,Raze,Killjoy,Omen,Jett","Breach,Raze,Killjoy,Omen,Fade"
Lotus,STAKERS,Odyssey Gaming,13,10,6,5,5,7,"Breach,Raze,Cypher,Omen,Fade","Breach,Killjoy,Omen,Neon,Fade"
Lotus,GATIT4S PEEK,AMBYS Team,13,6,5,2,4,8,"Breach,Killjoy,Omen,Neon,Gekko","Breach,Cypher,Omen,Neon,Fade"
Lotus,1000rr club,90 Seconds,13,9,8,4,5,5,"Breach,Killjoy,Omen,Neon,Gekko","Raze,Killjoy,Viper,Omen,Fade"
Lotus,Nexum EC,bazinga esports,13,4,9,3,1,4,"Breach,Cypher,Omen,Neon,Gekko","Breach,Raze,Cypher,Omen,Gekko"
Icebox,RTZN,DSYRE,8,13,5,7,6,3,"Sova,Killjoy,Viper,Jett,KAY/O","Sova,Killjoy,Viper,Sage,Jett"
Haven,English or Spanish,Full BIS Kit,13,8,6,3,5,7,"Breach,Cypher,Sova,Omen,Jett","Cypher,Sova,Killjoy,Omen,Iso"
Lotus,Paranoia Vortex,Event Horizon,13,6,9,3,3,4,"Breach,Cypher,Sova,Neon,Clove","Breach,Raze,Cypher,Omen,Fade"
Haven,Twitch Whisperers,Predator X Gaming,10,13,6,6,7,4,"Breach,Cypher,Sova,Omen,Jett","Breach,Sova,Killjoy,Omen,Jett"
Icebox,Lotus Karma,HOF Kitsune,13,11,5,7,4,8,"Sova,Killjoy,Viper,Harbor,Gekko","Sova,Killjoy,Viper,Jett,Gekko"
Sunset,DIVIZON,FOKUS,9,13,6,6,7,3,"Breach,Raze,Cypher,Sova,Omen","Cypher,Sage,Omen,KAY/O,Gekko"
Haven,Luminescent Sapphire,Empire Redux,11,13,6,6,7,5,"Cypher,Sova,Omen,Jett,Gekko","Breach,Cypher,Sova,Omen,Jett"
Split,NXT,Apinaorkesteri,13,9,7,3,6,6,"Raze,Omen,Skye,Astra,Deadlock","Breach,Raze,Cypher,Omen,Iso"
Lotus,Colorful Radiation,Silly Weapons All Game,7,13,7,5,8,0,"Breach,Killjoy,Omen,Neon,Gekko","Breach,Raze,Killjoy,Gekko,Clove"
Ascent,SiXSENSE GC,Neira Esports,13,7,10,2,5,3,"Breach,Sova,Killjoy,Omen,Jett","Breach,Sova,Killjoy,Omen,Jett"
Ascent,Akroma,Solary,15,17,5,11,6,10,"Sova,Killjoy,Phoenix,Omen,Jett","Cypher,Sova,Omen,Jett,Deadlock"
Ascent,GoNext Esports,Incognito,13,9,6,4,5,7,"Sova,Killjoy,Omen,Jett,KAY/O","Sova,Killjoy,Phoenix,Jett,Clove"
Lotus,Una Ludio X Sushi Bois,Eternal Focus Crimson,9,13,6,6,7,3,"Breach,Raze,Killjoy,Gekko,Clove","Breach,Raze,Cypher,Omen,Fade"
Icebox,Impulse GW,SAW,6,13,4,8,5,2,"Killjoy,Viper,Jett,KAY/O,Gekko","Sova,Killjoy,Viper,Sage,Jett"
Icebox,NOVO Esports,Axolotl,13,2,10,2,0,3,"Sova,Killjoy,Viper,Sage,Jett","Killjoy,Viper,Reyna,Jett,Gekko"
Icebox,Luminescent Sapphire,Empire Redux,13,3,3,1,2,10,"Killjoy,Viper,Jett,Harbor,Gekko","Killjoy,Viper,Sage,Jett,Gekko"
Haven,Galakticos,PCIFIC Espor,14,16,8,7,9,6,"Cypher,Sova,Omen,Jett,Iso","Breach,Sova,Killjoy,Omen,Jett"
Ascent,Colorful Radiation,Silly Weapons All Game,3,13,2,10,3,1,"Sova,Killjoy,Omen,Jett,KAY/O","Sova,Killjoy,Jett,Astra,KAY/O"
Bind,SK Nebula,Team Galaga Kitsune,13,10,4,7,3,9,"Raze,Cypher,Viper,Brimstone,Skye","Breach,Raze,Cypher,Brimstone,Yoru"
Split,DIVIZON,FOKUS,13,7,4,4,3,9,"Breach,Raze,Cypher,Omen,Skye","Raze,Omen,Yoru,Astra,Fade"
Sunset,Una Ludio X Sushi Bois,Eternal Focus Crimson,4,13,2,3,10,2,"Breach,Raze,Cypher,Omen,Fade","Breach,Raze,Cypher,Omen,Fade"
Sunset,Lotus Karma,HOF Kitsune,8,13,5,4,9,3,"Breach,Cypher,Sova,Omen,Neon","Breach,Raze,Cypher,Omen,Gekko"
Bind,Hex Esports,EXALTY Kali,13,7,5,3,4,8,"Raze,Cypher,Jett,Skye,Clove","Raze,Cypher,Brimstone,Skye,Gekko"
Ascent,Saltire Sirens,Formulation Gaming GC,1,13,1,11,2,0,"Sova,Killjoy,Omen,Jett,KAY/O","Sova,Killjoy,Omen,Jett,KAY/O"
Icebox,GoNext Esports,Incognito,13,4,9,3,1,4,"Sova,Killjoy,Viper,Sage,Jett","Sova,Killjoy,Viper,Reyna,Jett"
Lotus,Leftovers Crew,NOMAD GC,7,13,3,5,8,4,"Raze,Killjoy,Omen,Gekko,Clove","Breach,Raze,Killjoy,Omen,Fade"
Ascent,Dortmund eSports Dynasty,Last9,5,13,4,8,5,1,"Sova,Killjoy,Omen,Jett,KAY/O","Sova,Killjoy,Omen,Jett,KAY/O"
Split,Acient Freya,GnG White,13,8,6,3,5,7,"Breach,Raze,Cypher,Omen,Skye","Breach,Raze,Cypher,Omen,Jett"
Sunset,NUXERIA GC,5STARS GC,13,6,5,2,4,8,"Breach,Raze,Cypher,Omen,Gekko","Breach,Raze,Cypher,Omen,Gekko"
Bind,EMUs,Soul Society,13,3,10,2,1,3,"Raze,Cypher,Sova,Omen,Yoru","Raze,Viper,Brimstone,Skye,Gekko"
Icebox,SiXSENSE GC,Neira Esports,6,13,4,3,10,2,"Sova,Killjoy,Viper,Jett,Clove","Sova,Killjoy,Jett,KAY/O,Harbor"
Ascent,Celestials GC,EKO Esports GC,13,2,11,1,1,2,"Breach,Jett,KAY/O,Deadlock,Clove","Cypher,Sova,Phoenix,Omen,Jett"
Ascent,Crvena zvezda esports,axolotls and chips,6,13,2,10,3,4,"Sova,Killjoy,Phoenix,Omen,Jett","Breach,Cypher,Sova,Omen,Jett"
Icebox,Veni eSports Venom,BRUXA,13,6,6,6,0,7,"Sova,Killjoy,Viper,Reyna,Deadlock","Raze,Sova,Killjoy,Viper,Chamber"
Sunset,Team Falcons,Unity Esports,13,11,6,6,5,7,"Breach,Raze,Cypher,Omen,Gekko","Breach,Raze,Cypher,Omen,Fade"
Lotus,NYAN Esports,DESTINY,13,3,9,3,0,4,"Breach,Cypher,Sova,Omen,Yoru","Breach,Raze,Killjoy,Viper,Omen"
Icebox,Akroma,Solary,13,11,7,5,6,6,"Sova,Killjoy,Viper,Jett,Gekko","Sova,Killjoy,Viper,Sage,Jett"
Icebox,Ravens GC,Anonymo GC,3,13,3,9,4,0,"Sova,Killjoy,Viper,Jett,Gekko","Sova,Killjoy,Viper,Jett,Harbor"
Bind,NXT,Apinaorkesteri,12,14,8,5,9,4,"Raze,Viper,Brimstone,Fade,Gekko","Raze,Viper,Brimstone,Fade,Gekko"
Haven,Impulse GW,SAW,10,13,5,6,7,5,"Breach,Sova,Killjoy,Omen,Neon","Cypher,Sova,Omen,Yoru,Iso"
Ascent,LONETEAM,HGE Esports,10,13,5,7,6,5,"Raze,Sova,Killjoy,Omen,Gekko","Sova,Killjoy,Omen,Jett,KAY/O"
Lotus,bazinga esports,AMBYS Team,8,13,6,3,10,2,"Breach,Raze,Cypher,Omen,Gekko","Breach,Cypher,Omen,Neon,Fade"
Lotus,INCOGNITO,Odyssey Gaming,13,3,9,3,0,4,"Breach,Cypher,Phoenix,Astra,Neon","Breach,Killjoy,Omen,Neon,Fade"
Lotus,Signum Reges,SPACEGLID3RS,13,2,3,0,2,10,"Breach,Raze,Cypher,Omen,Fade","Killjoy,Viper,Omen,Neon,Fade"
Lotus,IAPEsports,STAKERS,13,5,7,5,0,6,"Breach,Cypher,Omen,Yoru,Neon","Breach,Raze,Killjoy,Omen,Fade"
Lotus,Capacitanes,Team Redux,13,8,6,3,5,7,"Breach,Raze,Killjoy,Omen,Gekko","Breach,Killjoy,Omen,Neon,Fade"
Lotus,InTenZive,Poverineeh,13,9,6,4,5,7,"Breach,Killjoy,Omen,Neon,Gekko","Breach,Killjoy,Omen,Yoru,Neon"
Lotus,GATIT4S PEEK,Nexum EC,13,11,9,3,8,4,"Breach,Killjoy,Omen,Neon,Gekko","Breach,Raze,Cypher,Omen,Fade"
Lotus,SZK Esports,90 Seconds,13,0,12,0,0,1,"Breach,Sova,Killjoy,Omen,Jett","Raze,Killjoy,Viper,Omen,Fade"
Sunset,Celestials GC,EKO Esports GC,13,3,3,1,2,10,"Raze,Cypher,KAY/O,Harbor,Gekko","Breach,Raze,Cypher,Omen,Gekko"
Icebox,Eternal Fire,Galatasaray Esports,2,13,0,3,10,2,"Sova,Killjoy,Viper,Reyna,Gekko","Sova,Killjoy,Viper,Jett,Harbor"
Lotus,SK Nebula,Team Galaga Kitsune,13,10,5,6,4,8,"Breach,Raze,Cypher,Viper,Omen","Breach,Sova,Killjoy,Omen,Neon"
Sunset,Veni eSports Venom,BRUXA,13,1,2,0,1,11,"Breach,Raze,Cypher,Omen,Gekko","Breach,Raze,Cypher,Omen,Skye"
Bind,Leftovers Crew,NOMAD GC,5,13,5,7,6,0,"Raze,Viper,Brimstone,Fade,Gekko","Breach,Raze,Cypher,Omen,Fade"
Ascent,Lotus Karma,HOF Kitsune,13,9,8,4,5,5,"Sova,Killjoy,Omen,Jett,KAY/O","Sova,Killjoy,Omen,Jett,KAY/O"
Lotus,EMUs,Soul Society,13,5,3,3,2,10,"Raze,Cypher,Omen,Jett,Skye","Breach,Killjoy,Omen,Neon,Fade"
Lotus,SiXSENSE GC,Neira Esports,13,5,5,1,4,8,"Breach,Raze,Killjoy,Omen,Fade","Breach,Killjoy,Omen,Neon,Fade"
Icebox,Hex Esports,EXALTY Kali,13,7,7,1,6,6,"Sova,Killjoy,Viper,Jett,Gekko","Sova,Killjoy,Viper,Jett,Gekko"
Bind,NYAN Esports,DESTINY,13,2,3,0,2,10,"Breach,Cypher,Sova,Brimstone,Yoru","Raze,Viper,Brimstone,Skye,Gekko"
Icebox,Saltire Sirens,Formulation Gaming GC,10,13,5,7,6,5,"Killjoy,Reyna,Harbor,Gekko,Iso","Sova,Killjoy,Viper,Sage,Jett"
Sunset,Colorful Radiation,Silly Weapons All Game,14,12,7,6,6,7,"Breach,Cypher,Omen,Neon,Gekko","Breach,Raze,Cypher,Gekko,Clove"
Bind,Team Falcons,Unity Esports,13,6,5,2,4,8,"Raze,Viper,Brimstone,Sage,Skye","Breach,Raze,Cypher,Omen,Skye"
Lotus,Crvena zvezda esports,axolotls and chips,5,13,5,7,6,0,"Breach,Raze,Killjoy,Omen,Fade","Raze,Cypher,Omen,Fade,Deadlock"
Breeze,Dortmund eSports Dynasty,Last9,9,13,5,5,8,4,"Cypher,Sova,Viper,Jett,Gekko","Cypher,Sova,Viper,Jett,Yoru"
Lotus,NUXERIA GC,5STARS GC,13,6,6,1,5,7,"Breach,Raze,Killjoy,Omen,Gekko","Breach,Raze,Killjoy,Omen,Gekko"
Ascent,Ravens GC,Anonymo GC,2,13,0,3,10,2,"Sova,Killjoy,Omen,Jett,KAY/O","Sova,Killjoy,Phoenix,Omen,Jett"
Icebox,Acient Freya,GnG White,14,12,5,8,4,9,"Sova,Killjoy,Viper,Jett,Gekko","Sova,Killjoy,Viper,Reyna,Jett"
Split,Chipi Chapa's,Acend,10,13,3,9,4,7,"Raze,Cypher,Viper,Omen,Fade","Raze,Cypher,Reyna,Omen,Jett"
Lotus,Ovation eSports,Permitta Unicorns,13,10,9,2,8,4,"Breach,Cypher,Sova,Omen,Neon","Breach,Raze,Killjoy,Omen,Fade"
Sunset,Cicadas Gaming,Mandatory,3,13,0,4,9,3,"Breach,Raze,Cypher,Omen,Yoru","Breach,Raze,Cypher,Omen,Gekko"
Icebox,Sissi State Punks Academy,KONOHA,4,13,3,9,4,1,"Sova,Killjoy,Viper,Reyna,Gekko","Sova,Killjoy,Viper,Reyna,Jett"
Haven,NXT,Apinaorkesteri,13,3,4,0,3,9,"Cypher,Sova,Omen,Jett,Yoru","Breach,Sova,Killjoy,Omen,Jett"
Ascent,Impulse GW,SAW,13,9,9,1,8,4,"Sova,Killjoy,Omen,Jett,KAY/O","Sova,Killjoy,Omen,Jett,KAY/O"
Split,Team Falcons,Unity Esports,13,4,9,3,1,4,"Breach,Raze,Cypher,Omen,Skye","Breach,Raze,Omen,Skye,Chamber"
Haven,Eternal Fire,Galatasaray Esports,9,13,5,7,6,4,"Cypher,Sova,Omen,Yoru,Iso","Breach,Sova,Killjoy,Omen,Jett"
Ascent,Sissi State Punks Academy,KONOHA,4,13,4,8,5,0,"Sova,Killjoy,Omen,Jett,KAY/O","Sova,Killjoy,Omen,Jett,KAY/O"
Sunset,Chipi Chapa's,Acend,8,13,3,6,7,5,"Breach,Raze,Cypher,Omen,Yoru","Raze,Cypher,Omen,KAY/O,Gekko"
Ascent,Outplayed,VX300 Gaming,13,11,6,6,5,7,"Cypher,Sova,Omen,Jett,Deadlock","Sova,Killjoy,Omen,Jett,KAY/O"
Lotus,Cicadas Gaming,Mandatory,4,13,2,3,10,2,"Cypher,Omen,KAY/O,Neon,Gekko","Raze,Killjoy,Viper,Omen,Fade"
Icebox,Ovation eSports,Permitta Unicorns,11,13,7,5,8,4,"Sova,Killjoy,Viper,Sage,Jett","Breach,Sova,Killjoy,Viper,Jett"
Lotus,NAMI eSports,DIVINE,13,10,7,5,5,6,"Breach,Raze,Killjoy,Omen,Gekko","Breach,Raze,Killjoy,Omen,Gekko"
Sunset,PPP,EX0TIK GAMING,13,4,10,2,2,3,"Breach,Cypher,Sova,Omen,Neon","Breach,Raze,Cypher,Omen,Gekko"
Ascent,Eternal Fire,Galatasaray Esports,13,11,5,7,4,8,"Sova,Killjoy,Omen,Jett,KAY/O","Sova,Killjoy,Omen,Jett,KAY/O"
Sunset,OnlyFins,Apeks,8,13,3,6,7,5,"Breach,Raze,Cypher,Omen,Gekko","Viper,Sage,Omen,KAY/O,Gekko"
Icebox,Chipi Chapa's,Acend,13,10,3,9,1,10,"Sova,Killjoy,Viper,Yoru,Gekko","Killjoy,Viper,Jett,KAY/O,Gekko"
Haven,Ovation eSports,Permitta Unicorns,13,4,4,1,3,9,"Breach,Cypher,Sova,Omen,Jett","Breach,Omen,Chamber,Neon,Gekko"
Ascent,NAMI eSports,DIVINE,14,12,4,9,3,10,"Sova,Killjoy,Omen,Jett,KAY/O","Sova,Killjoy,Omen,Jett,KAY/O"
Icebox,PPP,EX0TIK GAMING,11,13,5,7,6,6,"Sova,Killjoy,Viper,Sage,Jett","Sova,Killjoy,Viper,Jett,Gekko"
Haven,Papara SuperMassive,S2G Esports,9,13,6,6,7,3,"Breach,Cypher,Sova,Omen,Neon","Sova,Killjoy,Omen,Neon,Iso"
Haven,OnlyFins,Apeks,10,13,5,7,6,5,"Breach,Cypher,Sova,Omen,Neon","Breach,Sova,Killjoy,Omen,Jett"
Split,PPP,EX0TIK GAMING,13,7,5,3,4,8,"Breach,Cypher,Omen,Neon,Iso","Raze,Viper,Omen,Jett,Skye"
Sunset,Papara SuperMassive,S2G Esports,13,6,9,3,3,4,"Cypher,Sova,Omen,KAY/O,Neon","Cypher,Sova,Omen,Neon,Iso"
Lotus,Papara SuperMassive,S2G Esports,9,13,4,6,7,5,"Raze,Cypher,Omen,Fade,Deadlock","Cypher,Omen,Neon,Fade,Deadlock"
Sunset,ZETA DIVISION,Rex Regum Qeon,10,13,7,4,9,3,"Breach,Raze,Cypher,Omen,Gekko","Breach,Raze,Cypher,Omen,Gekko"
Split,ZETA DIVISION,Rex Regum Qeon,8,13,6,6,7,2,"Raze,Cypher,Viper,Omen,Skye","Raze,Viper,Omen,Jett,Skye"
Sunset,Talon Esports,DetonatioN FocusMe,13,10,6,6,4,7,"Breach,Cypher,Sova,Omen,Neon","Breach,Raze,Cypher,Omen,Gekko"
Lotus,Talon Esports,DetonatioN FocusMe,13,7,7,5,2,6,"Breach,Cypher,Sova,Astra,Neon","Breach,Cypher,Omen,Neon,Deadlock"
Bind,VIXENS,Clueless GC,13,5,6,0,5,7,"Raze,Viper,Brimstone,Fade,Gekko","Raze,Cypher,Jett,Gekko,Clove"
Bind,Paranoia Vortex,For Lyfe,13,3,9,3,0,4,"Cypher,Sova,Brimstone,Yoru,Iso","Raze,Viper,Skye,Iso,Clove"
Icebox,VIXENS,Clueless GC,13,3,11,1,2,2,"Killjoy,Viper,Jett,KAY/O,Gekko","Sova,Killjoy,Viper,Sage,Jett"
Icebox,Prospects,Flawless Esports,13,5,4,2,3,9,"Sova,Killjoy,Viper,Reyna,Jett","Sova,Killjoy,Viper,Reyna,Jett"
Haven,Event Horizon,Glizzy Gang,13,8,7,2,6,6,"Breach,Cypher,Sova,Omen,Jett","Cypher,Sova,Viper,Omen,Jett"
Split,E-Xolos LAZER,RETA Esports,13,9,4,8,1,9,"Raze,Cypher,Jett,Skye,Astra","Raze,Viper,Astra,Fade,Gekko"
Icebox,DXA Esports,Blossom,13,9,5,7,2,8,"Sova,Killjoy,Viper,Reyna,Jett","Killjoy,Jett,Harbor,Gekko,Clove"
Ascent,SeanGares' Kittens,Predator X Gaming,5,13,3,9,4,2,"Sova,Killjoy,Jett,KAY/O,Clove","Sova,Killjoy,Omen,Jett,KAY/O"
Lotus,Event Horizon,Glizzy Gang,13,3,12,0,3,1,"Breach,Raze,Cypher,Omen,Fade","Cypher,Omen,Neon,Fade,Deadlock"
Lotus,Paranoia Vortex,For Lyfe,13,11,9,3,8,4,"Raze,Cypher,Reyna,Gekko,Clove","Breach,Cypher,Omen,Neon,Gekko"
Lotus,Ambrosia,Full BIS Kit,8,13,2,7,6,6,"Raze,Killjoy,Viper,Omen,Fade","Raze,Cypher,Omen,Fade,Deadlock"
Bind,yves saint laurent,ABG luvrs,13,5,8,4,1,5,"Raze,Skye,Yoru,Chamber,Clove","Raze,Viper,Brimstone,Reyna,Skye"
Lotus,raindrops,polar bear,13,2,10,2,0,3,"Raze,Cypher,Omen,Fade,Gekko","Breach,Killjoy,Omen,Neon,Gekko"
Lotus,English or Spanish,LazerrFreeks Mythic,13,10,6,6,4,7,"Breach,Raze,Omen,Chamber,Gekko","Raze,Killjoy,Viper,Omen,Fade"
Sunset,MadBandits,Utica Blue,13,4,3,2,2,10,"Breach,Cypher,Sova,Omen,Neon","Breach,Raze,Cypher,Omen,Gekko"
Lotus,Prospects,Flawless Esports,13,11,9,3,8,4,"Raze,Killjoy,Viper,Omen,Fade","Breach,Raze,Omen,Neon,Deadlock"
Icebox,Paranoia Vortex,For Lyfe,4,13,3,9,4,1,"Sova,Killjoy,Viper,Reyna,Jett","Sova,Killjoy,Viper,Reyna,Iso"
Lotus,Aspyre x Swarm,SHOW ME,13,11,9,3,8,4,"Breach,Cypher,Neon,Gekko,Clove","Breach,Raze,Jett,Deadlock,Clove"
Lotus,Evergarden GC,VIXENS,13,9,7,3,6,6,"Breach,Raze,Cypher,Omen,Yoru","Breach,Raze,Cypher,Astra,Fade"
Lotus,E-Xolos LAZER,RETA Esports,9,13,7,5,8,2,"Breach,Cypher,Omen,Neon,Gekko","Raze,Killjoy,Viper,Omen,Fade"
Lotus,SeanGares' Kittens,Predator X Gaming,9,13,4,8,5,5,"Breach,Cypher,Neon,Gekko,Clove","Raze,Killjoy,Viper,Omen,Fade"
Bind,DXA Esports,Blossom,13,8,7,2,6,6,"Raze,Cypher,Viper,Brimstone,Skye","Raze,Cypher,Skye,Harbor,Clove"
Haven,yves saint laurent,ABG luvrs,13,10,6,6,4,7,"Sova,Killjoy,Reyna,Omen,Jett","Cypher,Sova,Phoenix,Omen,Jett"
Ascent,Special Grade,Event Horizon,13,6,11,1,5,2,"Sova,Killjoy,Omen,Jett,KAY/O","Sova,Killjoy,Omen,Jett,KAY/O"
Bind,MadBandits,Utica Blue,13,2,10,2,0,3,"Raze,Viper,Brimstone,Skye,Gekko","Raze,Viper,Brimstone,Skye,Gekko"
Icebox,Ambrosia,Full BIS Kit,9,13,5,5,8,4,"Sova,Killjoy,Viper,Jett,KAY/O","Sova,Killjoy,Viper,Reyna,Deadlock"
Bind,English or Spanish,LazerrFreeks Mythic,13,9,6,4,5,7,"Raze,Viper,Skye,Deadlock,Clove","Raze,Viper,Brimstone,Skye,Gekko"
Haven,raindrops,polar bear,13,7,6,2,5,7,"Breach,Sova,Killjoy,Omen,Neon","Breach,Sova,Killjoy,Omen,Jett"
Sunset,Aspyre x Swarm,SHOW ME,13,11,9,3,8,4,"Breach,Cypher,Omen,Neon,Gekko","Breach,Cypher,Neon,Gekko,Clove"
Ascent,Friends Over Everything,Paranoia Vortex,13,6,9,3,3,4,"Cypher,Sova,Omen,Jett,Deadlock","Sova,Killjoy,Omen,Yoru,Iso"
Ascent,Flawless Esports,Didd,13,8,6,6,2,7,"Sova,Killjoy,Phoenix,Omen,Jett","Cypher,Sova,Omen,Jett,KAY/O"
Bind,ABG luvrs,Spate Esports,13,5,5,1,4,8,"Raze,Viper,Brimstone,Reyna,Skye","Viper,Jett,Yoru,Gekko,Clove"
Sunset,Evergarden GC,VIXENS,10,13,7,4,9,3,"Cypher,Sova,Phoenix,Omen,Neon","Breach,Raze,Cypher,Omen,Gekko"
Haven,Special Grade,Event Horizon,10,13,5,6,7,5,"Breach,Sova,Killjoy,Omen,Neon","Breach,Sova,Killjoy,Omen,Jett"
Bind,Utica Blue,University of Idaho,13,8,5,7,1,8,"Raze,Viper,Brimstone,Skye,Gekko","Raze,Viper,Brimstone,Skye,Gekko"
Lotus,Twitch Whisperers,SaD GC ,13,4,4,1,3,9,"Raze,Omen,Chamber,Fade,Deadlock","Breach,Raze,Cypher,Omen,Gekko"
Lotus,Paranoia Esports,Glizzy Gang,9,13,5,5,8,4,"Raze,Killjoy,Viper,Omen,Fade","Cypher,Omen,Neon,Fade,Deadlock"
Lotus,Predator X Gaming,Excane,14,12,9,4,8,5,"Raze,Killjoy,Viper,Omen,Fade","Breach,Killjoy,Omen,Neon,Gekko"
Lotus,SaD Esports,yves saint laurent,13,11,7,5,6,6,"Breach,Raze,Cypher,Sova,Omen","Raze,Killjoy,Reyna,Skye,Clove"
Ascent,SR and Friends,English or Spanish,13,8,6,3,5,7,"Sova,Killjoy,Omen,Jett,KAY/O","Cypher,Sova,Omen,Jett,KAY/O"
Lotus,fortniteshootersV2,OutGoing Esports,9,13,5,5,8,4,"Breach,Cypher,Omen,Jett,Gekko","Breach,Raze,Cypher,Omen,Gekko"
Lotus,Ambrosia,Dexterity Gaming,8,13,1,8,5,7,"Raze,Killjoy,Viper,Omen,Fade","Breach,Cypher,Omen,Skye,Neon"
Sunset,E-Xolos LAZER,RETA Esports,13,10,7,5,5,6,"Breach,Raze,Cypher,Omen,Gekko","Raze,Cypher,Sova,Omen,KAY/O"
Bind,Blossom,Clueless GC,15,13,11,3,10,4,"Raze,Cypher,Skye,Harbor,Clove","Raze,Cypher,Jett,Gekko,Clove"
Abyss,Goated,For Lyfe,5,13,0,6,7,5,"Cypher,Reyna,Omen,Harbor,Deadlock","Cypher,Reyna,Jett,Astra,Fade"
Lotus,Friends Over Everything,Paranoia Vortex,14,12,8,5,7,6,"Raze,Cypher,Omen,Fade,Deadlock","Raze,Cypher,Reyna,Skye,Clove"
Lotus,Flawless Esports,Didd,12,14,7,6,8,5,"Breach,Omen,Neon,Gekko,Deadlock","Raze,Cypher,Omen,Fade,Deadlock"
Haven,ABG luvrs,Spate Esports,13,8,4,5,3,9,"Cypher,Sova,Phoenix,Omen,Jett","Breach,Cypher,Sova,Harbor,Clove"
Icebox,swaglord9000,Scissor Sisters,13,4,10,2,2,3,"Sova,Phoenix,Reyna,Jett,Clove","Sova,Killjoy,Viper,Reyna,Iso"
Icebox,Hammering Esports ST3,jasmins kittens,2,13,0,3,10,2,"Killjoy,Viper,Jett,KAY/O,Gekko","Viper,Sage,Reyna,Deadlock,Iso"
Haven,UltraLight Purple,fluffy kittens,3,13,2,10,3,1,"Breach,Cypher,Sova,Omen,Jett","Breach,Sova,Killjoy,Omen,Jett"
Lotus,Full BIS Kit,Ad Infinitum,13,1,2,0,1,11,"Raze,Cypher,Omen,Fade,Deadlock","Raze,Killjoy,Viper,Omen,Fade"
Sunset,Scarlet Death Esports,Appy Juice,2,13,1,11,2,1,"Breach,Raze,Omen,Gekko,Deadlock","Raze,Cypher,Sova,Gekko,Clove"
Haven,Sizzle Esports,SaD GC ,4,13,4,8,5,0,"Sova,Killjoy,Viper,Omen,Yoru","Breach,Sova,Killjoy,Omen,Neon"
Lotus,Silly Squad,Alliance Guardians,6,13,2,10,3,4,"Raze,Killjoy,Skye,Yoru,Clove","Breach,Raze,Cypher,Omen,Fade"
Sunset,Blue Otter,Prospects,13,9,7,5,4,6,"Breach,Cypher,Sova,Omen,Neon","Breach,Cypher,Omen,Neon,Gekko"
Icebox,IOUNL,Aspyre x Swarm,15,13,6,8,5,9,"Sova,Killjoy,Viper,Reyna,Gekko","Viper,Reyna,Chamber,Gekko,Deadlock"
Sunset,Utica Blue,University of Idaho,12,14,11,2,12,1,"Breach,Raze,Cypher,Omen,Gekko","Cypher,Reyna,Omen,KAY/O,Gekko"
Haven,SHOW ME,Green Beans,13,5,9,3,2,4,"Cypher,Omen,Jett,Skye,Neon","Breach,Sova,Killjoy,Omen,Jett"
Sunset,Special Grade,Event Horizon,13,7,4,4,3,9,"Breach,Raze,Cypher,Omen,Gekko","Cypher,Sova,Omen,Jett,KAY/O"
Lotus,Row Z,LazerrFreeks Mythic,7,13,4,8,5,3,"Breach,Raze,Killjoy,Omen,Gekko","Raze,Killjoy,Viper,Omen,Fade"
Icebox,Paranoia Esports,Glizzy Gang,11,13,6,6,7,5,"Sova,Killjoy,Viper,Reyna,Jett","Sova,Killjoy,Viper,Jett,Gekko"
Bind,LAS FLAUTAS,PRC,13,8,9,3,5,4,"Raze,Cypher,Brimstone,Jett,Skye","Raze,Viper,Brimstone,Yoru,Fade"
Haven,Ions Day Care,SeanGares' Kittens,13,3,2,2,1,11,"Breach,Cypher,Sova,Omen,Yoru","Breach,Cypher,Jett,Skye,Clove"
Ascent,fortniteshootersV2,OutGoing Esports,8,13,4,5,8,4,"Cypher,Sova,Omen,Jett,KAY/O","Sova,Killjoy,Omen,Jett,KAY/O"
Icebox,SaD Esports,yves saint laurent,10,13,5,7,6,5,"Killjoy,Viper,Jett,KAY/O,Gekko","Sova,Killjoy,Viper,Reyna,Jett"
Bind,SR and Friends,English or Spanish,11,13,3,9,4,8,"Raze,Viper,Brimstone,Skye,Deadlock","Raze,Viper,Skye,Deadlock,Clove"
Bind,Predator X Gaming,Excane,10,13,4,7,6,6,"Raze,Viper,Brimstone,Reyna,Skye","Omen,Yoru,Fade,Harbor,Deadlock"
Icebox,Ambrosia,Dexterity Gaming,13,15,6,8,7,7,"Sova,Killjoy,Viper,Jett,KAY/O","Sova,Killjoy,Viper,Harbor,Gekko"
Lotus,Nightblood Gaming,MadBandits,13,5,6,0,5,7,"Breach,Raze,Cypher,Sova,Astra","Breach,Raze,Omen,Jett,Skye"
Haven,Friends Over Everything,Paranoia Vortex,6,13,5,7,6,1,"Breach,Sova,Killjoy,Omen,Jett","Sova,Killjoy,Omen,Jett,Iso"
Haven,Goated,For Lyfe,11,13,7,5,8,4,"Sova,Phoenix,Sage,Omen,Deadlock","Cypher,Sova,Yoru,Iso,Clove"
Ascent,Ions Day Care,SeanGares' Kittens,13,2,3,0,2,10,"Sova,Killjoy,Omen,Yoru,Iso","Sova,Killjoy,Phoenix,Jett,Clove"
Bind,Evergarden GC,VIXENS,15,13,9,5,8,6,"Raze,Cypher,Brimstone,Skye,Clove","Raze,Viper,Brimstone,Fade,Gekko"
Icebox,Blossom,Clueless GC,13,10,5,6,4,8,"Killjoy,Jett,Harbor,Gekko,Clove","Sova,Killjoy,Viper,Sage,Jett"
Ascent,E-Xolos LAZER,RETA Esports,8,13,1,8,5,7,"Cypher,Sova,Omen,Jett,KAY/O","Sova,Killjoy,Omen,Jett,KAY/O"
Lotus,swaglord9000,Scissor Sisters,13,3,4,0,3,9,"Raze,Killjoy,Omen,Fade,Deadlock","Raze,Killjoy,Reyna,Omen,Skye"
Haven,Goldie Oldies,Twitch Whisperers,13,5,10,2,3,3,"Breach,Cypher,Sova,Omen,Neon","Breach,Sova,Killjoy,Omen,Jett"
Bind,Hammering Esports ST4,Squishy Squabblers,4,13,1,4,9,3,"Raze,Viper,Brimstone,Yoru,Gekko","Raze,Viper,Yoru,Chamber,Clove"
Ascent,Sizzle Esports,SaD GC ,8,13,1,8,5,7,"Cypher,Sova,Omen,Jett,KAY/O","Sova,Killjoy,Omen,Jett,KAY/O"
Bind,SHOW ME,Green Beans,13,8,8,4,4,5,"Raze,Cypher,Skye,Yoru,Clove","Breach,Raze,Cypher,Sova,Brimstone"
Haven,Full BIS Kit,Ad Infinitum,13,5,11,1,4,2,"Breach,Sova,Killjoy,Omen,Jett","Breach,Cypher,Sova,Jett,Astra"
Haven,Silly Squad,Alliance Guardians,6,13,0,7,6,6,"Sova,Killjoy,Reyna,Jett,Clove","Breach,Cypher,Sova,Omen,Neon"
Lotus,Scarlet Death Esports,Appy Juice,6,13,2,10,3,4,"Breach,Raze,Gekko,Deadlock,Clove","Raze,Killjoy,Omen,Fade,Gekko"
Sunset,fortniteshootersV2,OutGoing Esports,13,6,5,2,4,8,"Cypher,Sova,Omen,Jett,Gekko","Breach,Raze,Cypher,Sova,Omen"
Haven,IOUNL,Aspyre x Swarm,13,7,7,5,2,6,"Breach,Sova,Killjoy,Omen,Jett","Breach,Cypher,Sova,Omen,Neon"
Sunset,YFP Gaming,M80,4,13,3,9,4,1,"Breach,Raze,Cypher,Omen,Gekko","Breach,Cypher,Omen,Yoru,Gekko"
Lotus,ABG luvrs,Spate Esports,10,13,7,5,8,3,"Breach,Killjoy,Yoru,Gekko,Clove","Breach,Raze,Cypher,Omen,Gekko"
Ascent,Hammering Esports ST3,jasmins kittens,7,13,6,6,7,1,"Sova,Killjoy,Omen,Jett,KAY/O","Sova,Killjoy,Jett,Deadlock,Clove"
Bind,Row Z,LazerrFreeks Mythic,7,13,4,4,9,3,"Raze,Cypher,Brimstone,Skye,Gekko","Raze,Viper,Brimstone,Skye,Gekko"
Lotus,Blue Otter,Prospects,13,6,7,5,1,6,"Breach,Raze,Cypher,Omen,Gekko","Raze,Killjoy,Viper,Omen,Fade"
Ascent,SaD Esports,yves saint laurent,13,7,6,2,5,7,"Cypher,Sova,Omen,Jett,Deadlock","Sova,Killjoy,Phoenix,Omen,Jett"
Sunset,UltraLight Purple,fluffy kittens,12,14,6,7,7,6,"Breach,Raze,Omen,Gekko,Deadlock","Breach,Raze,Cypher,Omen,Gekko"
Haven,Flawless Esports,Didd,15,13,11,3,10,4,"Cypher,Sova,Omen,Jett,Iso","Cypher,Omen,Jett,Gekko,Iso"
Haven,LAS FLAUTAS,PRC,13,7,4,4,3,9,"Killjoy,Brimstone,Jett,Skye,KAY/O","Cypher,Astra,KAY/O,Neon,Gekko"
Haven,Ambrosia,Dexterity Gaming,13,5,2,4,1,11,"Breach,Sova,Killjoy,Omen,Jett","Breach,Cypher,Omen,Neon,Gekko"
Haven,SR and Friends,English or Spanish,13,8,6,3,5,7,"Breach,Sova,Killjoy,Omen,Jett","Breach,Cypher,Sova,Omen,Jett"
Lotus,Utica Blue,University of Idaho,13,11,7,5,6,6,"Breach,Raze,Cypher,Omen,Gekko","Raze,Killjoy,Omen,Fade,Gekko"
Abyss,Ions Day Care,SeanGares' Kittens,5,13,1,5,8,4,"Breach,Sova,Omen,Chamber,Neon","Breach,Cypher,Neon,Iso,Clove"
Ascent,Nightblood Gaming,MadBandits,13,7,4,4,3,9,"Cypher,Sova,Omen,Jett,Deadlock","Sova,Killjoy,Omen,Jett,KAY/O"
Sunset,Predator X Gaming,Excane,13,5,8,4,1,5,"Breach,Raze,Cypher,Omen,Gekko","Breach,Raze,Cypher,Omen,Gekko"
Haven,Event Horizon,Glizzy Gang,13,9,7,3,6,6,"Breach,Sova,Killjoy,Omen,Jett","Breach,Cypher,Sova,Omen,Jett"
Lotus,Goldie Oldies,Twitch Whisperers,13,1,11,1,0,2,"Breach,Raze,Cypher,Omen,Fade","Raze,Cypher,Omen,Fade,Deadlock"
Lotus,Hammering Esports ST4,Squishy Squabblers,2,13,1,11,2,1,"Raze,Cypher,Viper,Omen,Fade","Raze,Sage,Fade,Deadlock,Clove"
Ascent,Paranoia Vortex,For Lyfe,13,5,7,5,0,6,"Sova,Killjoy,Omen,Yoru,Iso","Cypher,Sova,Omen,Jett,KAY/O"
Ascent,YFP Gaming,M80,13,9,4,8,1,9,"Cypher,Sova,Omen,Jett,Deadlock","Cypher,Sova,Omen,Yoru,Deadlock"
Haven,yves saint laurent,Spate Esports,13,11,5,7,4,8,"Sova,Viper,Omen,Jett,Astra","Breach,Cypher,Sova,Harbor,Clove"
Bind,E-Xolos LAZER,RETA Esports,14,12,11,2,10,3,"Raze,Brimstone,Skye,Harbor,Gekko","Raze,Viper,Brimstone,Skye,Gekko"
Haven,Paranoia Vortex,For Lyfe,13,4,5,0,4,8,"Sova,Killjoy,Omen,Jett,Iso","Breach,Sova,Killjoy,Omen,Neon"
Lotus,Full BIS Kit,Dexterity Gaming,10,13,5,6,7,5,"Cypher,Omen,Fade,Deadlock,Iso","Breach,Cypher,Omen,Skye,Neon"
Sunset,LazerrFreeks Mythic,English or Spanish,11,13,3,9,4,8,"Breach,Raze,Cypher,Omen,Fade","Breach,Raze,Cypher,Omen,Gekko"
Lotus,Twitch Whisperers,SaD GC ,13,8,7,2,6,6,"Raze,Omen,Chamber,Fade,Deadlock","Raze,Killjoy,Omen,Neon,Gekko"
Ascent,Aspyre x Swarm,Green Beans,15,13,5,9,4,10,"Sova,Killjoy,Omen,Jett,KAY/O","Cypher,Sova,Omen,Jett,Deadlock"
Haven,Didd,Prospects,11,13,6,6,7,5,"Sova,Killjoy,Jett,Iso,Clove","Breach,Sova,Killjoy,Omen,Neon"
Ascent,Event Horizon,Glizzy Gang,13,10,6,6,4,7,"Sova,Killjoy,Omen,Jett,KAY/O","Sova,Killjoy,Omen,Jett,KAY/O"
Haven,Blue Otter,Flawless Esports,13,3,2,2,1,11,"Breach,Cypher,Sova,Omen,Jett","Breach,Sova,Killjoy,Omen,Jett"
Ascent,Goldie Oldies,Sizzle Esports,13,5,9,3,2,4,"Cypher,Sova,Omen,Jett,KAY/O","Cypher,Sova,Omen,Jett,KAY/O"
Icebox,Nightblood Gaming,Utica Blue,13,4,4,1,3,9,"Sova,Killjoy,Viper,Omen,Jett","Sova,Killjoy,Viper,Jett,Gekko"
Sunset,Friends Over Everything,Goated,13,0,12,0,0,1,"Cypher,Sova,Omen,KAY/O,Neon","Raze,Cypher,Omen,Astra,Gekko"
Sunset,Excane,SeanGares' Kittens,11,13,8,4,9,3,"Breach,Raze,Cypher,Omen,Gekko","Cypher,Sova,Neon,Gekko,Clove"
Ascent,SaD Esports,ABG luvrs,13,6,8,4,2,5,"Cypher,Sova,Omen,Jett,Deadlock","Sova,Killjoy,Omen,Jett,KAY/O"
Haven,Ions Day Care,Predator X Gaming,13,7,7,1,6,6,"Cypher,Sova,Brimstone,Jett,Iso","Sova,Killjoy,Reyna,Omen,Jett"
Sunset,Special Grade,Paranoia Esports,13,10,8,4,6,5,"Breach,Raze,Cypher,Omen,Gekko","Raze,Cypher,Phoenix,Omen,Gekko"
Lotus,IOUNL,SHOW ME,13,8,8,4,4,5,"Raze,Cypher,Omen,Fade,Deadlock","Breach,Killjoy,Neon,Gekko,Clove"
Ascent,SR and Friends,Row Z,13,4,2,3,1,11,"Sova,Killjoy,Omen,Jett,KAY/O","Sova,Killjoy,Omen,Jett,KAY/O"
Lotus,Ambrosia,Ad Infinitum,13,2,3,0,2,10,"Raze,Killjoy,Viper,Omen,Fade","Raze,Killjoy,Viper,Omen,Fade"
Sunset,MadBandits,University of Idaho,13,7,9,3,4,4,"Breach,Cypher,Omen,Neon,Fade","Cypher,Reyna,Omen,KAY/O,Gekko"
Haven,Goldie Oldies,Sizzle Esports,13,2,10,2,0,3,"Breach,Cypher,Sova,Omen,Neon","Sova,Killjoy,Viper,Omen,Yoru"
Bind,yves saint laurent,Spate Esports,13,7,7,1,6,6,"Raze,Sage,Reyna,Skye,Clove","Viper,Jett,Yoru,Gekko,Clove"
Ascent,Special Grade,Paranoia Esports,13,1,2,0,1,11,"Sova,Killjoy,Omen,Jett,KAY/O","Sova,Killjoy,Omen,Jett,KAY/O"
Lotus,Didd,Prospects,2,13,2,10,3,0,"Breach,Raze,Cypher,Omen,Fade","Raze,Killjoy,Viper,Omen,Fade"
Haven,Full BIS Kit,Dexterity Gaming,3,13,1,3,10,2,"Breach,Sova,Killjoy,Omen,Jett","Breach,Cypher,Omen,Neon,Gekko"
Haven,YFP Gaming,M80,9,13,3,9,4,6,"Breach,Cypher,Sova,Omen,Jett","Breach,Sova,Killjoy,Omen,Jett"
Lotus,Aspyre x Swarm,Green Beans,13,8,10,2,6,3,"Breach,Cypher,Neon,Gekko,Clove","Breach,Raze,Sova,Killjoy,Omen"
Haven,Twitch Whisperers,SaD GC ,13,5,7,5,0,6,"Breach,Sova,Killjoy,Omen,Jett","Breach,Sova,Killjoy,Omen,Jett"
Lotus,SaD Esports,ABG luvrs,13,2,12,0,2,1,"Breach,Raze,Cypher,Sova,Omen","Breach,Killjoy,Yoru,Gekko,Clove"
Sunset,Ions Day Care,Predator X Gaming,13,4,4,1,3,9,"Breach,Raze,Cypher,Omen,Gekko","Breach,Raze,Cypher,Omen,Gekko"
Lotus,Nightblood Gaming,Utica Blue,13,5,5,1,4,8,"Breach,Raze,Sova,Killjoy,Astra","Killjoy,Reyna,Omen,Neon,Gekko"
Ascent,MadBandits,University of Idaho,13,1,2,0,1,11,"Sova,Killjoy,Omen,Jett,KAY/O","Cypher,Sova,Omen,Jett,KAY/O"
Haven,LazerrFreeks Mythic,English or Spanish,8,13,5,7,6,3,"Breach,Sova,Killjoy,Omen,Jett","Breach,Cypher,Sova,Omen,Jett"
Icebox,Event Horizon,Glizzy Gang,6,13,3,9,4,3,"Sova,Killjoy,Viper,Jett,KAY/O","Sova,Killjoy,Viper,Jett,Gekko"
Bind,Friends Over Everything,Goated,13,2,10,2,0,3,"Raze,Viper,Brimstone,Skye,Gekko","Viper,Brimstone,Jett,Skye,Chamber"
Haven,SR and Friends,Row Z,13,3,2,2,1,11,"Breach,Cypher,Sova,Omen,Jett","Sova,Killjoy,Reyna,Omen,Jett"
Ascent,Excane,SeanGares' Kittens,5,13,1,5,8,4,"Sova,Killjoy,Omen,Jett,KAY/O","Sova,Killjoy,Phoenix,Jett,Clove"
Lotus,Paranoia Vortex,For Lyfe,12,14,7,6,8,5,"Raze,Cypher,Skye,Gekko,Clove","Breach,Cypher,Omen,Neon,Gekko"
Haven,IOUNL,SHOW ME,13,6,7,0,6,6,"Breach,Sova,Killjoy,Omen,Jett","Cypher,Omen,Jett,Skye,Yoru"
Icebox,Ambrosia,Ad Infinitum,13,1,11,1,0,2,"Sova,Killjoy,Viper,Jett,KAY/O","Sova,Killjoy,Viper,Jett,Gekko"
Ascent,Blue Otter,Flawless Esports,13,7,5,3,4,8,"Sova,Killjoy,Omen,Jett,KAY/O","Cypher,Sova,Phoenix,Omen,Jett"
Lotus,Lootcifer,INF Esports,13,7,6,2,5,7,"Breach,Cypher,Omen,KAY/O,Neon","Breach,Raze,Cypher,Omen,Fade"
Sunset,HONEYBADGER123,LA RUE,9,13,5,7,6,4,"Viper,Sage,Omen,KAY/O,Gekko","Breach,Raze,Cypher,Omen,Gekko"
Icebox,RIZON,Reveal Multigaming,8,13,4,5,8,4,"Sova,Killjoy,Viper,Reyna,Jett","Sova,Killjoy,Viper,Jett,Clove"
Haven,Lootcifer,INF Esports,11,13,5,7,6,6,"Breach,Cypher,Sova,Omen,Neon","Breach,Sova,Killjoy,Omen,Jett"
Lotus,FLUFFY AIMERS,Dough Bros,13,6,3,4,2,10,"Raze,Cypher,Omen,Skye,Deadlock","Raze,Omen,Fade,Deadlock,Clove"
Ascent,HONEYBADGER123,LA RUE,9,13,2,8,5,7,"Cypher,Sova,Omen,Jett,Deadlock","Sova,Killjoy,Jett,Astra,KAY/O"
Lotus,RIZON,Reveal Multigaming,10,13,2,9,4,8,"Killjoy,Viper,Omen,Neon,Gekko","Breach,Cypher,Sova,Omen,Neon"
Haven,BALD BUFF,Dortmund Esports,8,13,4,8,5,4,"Breach,Sova,Killjoy,Omen,Jett","Sova,Killjoy,Omen,Jett,Deadlock"
Lotus,Novita Esports,VEX ESPORTS,13,8,8,4,4,5,"Breach,Killjoy,Omen,Neon,Fade","Breach,Raze,Cypher,Omen,Gekko"
Bind,Lootcifer,INF Esports,13,3,10,2,1,3,"Cypher,Viper,Brimstone,Skye,Gekko","Raze,Viper,Brimstone,Skye,Gekko"
Haven,BÖSE BUBEN,Sissi State Punks Academy,13,8,8,4,4,5,"Breach,Sova,Killjoy,Omen,Neon","Breach,Cypher,Sova,Omen,Neon"
Sunset,FLUFFY AIMERS,Dough Bros,13,5,4,2,3,9,"Breach,Raze,Cypher,Omen,Skye","Breach,Cypher,Omen,Neon,Fade"
Bind,Novita Esports,VEX ESPORTS,13,3,9,3,0,4,"Raze,Viper,Skye,Gekko,Clove","Raze,Brimstone,Skye,Gekko,Deadlock"
Sunset,BALD BUFF,Dortmund Esports,4,13,3,2,11,1,"Raze,Cypher,Sova,Omen,KAY/O","Breach,Cypher,Omen,Neon,Gekko"
Lotus,BÖSE BUBEN,Sissi State Punks Academy,13,3,2,2,1,11,"Breach,Cypher,Sova,Omen,Neon","Breach,Raze,Sova,Killjoy,Omen"
Lotus,Team PlayHard Glasterz,SiXSENSE GC,11,13,7,5,8,4,"Breach,Raze,Cypher,Omen,Fade","Breach,Raze,Killjoy,Omen,Fade"
Sunset,Xravel CBRS,BRUXA,12,14,7,6,8,5,"Raze,Cypher,Sova,Gekko,Clove","Breach,Raze,Cypher,Omen,Skye"
Ascent,Soul Society,RAKUZAN,13,5,3,3,2,10,"Sova,Killjoy,Omen,Jett,KAY/O","Breach,Sova,Killjoy,Jett,Clove"
Lotus,Celestials GC,Scald eSport GC,13,9,4,6,3,9,"Raze,Cypher,KAY/O,Gekko,Clove","Breach,Raze,Sova,Killjoy,Omen"
Lotus,Lootcifer,Reveal Multigaming,13,5,4,2,3,9,"Breach,Cypher,Omen,KAY/O,Neon","Breach,Cypher,Sova,Omen,Neon"
Lotus,FNATIC,Karmine Corp,13,8,8,4,4,5,"Raze,Killjoy,Viper,Omen,Fade","Cypher,Sova,Omen,Yoru,Fade"
Lotus,Colorful Radiation,ECO Akuma,13,3,11,1,2,2,"Breach,Killjoy,Omen,Neon,Gekko","Breach,Raze,Killjoy,Omen,Gekko"
Ascent,NUXERIA GC,OATMILK,14,12,7,6,6,7,"Sova,Killjoy,Omen,Jett,KAY/O","Cypher,Sova,Omen,Jett,KAY/O"
Bind,SPICY,Veni eSports Venom,11,13,5,7,6,6,"Raze,Cypher,Viper,Brimstone,Skye","Breach,Raze,Cypher,Brimstone,Gekko"
Ascent,aNc Outplayed GC,Lotus Karma,8,13,6,6,7,2,"Cypher,Sova,Phoenix,Omen,Jett","Sova,Killjoy,Omen,Jett,KAY/O"
Lotus,Crvena zvezda esports,Idynomashimi,14,12,6,7,5,8,"Breach,Raze,Killjoy,Omen,Fade","Breach,Raze,Killjoy,Omen,Fade"
Haven,Dortmund Esports,VEX ESPORTS,13,5,5,1,4,8,"Sova,Killjoy,Omen,Jett,Deadlock","Breach,Killjoy,Omen,Jett,Gekko"
Bind,Xravel CBRS,BRUXA,13,8,8,4,4,5,"Raze,Viper,Brimstone,Gekko,Deadlock","Raze,Omen,Skye,Chamber,Gekko"
Haven,FNATIC,Karmine Corp,13,3,4,0,3,9,"Cypher,Sova,Omen,Yoru,Iso","Killjoy,Viper,Yoru,Harbor,Gekko"
Lotus,Soul Society,RAKUZAN,13,9,8,4,5,5,"Breach,Killjoy,Omen,Neon,Fade","Cypher,Viper,Jett,Gekko,Clove"
Sunset,GnG White,Imperium Livia,13,2,3,0,2,10,"Breach,Raze,Cypher,Sova,Omen","Breach,Raze,Cypher,Omen,Deadlock"
Sunset,EKO Esports GC,Cannes Esports,13,5,3,3,2,10,"Breach,Raze,Cypher,Omen,Gekko","Breach,Raze,Cypher,Omen,Fade"
Sunset,Celestials GC,Scald eSport GC,9,13,5,5,8,4,"Raze,Cypher,KAY/O,Harbor,Gekko","Breach,Raze,Cypher,Omen,Gekko"
Breeze,SPICY,Veni eSports Venom,6,13,6,6,7,0,"Cypher,Sova,Viper,Jett,Clove","Cypher,Sova,Viper,Omen,Jett"
Icebox,Lootcifer,Reveal Multigaming,9,13,3,7,6,6,"Sova,Killjoy,Reyna,Harbor,Clove","Sova,Killjoy,Viper,Jett,Clove"
Lotus,Mulieres Vires,Acient Freya,3,13,2,2,11,1,"Breach,Raze,Sova,Omen,Chamber","Breach,Killjoy,Omen,Neon,Gekko"
Bind,aNc Outplayed GC,Lotus Karma,13,7,8,4,3,5,"Raze,Cypher,Brimstone,Skye,Gekko","Raze,Viper,Brimstone,Skye,Gekko"
Icebox,WLGaming Esports GC,Team Galaga Kitsune,2,13,2,10,3,0,"Sova,Killjoy,Viper,Jett,Gekko","Sova,Killjoy,Viper,Sage,Jett"
Sunset,GoatFellas Tragos,5STARS GC,5,13,4,8,5,1,"Raze,Cypher,Sova,Omen,KAY/O","Breach,Raze,Cypher,Omen,Gekko"
Bind,Dortmund Esports,VEX ESPORTS,5,13,2,4,9,3,"Viper,Omen,Yoru,KAY/O,Gekko","Raze,Brimstone,Skye,Gekko,Deadlock"
Sunset,RevenantVAL,TwentyStars,8,13,4,8,5,4,"Breach,Raze,Cypher,Omen,Gekko","Breach,Cypher,Sova,Omen,Neon"
Lotus,NYAN Esports,Dragons Esports GC,13,5,9,3,2,4,"Breach,Cypher,Sova,Omen,Yoru","Raze,Killjoy,Viper,Omen,Fade"
Breeze,Team PlayHard Glasterz,SiXSENSE GC,10,13,4,7,6,6,"Cypher,Sova,Viper,Jett,KAY/O","Cypher,Sova,Viper,Omen,Yoru"
Ascent,KONOHA,Reveal Multigaming Saphire,13,15,6,8,7,7,"Sova,Killjoy,Omen,Jett,KAY/O","Cypher,Reyna,Jett,KAY/O,Clove"
Icebox,TREMBLE,Hex Esports,9,13,6,6,7,3,"Sova,Killjoy,Viper,Jett,Harbor","Sova,Killjoy,Viper,Jett,Gekko"
Sunset,SSP Numina,Last9,5,13,2,10,3,3,"Breach,Raze,Cypher,Omen,Gekko","Cypher,Sova,Omen,KAY/O,Neon"
Ascent,Crvena zvezda esports,Idynomashimi,13,7,10,2,5,3,"Sova,Killjoy,Phoenix,Omen,Jett","Breach,Killjoy,Phoenix,Jett,Astra"
Icebox,HOF Kitsune,Zyron Sadashi,13,5,4,2,3,9,"Sova,Killjoy,Viper,Jett,Gekko","Killjoy,Viper,Reyna,Gekko,Iso"
Ascent,Coalesce Roses,Dortmund eSports Dynasty,5,13,3,3,10,2,"Killjoy,Reyna,Omen,Fade,Harbor","Sova,Killjoy,Omen,Jett,KAY/O"
Icebox,6TM ESPORTS,TeamOrangeGaming,7,13,3,5,8,4,"Sova,Killjoy,Viper,Omen,Jett","Sova,Killjoy,Viper,Sage,Jett"
Ascent,Silly Weapons All Game,Team Genetix Queens,13,2,3,0,2,10,"Sova,Killjoy,Jett,KAY/O,Clove","Sova,Killjoy,Omen,Jett,KAY/O"
Icebox,Colorful Radiation,ECO Akuma,12,14,6,7,7,6,"Sova,Killjoy,Viper,Jett,KAY/O","Killjoy,Viper,Jett,Harbor,Gekko"
Lotus,NUXERIA GC,OATMILK,15,13,7,7,6,8,"Breach,Raze,Killjoy,Omen,Gekko","Breach,Raze,Cypher,Omen,Gekko"
Sunset,HELLO KITTY,DESTINY,10,13,6,6,7,4,"Cypher,Sova,Omen,Jett,Gekko","Breach,Sage,Omen,Jett,Gekko"
Bind,Saltire Sirens,Oserv Esport GC,14,12,6,7,5,8,"Raze,Cypher,Reyna,Skye,Clove","Raze,Cypher,Brimstone,Skye,Gekko"
Ascent,Exanimis,SK Nebula,9,13,4,6,7,5,"Sova,Killjoy,Omen,Jett,KAY/O","Sova,Killjoy,Omen,Jett,KAY/O"
Ascent,BÖSE BUBEN,IMPERIUM,13,7,4,4,3,9,"Sova,Killjoy,Omen,Jett,KAY/O","Sova,Killjoy,Omen,Jett,KAY/O"
Lotus,Shine in Shade,EXALTY Kali,5,13,4,8,5,1,"Breach,Cypher,Omen,Neon,Fade","Breach,Raze,Cypher,Omen,Gekko"
Icebox,Digity Esport,Ravens GC,6,13,3,9,4,3,"Raze,Sova,Killjoy,Harbor,Gekko","Sova,Killjoy,Viper,Jett,Gekko"
Sunset,EMUs,PURE GC,13,4,9,3,1,4,"Breach,Raze,Cypher,Omen,KAY/O","Breach,Raze,Cypher,Omen,Gekko"
Sunset,Powerpuff GC,NOMAD GC,4,13,4,8,5,0,"Breach,Cypher,Omen,Neon,Fade","Breach,Cypher,Sova,Omen,Jett"
Icebox,Anonymo GC,?,13,0,12,0,0,1,"Sova,Killjoy,Viper,Jett,Harbor","Sova,Killjoy,Viper,Jett,Gekko"
Bind,Formulation Gaming GC,Red Velvet,13,8,6,3,5,7,"Raze,Viper,Brimstone,Skye,Chamber","Raze,Viper,Brimstone,Skye,Gekko"
Ascent,Zenithia,axolotls and chips,1,13,1,11,2,0,"Raze,Viper,Reyna,Skye,Harbor","Breach,Cypher,Sova,Omen,Jett"
Lotus,Dortmund Esports,VEX ESPORTS,13,8,7,5,3,6,"Omen,Yoru,Neon,Gekko,Deadlock","Breach,Raze,Omen,Gekko,Deadlock"
Lotus,Xravel CBRS,BRUXA,14,16,9,6,10,5,"Breach,Raze,Killjoy,Viper,Omen","Breach,Raze,Killjoy,Omen,Fade"
Sunset,Silly Weapons All Game,Team Genetix Queens,13,2,2,1,1,11,"Breach,Raze,Cypher,Gekko,Clove","Breach,Raze,Cypher,Sova,Omen"
Breeze,SSP Numina,Last9,7,13,4,4,9,3,"Sova,Viper,Jett,Yoru,Astra","Cypher,Sova,Viper,Jett,Yoru"
Split,EKO Esports GC,Cannes Esports,13,9,5,5,4,8,"Raze,Cypher,Sage,Reyna,Omen","Breach,Raze,Cypher,Omen,Skye"
Icebox,GnG White,Imperium Livia,13,10,6,6,4,7,"Sova,Killjoy,Viper,Reyna,Jett","Sova,Killjoy,Viper,Harbor,Gekko"
Haven,KONOHA,Reveal Multigaming Saphire,9,13,6,6,7,3,"Breach,Sova,Killjoy,Omen,Jett","Breach,Cypher,Sova,Omen,Jett"
Bind,Lootcifer,Reveal Multigaming,13,11,8,4,7,5,"Cypher,Viper,Brimstone,Skye,Gekko","Raze,Viper,Brimstone,Skye,Gekko"
Lotus,RevenantVAL,TwentyStars,8,13,3,6,7,5,"Breach,Raze,Killjoy,Omen,Fade","Breach,Sova,Killjoy,Omen,Jett"
Ascent,Digity Esport,Ravens GC,2,13,2,10,3,0,"Breach,Raze,Sova,Killjoy,Omen","Sova,Killjoy,Omen,Jett,KAY/O"
Ascent,WLGaming Esports GC,Team Galaga Kitsune,10,13,5,7,6,5,"Sova,Killjoy,Omen,Jett,KAY/O","Breach,Sova,Killjoy,Omen,Jett"
Split,Celestials GC,Scald eSport GC,13,9,6,4,5,7,"Breach,Raze,Cypher,KAY/O,Clove","Breach,Raze,Cypher,Skye,Astra"
Icebox,SPICY,Veni eSports Venom,13,9,4,8,1,9,"Sova,Killjoy,Viper,Sage,Jett","Sova,Killjoy,Viper,Reyna,Deadlock"
Bind,HELLO KITTY,DESTINY,6,13,4,3,10,2,"Viper,Brimstone,Chamber,Neon,Gekko","Raze,Viper,Brimstone,Skye,Gekko"
Lotus,Powerpuff GC,NOMAD GC,3,13,1,3,10,2,"Breach,Killjoy,Omen,Neon,Gekko","Breach,Raze,Killjoy,Omen,Fade"
Ascent,Team PlayHard Glasterz,SiXSENSE GC,13,7,9,3,4,4,"Sova,Killjoy,Omen,Jett,KAY/O","Breach,Sova,Killjoy,Omen,Jett"
Breeze,aNc Outplayed GC,Lotus Karma,10,13,8,3,10,2,"Cypher,Sova,Viper,Jett,KAY/O","Sova,Viper,KAY/O,Chamber,Neon"
Bind,BÖSE BUBEN,IMPERIUM,13,6,10,2,4,3,"Raze,Viper,Brimstone,Skye,Yoru","Raze,Viper,Brimstone,Skye,Gekko"
Ascent,Mulieres Vires,Acient Freya,11,13,9,3,10,2,"Sova,Killjoy,Omen,Jett,KAY/O","Sova,Killjoy,Phoenix,Omen,Jett"
Split,KOI,Gentle Mates,11,13,6,6,7,5,"Breach,Raze,Viper,Omen,Fade","Breach,Raze,Cypher,Omen,Yoru"
Lotus,TREMBLE,Hex Esports,5,13,2,4,9,3,"Breach,Raze,Killjoy,Viper,Omen","Breach,Raze,Killjoy,Neon,Clove"
Bind,EMUs,PURE GC,13,5,6,0,5,7,"Raze,Brimstone,Yoru,Harbor,Gekko","Raze,Viper,Brimstone,Fade,Gekko"
Split,Soul Society,RAKUZAN,11,13,8,4,9,3,"Breach,Raze,Cypher,Omen,Yoru","Breach,Cypher,Sage,Jett,Clove"
Bind,NYAN Esports,Dragons Esports GC,13,8,7,2,6,6,"Breach,Cypher,Sova,Brimstone,Yoru","Raze,Viper,Brimstone,Skye,Gekko"
Sunset,Crvena zvezda esports,Idynomashimi,9,13,4,6,7,5,"Breach,Raze,Sage,Omen,Gekko","Breach,Cypher,Omen,Neon,Iso"
Sunset,HOF Kitsune,Zyron Sadashi,13,8,6,3,5,7,"Breach,Raze,Cypher,Omen,Gekko","Breach,Cypher,Omen,Neon,Fade"
Ascent,Shine in Shade,EXALTY Kali,4,13,1,4,9,3,"Cypher,Sova,Omen,Jett,KAY/O","Sova,Killjoy,Omen,Jett,KAY/O"
Lotus,GoatFellas Tragos,5STARS GC,9,13,6,6,7,3,"Breach,Raze,Killjoy,Viper,Omen","Breach,Raze,Killjoy,Omen,Gekko"
Lotus,Anonymo GC,?,13,2,3,0,2,10,"Raze,Sova,Omen,Yoru,Deadlock","Raze,Killjoy,Viper,Omen,Fade"
Sunset,Colorful Radiation,ECO Akuma,13,6,5,2,4,8,"Breach,Cypher,Omen,Neon,Gekko","Breach,Cypher,Omen,Neon,Gekko"
Icebox,Exanimis,SK Nebula,6,13,5,7,6,1,"Sova,Killjoy,Gekko,Iso,Clove","Sova,Killjoy,Viper,Sage,Jett"
Icebox,Coalesce Roses,Dortmund eSports Dynasty,8,13,7,5,8,1,"Sova,Killjoy,Viper,Reyna,Iso","Sova,Killjoy,Viper,Jett,Gekko"
Sunset,Formulation Gaming GC,Red Velvet,13,3,3,1,2,10,"Breach,Raze,Cypher,Omen,Fade","Breach,Raze,Cypher,Omen,Gekko"
Icebox,Saltire Sirens,Oserv Esport GC,13,8,5,7,1,8,"Killjoy,Reyna,Harbor,Gekko,Iso","Sova,Killjoy,Viper,Jett,Gekko"
Sunset,NUXERIA GC,OATMILK,11,13,6,6,7,5,"Breach,Raze,Cypher,Omen,Gekko","Breach,Cypher,Omen,Jett,Gekko"
Lotus,Zenithia,axolotls and chips,3,13,1,11,2,2,"Breach,Raze,Killjoy,Omen,Fade","Raze,Cypher,Omen,Fade,Deadlock"
Bind,Melilla Titans,Signum Reges,13,5,4,2,3,9,"Raze,Viper,Brimstone,Reyna,Skye","Raze,Viper,Omen,Skye,Iso"
Sunset,KOI,Gentle Mates,11,13,7,5,8,4,"Raze,Cypher,Sova,Omen,KAY/O","Cypher,Sage,Omen,KAY/O,Neon"
Icebox,Melilla Titans,Signum Reges,13,1,11,1,0,2,"Sova,Killjoy,Viper,Jett,Harbor","Killjoy,Viper,KAY/O,Gekko,Iso"
Ascent,XOXO-01,XERXIA Esports,3,13,2,2,11,1,"Breach,Sova,Killjoy,Omen,Jett","Sova,Killjoy,Omen,Jett,KAY/O"
Haven,Ninjas in Galaxy,Kizuna Esports,15,17,5,11,6,10,"Breach,Sova,Killjoy,Omen,Jett","Breach,Sova,Killjoy,Omen,Jett"
Split,XOXO-01,XERXIA Esports,9,13,5,5,8,4,"Raze,Cypher,Viper,Omen,Skye","Raze,Cypher,Viper,Omen,Skye"
Ascent,Revenant Esports,True Rippers,13,6,9,3,3,4,"Cypher,Sova,Omen,Jett,Iso","Sova,Killjoy,Omen,Jett,KAY/O"
Lotus,Ninjas in Galaxy,Kizuna Esports,10,13,5,7,6,5,"Raze,Killjoy,Viper,Omen,Fade","Breach,Sova,Killjoy,Omen,Jett"
Ascent,Team Big BAAM,Unicorn Cyber Esports,14,12,7,6,6,7,"Sova,Killjoy,Reyna,Omen,Jett","Sova,Killjoy,Reyna,Jett,Clove"
Lotus,XOXO-01,XERXIA Esports,13,7,7,5,2,6,"Raze,Killjoy,Viper,Omen,Fade","Breach,Raze,Cypher,Omen,Fade"
Bind,Team Big BAAM,Unicorn Cyber Esports,8,13,4,8,5,4,"Raze,Cypher,Viper,Omen,Skye","Raze,Chamber,Gekko,Deadlock,Clove"
Bind,Elevate (SG),NEXGA,13,1,11,1,0,2,"Raze,Cypher,Viper,Brimstone,KAY/O","Raze,Viper,Brimstone,Skye,Iso"
Haven,BOBO,Rub n' Pug,13,7,5,3,4,8,"Cypher,Sova,Omen,Jett,Fade","Breach,Sova,Omen,Jett,Iso"
Bind,Barn nong chok,Team NKT,6,13,1,6,7,5,"Raze,Viper,Brimstone,Skye,Deadlock","Reyna,Yoru,Astra,Harbor,Gekko"
Sunset,Revenant Esports,True Rippers,13,5,8,4,1,5,"Sova,Omen,Neon,Gekko,Iso","Breach,Cypher,Sova,Omen,Jett"
Ascent,BOBO,Rub n' Pug,13,6,2,5,1,11,"Sova,Killjoy,Omen,Jett,KAY/O","Sova,Killjoy,Omen,Jett,KAY/O"
Lotus,Elevate (SG),NEXGA,13,6,8,4,2,5,"Raze,Cypher,Omen,Fade,Deadlock","Breach,Sova,Killjoy,Omen,Jett"
Sunset,Barn nong chok,Team NKT,4,13,2,3,10,2,"Breach,Raze,Cypher,Omen,Gekko","Cypher,Sova,Omen,Jett,KAY/O"
Split,Team Big BAAM,Unicorn Cyber Esports,13,9,9,1,8,4,"Raze,Cypher,Viper,Omen,Skye","Raze,Cypher,Viper,Omen,Skye"
Bind,Revenant Esports,True Rippers,13,10,5,7,3,8,"Raze,Viper,Brimstone,Skye,Gekko","Cypher,Sova,Brimstone,Jett,Gekko"
Bind,EDGE (OCE),iPGN,7,13,6,6,7,1,"Breach,Cypher,Brimstone,Jett,Gekko","Raze,Viper,Brimstone,Fade,Gekko"
Bind,Gang Gang,Asmodeus Colosseum GC,6,13,4,8,5,2,"Raze,Cypher,Viper,Omen,Skye","Raze,Viper,Brimstone,Fade,Gekko"
Sunset,Alter Ego,Doa Ibu Selamanya,13,3,9,3,0,4,"Breach,Raze,Cypher,Omen,Gekko","Raze,Cypher,Reyna,Omen,KAY/O"
Ascent,REJECT,FENNEL,7,13,2,6,7,5,"Sova,Killjoy,Omen,Jett,KAY/O","Sova,Killjoy,Omen,Jett,KAY/O"
Lotus,Team Big BAAM,Unicorn Cyber Esports,14,12,5,8,4,9,"Breach,Raze,Killjoy,Omen,Fade","Raze,Killjoy,Fade,Gekko,Clove"
Ascent,EDGE (OCE),iPGN,13,4,5,0,4,8,"Cypher,Sova,Phoenix,Omen,Deadlock","Sova,Killjoy,Omen,Jett,KAY/O"
Ascent,Carti World,ZOL Esports,13,15,9,5,10,4,"Sova,Killjoy,Omen,Jett,KAY/O","Sova,Killjoy,Omen,Jett,KAY/O"
Lotus,Gang Gang,Asmodeus Colosseum GC,10,13,7,4,9,3,"Breach,Killjoy,Omen,Neon,Iso","Breach,Raze,Killjoy,Omen,Fade"
Icebox,Alter Ego,Doa Ibu Selamanya,13,8,9,3,5,4,"Raze,Sova,Killjoy,Viper,KAY/O","Sova,Killjoy,Viper,Jett,Gekko"
Sunset,REJECT,FENNEL,5,13,0,6,7,5,"Raze,Cypher,Omen,KAY/O,Gekko","Raze,Cypher,Sage,Omen,Fade"
Icebox,EDGE (OCE),iPGN,9,13,4,8,5,5,"Sova,Killjoy,Viper,Reyna,Jett","Sova,Killjoy,Viper,Sage,Jett"
Icebox,Carti World,ZOL Esports,7,13,2,6,7,5,"Sova,Killjoy,Viper,Jett,Gekko","Sova,Killjoy,Viper,Jett,KAY/O"
Split,Le Crapaud,Bigetron Arctic,13,8,6,6,2,7,"Raze,Cypher,Omen,Jett,Skye","Raze,Cypher,Viper,Omen,Skye"
Split,RIDDLE ORDER,VARREL,13,10,8,4,6,5,"Raze,Viper,Omen,Jett,Skye","Raze,Viper,Omen,Jett,Skye"
Split,OLD STINKY CAT,Oasis Gaming,10,13,7,5,8,3,"Raze,Cypher,Omen,Jett,Skye","Raze,Cypher,Sage,Skye,Astra"
Ascent,Le Crapaud,Bigetron Arctic,13,10,3,8,2,10,"Sova,Killjoy,Omen,Jett,KAY/O","Sova,Killjoy,Omen,Jett,KAY/O"
Ascent,RIDDLE ORDER,VARREL,13,6,6,1,5,7,"Sova,Killjoy,Omen,Jett,KAY/O","Cypher,Sova,Omen,Jett,Deadlock"
Lotus,OLD STINKY CAT,Oasis Gaming,7,13,4,8,5,3,"Raze,Killjoy,Sage,Chamber,Harbor","Raze,Killjoy,Viper,Omen,Fade"
Ascent,Reven eClub,RETA Esports,3,13,3,9,4,0,"Cypher,Sova,Omen,Jett,KAY/O","Sova,Killjoy,Omen,Jett,KAY/O"
Bind,Reven eClub,RETA Esports,2,13,2,10,3,0,"Raze,Cypher,Viper,Omen,Skye","Raze,Viper,Brimstone,Skye,Gekko"
Lotus,Reven eClub,RETA Esports,13,7,5,3,4,8,"Breach,Cypher,Omen,Neon,Gekko","Raze,Killjoy,Viper,Omen,Fade"
Icebox,Reven eClub,RETA Esports,13,2,3,0,2,10,"Killjoy,Viper,Jett,KAY/O,Gekko","Sova,Killjoy,Viper,Jett,Harbor"
Haven,Oxygen Esports,DarkZero Esports,10,13,4,8,5,6,"Breach,Sova,Killjoy,Omen,Jett","Breach,Cypher,Sova,Omen,Jett"
Sunset,Reven eClub,RETA Esports,6,13,6,6,7,0,"Cypher,Sova,Omen,KAY/O,Neon","Raze,Cypher,Sova,Omen,KAY/O"
Bind,Oxygen Esports,DarkZero Esports,7,13,5,7,6,2,"Raze,Viper,Brimstone,Skye,Gekko","Viper,Brimstone,Sage,Neon,Gekko"
Sunset,Oxygen Esports,DarkZero Esports,13,4,3,2,2,10,"Breach,Raze,Cypher,Omen,KAY/O","Breach,Cypher,Omen,KAY/O,Neon"
Haven,Blinn Esports,Winthrop University,13,6,6,1,5,7,"Breach,Omen,Chamber,Neon,Fade","Breach,Cypher,Omen,Jett,Iso"
Icebox,Blinn Esports,Winthrop University,13,3,4,0,3,9,"Sova,Killjoy,Viper,Jett,Clove","Sova,Killjoy,Viper,Jett,Clove"
Split,Scald eSport GC,Itz 2 EZzy,14,12,9,4,8,5,"Breach,Raze,Cypher,Skye,Astra","Breach,Raze,Cypher,Viper,Astra"
Sunset,XProjekt Lioness,HELLO KITTY,11,13,8,4,9,3,"Breach,Raze,Cypher,Omen,Gekko","Cypher,Sova,Omen,Jett,Gekko"
Ascent,EXALTY Kali,ANYMOLLY,13,10,7,5,5,6,"Sova,Killjoy,Omen,Jett,KAY/O","Sova,Killjoy,Omen,Jett,KAY/O"
Lotus,Silly Weapons All Game,ditto,13,3,4,0,3,9,"Breach,Raze,Killjoy,Gekko,Clove","Raze,Sova,Killjoy,Reyna,Omen"
Breeze,6TM ESPORTS,AKA HERO,7,13,4,8,5,3,"Cypher,Sova,Viper,Jett,Harbor","Cypher,Sova,Viper,Jett,KAY/O"
Split,Southpaw,RAKUZAN,4,13,2,3,10,2,"Raze,Cypher,Omen,Skye,Yoru","Breach,Cypher,Sage,Jett,Clove"
Sunset,EKO Esports GC,RedPack GC,13,10,5,7,3,8,"Breach,Raze,Cypher,Omen,Gekko","Breach,Cypher,Sova,Neon,Clove"
Bind,DSYRE Academy,Fishing Rods,6,13,4,8,5,2,"Raze,Brimstone,Skye,Yoru,Gekko","Raze,Sova,Viper,Brimstone,Skye"
Ascent,Natus Vincere,GIANTX,8,13,3,6,7,5,"Cypher,Sova,Omen,Jett,KAY/O","Cypher,Sova,Omen,Jett,KAY/O"
Lotus,Imperium Livia,Nova Elite GC,13,6,9,3,3,4,"Breach,Killjoy,Omen,Neon,Gekko","Breach,Raze,Killjoy,Omen,Gekko"
Ascent,Les Zoneuses,Dragons Esports GC,6,13,4,8,5,2,"Sova,Killjoy,Reyna,Omen,Jett","Sova,Killjoy,Omen,Jett,KAY/O"
Ascent,Scald eSport GC,Itz 2 EZzy,9,13,4,8,5,5,"Sova,Omen,Jett,Yoru,Deadlock","Sova,Killjoy,Omen,Jett,KAY/O"
Bind,Red Velvet,K1 Kaisen,13,10,8,3,7,5,"Raze,Viper,Brimstone,Skye,Gekko","Raze,Cypher,Omen,Jett,Skye"
Sunset,5STARS GC,Hyper Divas,13,7,4,4,3,9,"Breach,Raze,Cypher,Omen,Gekko","Breach,Raze,Cypher,Astra,Gekko"
Icebox,EKO Esports GC,RedPack GC,13,1,2,0,1,11,"Sova,Killjoy,Viper,Sage,Jett","Sova,Killjoy,Viper,Jett,Gekko"
Bind,Cursed Cats GC,PURE GC,9,13,5,5,8,4,"Raze,Viper,Brimstone,Fade,Gekko","Raze,Viper,Brimstone,Fade,Gekko"
Lotus,Luminary GC,BRUXA,10,13,5,6,7,5,"Breach,Killjoy,Omen,Astra,Neon","Breach,Raze,Killjoy,Omen,Fade"
Lotus,Deathmoth,Veni eSports Venom,10,13,4,8,5,6,"Breach,Raze,Killjoy,Omen,Gekko","Breach,Raze,Omen,Chamber,Gekko"
Lotus,SFAM ESPORT GC,Neira Esports,2,13,1,11,2,1,"Breach,Raze,Cypher,Killjoy,Omen","Killjoy,Omen,Jett,Fade,Gekko"
Bind,XProjekt Lioness,HELLO KITTY,13,15,8,6,9,5,"Raze,Cypher,Skye,Gekko,Clove","Viper,Brimstone,Chamber,Neon,Gekko"
Ascent,Silly Weapons All Game,ditto,8,13,3,6,7,5,"Sova,Killjoy,Jett,Astra,KAY/O","Sova,Killjoy,Phoenix,Omen,Jett"
Ascent,Unicorn Cyber Esports,Crocodile Tear,13,6,8,4,2,5,"Sova,Killjoy,Reyna,Jett,Clove","Sova,Killjoy,Omen,Jett,KAY/O"
Bind,?,ONEXT,14,12,8,5,7,6,"Raze,Viper,Brimstone,Skye,Deadlock","Raze,Cypher,Viper,Brimstone,Skye"
Icebox,Idynomashimi,cheerleaders,13,8,3,6,2,10,"Sova,Killjoy,Viper,Jett,Iso","Sova,Killjoy,Viper,Jett,Gekko"
Icebox,Relentless GC,SK Nebula,4,13,4,8,5,0,"Killjoy,Viper,Jett,Gekko,Clove","Sova,Killjoy,Viper,Sage,Jett"
Bind,EXALTY Kali,ANYMOLLY,13,8,8,4,4,5,"Raze,Cypher,Brimstone,Skye,Gekko","Viper,Brimstone,Jett,Skye,Gekko"
Icebox,Hex Esports,Sacos,14,12,6,7,5,8,"Sova,Killjoy,Viper,Jett,Gekko","Breach,Sova,Killjoy,Viper,Gekko"
Icebox,SiXSENSE GC,Vay Esports GC,13,5,8,4,1,5,"Sova,Killjoy,Viper,Jett,Clove","Sova,Killjoy,Viper,Jett,Neon"
Haven,DSYRE Academy,Fishing Rods,8,13,3,9,4,5,"Cypher,Sova,Omen,Yoru,Iso","Breach,Sova,Killjoy,Omen,Jett"
Ascent,6TM ESPORTS,AKA HERO,7,13,3,5,8,4,"Cypher,Sova,Omen,Jett,KAY/O","Cypher,Sova,Omen,Jett,KAY/O"
Lotus,Acient Freya,Penta Glamour,13,9,6,6,3,7,"Breach,Killjoy,Omen,Neon,Gekko","Breach,Raze,Killjoy,Omen,Gekko"
Lotus,Cannes Esports,Banana Bandits,13,5,9,3,2,4,"Breach,Raze,Killjoy,Omen,Fade","Raze,Killjoy,Viper,Omen,Fade"
Ascent,PSQ GC,Team Galaga Kitsune,4,13,4,8,5,0,"Sova,Killjoy,Omen,Jett,KAY/O","Breach,Sova,Killjoy,Omen,Jett"
Ascent,Team Meaow,Soul Society,4,13,2,3,10,2,"Sova,Killjoy,Phoenix,Brimstone,Jett","Sova,Killjoy,Omen,Jett,KAY/O"
Breeze,AnakinCrew Esport GC,Last9,4,13,3,9,4,1,"Cypher,Sova,Viper,Jett,Skye","Cypher,Sova,Viper,Jett,Yoru"
Split,Melilla Titans Aura,Formulation Gaming GC,2,13,2,10,3,0,"Breach,Raze,Cypher,Omen,Skye","Raze,Cypher,Viper,Omen,Skye"
Sunset,Team Genetix Queens,AURORA,13,7,8,0,7,5,"Breach,Raze,Cypher,Sova,Omen","Breach,Raze,Cypher,Omen,Gekko"
Sunset,Southpaw,RAKUZAN,10,13,4,8,5,6,"Raze,Cypher,Phoenix,Omen,Gekko","Cypher,Sova,Jett,Gekko,Clove"
Lotus,Entropy Azúcar,Ravens GC,8,13,2,7,6,6,"Breach,Raze,Killjoy,Omen,Fade","Breach,Raze,Killjoy,Omen,Fade"
Lotus,ECO Akuma,GULUGULU,13,5,5,1,4,8,"Breach,Raze,Killjoy,Omen,Gekko","Breach,Raze,Killjoy,Jett,Astra"
Lotus,Natus Vincere,GIANTX,9,13,4,8,5,5,"Breach,Raze,Killjoy,Brimstone,Gekko","Killjoy,Omen,Skye,Neon,Fade"
Lotus,PCIFIC Waves,GnG White,8,13,1,8,5,7,"Breach,Raze,Killjoy,Omen,Fade","Breach,Raze,Killjoy,Fade,Clove"
Split,DESTINY,Winx Enchantrix,13,9,7,3,6,6,"Breach,Cypher,Omen,Jett,Clove","Breach,Raze,Cypher,Sage,Omen"
Icebox,Oserv Esport GC,Projet Améthyste,13,3,9,3,0,4,"Sova,Killjoy,Viper,Jett,Gekko","Sova,Killjoy,Sage,Omen,Jett"
Sunset,OMNIA GC,Dortmund eSports Dynasty,4,13,3,9,4,1,"Breach,Raze,Cypher,Omen,Fade","Breach,Cypher,Viper,Omen,Gekko"
Ascent,OATMILK,Venenum GC,13,6,9,3,3,4,"Cypher,Sova,Omen,Jett,KAY/O","Sova,Killjoy,Omen,Jett,KAY/O"
Bind,NOMAD GC,CriTicS Roses,13,0,1,0,0,12,"Breach,Raze,Cypher,Omen,Fade","Raze,Killjoy,Brimstone,Skye,Iso"
Sunset,RADX E-Sports,axolotls and chips,0,13,0,1,12,0,"Raze,Cypher,Viper,KAY/O,Gekko","Breach,Cypher,Sova,Reyna,Harbor"
Lotus,Les Zoneuses,Dragons Esports GC,7,13,3,9,4,4,"Raze,Killjoy,Omen,Neon,Gekko","Raze,Killjoy,Viper,Omen,Fade"
Ascent,Relentless GC,SK Nebula,3,13,3,9,4,0,"Sova,Killjoy,Omen,Jett,KAY/O","Sova,Killjoy,Omen,Jett,KAY/O"
Ascent,Team Galaga,SZK Esports,13,3,4,0,3,9,"Sova,Killjoy,Omen,Jett,KAY/O","Sova,Killjoy,Omen,Jett,KAY/O"
Icebox,SFAM ESPORT GC,Neira Esports,5,13,0,6,7,5,"Sova,Killjoy,Viper,Jett,Gekko","Sova,Killjoy,Jett,KAY/O,Harbor"
Lotus,Team Meaow,Soul Society,1,13,1,11,2,0,"Breach,Raze,Killjoy,Brimstone,Harbor","Breach,Killjoy,Omen,Neon,Fade"
Icebox,Deathmoth,Veni eSports Venom,3,13,0,4,9,3,"Sova,Killjoy,Jett,Harbor,Gekko","Sova,Killjoy,Viper,Reyna,Deadlock"
Icebox,Unicorn Cyber Esports,Crocodile Tear,6,13,1,11,2,5,"Sova,Killjoy,Viper,Gekko,Iso","Killjoy,Viper,KAY/O,Gekko,Iso"
Bind,PSQ GC,Team Galaga Kitsune,1,13,0,2,11,1,"Cypher,Omen,Skye,Neon,Gekko","Breach,Raze,Cypher,Brimstone,Yoru"
Sunset,AnakinCrew Esport GC,Last9,2,13,2,10,3,0,"Breach,Raze,Cypher,Omen,Gekko","Cypher,Sova,Omen,KAY/O,Neon"
Sunset,Imperium Livia,Nova Elite GC,13,3,10,2,1,3,"Breach,Raze,Cypher,Omen,Deadlock","Breach,Raze,Cypher,Omen,Gekko"
Split,DSYRE Academy,Fishing Rods,13,6,9,3,3,4,"Raze,Cypher,Sage,Omen,Jett","Raze,Cypher,Sage,Omen,Skye"
Sunset,6TM ESPORTS,AKA HERO,13,5,8,4,1,5,"Cypher,Omen,KAY/O,Neon,Gekko","Breach,Cypher,Omen,Jett,Yoru"
Lotus,Melilla Titans Aura,Formulation Gaming GC,5,13,3,9,4,2,"Breach,Raze,Killjoy,Omen,Gekko","Raze,Killjoy,Viper,Omen,Fade"
Sunset,Scald eSport GC,Itz 2 EZzy,13,11,7,5,6,6,"Breach,Raze,Cypher,Omen,Gekko","Breach,Raze,Cypher,Astra,Gekko"
Lotus,DESTINY,Winx Enchantrix,13,1,11,1,0,2,"Breach,Raze,Killjoy,Viper,Omen","Breach,Cypher,Omen,Jett,Fade"
Sunset,Luminary GC,BRUXA,6,13,2,5,8,4,"Breach,Raze,Cypher,Sova,Omen","Breach,Raze,Cypher,Omen,Skye"
Split,PCIFIC Waves,GnG White,7,13,5,7,6,2,"Breach,Raze,Cypher,Omen,Skye","Breach,Raze,Cypher,Omen,Jett"
Lotus,XProjekt Lioness,HELLO KITTY,13,8,8,4,4,5,"Breach,Raze,Killjoy,Omen,Gekko","Breach,Killjoy,Omen,Jett,Gekko"
Lotus,Cursed Cats GC,PURE GC,11,13,7,5,8,4,"Breach,Raze,Killjoy,Omen,Gekko","Breach,Killjoy,Omen,Neon,Gekko"
Lotus,5STARS GC,Hyper Divas,13,9,7,5,4,6,"Breach,Raze,Killjoy,Omen,Gekko","Breach,Raze,Sova,Killjoy,Omen"
Breeze,Southpaw,RAKUZAN,13,5,10,2,3,3,"Cypher,Sova,Viper,Yoru,Astra","Cypher,Sova,Viper,Jett,Skye"
Lotus,EXALTY Kali,ANYMOLLY,9,13,4,6,7,5,"Breach,Raze,Cypher,Omen,Gekko","Breach,Killjoy,Viper,Jett,Clove"
Sunset,Red Velvet,K1 Kaisen,15,13,5,9,4,10,"Breach,Raze,Cypher,Omen,Gekko","Breach,Cypher,Sova,Omen,Jett"
Sunset,ECO Akuma,GULUGULU,13,5,5,1,4,8,"Breach,Raze,Cypher,Omen,Gekko","Breach,Raze,Cypher,Omen,Gekko"
Sunset,Silly Weapons All Game,ditto,13,8,6,6,2,7,"Breach,Raze,Cypher,Gekko,Clove","Raze,Cypher,Sova,Omen,Neon"
Split,Cannes Esports,Banana Bandits,13,7,7,5,2,6,"Breach,Raze,Cypher,Omen,Skye","Breach,Raze,Cypher,Omen,Skye"
Sunset,Idynomashimi,cheerleaders,13,10,4,8,2,9,"Breach,Cypher,Omen,Neon,Iso","Breach,Cypher,Sova,Omen,Neon"
Ascent,Hex Esports,Sacos,13,10,3,9,1,10,"Killjoy,Omen,Jett,KAY/O,Neon","Raze,Sova,Killjoy,Omen,KAY/O"
Icebox,OMNIA GC,Dortmund eSports Dynasty,3,13,3,9,4,0,"Sova,Killjoy,Viper,Jett,Gekko","Sova,Killjoy,Viper,Jett,Gekko"
Lotus,OATMILK,Venenum GC,13,1,11,1,0,2,"Breach,Raze,Cypher,Omen,Gekko","Breach,Raze,Killjoy,Omen,Gekko"
Sunset,?,ONEXT,13,10,7,4,6,6,"Breach,Raze,Cypher,Omen,Fade","Breach,Raze,Cypher,Omen,Gekko"
Icebox,Acient Freya,Penta Glamour,13,8,9,3,5,4,"Sova,Killjoy,Viper,Jett,Gekko","Killjoy,Viper,Jett,KAY/O,Gekko"
Ascent,Entropy Azúcar,Ravens GC,6,13,3,9,4,3,"Sova,Killjoy,Omen,Jett,KAY/O","Sova,Killjoy,Omen,Jett,KAY/O"
Ascent,Team Genetix Queens,AURORA,13,6,9,3,3,4,"Sova,Killjoy,Omen,Jett,KAY/O","Sova,Killjoy,Omen,Jett,KAY/O"
Sunset,NOMAD GC,CriTicS Roses,13,3,3,1,2,10,"Breach,Cypher,Sova,Omen,Jett","Breach,Cypher,Neon,Gekko,Clove"
Lotus,Oserv Esport GC,Projet Améthyste,13,1,11,1,0,2,"Breach,Raze,Killjoy,Omen,Fade","Breach,Killjoy,Omen,Neon,Fade"
Ascent,RADX E-Sports,axolotls and chips,1,13,1,11,2,0,"Sova,Killjoy,Omen,Jett,KAY/O","Breach,Cypher,Sova,Omen,Jett"
Ascent,SiXSENSE GC,Vay Esports GC,13,11,8,4,7,5,"Breach,Sova,Killjoy,Omen,Jett","Sova,Killjoy,Omen,Jett,KAY/O"
Ascent,BBL Esports,Team Liquid,13,5,7,5,0,6,"Cypher,Sova,Omen,Jett,KAY/O","Cypher,Sova,Omen,Jett,Iso"
Sunset,Team Galaga,SZK Esports,14,12,7,6,6,7,"Breach,Raze,Cypher,Omen,Gekko","Breach,Cypher,Omen,Neon,Gekko"
Sunset,Unicorn Cyber Esports,Crocodile Tear,13,10,6,6,4,7,"Cypher,Sova,Omen,KAY/O,Neon","Raze,Cypher,Omen,KAY/O,Gekko"
Lotus,Hexagon,Gang Gang,6,13,6,6,7,0,"Breach,Raze,Killjoy,Omen,Gekko","Breach,Raze,Killjoy,Omen,Iso"
Lotus,BBL Esports,Team Liquid,13,6,6,1,5,7,"Breach,Cypher,Omen,Neon,Fade","Breach,Raze,Cypher,Omen,Fade"
Haven,Asmodeus Colosseum GC,Team Caraxes,13,8,7,2,6,6,"Breach,Sova,Killjoy,Omen,Neon","Sova,Killjoy,Reyna,Omen,Jett"
Haven,Unicorn Cyber Esports,Crocodile Tear,13,7,8,4,3,5,"Breach,Cypher,Sova,Omen,Jett","Breach,Sova,Killjoy,Astra,Neon"
Lotus,Team Galaga,SZK Esports,15,17,11,5,12,4,"Breach,Raze,Cypher,Omen,Gekko","Breach,Sova,Killjoy,Omen,Jett"
Sunset,XERXIA Esports,Sharper Esports,2,13,0,3,10,2,"Breach,Raze,Cypher,Omen,Gekko","Breach,Raze,Sage,Omen,Gekko"
Bind,Hexagon,Gang Gang,6,13,3,4,9,3,"Raze,Cypher,Phoenix,Brimstone,Skye","Raze,Cypher,Viper,Omen,Skye"
Lotus,Asmodeus Colosseum GC,Team Caraxes,13,7,7,5,2,6,"Breach,Raze,Killjoy,Omen,Fade","Breach,Raze,Killjoy,Omen,Gekko"
Lotus,XERXIA Esports,Sharper Esports,13,10,8,3,7,5,"Breach,Raze,Cypher,Omen,Fade","Breach,Raze,Cypher,Omen,Fade"
Lotus,LaZe,Please Don't Fire,13,3,9,3,0,4,"Breach,Cypher,Sova,Omen,Neon","Breach,Raze,Omen,Jett,Skye"
Lotus,Unicorn Cyber Esports,Crocodile Tear,4,13,3,9,4,1,"Raze,Killjoy,Viper,Omen,Fade","Omen,Jett,Astra,Chamber,Fade"
Lotus,Rank El Cuties,NAOS Esports,12,14,8,5,9,4,"Raze,Killjoy,Viper,Omen,Fade","Raze,Viper,Omen,Chamber,Fade"
Split,XERXIA Esports,Sharper Esports,8,13,6,6,7,2,"Raze,Cypher,Viper,Omen,Skye","Raze,Viper,Omen,Skye,Chamber"
Sunset,LaZe,Please Don't Fire,13,10,10,1,9,3,"Breach,Raze,Cypher,Sova,Omen","Cypher,Sova,Omen,Neon,Iso"
Lotus,Deadlift GC,Team Caraxes,8,13,4,5,8,4,"Breach,Raze,Killjoy,Omen,Jett","Breach,Killjoy,Omen,Neon,Iso"
Lotus,Baby Royals,Gang Gang,8,13,4,5,8,4,"Breach,Raze,Killjoy,Omen,Jett","Breach,Killjoy,Omen,Neon,Iso"
Split,Rank El Cuties,NAOS Esports,5,13,2,4,9,3,"Raze,Cypher,Viper,Omen,Skye","Raze,Cypher,Omen,Jett,Skye"
Icebox,Shortcake,Asmodeus Colosseum GC,1,13,1,11,2,0,"Sova,Sage,Reyna,Jett,Clove","Sova,Killjoy,Viper,Reyna,Jett"
Lotus,FOCUSGG,Rub n' Pug,13,10,8,3,7,5,"Raze,Killjoy,Viper,Omen,Fade","Breach,Raze,Omen,Neon,Gekko"
Sunset,True Rippers,Velocity Gaming,13,15,2,12,3,11,"Cypher,Sova,Omen,Jett,Chamber","Breach,Raze,Cypher,Omen,Gekko"
Ascent,Disguised,Kizuna Esports,13,5,5,1,4,8,"Cypher,Sova,Omen,Jett,Iso","Sova,Killjoy,Omen,Jett,KAY/O"
Lotus,XOXO-01, Santa Gang,12,14,6,7,7,6,"Raze,Killjoy,Viper,Omen,Fade","Raze,Cypher,Viper,Omen,Fade"
Bind,LAZY,Team Big BAAM,17,15,10,6,9,7,"Raze,Viper,Brimstone,Sage,Skye","Raze,Cypher,Viper,Omen,Skye"
Bind,Shortcake,Asmodeus Colosseum GC,3,13,3,9,4,0,"Breach,Cypher,Phoenix,Omen,Jett","Breach,Raze,Cypher,Brimstone,Gekko"
Bind,Baby Royals,Gang Gang,8,13,6,3,10,2,"Breach,Raze,Cypher,Sova,Brimstone","Raze,Cypher,Viper,Omen,Skye"
Bind,Deadlift GC,Team Caraxes,8,13,6,3,10,2,"Breach,Raze,Cypher,Sova,Brimstone","Raze,Cypher,Viper,Omen,Skye"
Haven,True Rippers,Velocity Gaming,13,6,5,2,4,8,"Breach,Sova,Killjoy,Omen,Jett","Breach,Sova,Killjoy,Omen,Jett"
Ascent,FOCUSGG,Rub n' Pug,13,7,7,5,2,6,"Sova,Killjoy,Omen,Jett,KAY/O","Sova,Killjoy,Omen,Jett,KAY/O"
Bind,JustUs,ZOL Esports,11,13,5,7,6,6,"Raze,Cypher,Brimstone,Reyna,Skye","Raze,Cypher,Brimstone,Skye,Gekko"
Icebox,Disguised,Kizuna Esports,13,3,9,3,0,4,"Sova,Killjoy,Viper,Jett,Iso","Sova,Killjoy,Viper,Sage,Jett"
Sunset,XOXO-01, Santa Gang,7,13,4,4,9,3,"Raze,Cypher,Omen,KAY/O,Gekko","Raze,Cypher,Sova,Omen,KAY/O"
Bind,Doa Ibu Selamanya,ARF TEAM,1,13,0,2,11,1,"Raze,Brimstone,Reyna,Fade,Gekko","Raze,Cypher,Brimstone,Reyna,Skye"
Haven,LAZY,Team Big BAAM,13,10,6,5,5,7,"Breach,Cypher,Sova,Omen,Jett","Breach,Sova,Killjoy,Omen,Jett"
Split,BOBO,Justice For Tomorrow,6,13,2,10,3,4,"Breach,Raze,Cypher,Skye,Astra","Cypher,Omen,Jett,Skye,Iso"
Sunset,JustUs,ZOL Esports,6,13,1,6,7,5,"Cypher,Sova,Phoenix,Omen,Gekko","Raze,Cypher,Sova,Omen,KAY/O"
Lotus,True Rippers,Velocity Gaming,8,13,7,5,8,1,"Raze,Killjoy,Viper,Omen,Fade","Raze,Killjoy,Viper,Omen,Fade"
Breeze,Doa Ibu Selamanya,ARF TEAM,8,13,3,6,7,5,"Cypher,Sova,Viper,Jett,Yoru","Cypher,Sova,Viper,Yoru,Astra"
Lotus,LAZY,Team Big BAAM,6,13,3,4,9,3,"Raze,Killjoy,Viper,Omen,Fade","Breach,Raze,Killjoy,Omen,Fade"
Icebox,SCARZ,Murash Gaming,13,10,9,2,8,4,"Raze,Killjoy,Viper,KAY/O,Gekko","Killjoy,Viper,Reyna,KAY/O,Gekko"
Bind,Dplus Esports,FearX,13,9,3,7,2,10,"Raze,Viper,Omen,KAY/O,Gekko","Sova,Omen,Yoru,Gekko,Iso"
Haven,BOBO,Justice For Tomorrow,8,13,5,7,6,3,"Cypher,Sova,Omen,Jett,Fade","Cypher,Sova,Omen,Jett,Iso"
Ascent,JustUs,ZOL Esports,13,7,7,5,2,6,"Sova,Killjoy,Reyna,Omen,Jett","Raze,Killjoy,Omen,KAY/O,Gekko"
Sunset,THE HERO DETA,Bigetron Arctic,13,5,10,2,3,3,"Breach,Raze,Cypher,Omen,Gekko","Breach,Raze,Cypher,Omen,Gekko"
Ascent,SCARZ,Murash Gaming,13,5,4,2,3,9,"Sova,Killjoy,Omen,Jett,KAY/O","Sova,Killjoy,Omen,Jett,KAY/O"
Haven,Dplus Esports,FearX,13,5,8,4,1,5,"Breach,Sova,Killjoy,Omen,Jett","Yoru,Astra,KAY/O,Neon,Gekko"
Sunset,BOBO,Justice For Tomorrow,13,10,7,4,6,6,"Raze,Cypher,Sova,Omen,KAY/O","Cypher,Sova,Omen,Gekko,Iso"
Lotus,THE HERO DETA,Bigetron Arctic,10,13,7,5,8,3,"Raze,Killjoy,Viper,Omen,Fade","Raze,Killjoy,Omen,Skye,Fade"
Ascent,Avernus Esports,Tyrant Esports PH,13,8,9,3,5,4,"Sova,Killjoy,Omen,Jett,KAY/O","Sova,Killjoy,Omen,Jett,KAY/O"
Lotus,Sengoku Gaming,NORTHEPTION,13,6,4,3,3,9,"Raze,Killjoy,Viper,Omen,Fade","Breach,Chamber,Neon,Gekko,Clove"
Bind,Sin Prisa Gaming,Nongshim RedForce,13,4,10,2,2,3,"Raze,Cypher,Brimstone,Skye,Deadlock","Omen,Yoru,Fade,Gekko,Clove"
Ascent,THE HERO DETA,Bigetron Arctic,13,7,5,3,4,8,"Sova,Killjoy,Omen,Jett,KAY/O","Sova,Killjoy,Omen,Jett,KAY/O"
Icebox,Avernus Esports,Tyrant Esports PH,11,13,4,8,5,7,"Sova,Killjoy,Viper,Jett,Gekko","Killjoy,Viper,Sage,Jett,Gekko"
Ascent,Sengoku Gaming,NORTHEPTION,13,7,10,2,5,3,"Sova,Killjoy,Omen,Jett,KAY/O","Cypher,Sova,Phoenix,Jett,Clove"
Lotus,Sin Prisa Gaming,Nongshim RedForce,13,11,5,7,4,8,"Cypher,Omen,Neon,Gekko,Clove","Raze,Killjoy,Viper,Omen,Fade"
Split,Avernus Esports,Tyrant Esports PH,13,4,4,1,3,9,"Breach,Raze,Cypher,Omen,Skye","Raze,Cypher,Omen,Jett,Skye"
Haven,Flawless Esports,RVNG,10,13,6,6,7,4,"Sova,Omen,Jett,Deadlock,Iso","Breach,Cypher,Sova,Omen,Jett"
Ascent,Risk,RVNG,1,13,1,11,2,0,"Sova,Killjoy,Omen,Jett,KAY/O","Sova,Killjoy,Omen,Jett,KAY/O"
Lotus,Flawless Esports,Mountain Beasts,13,4,8,4,0,5,"Breach,Omen,Neon,Gekko,Deadlock","Breach,Cypher,Omen,Neon,Gekko"
Bind,BadRNG,Risk,11,13,5,7,6,6,"Raze,Viper,Jett,Skye,Clove","Raze,Cypher,Brimstone,Skye,Fade"
Ascent,Los gallos de oro,Flawless Esports,10,13,3,8,5,7,"Cypher,Sova,Omen,Jett,KAY/O","Sova,Phoenix,Omen,Jett,Deadlock"
Icebox,2Game Esports,Stellae Gaming,13,8,10,2,6,3,"Sova,Killjoy,Viper,Jett,Gekko","Sova,Killjoy,Viper,Jett,KAY/O"
Bind,Spate Esports,Mountain Beasts,11,13,5,7,6,6,"Viper,Jett,Yoru,Gekko,Clove","Cypher,Brimstone,Skye,Neon,Gekko"
Haven,TMX,RVNG,5,13,1,5,8,4,"Breach,Sova,Killjoy,Omen,Neon","Breach,Cypher,Sova,Omen,Jett"
Ascent,BadRNG,silver slayers,13,4,8,4,0,5,"Cypher,Sova,Omen,Jett,KAY/O","Cypher,Killjoy,Reyna,Omen,Gekko"
Bind,9z Team,All Knights,11,13,4,8,5,7,"Raze,Sova,Viper,Brimstone,KAY/O","Raze,Viper,Brimstone,Fade,Gekko"
Lotus,Los gallos de oro,GroundX,13,4,9,3,1,4,"Breach,Cypher,Neon,Gekko,Clove","Breach,Raze,Killjoy,Reyna,Omen"
Haven,QoR,SaD Esports,10,13,8,4,9,2,"Cypher,Sova,Omen,Jett,KAY/O","Sova,Jett,Astra,Deadlock,Iso"
Ascent,Risk,Death be Happen,13,9,8,2,7,5,"Sova,Killjoy,Omen,Jett,KAY/O","Sova,Killjoy,Omen,Jett,KAY/O"
Haven,Flawless Esports,Omnipotence,13,9,5,7,2,8,"Sova,Omen,Jett,Deadlock,Iso","Breach,Sova,Killjoy,Omen,Neon"
Icebox,013,TMX,9,13,3,9,4,6,"Sova,Killjoy,Harbor,Iso,Clove","Sova,Killjoy,Viper,Reyna,Chamber"
Haven,GroundX,Brick League,13,1,12,0,1,1,"Cypher,Sova,Reyna,Omen,Jett","Killjoy,KAY/O,Gekko,Iso,Clove"
Lotus,Spate Esports,hex whadafunk,13,0,1,0,0,12,"Breach,Raze,Cypher,Omen,Gekko","Sova,Sage,Reyna,Jett,Clove"
Ascent,Neglected,Mountain Beasts,13,15,3,11,4,10,"Sova,Killjoy,Omen,Jett,KAY/O","Cypher,Sova,Sage,Omen,KAY/O"
Ascent,2Game Esports,Stellae Gaming,15,13,9,5,8,6,"Cypher,Sova,Omen,Jett,Yoru","Sova,Killjoy,Omen,Jett,KAY/O"
Ascent,silver slayers,Campfire Esports,13,11,3,9,2,10,"Killjoy,Phoenix,Reyna,Omen,Gekko","Cypher,Killjoy,Jett,Skye,Clove"
Lotus,RVNG,Jamookie Bears,13,9,6,4,5,7,"Breach,Cypher,Omen,Neon,Gekko","Breach,Cypher,Omen,Neon,Iso"
Ascent,9z Team,All Knights,11,13,4,8,5,7,"Cypher,Sova,Omen,Jett,Deadlock","Sova,Killjoy,Omen,Jett,KAY/O"
Sunset,QoR,SaD Esports,12,14,5,8,6,7,"Raze,Sova,Viper,Sage,Omen","Breach,Raze,Cypher,Sova,Omen"
Sunset,9z Team,All Knights,11,13,5,7,6,6,"Breach,Raze,Cypher,Omen,Gekko","Breach,Raze,Cypher,Omen,Fade"
Sunset,Legacy,Galorys,12,14,6,7,7,6,"Raze,Cypher,Sova,Omen,KAY/O","Breach,Cypher,Sova,Omen,Neon"
Bind,Moist x Shopify,TSM,13,7,7,5,2,6,"Raze,Viper,Brimstone,Fade,Gekko","Raze,Brimstone,Skye,Gekko,Deadlock"
Lotus,FNATIC,Team Vitality,13,7,8,4,3,5,"Raze,Killjoy,Viper,Omen,Fade","Cypher,Omen,Neon,Fade,Gekko"
Icebox,Moist x Shopify,TSM,13,6,6,1,5,7,"Killjoy,Viper,Reyna,KAY/O,Gekko","Killjoy,Viper,Reyna,Omen,Gekko"
Icebox,9z Team,All Knights,13,11,7,5,6,6,"Sova,Killjoy,Viper,Sage,Jett","Sova,Killjoy,Viper,Jett,Harbor"
Split,Legacy,Galorys,11,13,7,5,8,4,"Raze,Cypher,Viper,Omen,Skye","Raze,Viper,Omen,Jett,Skye"
Icebox,FNATIC,Team Vitality,6,13,3,9,4,3,"Sova,Killjoy,Viper,Reyna,Gekko","Sova,Killjoy,Viper,Gekko,Iso"
Icebox,HONEYBADGER123,RIZON,13,3,9,3,0,4,"Sova,Killjoy,Viper,Jett,Gekko","Sova,Killjoy,Viper,Jett,Harbor"
Bind,INF Esports,Reveal Multigaming,8,13,3,6,7,5,"Raze,Viper,Brimstone,Skye,Gekko","Raze,Viper,Brimstone,Skye,Gekko"
Sunset,HONEYBADGER123,RIZON,5,13,5,7,6,0,"Viper,Sage,Omen,KAY/O,Gekko","Raze,Cypher,Sova,Omen,KAY/O"
Haven,FNATIC,Team Vitality,13,6,9,3,3,4,"Cypher,Sova,Omen,Yoru,Iso","Sova,Killjoy,Omen,Neon,Iso"
Ascent,INF Esports,Reveal Multigaming,13,10,9,2,8,4,"Breach,Viper,Brimstone,Sage,Neon","Cypher,Sova,Killjoy,Omen,Jett"
Lotus,HONEYBADGER123,RIZON,13,8,5,4,4,8,"Raze,Killjoy,Omen,KAY/O,Gekko","Killjoy,Viper,Omen,Neon,Gekko"
Split,Team Heretics,FUT Esports,13,6,4,3,3,9,"Breach,Cypher,Omen,Neon,Iso","Breach,Raze,Cypher,Omen,Gekko"
Icebox,INF Esports,Reveal Multigaming,7,13,3,5,8,4,"Sova,Killjoy,Viper,Jett,KAY/O","Sova,Killjoy,Viper,Jett,Clove"
Sunset,Team Heretics,FUT Esports,13,10,7,4,6,6,"Cypher,Sova,Omen,KAY/O,Neon","Breach,Raze,Cypher,Omen,Gekko"
Sunset,Orangutan,Velocity Gaming,9,13,7,3,10,2,"Raze,Cypher,Omen,KAY/O,Gekko","Breach,Raze,Cypher,Omen,Gekko"
Split,Oblivion Force,ONE Team Esports,13,11,5,7,4,8,"Raze,Cypher,Omen,Jett,Skye","Raze,Cypher,Omen,Skye,Yoru"
Lotus,Elevate (SG),Reve Drift Arena,5,13,1,5,8,4,"Raze,Killjoy,Viper,Omen,Fade","Raze,Cypher,Viper,Omen,Skye"
Icebox,Orangutan,Velocity Gaming,6,13,1,6,7,5,"Killjoy,Viper,Jett,KAY/O,Gekko","Sova,Killjoy,Viper,Sage,Jett"
Lotus,Made in Thailand,Team NKT,13,10,6,6,4,7,"Raze,Killjoy,Viper,Omen,Gekko","Raze,Omen,Fade,Gekko,Deadlock"
Haven,Oblivion Force,ONE Team Esports,10,13,3,8,5,7,"Breach,Sova,Killjoy,Omen,Jett","Breach,Killjoy,Jett,Iso,Clove"
Icebox,Elevate (SG),Reve Drift Arena,8,13,2,7,6,6,"Sova,Viper,Sage,Omen,Chamber","Sova,Killjoy,Viper,Jett,Gekko"
Haven,Made in Thailand,Team NKT,13,10,6,6,4,7,"Breach,Sova,Killjoy,Jett,Astra","Breach,Cypher,Sova,Jett,Astra"
Bind,Oblivion Force,ONE Team Esports,13,6,7,0,6,6,"Raze,Viper,Omen,Skye,Gekko","Raze,Viper,Brimstone,Skye,Gekko"
Icebox,Subversive,Tyrant Esports PH,11,13,5,7,6,6,"Sova,Killjoy,Viper,Jett,Clove","Killjoy,Viper,Sage,Jett,Gekko"
Lotus,NEXGA,Ninjas in Galaxy,13,6,9,3,3,4,"Breach,Sova,Killjoy,Omen,Jett","Raze,Killjoy,Viper,Omen,Fade"
Haven,Revenant Esports,True Rippers,14,12,9,4,8,5,"Breach,Cypher,Sova,Omen,Jett","Breach,Sova,Killjoy,Omen,Jett"
Bind,JiJieHao Bonkers,iPGN,13,7,8,4,3,5,"Raze,Cypher,Viper,Brimstone,Gekko","Raze,Viper,Brimstone,Fade,Gekko"
Haven,Da Feng Gou,PAPA ESPORTS,6,13,3,9,4,3,"Breach,Omen,Jett,Skye,Neon","Raze,Reyna,Astra,Neon,Iso"
Bind,Team Kobolds, ROA,10,13,5,7,6,5,"Raze,Viper,Brimstone,Skye,Gekko","Raze,Phoenix,Brimstone,Skye,Clove"
Lotus,FULL SENSE,Barn nong chok,13,9,5,5,4,8,"Breach,Killjoy,Sage,Omen,Neon","Raze,Killjoy,Viper,Omen,Fade"
Ascent,Subversive,Tyrant Esports PH,9,13,1,9,4,8,"Sova,Killjoy,Omen,Jett,KAY/O","Sova,Killjoy,Omen,Jett,KAY/O"
Lotus,JiJieHao Bonkers,iPGN,13,2,10,2,0,3,"Breach,Raze,Cypher,Omen,Fade","Breach,Raze,Killjoy,Omen,Fade"
Icebox,Revenant Esports,True Rippers,12,14,6,7,7,6,"Sova,Killjoy,Viper,Jett,Harbor","Sova,Killjoy,Viper,Jett,Gekko"
Icebox,NEXGA,Ninjas in Galaxy,15,13,8,6,7,7,"Sova,Killjoy,Viper,Jett,Iso","Sova,Killjoy,Viper,Jett,Harbor"
Sunset,Team Kobolds, ROA,11,13,5,7,6,6,"Cypher,Sova,Omen,Jett,KAY/O","Breach,Raze,Cypher,Omen,Gekko"
Ascent,Da Feng Gou,PAPA ESPORTS,9,13,5,7,6,4,"Sova,Killjoy,Omen,Jett,KAY/O","Sova,Killjoy,Omen,Jett,KAY/O"
Split,FULL SENSE,Barn nong chok,13,0,12,0,0,1,"Raze,Cypher,Sage,Omen,Skye","Raze,Cypher,Viper,Omen,Skye"
Split,Avernus Esports,ZOL Esports,9,13,5,5,8,4,"Raze,Cypher,Omen,Jett,Skye","Raze,Cypher,Omen,Skye,Neon"
Icebox,Arena Internet Cafe,EDGE (OCE),13,10,7,5,5,6,"Sova,Killjoy,Viper,Sage,Iso","Sova,Killjoy,Viper,Reyna,Jett"
Lotus,Revenant Esports,True Rippers,13,7,6,6,1,7,"Raze,Viper,Omen,Chamber,Fade","Raze,Killjoy,Viper,Omen,Fade"
Lotus,Superfect Esports Academy,Team IAM,7,13,5,7,6,2,"Raze,Killjoy,Omen,Astra,Fade","Raze,Killjoy,Viper,Omen,Fade"
Icebox,Avernus Esports,ZOL Esports,8,13,5,7,6,3,"Sova,Killjoy,Viper,Jett,Gekko","Sova,Killjoy,Viper,Jett,KAY/O"
Haven,Arena Internet Cafe,EDGE (OCE),8,13,1,8,5,7,"Breach,Cypher,Sova,Omen,Jett","Breach,Sova,Yoru,Astra,Chamber"
Haven,Superfect Esports Academy,Team IAM,11,13,7,5,8,4,"Sova,Killjoy,Jett,Yoru,Astra","Killjoy,Viper,Omen,Jett,Skye"
Ascent,Arena Internet Cafe,EDGE (OCE),13,5,9,3,2,4,"Sova,Killjoy,Omen,Jett,KAY/O","Cypher,Sova,Phoenix,Omen,Deadlock"
Sunset,Oasis Gaming,NAOS Esports,13,10,5,6,4,8,"Raze,Cypher,Sova,Omen,KAY/O","Raze,Cypher,Omen,KAY/O,Gekko"
Lotus,SLT Seongam,VEC DAEJEON,13,5,5,1,4,8,"Raze,Killjoy,Viper,Omen,Fade","Breach,Raze,Viper,Omen,Skye"
Split,Oasis Gaming,NAOS Esports,11,13,5,7,6,6,"Raze,Cypher,Sage,Omen,Skye","Raze,Cypher,Viper,Omen,Skye"
Haven,SLT Seongam,VEC DAEJEON,13,10,8,3,7,5,"Breach,Cypher,Sova,Astra,Neon","Breach,Sova,Killjoy,Omen,Jett"
Lotus,Oasis Gaming,NAOS Esports,13,7,2,6,1,11,"Raze,Killjoy,Viper,Omen,Fade","Raze,Viper,Omen,Chamber,Fade"
Sunset,Spate Esports,Outlast Gaming,9,13,3,7,6,6,"Cypher,Omen,Yoru,KAY/O,Neon","Breach,Raze,Cypher,Omen,Gekko"
Lotus,Spate Esports,Outlast Gaming,6,13,3,4,9,3,"Breach,Raze,Cypher,Omen,Gekko","Killjoy,Viper,Omen,Skye,Neon"
Lotus,Thugging Thugs,Outlast Gaming,12,14,6,7,7,6,"Raze,Killjoy,Omen,Gekko,Iso","Raze,Killjoy,Viper,Omen,Fade"
Ascent,Outlast Gaming,Event Horizon Red,13,3,3,1,2,10,"Sova,Killjoy,Omen,Jett,KAY/O","Sova,Killjoy,Omen,Jett,KAY/O"
Lotus,RED Canids,TBK Esports,9,13,4,6,7,5,"Raze,Killjoy,Viper,Omen,Skye","Raze,Killjoy,Viper,Omen,Fade"
Lotus,Spate Esports,The Dealers,13,4,5,0,4,8,"Breach,Raze,Cypher,Omen,Gekko","Breach,Cypher,Neon,Gekko,Clove"
Icebox,Los gallos de oro,ST x WTP,7,13,3,5,8,4,"Sova,Killjoy,Viper,Jett,Gekko","Sova,Killjoy,Viper,Reyna,Jett"
Sunset,Thugging Thugs,Omnipotence,13,8,8,1,7,5,"Raze,Cypher,Omen,Gekko,Iso","Breach,Raze,Cypher,Omen,Gekko"
Ascent,Wichita State Esports,Outlast Gaming,9,13,6,6,7,3,"Sova,Killjoy,Reyna,Iso,Clove","Sova,Killjoy,Omen,Jett,KAY/O"
Haven,Los gallos de oro,Risk,13,3,4,0,3,9,"Breach,Killjoy,Omen,Neon,Gekko","Breach,Sova,Killjoy,Omen,Jett"
Bind,Spate Esports,Prestige XOXO,13,2,11,1,1,2,"Viper,Jett,Yoru,Gekko,Clove","Raze,Cypher,Viper,Brimstone,Skye"
Sunset,RED Canids,TBK Esports,13,6,6,1,5,7,"Breach,Raze,Cypher,Omen,KAY/O","Cypher,Sova,Omen,KAY/O,Neon"
Lotus,Thugging Thugs,TMX,13,8,5,7,1,8,"Raze,Killjoy,Omen,Gekko,Iso","Breach,Raze,Cypher,Omen,Gekko"
Sunset,Flawless Esports,Outlast Gaming,1,13,1,11,2,0,"Breach,Raze,Cypher,Omen,Gekko","Breach,Raze,Cypher,Omen,Gekko"
Haven,Omnipotence,koupert and friends,13,9,9,3,6,4,"Breach,Sova,Killjoy,Omen,Neon","Breach,Sova,Killjoy,Omen,Jett"
Icebox,6ix Stock,The Dealers,11,13,5,7,6,6,"Sova,Killjoy,Viper,Sage,Iso","Sova,Killjoy,Viper,Harbor,Gekko"
Ascent,ST x WTP,POLAR SQUAD ESPORTS,14,12,4,9,3,10,"Sova,Killjoy,Jett,Iso,Clove","Sova,Killjoy,Omen,Jett,KAY/O"
Ascent,Risk,DA HOOD,13,2,11,1,1,2,"Sova,Killjoy,Jett,KAY/O,Clove","Killjoy,Reyna,Omen,Jett,Chamber"
Bind,RED Canids,TBK Esports,4,13,2,10,3,2,"Raze,Cypher,Viper,Brimstone,Skye","Raze,Viper,Brimstone,Sage,Skye"
Split,OXEN,All Knights,10,13,5,7,6,5,"Raze,Cypher,Skye,Astra,Deadlock","Raze,Killjoy,Viper,Skye,Astra"
Ascent,XLD Gaming,SAGAZ,13,10,6,6,4,7,"Sova,Killjoy,Omen,Jett,KAY/O","Sova,Killjoy,Omen,Jett,KAY/O"
Ascent,BALD BUFF,AKA HERO,7,13,1,7,6,6,"Sova,Killjoy,Omen,Jett,KAY/O","Cypher,Sova,Omen,Jett,KAY/O"
Ascent,BALD BUFF,AKA HERO,7,13,1,7,6,6,"Sova,Killjoy,Omen,Jett,KAY/O","Cypher,Sova,Omen,Jett,KAY/O"
Lotus,Hero Base,The7,7,13,4,4,9,3,"Breach,Cypher,Viper,Omen,Neon","Breach,Neon,Fade,Iso,Clove"
Breeze,OXEN,All Knights,9,13,5,5,8,4,"Cypher,Sova,Viper,Jett,KAY/O","Cypher,Sova,Viper,Jett,Yoru"
Icebox,XLD Gaming,SAGAZ,5,13,5,7,6,0,"Sova,Killjoy,Viper,Sage,Jett","Sova,Killjoy,Viper,Sage,Jett"
Sunset,Hero Base,The7,10,13,3,8,5,7,"Breach,Raze,Cypher,Omen,KAY/O","Raze,Cypher,Omen,KAY/O,Gekko"
Lotus,BALD BUFF,AKA HERO,10,13,6,6,7,4,"Raze,Killjoy,Viper,Omen,Fade","Breach,Cypher,Sova,Omen,Neon"
Lotus,BALD BUFF,AKA HERO,10,13,6,6,7,4,"Raze,Killjoy,Viper,Omen,Fade","Breach,Cypher,Sova,Omen,Neon"
Ascent,OXEN,All Knights,11,13,5,7,6,6,"Sova,Killjoy,Omen,Jett,KAY/O","Sova,Killjoy,Omen,Jett,KAY/O"
Sunset,XLD Gaming,SAGAZ,13,10,6,6,4,7,"Breach,Cypher,Sova,Omen,Neon","Breach,Raze,Cypher,Omen,Gekko"
Sunset,BALD BUFF,AKA HERO,13,7,7,5,2,6,"Raze,Cypher,Sova,Omen,KAY/O","Cypher,Omen,Jett,Yoru,KAY/O"
Sunset,BALD BUFF,AKA HERO,13,7,7,5,2,6,"Raze,Cypher,Sova,Omen,KAY/O","Cypher,Omen,Jett,Yoru,KAY/O"
Icebox,KOI,GIANTX,14,12,9,4,8,5,"Killjoy,Viper,Jett,KAY/O,Gekko","Sova,Killjoy,Viper,Sage,Jett"
Sunset,SZK Esports,Dimonis,13,10,8,3,7,5,"Breach,Cypher,Omen,Neon,Gekko","Raze,Cypher,Omen,KAY/O,Gekko"
Icebox,Signum Reges,eQuizers,13,1,11,1,0,2,"Killjoy,Viper,KAY/O,Gekko,Iso","Killjoy,Viper,Jett,KAY/O,Gekko"
Ascent,Sissi State Punks,LA RUE,13,8,5,4,4,8,"Sova,Killjoy,Omen,Jett,KAY/O","Sova,Killjoy,Omen,Jett,KAY/O"
Lotus,AKA HERO,Dortmund Esports,13,4,10,2,2,3,"Breach,Cypher,Sova,Omen,Neon","Omen,Yoru,Neon,Gekko,Deadlock"
Split,BALD BUFF,TeamOrangeGaming,6,13,1,6,7,5,"Raze,Cypher,Viper,Omen,Skye","Raze,Cypher,Sage,Omen,Skye"
Ascent,VEX ESPORTS,MAJOR MONOGWAM,15,13,6,8,5,9,"Cypher,Sova,Omen,Jett,KAY/O","Sova,Killjoy,Omen,Jett,KAY/O"
Sunset,Novita Esports,6TM ESPORTS,13,4,5,0,4,8,"Breach,Cypher,Sova,Omen,Neon","Cypher,Omen,KAY/O,Neon,Gekko"
Lotus,Reveal Multigaming Saphire,Exceptional Gaming,3,13,1,11,2,2,"Raze,Killjoy,Viper,Omen,Gekko","Breach,Cypher,Sova,Omen,Neon"
Ascent,SZK Esports,Dimonis,13,7,4,4,3,9,"Sova,Killjoy,Omen,Jett,KAY/O","Sova,Killjoy,Omen,Jett,Iso"
Sunset,KOI,GIANTX,13,5,7,5,0,6,"Raze,Cypher,Sova,Omen,KAY/O","Breach,Raze,Cypher,Omen,Gekko"
Sunset,Signum Reges,eQuizers,13,7,5,3,4,8,"Breach,Cypher,Omen,Neon,Gekko","Breach,Cypher,Omen,Neon,Iso"
Split,Sissi State Punks,LA RUE,13,10,6,6,4,7,"Breach,Raze,Cypher,Omen,Skye","Raze,Cypher,Gekko,Deadlock,Clove"
Bind,Reveal Multigaming Saphire,Exceptional Gaming,6,13,5,7,6,1,"Raze,Viper,Brimstone,Skye,Yoru","Raze,Cypher,Brimstone,Skye,Gekko"
Bind,Novita Esports,6TM ESPORTS,13,4,9,3,1,4,"Raze,Viper,Skye,Gekko,Clove","Viper,Reyna,Omen,Jett,Gekko"
Bind,VEX ESPORTS,MAJOR MONOGWAM,13,8,6,6,2,7,"Raze,Brimstone,Skye,Gekko,Deadlock","Raze,Cypher,Viper,Fade,Clove"
Sunset,AKA HERO,Dortmund Esports,16,14,5,10,4,11,"Breach,Cypher,Omen,Jett,Yoru","Breach,Cypher,Omen,Neon,Gekko"
Sunset,BALD BUFF,TeamOrangeGaming,11,13,7,5,8,4,"Raze,Cypher,Sova,Omen,KAY/O","Breach,Raze,Cypher,Sova,Omen"
Ascent,Dimonis,SLTitans Esports,13,9,5,7,2,8,"Sova,Killjoy,Reyna,Jett,Clove","Sova,Killjoy,Omen,Jett,KAY/O"
Lotus,Melilla Titans,Signum Reges,13,5,4,2,3,9,"Killjoy,Viper,Omen,Neon,Fade","Breach,Cypher,Omen,Neon,Gekko"
Haven,Lotus Knights,eQuizers,3,13,2,10,3,1,"Breach,Sova,Killjoy,Omen,Jett","Sova,Astra,Neon,Deadlock,Iso"
Sunset,Team Galaga,SZK Esports,13,6,7,5,1,6,"Breach,Raze,Cypher,Omen,Gekko","Breach,Cypher,Omen,Neon,Gekko"
Icebox,Dimonis,SLTitans Esports,13,10,9,3,7,4,"Sova,Killjoy,Viper,Jett,Iso","Killjoy,Viper,KAY/O,Gekko,Iso"
Icebox,Melilla Titans,Signum Reges,5,13,0,6,7,5,"Killjoy,Viper,Reyna,Harbor,Gekko","Killjoy,Viper,KAY/O,Gekko,Iso"
Sunset,Dimonis,SLTitans Esports,6,13,3,9,4,3,"Raze,Cypher,Omen,KAY/O,Gekko","Breach,Cypher,Omen,Jett,Gekko"
Ascent,Team Galaga,SZK Esports,13,9,5,5,4,8,"Sova,Killjoy,Omen,Jett,KAY/O","Sova,Killjoy,Omen,Jett,KAY/O"
Lotus,Lotus Knights,eQuizers,7,13,4,4,9,3,"Breach,Killjoy,Omen,Neon,Gekko","Breach,Cypher,Sova,Omen,Neon"
Sunset,Melilla Titans,Signum Reges,13,7,5,3,4,8,"Breach,Cypher,Sova,Omen,Neon","Breach,Cypher,Omen,Neon,Gekko"
Haven,LaZe,Kizuna Esports,13,8,6,3,5,7,"Breach,Cypher,Sova,Omen,Jett","Breach,Sova,Killjoy,Omen,Jett"
Sunset,LaZe,Kizuna Esports,13,2,10,2,0,3,"Breach,Raze,Cypher,Sova,Omen","Breach,Raze,Cypher,Omen,Gekko"
Split,True Rippers,Velocity Gaming,13,7,5,3,4,8,"Raze,Cypher,Viper,Omen,Skye","Breach,Raze,Cypher,Omen,Fade"
Icebox,Elevate (SG),Please Don't Fire,13,2,11,1,1,2,"Sova,Viper,Sage,Omen,Chamber","Sova,Killjoy,Viper,Jett,Iso"
Icebox,True Rippers,Velocity Gaming,13,2,3,0,2,10,"Sova,Killjoy,Viper,Jett,Gekko","Sova,Killjoy,Viper,Sage,Gekko"
Sunset,Elevate (SG),Please Don't Fire,10,13,4,8,5,6,"Breach,Raze,Cypher,Omen,Gekko","Cypher,Sova,Omen,Neon,Iso"
Lotus,Elevate (SG),Please Don't Fire,13,3,3,1,2,10,"Raze,Killjoy,Viper,Omen,Fade","Breach,Raze,Omen,Skye,Neon"
Icebox,Revenant Esports,Orangutan,13,6,8,4,2,5,"Sova,Killjoy,Viper,Jett,Harbor","Killjoy,Viper,Jett,KAY/O,Gekko"
Haven,Revenant Esports,Orangutan,13,5,8,4,1,5,"Breach,Cypher,Sova,Omen,Jett","Breach,Cypher,Sova,Jett,Astra"
Lotus,G2 Esports,Cloud9,13,8,4,8,0,9,"Raze,Killjoy,Viper,Omen,Fade","Breach,Raze,Cypher,Omen,Gekko"
Icebox,G2 Esports,Cloud9,5,13,3,3,10,2,"Sova,Killjoy,Viper,Harbor,Gekko","Sova,Killjoy,Viper,Reyna,Gekko"
Ascent,G2 Esports,Cloud9,13,11,4,8,3,9,"Sova,Killjoy,Omen,KAY/O,Neon","Sova,Killjoy,Omen,Jett,KAY/O"
Ascent,HOF Esports,GTZ Esports,9,13,8,4,9,1,"Cypher,Sova,Omen,Jett,KAY/O","Breach,Cypher,Sova,Omen,Jett"
Lotus,R8 Esports,NASR Esports,13,3,9,3,0,4,"Raze,Killjoy,Omen,Skye,Astra","Raze,Killjoy,Viper,Omen,Skye"
Icebox,Team Galaga,Dimonis,13,8,6,3,5,7,"Sova,Killjoy,Viper,Sage,Jett","Sova,Killjoy,Viper,Jett,Iso"
Lotus,PPP,EX0TIK GAMING,13,3,2,2,1,11,"Breach,Raze,Cypher,Sova,Omen","Breach,Killjoy,Omen,Neon,Gekko"
Sunset,Melilla Titans,Lotus Knights,13,4,3,2,2,10,"Breach,Cypher,Sova,Omen,Neon","Breach,Cypher,Omen,Gekko,Iso"
Icebox,DSYRE,NOVO Esports,13,10,4,7,3,9,"Sova,Killjoy,Viper,Sage,Jett","Sova,Killjoy,Viper,Sage,Jett"
Ascent,Eternal Fire,Fenerbahçe Esports,13,6,10,2,4,3,"Sova,Killjoy,Omen,Jett,KAY/O","Cypher,Sova,Omen,Jett,KAY/O"
Sunset,R8 Esports,NASR Esports,8,13,5,7,6,3,"Breach,Raze,Cypher,Omen,Gekko","Breach,Raze,Cypher,Omen,Fade"
Lotus,1000rr club,SLTitans Esports,12,14,7,6,8,5,"Breach,Raze,Killjoy,Omen,Gekko","Breach,Sova,Killjoy,Omen,Neon"
Sunset,Team Galaga,Dimonis,14,12,8,5,7,6,"Breach,Raze,Cypher,Omen,Gekko","Raze,Cypher,Omen,KAY/O,Gekko"
Icebox,Melilla Titans,Lotus Knights,11,13,6,6,7,5,"Killjoy,Viper,Reyna,Harbor,Gekko","Sova,Killjoy,Viper,Jett,Gekko"
Ascent,FTW LEÇA FC,SAW,9,13,2,8,5,7,"Breach,Cypher,Omen,Jett,Neon","Sova,Killjoy,Omen,Jett,KAY/O"
Haven,Eternal Fire,Fenerbahçe Esports,13,7,7,1,6,6,"Cypher,Sova,Omen,Yoru,Iso","Breach,Cypher,Sova,Omen,Neon"
Split,Acend,Diamant Esports,13,6,4,3,3,9,"Raze,Cypher,Reyna,Omen,Jett","Raze,Sova,Viper,Omen,KAY/O"
Ascent,HGE Esports,Outplayed,10,13,4,7,6,6,"Sova,Killjoy,Omen,Jett,KAY/O","Cypher,Sova,Omen,Jett,Deadlock"
Icebox,R8 Esports,NASR Esports,13,10,8,3,7,5,"Killjoy,Viper,Sage,Reyna,Gekko","Sova,Killjoy,Viper,Reyna,Jett"
Ascent,1000rr club,SLTitans Esports,6,13,6,6,7,0,"Breach,Sova,Omen,Jett,Fade","Sova,Killjoy,Omen,Jett,KAY/O"
Split,KPI Gaming,Falke Esports,13,1,2,0,1,11,"Breach,Raze,Cypher,Omen,Skye","Raze,Cypher,Skye,Astra,Iso"
Lotus,Team Aku Aku,eQuizers,3,13,3,9,4,0,"Breach,Cypher,Neon,Iso,Clove","Breach,Cypher,Sova,Omen,Neon"
Ascent,Team Galaga,Dimonis,9,13,2,8,5,7,"Sova,Killjoy,Reyna,Omen,Jett","Sova,Killjoy,Omen,Jett,KAY/O"
Lotus,Eternal Fire,Fenerbahçe Esports,7,13,4,4,9,3,"Breach,Raze,Sova,Viper,Omen","Raze,Cypher,Omen,Fade,Iso"
Lotus,Melilla Titans,Lotus Knights,14,12,8,5,7,6,"Raze,Killjoy,Viper,Omen,Fade","Breach,Killjoy,Omen,Neon,Gekko"
Sunset,VX300 Gaming,RTZN,13,2,3,0,2,10,"Breach,Raze,Cypher,Omen,Gekko","Breach,Raze,Cypher,Omen,Gekko"
Sunset,Unity Esports,Underground Gaming,13,2,3,0,2,10,"Breach,Raze,Cypher,Omen,Fade","Breach,Raze,Cypher,Omen,Fade"
Sunset,SZK Esports,SLTitans Esports,13,2,3,0,2,10,"Breach,Cypher,Omen,Neon,Gekko","Breach,Cypher,Omen,Gekko,Iso"
Haven,KPI Gaming,Falke Esports,13,8,7,2,6,6,"Killjoy,Viper,Omen,Jett,Skye","Killjoy,Viper,Omen,Jett,Skye"
Breeze,Acend,Diamant Esports,15,13,9,5,8,6,"Cypher,Sova,Viper,Jett,KAY/O","Cypher,Sova,Viper,Omen,Yoru"
Sunset,Signum Reges,eQuizers,13,6,9,3,3,4,"Breach,Cypher,Omen,Neon,Gekko","Breach,Cypher,Omen,Yoru,Neon"
Ascent,Team Aku Aku,Lotus Knights,8,13,6,6,7,2,"Sova,Killjoy,Phoenix,Jett,Clove","Sova,Killjoy,Omen,Jett,KAY/O"
Lotus,Unity Esports,Underground Gaming,13,5,8,4,1,5,"Breach,Raze,Killjoy,Omen,Fade","Breach,Raze,Killjoy,Omen,Gekko"
Lotus,SZK Esports,SLTitans Esports,13,11,9,3,8,4,"Breach,Cypher,Omen,Neon,Fade","Breach,Sova,Killjoy,Omen,Neon"
Icebox,KPI Gaming,Falke Esports,13,2,3,0,2,10,"Killjoy,Viper,Jett,KAY/O,Gekko","Killjoy,Viper,Jett,KAY/O,Gekko"
Icebox,Dimonis,1000rr club,13,8,10,2,6,3,"Sova,Killjoy,Viper,Jett,Iso","Sova,Viper,Sage,Jett,Chamber"
Haven,Signum Reges,eQuizers,14,12,1,12,0,13,"Breach,Sova,Killjoy,Omen,Jett","Sova,Astra,Neon,Deadlock,Iso"
Ascent,Axolotl,LONETEAM,13,7,7,5,2,6,"Breach,Killjoy,Omen,Yoru,Deadlock","Raze,Sova,Killjoy,Omen,Gekko"
Icebox,HOWL Esports,PCIFIC Espor,13,10,8,3,7,5,"Killjoy,Viper,Jett,Skye,Harbor","Sova,Killjoy,Viper,Jett,Gekko"
Split,Incognito,B8 Esports,6,13,1,6,7,5,"Raze,Cypher,Viper,Omen,Skye","Raze,Viper,Omen,Yoru,Fade"
Lotus,Dimonis,1000rr club,13,6,8,4,2,5,"Raze,Killjoy,Viper,Omen,Gekko","Cypher,Sova,Jett,Yoru,Clove"
Lotus,Incognito,B8 Esports,4,13,1,4,9,3,"Raze,Killjoy,Viper,Omen,Fade","Raze,Cypher,Omen,KAY/O,Fade"
Lotus,Team Aku Aku,Lotus Knights,14,16,9,6,10,5,"Breach,Killjoy,Neon,Iso,Clove","Breach,Killjoy,Omen,Neon,Gekko"
Sunset,HOWL Esports,PCIFIC Espor,13,9,8,4,5,5,"Raze,Cypher,Omen,KAY/O,Gekko","Breach,Raze,Cypher,Omen,Gekko"
Icebox,Team Secret,T1,14,12,9,4,8,5,"Killjoy,Viper,Jett,KAY/O,Gekko","Viper,KAY/O,Chamber,Gekko,Iso"
Split,Team Secret,T1,13,6,7,5,1,6,"Raze,Cypher,Viper,Omen,Skye","Raze,Viper,Omen,Skye,Chamber"
Haven,Team Secret,T1,10,13,4,7,6,6,"Breach,Sova,Killjoy,Omen,Neon","Breach,Cypher,Sova,Omen,Jett"
Sunset,DRX,Rex Regum Qeon,12,14,4,9,5,8,"Breach,Cypher,Sova,Omen,Jett","Breach,Raze,Cypher,Omen,Gekko"
Split,DRX,Rex Regum Qeon,12,14,3,10,4,9,"Raze,Cypher,Viper,Omen,Skye","Raze,Viper,Omen,Jett,Skye"
Icebox,LOUD,Evil Geniuses,11,13,5,7,6,6,"Killjoy,Viper,Omen,KAY/O,Gekko","Sova,Killjoy,Harbor,Iso,Clove"
Icebox,Fisher College Navy,Top Notch,13,10,8,3,7,5,"Killjoy,Viper,Jett,KAY/O,Gekko","Sova,Killjoy,Viper,Gekko,Iso"
Sunset,LF8 Mythic,Awaken,13,6,4,3,3,9,"Breach,Raze,Cypher,Omen,Fade","Breach,Sage,Omen,Neon,Gekko"
Bind,les piments,foppish iquanas,7,13,1,7,6,6,"Raze,Cypher,Viper,Skye,Clove","Raze,Viper,Brimstone,Skye,Yoru"
Ascent,Kats Squad,Special Grade,1,13,1,11,2,0,"Cypher,Sova,Omen,Jett,Clove","Sova,Killjoy,Omen,Jett,KAY/O"
Lotus,Malicious,Van Lyn,2,13,1,11,2,1,"Raze,Killjoy,Omen,Chamber,Gekko","Raze,Killjoy,Viper,Omen,Fade"
Lotus,Orangutan Gang,Lemonade Stand,13,15,4,10,5,9,"Breach,Cypher,Neon,Gekko,Clove","Breach,Raze,Omen,Chamber,Gekko"
Lotus,The GRID,Burger Boyz 2.0,13,9,9,3,6,4,"Breach,Cypher,Neon,Iso,Clove","Raze,Cypher,Viper,Skye,Clove"
Sunset,LOUD,Evil Geniuses,6,13,0,7,6,6,"Breach,Cypher,Omen,Neon,Gekko","Breach,Cypher,Omen,Neon,Fade"
Split,Outlast Gaming,Top Notch,11,13,2,10,3,9,"Breach,Raze,Viper,Omen,Skye","Raze,Cypher,Viper,Omen,Skye"
Bind,YDZ Infinity,Burger Boyz 2.0,2,13,2,10,3,0,"Raze,Brimstone,Skye,Harbor,Iso","Raze,Cypher,Brimstone,Skye,Clove"
Lotus,CCG Esports,Fisher College Navy,8,13,3,6,7,5,"Raze,Cypher,Viper,Omen,Fade","Breach,Raze,Killjoy,Omen,Gekko"
Icebox,Predator X Gaming,LF8 Mythic,8,13,2,7,6,6,"Sova,Killjoy,Viper,Jett,Iso","Sova,Killjoy,Viper,Sage,Jett"
Lotus,Malicious,Shifty505,13,8,6,6,2,7,"Raze,Killjoy,Omen,Chamber,Gekko","Breach,Reyna,Omen,Skye,Neon"
Ascent,Sussy Players,Orangutan Gang,6,13,4,8,5,2,"Sova,Killjoy,Omen,Jett,KAY/O","Sova,Killjoy,Omen,Jett,KAY/O"
Sunset,Special Grade,Raven Esports,13,2,3,0,2,10,"Breach,Raze,Cypher,Omen,Gekko","Cypher,Sova,Viper,Omen,Yoru"
Breeze,les piments,Bedwars Lions,15,13,9,5,8,6,"Cypher,Sova,Viper,Jett,Yoru","Sova,Viper,Jett,Yoru,Astra"
Ascent,Destro,Awaken,6,13,2,10,3,4,"Cypher,Sova,Omen,Jett,Deadlock","Cypher,Sova,Omen,Jett,Deadlock"
Breeze,Lionheart eSports,Lemonade Stand,1,13,0,2,11,1,"Cypher,Sova,Viper,Jett,KAY/O","Cypher,Sova,Viper,Jett,KAY/O"
Lotus,BIRRIA TACOS,Kats Squad,12,14,8,5,9,4,"Breach,Raze,Cypher,Omen,Fade","Breach,Cypher,Sova,Astra,Neon"
Icebox,ROSE,Van Lyn,10,13,8,4,9,2,"Sova,Killjoy,Viper,Jett,KAY/O","Sova,Killjoy,Viper,Jett,KAY/O"
Icebox,The GRID,Aspyre x Swarm,13,6,7,5,1,6,"Sova,Killjoy,Viper,Reyna,Iso","Viper,Chamber,Gekko,Deadlock,Iso"
Lotus,foppish iquanas,1337 (NA),13,7,11,1,6,2,"Breach,Raze,Cypher,Omen,Gekko","Breach,Raze,Cypher,Omen,Gekko"
Lotus,LOUD,Evil Geniuses,13,7,7,1,6,6,"Cypher,Omen,Neon,Fade,Gekko","Breach,Cypher,Omen,Fade,Iso"
Sunset,Poggers,Lionheart eSports,7,13,3,5,8,4,"Raze,Cypher,Sova,Omen,Gekko","Breach,Cypher,Sova,Omen,Neon"
Lotus,ROSE,Fractal Gaming,13,4,2,3,1,11,"Raze,Killjoy,Viper,Omen,Fade","Raze,Cypher,Viper,Omen,Fade"
Sunset,BBL DRIZZ,Shifty505,4,13,3,9,4,1,"Breach,Raze,Cypher,Iso,Clove","Breach,Cypher,Sova,Omen,Neon"
Lotus,Oppyy,Bedwars Lions,6,13,2,5,8,4,"Breach,Killjoy,Omen,Neon,Gekko","Breach,Raze,Cypher,Omen,Fade"
Bind,Radford University,Sussy Players,9,13,5,5,8,4,"Breach,Raze,Viper,Brimstone,Gekko","Raze,Viper,Brimstone,Skye,Deadlock"
Lotus,Awaken,Double Gulp Cup Esports,13,8,7,2,6,6,"Cypher,Omen,KAY/O,Neon,Gekko","Raze,Killjoy,Omen,Gekko,Iso"
Lotus,les piments,Trident (NA),13,6,8,4,2,5,"Raze,Cypher,Sova,Omen,Gekko","Raze,Cypher,Omen,Fade,Deadlock"
Lotus,College Rejects,Destro,7,13,3,5,8,4,"Raze,Killjoy,Viper,Omen,Fade","Raze,Viper,Omen,Fade,Deadlock"
Lotus,Harmony,Kats Squad,4,13,2,3,10,2,"Breach,Raze,Killjoy,Omen,Fade","Breach,Cypher,Sova,Astra,Neon"
Lotus,Akave Esports Black,Lemonade Stand,3,13,0,4,9,3,"Breach,Raze,Cypher,Omen,Gekko","Breach,Raze,Omen,Chamber,Gekko"
Lotus,BIRRIA TACOS,RITUAL BLACK,13,4,8,4,0,5,"Breach,Raze,Cypher,Omen,Fade","Breach,Raze,Omen,Chamber,Gekko"
Ascent,Neebs and Weebs,Malicious,11,13,6,6,7,5,"Cypher,Sova,Omen,Jett,Iso","Cypher,Sova,Omen,Jett,Deadlock"
Bind,DOOMSDAY,Special Grade,8,13,4,5,8,4,"Sage,Harbor,Deadlock,Iso,Clove","Raze,Viper,Brimstone,Skye,Iso"
Sunset,LIVVY GRONK,Orangutan Gang,3,13,2,2,11,1,"Breach,Omen,Neon,Gekko,Deadlock","Breach,Cypher,Sova,Omen,Neon"
Sunset,foppish iquanas,blueming,13,6,6,1,5,7,"Breach,Cypher,Sova,Omen,Neon","Breach,Raze,Cypher,Omen,Iso"
Sunset,Predator X Gaming,Shopify Rebellion,13,11,9,3,8,4,"Breach,Raze,Cypher,Omen,Gekko","Breach,Raze,Cypher,Omen,Gekko"
Lotus,Last Chance (NA),LF8 Mythic,6,13,2,5,8,4,"Breach,Raze,Cypher,Omen,Gekko","Raze,Killjoy,Viper,Omen,Fade"
Lotus,Raven Esports,Zero MarksMen Black,13,11,9,3,8,4,"Breach,Raze,Cypher,Omen,Fade","Cypher,Omen,Skye,Neon,Gekko"
Icebox,Aspyre x Swarm,KingstonKittens,13,5,8,4,1,5,"Viper,Chamber,Gekko,Deadlock,Iso","Sova,Viper,Jett,Neon,Deadlock"
Bind,Excane,YDZ Infinity,12,14,5,8,6,7,"Omen,Yoru,Fade,Harbor,Deadlock","Raze,Brimstone,Skye,Harbor,Iso"
Lotus,Outlast Gaming,Cataclysm Gaming,16,14,8,7,7,8,"Raze,Killjoy,Viper,Omen,Fade","Breach,Raze,Killjoy,Omen,Gekko"
Sunset,Top Notch,BHOP Esports,13,7,4,4,3,9,"Breach,Raze,Cypher,Omen,Gekko","Breach,Raze,Cypher,Omen,Iso"
Lotus,The GRID,dawg eat,13,3,11,1,2,2,"Breach,Cypher,Neon,Iso,Clove","Raze,Killjoy,Viper,Omen,Fade"
Lotus,CCG Esports,Roblox Cows,14,12,8,5,7,6,"Raze,Cypher,Viper,Omen,Fade","Breach,Cypher,Omen,Neon,Gekko"
Haven,FURIA,100 Thieves,16,14,11,4,10,5,"Breach,Killjoy,Omen,Neon,Gekko","Sova,Killjoy,Omen,Jett,KAY/O"
Ascent,Mandatory,DVM Esport,13,7,8,4,3,5,"Raze,Viper,KAY/O,Harbor,Gekko","Killjoy,Phoenix,Omen,Jett,Fade"
Icebox,FURIA,100 Thieves,14,12,7,6,6,7,"Sova,Killjoy,Viper,Sage,Jett","Sova,Killjoy,Viper,Jett,Gekko"
Split,BB Esports,Surely Tragic,13,2,10,2,0,3,"Raze,Viper,Omen,Jett,Skye","Breach,Raze,Omen,Gekko,Deadlock"
Sunset,Lets Be Great,GOONING,4,13,3,9,4,1,"Breach,Raze,Cypher,Omen,Gekko","Breach,Raze,Cypher,Omen,Gekko"
Split,Papara SuperMassive,Fire Flux Esports,15,13,4,10,3,11,"Breach,Raze,Cypher,Omen,KAY/O","Breach,Raze,Cypher,Omen,Yoru"
Sunset,Mandatory,DVM Esport,6,13,3,9,4,3,"Breach,Raze,Cypher,Omen,Gekko","Raze,Cypher,Phoenix,Omen,Fade"
Lotus,CTRL x YARI Esports,Free Orbs,16,15,6,10,5,10,"Breach,Raze,Cypher,Omen,Fade","Breach,Killjoy,Omen,Neon,Fade"
Sunset,Onyx Ravens,NASR Esports,5,13,2,4,9,3,"Breach,Raze,Cypher,Sova,Omen","Breach,Raze,Cypher,Omen,Fade"
Icebox,Hidden Horizon,Amanakomeow,8,13,5,4,9,3,"Sova,Killjoy,Viper,Jett,Gekko","Sova,Killjoy,Viper,Sage,Jett"
Sunset,Salmans,BB Esports,11,13,4,8,5,7,"Omen,KAY/O,Gekko,Deadlock,Clove","Breach,Raze,Cypher,Omen,Gekko"
Lotus,Nexum EC,Capacitanes,15,16,5,10,6,10,"Breach,Raze,Killjoy,Omen,Fade","Breach,Raze,Killjoy,Omen,Gekko"
Breeze,Sila4i,UAOPG,13,11,5,7,4,8,"Cypher,Sova,Viper,Yoru,Neon","Cypher,Sova,Viper,Jett,Yoru"
Ascent,Mania,GOONING,3,13,3,9,4,0,"Sova,Killjoy,Omen,Jett,KAY/O","Cypher,Sova,Phoenix,Omen,Jett"
Lotus,Free Orbs,Jabba Enjoyers,13,10,5,7,3,8,"Breach,Killjoy,Omen,Neon,Fade","Breach,Raze,Killjoy,Omen,Fade"
Split,Lets Be Great,Project 1,16,15,6,10,5,10,"Raze,Cypher,Omen,Jett,Skye","Raze,Cypher,Viper,Omen,Skye"
Bind,Papara SuperMassive,Fire Flux Esports,11,13,9,3,10,2,"Viper,Brimstone,Skye,Neon,Gekko","Sova,Viper,Omen,Jett,Gekko"
Icebox,Surely Tragic,Coalesce,13,8,7,2,6,6,"Sova,Killjoy,Viper,Sage,Iso","Sova,Killjoy,Viper,Sage,Jett"
Lotus,Mandatory,DVM Esport,13,7,6,2,5,7,"Raze,Killjoy,Viper,Omen,Fade","Raze,Cypher,Phoenix,Omen,Fade"
Ascent,Andromeda Gaming,lodzik,3,13,2,2,11,1,"Sova,Killjoy,Omen,Jett,KAY/O","Sova,Killjoy,Omen,Jett,Iso"
Ascent,Five Media Clan,Ramboot Club,1,13,1,11,2,0,"Sova,Killjoy,Omen,Jett,KAY/O","Sova,Killjoy,Omen,Jett,Iso"
Bind,1000rr club,INCOGNITO,5,13,1,11,2,4,"Breach,Cypher,Sova,Brimstone,Jett","Raze,Cypher,Skye,Neon,Clove"
Ascent,CTRL x YARI Esports,K10,13,4,5,0,4,8,"Sova,Killjoy,Omen,Jett,KAY/O","Sova,Killjoy,Omen,Jett,KAY/O"
Icebox,Overheat,Amanakomeow,6,13,1,6,7,5,"Sova,Killjoy,Viper,Jett,Iso","Sova,Killjoy,Viper,Sage,Iso"
Icebox,Hidden Horizon,Phantom Fury,13,8,8,4,4,5,"Sova,Killjoy,Viper,Jett,Gekko","Sova,Killjoy,Viper,Omen,Gekko"
Icebox,thegiornalisti,Team Galaga,13,6,8,4,2,5,"Sova,Killjoy,Viper,Reyna,Jett","Sova,Killjoy,Viper,Sage,Jett"
Breeze,XPERION NXT,DIVIZON,12,14,7,6,8,5,"Cypher,Sova,Viper,Yoru,Clove","Breach,Cypher,Viper,Yoru,Clove"
Ascent,VX300 Gaming,HGE Esports,10,13,5,7,6,5,"Sova,Killjoy,Omen,Jett,KAY/O","Sova,Killjoy,Omen,Jett,KAY/O"
Bind,Onyx Ravens,NASR Esports,9,13,3,7,6,6,"Raze,Viper,Brimstone,Skye,Gekko","Raze,Cypher,Viper,Brimstone,Skye"
Lotus,RevenantVAL,Melilla Titans,12,14,6,7,7,6,"Breach,Raze,Killjoy,Omen,Fade","Raze,Killjoy,Viper,Omen,Fade"
Ascent,TwentyStars,Signum Reges,2,13,0,3,10,2,"Sova,Killjoy,Omen,Jett,KAY/O","Sova,Killjoy,Omen,Jett,KAY/O"
Sunset,ContentOverload,Jabba Enjoyers,4,13,4,8,5,0,"Breach,Cypher,Omen,Neon,Gekko","Breach,Raze,Cypher,Omen,Gekko"
Split,Mania,Team Pure,13,4,8,4,0,5,"Raze,Cypher,Omen,Skye,Iso","Raze,Cypher,Viper,Omen,Skye"
Lotus,Project 1,BlessedByDrags,13,4,8,4,0,5,"Raze,Killjoy,Viper,Omen,Fade","Raze,Killjoy,Omen,Neon,Fade"
Ascent,CTRL x YARI Esports,Cognizant,13,5,3,3,2,10,"Sova,Killjoy,Omen,Jett,KAY/O","Breach,Sova,Omen,Chamber,Neon"
Sunset,5STARS,Lets Be Great,8,13,4,5,8,4,"Breach,Raze,Cypher,Omen,Gekko","Breach,Raze,Cypher,Omen,Gekko"
Ascent,Phantom Fury,Brother eww,13,1,2,0,1,11,"Cypher,Sova,Omen,Jett,KAY/O","Sova,Killjoy,Phoenix,Omen,Jett"
Sunset,Next In Line,Free Orbs,10,13,5,6,7,5,"Raze,Cypher,Omen,Gekko,Iso","Breach,Cypher,Sova,Omen,Neon"
Lotus,GOONING,REY eSports,13,9,9,3,6,4,"Breach,Raze,Killjoy,Omen,Neon","Killjoy,Viper,Omen,Neon,Gekko"
Lotus,RYL | Royal Legion,Amanakomeow,1,13,0,2,11,1,"Breach,Cypher,Omen,Neon,Fade","Breach,Raze,Cypher,Harbor,Deadlock"
Bind,Gladius,Salmans,6,13,5,7,6,1,"Raze,Viper,Brimstone,Fade,Gekko","Raze,Viper,Brimstone,Fade,Gekko"
Icebox,K10,Summer Kittens,13,4,5,0,4,8,"Sova,Killjoy,Viper,Jett,Harbor","Sova,Killjoy,Viper,Jett,Gekko"
Icebox,EWOLVES,Surely Tragic,4,13,4,8,5,0,"Sova,Killjoy,Viper,Jett,Deadlock","Sova,Killjoy,Viper,Sage,Iso"
Ascent,Hidden Horizon,Enhanced Aim,13,3,4,0,3,9,"Sova,Killjoy,Omen,Jett,KAY/O","Cypher,Sova,Omen,KAY/O,Iso"
Icebox,ZODIAC,BB Esports,12,14,5,8,6,7,"Sova,Killjoy,Viper,Jett,Gekko","Sova,Killjoy,Viper,Gekko,Iso"
Lotus,Russian Vodka ,Overheat,3,13,1,11,2,2,"Breach,Raze,Killjoy,Omen,Gekko","Raze,Killjoy,Omen,Fade,Iso"
Ascent,On Sight,Exanimis,14,12,8,5,7,6,"Sova,Killjoy,Omen,Jett,KAY/O","Sova,Killjoy,Omen,Jett,KAY/O"
Lotus,GoNext Esports,B8 Esports,13,7,7,5,2,6,"Breach,Sova,Killjoy,Omen,Jett","Raze,Cypher,Omen,KAY/O,Fade"
Split,lodzik,BALENCI BRIEFS,13,8,6,6,2,7,"Raze,Cypher,Omen,Jett,Skye","Raze,Cypher,Omen,Skye,Iso"
Lotus,Nexum EC,Solar Flare,13,4,10,2,2,3,"Breach,Raze,Killjoy,Omen,Fade","Breach,Raze,Killjoy,Omen,Jett"
Haven,Five Media Clan,Ramboot Club,5,13,1,5,8,4,"Cypher,Sova,Omen,Jett,KAY/O","Cypher,Sova,Omen,Neon,Iso"
Lotus,Babos Gaming,Sissi State Punks,4,13,2,10,3,2,"Breach,Killjoy,Omen,Neon,Gekko","Breach,Sova,Killjoy,Omen,Neon"
Split,TOG Kitsune,axolotls and chips,13,3,9,3,0,4,"Breach,Cypher,Omen,Jett,Yoru","Breach,Raze,Cypher,Omen,Yoru"
Lotus,Dortmund Esports,Glacial Guardians,13,10,9,2,8,4,"Omen,Yoru,Neon,Gekko,Deadlock","Killjoy,Viper,Omen,Jett,Gekko"
Ascent,STAKERS,RevenantVAL,1,13,1,11,2,0,"Cypher,Sova,Omen,Jett,KAY/O","Sova,Killjoy,Omen,Jett,KAY/O"
Breeze,REVOADA,LOUD GC,8,13,5,4,9,3,"Cypher,Sova,Viper,Jett,KAY/O","Cypher,Sova,Viper,Jett,Yoru"
Sunset,UAOPG,Lenovo Honvéd,15,13,6,8,5,9,"Breach,Raze,Cypher,Omen,Fade","Raze,Cypher,Omen,Fade,Gekko"
Lotus,Capacitanes,Las Palmas Unity,15,13,10,4,9,5,"Breach,Raze,Killjoy,Omen,Gekko","Breach,Omen,Chamber,Neon,Gekko"
Ascent,INCOGNITO,SZK Esports,13,11,6,6,5,7,"Breach,Sova,Killjoy,Omen,Jett","Sova,Killjoy,Omen,Jett,KAY/O"
Lotus,1000rr club,KHORE GAMING,13,4,11,1,3,2,"Cypher,Sova,Jett,Yoru,Clove","Breach,Cypher,Omen,Jett,Iso"
Sunset,bazinga esports,Team Galaga,11,13,5,7,6,6,"Breach,Raze,Cypher,Omen,Gekko","Breach,Raze,Cypher,Omen,Gekko"
Sunset,thegiornalisti,GMBLERS Esports,13,10,9,2,8,4,"Breach,Raze,Cypher,Reyna,Omen","Breach,Raze,Cypher,Omen,Gekko"
Lotus,Soul Society,ForsaKen GC,5,13,3,9,4,2,"Breach,Killjoy,Omen,Neon,Fade","Breach,Raze,Cypher,Sova,Omen"
Ascent,bezshanov,Sila4i,4,13,4,8,5,0,"Sova,Killjoy,Omen,Jett,Yoru","Sova,Killjoy,Sage,Omen,Jett"
Ascent,XPERION NXT,DIVIZON,4,13,2,3,10,2,"Sova,Killjoy,Omen,Jett,KAY/O","Sova,Killjoy,Omen,Jett,KAY/O"
Ascent,ALTERNATE aTTaX Ruby,GnG White,13,4,4,1,3,9,"Sova,Killjoy,Omen,Jett,KAY/O","Sova,Killjoy,Omen,Jett,KAY/O"
Lotus,Locked Hanters,TwentyStars,7,13,2,6,7,5,"Killjoy,Viper,Omen,Jett,Fade","Breach,Sova,Killjoy,Omen,Jett"
Split,delman,Andromeda Gaming,10,13,7,5,8,3,"Breach,Raze,Cypher,Omen,Jett","Breach,Raze,Viper,Omen,Skye"
Sunset,SPACEGLID3RS,Signum Reges,3,13,3,9,4,0,"Breach,Raze,Cypher,Omen,Gekko","Breach,Cypher,Omen,Neon,Gekko"
Lotus,DSYRE,Axolotl,13,4,9,3,1,4,"Raze,Killjoy,Viper,Omen,Fade","Raze,Chamber,Fade,Deadlock,Clove"
Bind,Melilla Titans,TLS eSports,13,8,4,5,3,9,"Raze,Viper,Brimstone,Reyna,Skye","Raze,Cypher,Brimstone,Jett,Gekko"
Ascent,Papara SuperMassive,Fire Flux Esports,13,8,5,4,4,8,"Cypher,Sova,Omen,Jett,Deadlock","Sova,Killjoy,Omen,Jett,KAY/O"
Icebox,F9 Wonders,Idynomashimi,13,2,2,1,1,11,"Sova,Killjoy,Viper,Sage,Jett","Sova,Killjoy,Viper,Jett,Iso"
Icebox,Twisted Minds Orchid,RIZON Sugar,13,5,9,3,2,4,"Sova,Killjoy,Viper,Jett,Iso","Sova,Killjoy,Viper,Reyna,Jett"
Sunset,Joblife,Cicadas Gaming,13,9,7,3,6,6,"Breach,Cypher,Sova,Omen,Neon","Breach,Raze,Cypher,Omen,Yoru"
Ascent,last second,Anonymo GC,13,5,3,3,2,10,"Sova,Killjoy,Omen,Jett,KAY/O","Sova,Killjoy,Phoenix,Omen,Jett"
Bind,BLVKHVND,Crvena zvezda esports,13,1,11,1,0,2,"Raze,Viper,Brimstone,Skye,Gekko","Raze,Viper,Brimstone,Sage,Skye"
Sunset,Team Aku Aku,Dimonis,5,13,2,4,9,3,"Breach,Raze,Cypher,Omen,Gekko","Raze,Cypher,Omen,KAY/O,Gekko"
Bind,The Ultimates,Underground Gaming,10,13,3,9,4,7,"Raze,Viper,Omen,KAY/O,Gekko","Raze,Cypher,Viper,Omen,Skye"
Sunset,GoNext Esports,B8 Esports,13,10,8,4,6,5,"Breach,Raze,Sage,Omen,Gekko","Breach,Raze,Cypher,Sova,Omen"
Icebox,bezshanov,KANAFI,13,6,6,6,0,7,"Sova,Killjoy,Viper,Yoru,Gekko","Raze,Viper,Omen,KAY/O,Iso"
Sunset,DREAMED WORLD,Dortmund Esports,10,13,6,6,7,4,"Raze,Viper,Omen,KAY/O,Gekko","Breach,Cypher,Omen,Neon,Gekko"
Sunset,Zeniths,SPACEGLID3RS,4,13,2,3,10,2,"Breach,Raze,Cypher,Omen,Gekko","Breach,Raze,Cypher,Omen,Gekko"
Sunset,TwentyStars,IAPEsports,13,6,9,3,3,4,"Breach,Cypher,Sova,Omen,Neon","Breach,Raze,Cypher,Omen,Iso"
Bind,Smash Power,Lenovo Honvéd,4,13,4,8,5,0,"Raze,Viper,Omen,Skye,Yoru","Raze,Cypher,Omen,Fade,Iso"
Bind,Nexum EC,AMBYS Team,13,10,4,7,3,9,"Raze,Omen,Skye,KAY/O,Clove","Breach,Cypher,Brimstone,Yoru,Gekko"
Lotus,delman,HR EAST,13,3,4,0,3,9,"Breach,Raze,Killjoy,Omen,Iso","Raze,Killjoy,Viper,Omen,Gekko"
Lotus,UAOPG,eXtreme Gaming,14,12,6,7,5,8,"Killjoy,Omen,Neon,Fade,Gekko","Breach,Raze,Killjoy,Fade,Clove"
Bind,Capacitanes,Odyssey Gaming,13,8,7,2,6,6,"Raze,Cypher,Brimstone,Skye,Fade","Raze,Cypher,Brimstone,Gekko,Iso"
Icebox,Flame Hard,lodzik,11,13,2,10,3,9,"Sova,Killjoy,Viper,Sage,Jett","Sova,Killjoy,Viper,Sage,Jett"
Lotus,Vahuma eSports,Locked Hanters,3,13,0,4,9,3,"Breach,Raze,Killjoy,Omen,Gekko","Raze,Killjoy,Viper,Omen,Fade"
Ascent,zer0 club,TLS eSports,3,13,2,2,11,1,"Breach,Cypher,Omen,Yoru,Iso","Killjoy,Viper,Omen,Jett,Skye"
Ascent,Las Palmas Unity,Team Redux,13,5,4,2,3,9,"Sova,Killjoy,Omen,Jett,KAY/O","Sova,Killjoy,Omen,Jett,KAY/O"
Ascent,GMBLERS Esports,Grow uP eSports,13,7,6,6,1,7,"Sova,Killjoy,Omen,Jett,KAY/O","Sova,Killjoy,Phoenix,Omen,Jett"
Icebox,Unlucky boys,Melilla Titans,3,13,0,4,9,3,"Sova,Killjoy,Viper,Sage,Jett","Killjoy,Viper,Reyna,Harbor,Gekko"
Bind,Glacial Guardians,BALD BUFF,13,1,2,0,1,11,"Cypher,Viper,Jett,Skye,Clove","Raze,Viper,Brimstone,Skye,Gekko"
Lotus,Tono Gang,RevenantVAL,4,13,1,4,9,3,"Breach,Killjoy,Omen,Jett,Fade","Breach,Raze,Killjoy,Omen,Fade"
Breeze,Solar Flare,Team 7 Esports,13,10,6,5,5,7,"Sova,Viper,Jett,Yoru,Chamber","Cypher,Sova,Viper,Jett,KAY/O"
Sunset,The Avengers,bazinga esports,8,13,3,6,7,5,"Breach,Raze,Cypher,Omen,Gekko","Breach,Raze,Cypher,Omen,Gekko"
Lotus,Babos Gaming,V2X Gaming,13,7,8,4,3,5,"Breach,Killjoy,Omen,Neon,Gekko","Raze,Killjoy,Viper,Omen,Fade"
Ascent,STAKERS,InTenZive,13,11,7,5,6,6,"Cypher,Sova,Omen,Jett,KAY/O","Sova,Killjoy,Omen,Jett,Iso"
Icebox,hydragon esports,thegiornalisti,7,13,2,6,7,5,"Sova,Killjoy,Viper,Reyna,Iso","Sova,Killjoy,Viper,Reyna,Jett"
Lotus,PSOE GITANO,1000rr club,9,13,5,7,6,4,"Breach,Raze,Killjoy,Viper,Omen","Breach,Cypher,Sova,Omen,Jett"
Sunset,SZK Esports,Poverineeh,13,0,12,0,0,1,"Breach,Cypher,Omen,Neon,Gekko","Raze,Cypher,Sova,Omen,Gekko"
Lotus,90 Seconds,KHORE GAMING,2,13,2,10,3,0,"Raze,Killjoy,Viper,Omen,Fade","Breach,Cypher,Omen,Neon,Iso"
Split,INCOGNITO,TERRONIAIM,13,7,9,3,4,4,"Breach,Raze,Cypher,Omen,Neon","Breach,Raze,Cypher,Omen,Gekko"
Lotus,REVOADA,LOUD GC,8,13,2,7,6,6,"Raze,Killjoy,Viper,Omen,Fade","Raze,Killjoy,Viper,Omen,Fade"
Ascent,Impulse GW,FTW LEÇA FC,13,10,8,4,6,5,"Sova,Killjoy,Omen,Jett,KAY/O","Breach,Sova,Omen,Jett,Iso"
Sunset,Five Media Clan,Ramboot Club,9,13,7,5,8,2,"Cypher,Sova,Omen,Jett,KAY/O","Sova,Killjoy,Brimstone,Omen,Yoru"
Lotus,ALTERNATE aTTaX Ruby,GnG White,13,9,7,5,4,6,"Breach,Raze,Cypher,Omen,Fade","Breach,Raze,Killjoy,Omen,Fade"
Sunset,F9 Wonders,Idynomashimi,13,6,4,3,3,9,"Breach,Raze,Cypher,Omen,Yoru","Breach,Raze,Cypher,Omen,Gekko"
Breeze,Joblife,Cicadas Gaming,4,13,2,3,10,2,"Cypher,Sova,Viper,Yoru,KAY/O","Cypher,Sova,Viper,Jett,Yoru"
Lotus,On Sight,Exanimis,15,13,9,5,8,6,"Breach,Raze,Killjoy,Omen,Gekko","Breach,Raze,Killjoy,Omen,Iso"
Bind,Soul Society,ForsaKen GC,8,13,4,5,8,4,"Breach,Cypher,Brimstone,Neon,Gekko","Breach,Raze,Cypher,Omen,Gekko"
Icebox,TOG Kitsune,axolotls and chips,14,12,8,5,7,6,"Sova,Killjoy,Viper,Jett,Gekko","Killjoy,Viper,Chamber,Gekko,Clove"
Lotus,last second,Anonymo GC,13,8,5,4,4,8,"Breach,Killjoy,Omen,Neon,Gekko","Raze,Sova,Omen,Deadlock,Iso"
Lotus,Twisted Minds Orchid,RIZON Sugar,13,5,7,5,0,6,"Breach,Raze,Cypher,Omen,Fade","Raze,Killjoy,Astra,Neon,Gekko"
Ascent,BLVKHVND,Crvena zvezda esports,13,6,9,3,3,4,"Sova,Killjoy,Omen,Jett,KAY/O","Sova,Killjoy,Phoenix,Omen,Jett"
Icebox,NOVO Esports,Outplayed,13,6,7,0,6,6,"Sova,Killjoy,Viper,Sage,Jett","Killjoy,Viper,Jett,KAY/O,Gekko"
Bind,FOKUS,CGN Esports,13,6,9,3,3,4,"Viper,Brimstone,Skye,Yoru,Gekko","Raze,Viper,Brimstone,Sage,Gekko"
Sunset,Galakticos,S2G Esports,13,7,8,4,3,5,"Raze,Cypher,Sova,Omen,Iso","Breach,Raze,Cypher,Omen,Gekko"
Lotus,Team Aku Aku,Dimonis,11,13,5,7,6,6,"Raze,Killjoy,Viper,Omen,Gekko","Raze,Killjoy,Viper,Omen,Gekko"
Bind,GoNext Esports,B8 Esports,8,13,4,5,8,4,"Raze,Viper,Brimstone,Skye,Gekko","Raze,Viper,Brimstone,Fade,Gekko"
Sunset,The Ultimates,Underground Gaming,11,13,7,5,8,4,"Cypher,Sova,Omen,KAY/O,Neon","Breach,Raze,Cypher,Omen,Fade"
Split,REVOADA,LOUD GC,8,13,6,6,7,2,"Raze,Cypher,Viper,Omen,Skye","Raze,Killjoy,Viper,Skye,Astra"
Lotus,FUZOS,EX0TIK GAMING,13,9,5,7,2,8,"Cypher,Omen,Skye,Neon,Iso","Breach,Killjoy,Omen,Neon,Gekko"
Lotus,Five Media Clan,Ramboot Club,14,12,3,10,2,11,"Breach,Cypher,Sova,Omen,Jett","Cypher,Sova,Omen,Yoru,Neon"
Icebox,RTZN,LONETEAM,5,13,4,8,5,1,"Killjoy,Viper,Sage,Jett,KAY/O","Sova,Killjoy,Viper,Jett,Gekko"
Ascent,Joblife,Cicadas Gaming,13,11,7,5,6,6,"Sova,Killjoy,Omen,Jett,KAY/O","Sova,Killjoy,Omen,Jett,KAY/O"
Ascent,FOKUS,CGN Esports,6,13,2,5,8,4,"Sova,Killjoy,Omen,Jett,KAY/O","Sova,Killjoy,Phoenix,Jett,Astra"
Ascent,NOM Esports,trashcan,3,13,3,9,4,0,"Sova,Killjoy,Omen,Jett,KAY/O","Sova,Killjoy,Sage,Omen,Jett"
Icebox,Galakticos,S2G Esports,13,10,5,6,4,8,"Sova,Omen,Jett,KAY/O,Clove","Sova,Killjoy,Viper,Jett,Clove"
Breeze,Team Aku Aku,Dimonis,12,14,4,9,5,8,"Cypher,Sova,Viper,Omen,Jett","Cypher,Sova,Viper,Jett,KAY/O"
Lotus,GTZ Esports,PPP,4,13,0,5,8,4,"Breach,Raze,Cypher,Sova,Omen","Breach,Raze,Cypher,Sova,Omen"
Split,FOKUS,CGN Esports,13,5,4,2,3,9,"Raze,Omen,Yoru,Astra,Fade","Raze,Viper,Sage,Omen,Jett"
Split,NOM Esports,trashcan,10,13,3,8,5,7,"Raze,Cypher,Viper,Omen,Skye","Cypher,Viper,Omen,Jett,Skye"
Lotus,Galakticos,S2G Esports,12,14,8,5,9,4,"Breach,Cypher,Omen,Yoru,Iso","Cypher,Omen,Neon,Fade,Deadlock"
Ascent,SAW,HOF Esports,13,2,10,2,0,3,"Sova,Killjoy,Omen,Jett,KAY/O","Sova,Killjoy,Omen,Jett,KAY/O"
Split,MOUZ,Eintracht Frankfurt,9,13,7,5,8,2,"Breach,Raze,Cypher,Omen,Skye","Raze,Cypher,Sage,Omen,Skye"
Ascent,Striders,DELTA esports (JP),14,16,6,9,7,8,"Sova,Killjoy,Omen,Jett,KAY/O","Sova,Killjoy,Omen,Jett,KAY/O"
Icebox,The MongolZ,WICKED,13,9,7,5,4,6,"Killjoy,Viper,Jett,KAY/O,Gekko","Sova,Viper,Jett,Gekko,Iso"
Split,esports team αD,NOEZ FOXX,8,13,1,8,5,7,"Breach,Raze,Cypher,Sage,Omen","Raze,Cypher,Omen,Neon,Iso"
Bind,Delight,Crest Gaming ZST,14,16,9,6,10,5,"Breach,Raze,Brimstone,Neon,Gekko","Raze,Reyna,Gekko,Iso,Clove"
Bind,MOUZ,Eintracht Frankfurt,8,13,4,8,5,4,"Breach,Raze,Viper,Brimstone,Gekko","Raze,Viper,Yoru,Gekko,Clove"
Sunset,WICKED,じゅんや友達,13,9,6,6,3,7,"Cypher,Sova,Omen,Jett,Iso","Breach,Raze,Sage,Omen,Gekko"
Ascent,DetonatioN FocusMe,ZETA DIVISION,13,10,7,4,6,6,"Sova,Killjoy,Omen,Jett,KAY/O","Sova,Killjoy,Omen,Jett,KAY/O"
Lotus,NTPOJA,Striders,10,13,5,6,7,5,"Breach,Killjoy,Omen,Neon,Gekko","Sova,Killjoy,Omen,Neon,Iso"
Lotus,ODD PLAN,NOEZ FOXX,8,13,5,7,6,3,"Breach,Cypher,Omen,Neon,Iso","Raze,Cypher,Omen,Neon,Iso"
Breeze,The MongolZ,BC SWELL,13,5,7,5,0,6,"Breach,Cypher,Sova,Viper,Jett","Cypher,Sova,Viper,Omen,Yoru"
Bind,Crest Gaming ZST,RIP root,13,2,3,0,2,10,"Raze,Reyna,Gekko,Iso,Clove","Phoenix,Reyna,Deadlock,Iso,Clove"
Sunset,Delight,Slovo Yakuta,13,6,9,3,3,4,"Breach,Raze,Sage,Omen,Gekko","Raze,Cypher,Omen,Gekko,Iso"
Ascent,IGZIST,DELTA esports (JP),9,13,5,5,8,4,"Sova,Killjoy,Jett,Iso,Clove","Sova,Killjoy,Omen,Jett,KAY/O"
Sunset,esports team αD,Haven Liberty,13,6,7,5,1,6,"Raze,Cypher,Sage,Omen,Fade","Raze,Cypher,Omen,KAY/O,Gekko"
Lotus,MOUZ,Eintracht Frankfurt,13,6,7,0,6,6,"Breach,Cypher,Omen,Yoru,Fade","Raze,Cypher,Sova,Omen,Astra"
Ascent,ゆぴお戦隊ゴレンジャー,BC SWELL,6,13,3,9,4,3,"Sova,Killjoy,Omen,Jett,KAY/O","Sova,Killjoy,Omen,Jett,KAY/O"
Icebox,FAV gaming,WICKED,11,13,5,7,6,6,"Killjoy,Viper,Jett,KAY/O,Gekko","Sova,Viper,Jett,Gekko,Iso"
Icebox,Team  Swamp,The MongolZ,1,13,0,2,11,1,"Sova,Killjoy,Viper,Jett,Deadlock","Killjoy,Viper,Jett,KAY/O,Gekko"
Sunset,TeamDuration,じゅんや友達,5,13,4,8,5,1,"Raze,Cypher,Sage,Omen,Fade","Breach,Raze,Sage,Omen,Gekko"
Lotus,IGZIST,SilhouetteS,13,3,10,2,1,3,"Raze,Cypher,Reyna,Iso,Clove","Breach,Killjoy,Omen,Jett,Fade"
Sunset,NIX EAST,Slovo Yakuta,6,13,6,6,7,0,"Raze,Cypher,Sage,Omen,Fade","Raze,Cypher,Omen,Gekko,Iso"
Bind,俺らヨル専,RIP root,9,13,4,6,7,5,"Cypher,Phoenix,Yoru,Iso,Clove","Raze,Reyna,Jett,Iso,Clove"
Icebox,Striders,DragonGaming,13,9,7,3,6,6,"Sova,Killjoy,Viper,Jett,KAY/O","Sova,Killjoy,Viper,Jett,Iso"
Ascent,NTPOJA,デブキラー,13,9,4,8,1,9,"Breach,Sova,Killjoy,Omen,Jett","Sova,Killjoy,Phoenix,Omen,Jett"
Lotus,Haven Liberty,toshio,13,2,11,1,1,2,"Raze,Killjoy,Omen,Fade,Deadlock","Breach,Raze,Killjoy,Omen,Fade"
Bind,NOEZ FOXX,BEST OF ADHD,13,7,7,1,6,6,"Raze,Brimstone,Neon,Gekko,Iso","Raze,Brimstone,Skye,Gekko,Iso"
Ascent,Crest Gaming ZST,TRIDENT,13,11,5,7,4,8,"Cypher,Sova,Jett,Iso,Clove","Sova,Killjoy,Omen,Jett,KAY/O"
Lotus,DELTA esports (JP),にゃん汰親衛隊,13,7,6,6,1,7,"Raze,Killjoy,Viper,Omen,Fade","Raze,Killjoy,Omen,Skye,Gekko"
Lotus,TEAM NAY,Delight,9,13,3,7,6,6,"Breach,Killjoy,Omen,Jett,Fade","Breach,Raze,Cypher,Omen,Fade"
Sunset,ODD PLAN,Cryptid,13,8,8,1,7,5,"Breach,Cypher,Omen,Neon,Iso","Breach,Raze,Cypher,Sova,Omen"
Sunset,NoNameGamings,esports team αD,7,13,6,6,7,1,"Breach,Raze,Cypher,Omen,Gekko","Raze,Cypher,Gekko,Iso,Clove"
Sunset,DetonatioN FocusMe,ZETA DIVISION,13,9,7,5,4,6,"Breach,Raze,Cypher,Omen,Gekko","Breach,Raze,Cypher,Omen,Gekko"
Haven,DetonatioN FocusMe,ZETA DIVISION,7,13,3,5,8,4,"Breach,Sova,Killjoy,Omen,Jett","Breach,Sova,Killjoy,Omen,Neon"
Icebox,polar bear,Evergarden GC,13,6,10,2,4,3,"Sova,Killjoy,Viper,Gekko,Iso","Raze,Killjoy,Viper,Yoru,Fade"
Bind,Scissor Sisters,Blossom,13,11,7,5,6,6,"Raze,Cypher,Skye,Astra,Clove","Raze,Cypher,Skye,Harbor,Clove"
Sunset,Global Esports,Bleed Esports,13,6,6,1,5,7,"Cypher,Sova,Omen,KAY/O,Neon","Raze,Cypher,Sova,Omen,KAY/O"
Sunset,polar bear,Evergarden GC,1,13,1,11,2,0,"Cypher,Sova,Omen,Neon,Gekko","Cypher,Sova,Phoenix,Omen,Neon"
Bind,Clueless GC,VIXENS,6,13,1,6,7,5,"Raze,Cypher,Jett,Gekko,Clove","Raze,Viper,Brimstone,Fade,Gekko"
Icebox,ViBe,swaglord9000,4,13,2,3,10,2,"Sova,Viper,Sage,Reyna,Jett","Sova,Killjoy,Viper,Sage,Jett"
Sunset,Scissor Sisters,Blossom,13,7,9,3,4,4,"Breach,Raze,Cypher,Gekko,Clove","Breach,Cypher,Sova,Omen,Neon"
Ascent,polar bear,Evergarden GC,13,5,10,2,3,3,"Sova,Killjoy,Omen,Jett,KAY/O","Sova,Killjoy,Phoenix,Omen,Jett"
Bind,ViBe,swaglord9000,1,13,1,11,2,0,"Raze,Killjoy,Viper,Brimstone,Skye","Raze,Viper,Brimstone,Skye,Deadlock"
Icebox,Clueless GC,VIXENS,2,13,0,3,10,2,"Sova,Killjoy,Viper,Sage,Jett","Killjoy,Viper,Jett,KAY/O,Gekko"
Lotus,Global Esports,Bleed Esports,13,6,9,3,3,4,"Breach,Cypher,Omen,Neon,Fade","Raze,Cypher,Viper,Omen,Fade"
Sunset,Scissor Sisters,ViBe,13,2,10,2,0,3,"Breach,Raze,Cypher,Gekko,Clove","Cypher,Reyna,Omen,Gekko,Iso"
Haven,VIXENS,polar bear,6,13,3,9,4,3,"Breach,Cypher,Jett,Astra,Gekko","Breach,Sova,Killjoy,Omen,Jett"
Bind,Evergarden GC,Blossom,16,14,11,4,10,5,"Raze,Cypher,Brimstone,Skye,Clove","Raze,Cypher,Skye,Harbor,Clove"
Bind,swaglord9000,Clueless GC,13,0,1,0,0,12,"Raze,Viper,Brimstone,Skye,Iso","Raze,Cypher,Jett,Gekko,Clove"
Icebox,swaglord9000,Clueless GC,13,1,2,0,1,11,"Sova,Killjoy,Viper,Jett,KAY/O","Sova,Killjoy,Viper,Sage,Jett"
Sunset,Evergarden GC,Blossom,13,2,10,2,0,3,"Cypher,Sova,Phoenix,Omen,Neon","Breach,Cypher,Sova,Omen,Neon"
Lotus,Scissor Sisters,ViBe,13,11,7,5,6,6,"Raze,Killjoy,Reyna,Omen,Skye","Killjoy,Reyna,Skye,Gekko,Clove"
Sunset,VIXENS,polar bear,11,13,5,7,6,6,"Breach,Raze,Cypher,Omen,Gekko","Cypher,Sova,Omen,Neon,Gekko"
Icebox,no team name,koupert and friends,3,13,2,10,3,1,"Sova,Killjoy,Viper,Jett,Gekko","Sova,Viper,Harbor,Gekko,Iso"
Lotus,no team name,koupert and friends,6,13,1,6,7,5,"Breach,Raze,Killjoy,Omen,Iso","Raze,Cypher,Omen,Gekko,Deadlock"
Sunset,Sentinels,NRG Esports,14,12,10,3,9,4,"Breach,Raze,Cypher,Omen,Gekko","Cypher,Sova,Omen,KAY/O,Neon"
Sunset,no team name,koupert and friends,13,4,9,3,1,4,"Raze,Cypher,Omen,Gekko,Iso","Breach,Raze,Cypher,Sova,Omen"
Lotus,Sentinels,NRG Esports,13,8,8,4,4,5,"Raze,Cypher,Omen,Fade,Deadlock","Breach,Cypher,Neon,Gekko,Clove"
Split,no team name,RECR,13,9,8,4,5,5,"Breach,Raze,Cypher,Iso,Clove","Raze,Cypher,Viper,Omen,Skye"
Sunset,Akron Esports,koupert and friends,8,13,5,7,6,3,"Breach,Raze,Cypher,Sova,Omen","Breach,Raze,Cypher,Sova,Omen"
Icebox,plano gooners,koupert and friends,1,13,1,11,2,0,"Cypher,Omen,KAY/O,Neon,Iso","Sova,Viper,Harbor,Gekko,Iso"
Icebox,MIBR,Leviatán,7,13,3,9,4,4,"Sova,Killjoy,Viper,Jett,Gekko","Sova,Killjoy,Viper,Jett,Harbor"
Lotus,Omnipotence,Akron Esports,1,13,1,11,2,0,"Breach,Raze,Killjoy,Omen,Fade","Raze,Viper,Omen,Chamber,Fade"
Ascent,Dog Barkers,RECR,12,14,3,10,4,9,"Cypher,Sova,Omen,Jett,KAY/O","Sova,Killjoy,Omen,Jett,KAY/O"
Split,BOMB IMPOUNDMENT SQUADRON,no team name,5,13,0,6,7,5,"Breach,Cypher,Omen,Jett,Skye","Breach,Raze,Cypher,Iso,Clove"
Icebox,plano gooners,GroundX,13,10,7,4,6,6,"Cypher,Skye,Neon,Iso,Clove","Sova,Viper,Jett,Chamber,Gekko"
Sunset,BOMB IMPOUNDMENT SQUADRON,SSK Gaming,13,3,9,3,0,4,"Breach,Raze,Cypher,Omen,Gekko","Cypher,Sova,Omen,Gekko,Iso"
Lotus,koupert and friends,TAMU White,14,12,8,5,7,6,"Raze,Cypher,Omen,Jett,Gekko","Breach,Raze,Gekko,Iso,Clove"
Sunset,Akron Esports,Tier 1 Québec,15,13,9,5,8,6,"Breach,Raze,Cypher,Sova,Omen","Raze,Cypher,Omen,Gekko,Iso"
Lotus,Team Leveling,LOUD GC,2,13,2,10,3,0,"Breach,Cypher,Omen,Neon,Gekko","Raze,Killjoy,Viper,Omen,Fade"
Bind,Omnipotence,Variety,13,0,1,0,0,12,"Raze,Cypher,Brimstone,Skye,Fade","Raze,Cypher,Skye,Iso,Clove"
Bind,5 gecs,Dog Barkers,6,13,2,5,8,4,"Raze,Cypher,Brimstone,Skye,Yoru","Raze,Viper,Brimstone,Gekko,Iso"
Lotus,RITUAL BLACK,RECR,10,13,7,5,8,3,"Breach,Omen,Skye,Chamber,Neon","Breach,Cypher,Sova,Astra,Neon"
Ascent,MIBR,Leviatán,9,13,6,6,7,3,"Sova,Killjoy,Omen,Yoru,Iso","Sova,Killjoy,Omen,Jett,KAY/O"
Ascent,no team name,BuyWeWin,13,9,6,6,3,7,"Sova,Killjoy,Omen,Jett,KAY/O","Sova,Killjoy,Omen,Jett,Iso"
Split,R8 Esports,Team RA'AD,8,13,7,2,11,1,"Raze,Cypher,Viper,Omen,Skye","Raze,Cypher,Viper,Omen,Skye"
Breeze,koupert and friends,The Outcasts,13,7,3,5,2,10,"Cypher,Viper,Yoru,Fade,Iso","Cypher,Sova,Viper,Jett,KAY/O"
Ascent,OCC Esports,GroundX,3,13,1,3,10,2,"Sova,Killjoy,Phoenix,Omen,Jett","Sova,Reyna,Omen,Jett,Chamber"
Lotus,Akron Esports,Hasbulla,13,4,2,3,1,11,"Raze,Viper,Omen,Chamber,Gekko","Breach,Killjoy,Omen,Neon,Gekko"
Bind,Team Leveling,LOUD GC,4,13,1,4,9,3,"Breach,Viper,Brimstone,Neon,Gekko","Raze,Viper,Brimstone,Skye,Gekko"
Lotus,TAMU White,winners circle,13,6,8,4,2,5,"Breach,Raze,Gekko,Iso,Clove","Breach,Raze,Killjoy,Omen,Fade"
Bind,Clemson Esports,Dog Barkers,6,13,1,6,7,5,"Raze,Viper,Brimstone,Skye,Yoru","Raze,Viper,Brimstone,Gekko,Iso"
Lotus,SSK Gaming,AURA Valorant,13,10,8,3,7,5,"Raze,Killjoy,Viper,Omen,Fade","Breach,Raze,Cypher,Omen,Gekko"
Ascent,RECR,Team GC,13,0,12,0,0,1,"Sova,Killjoy,Omen,Jett,KAY/O","Breach,Sova,Killjoy,Viper,Sage"
Ascent,The Criminals,Tier 1 Québec,11,13,5,7,6,6,"Sova,Killjoy,Omen,Jett,KAY/O","Sova,Killjoy,Omen,Jett,KAY/O"
Split,1st Odyssey,no team name,1,13,0,2,11,1,"Raze,Cypher,Jett,Skye,Astra","Breach,Raze,Cypher,Iso,Clove"
Ascent,Jean shorts,Variety,8,13,7,5,8,1,"Killjoy,Phoenix,Skye,Astra,Iso","Sova,Killjoy,Jett,Iso,Clove"
Icebox,R8 Esports,Team RA'AD,7,13,5,7,6,2,"Killjoy,Viper,Sage,Reyna,Gekko","Killjoy,Viper,Sage,Gekko,Clove"
Sunset,ForsaKen GC,Saltire Sirens,13,6,6,1,5,7,"Breach,Raze,Cypher,Omen,Gekko","Breach,Raze,Cypher,Omen,Gekko"
Lotus,TOG Kitsune,Team Galaga Kitsune,13,8,8,4,4,5,"Breach,Raze,Killjoy,Omen,Gekko","Breach,Sova,Killjoy,Omen,Neon"
Ascent,Exanimis,GoatFellas Tragos,13,9,8,2,7,5,"Sova,Killjoy,Omen,Jett,KAY/O","Sova,Killjoy,Omen,Jett,KAY/O"
Ascent,LONETEAM,Outplayed,8,13,2,7,6,6,"Raze,Sova,Killjoy,Omen,Gekko","Cypher,Sova,Omen,Jett,Deadlock"
Bind,Solary,Valiant,10,13,6,6,7,4,"Viper,Brimstone,Skye,Yoru,Gekko","Raze,Viper,Brimstone,Skye,Gekko"
Sunset,Permitta Unicorns,ALTERNATE aTTaX,7,13,7,5,8,0,"Breach,Raze,Cypher,Omen,Fade","Raze,Cypher,Omen,KAY/O,Gekko"
Ascent,Acient Freya,Idynomashimi,12,14,6,7,7,6,"Sova,Killjoy,Phoenix,Omen,Jett","Sova,Killjoy,Phoenix,Omen,Jett"
Lotus,R8 Esports,Team RA'AD,13,8,7,2,6,6,"Raze,Killjoy,Omen,Skye,Astra","Raze,Omen,Fade,Deadlock,Clove"
Ascent,REVOADA,TBS GC,14,12,5,8,4,9,"Sova,Killjoy,Omen,Jett,KAY/O","Sova,Killjoy,Omen,Jett,KAY/O"
Ascent,ESC Gaming,Chipi Chapa's,9,13,4,6,7,5,"Sova,Killjoy,Omen,Jett,KAY/O","Sova,Killjoy,Omen,Jett,KAY/O"
Sunset,Exanimis,GoatFellas Tragos,13,6,7,0,6,6,"Breach,Raze,Cypher,Iso,Clove","Raze,Cypher,Sova,Omen,KAY/O"
Ascent,ForsaKen GC,Saltire Sirens,11,13,3,9,4,8,"Sova,Killjoy,Omen,Jett,KAY/O","Sova,Killjoy,Omen,Jett,KAY/O"
Sunset,TOG Kitsune,Team Galaga Kitsune,5,13,4,8,5,1,"Breach,Raze,Cypher,Omen,Gekko","Breach,Cypher,Sova,Omen,Jett"
Icebox,VX300 Gaming,NOVO Esports,4,13,1,4,9,3,"Killjoy,Viper,Jett,KAY/O,Gekko","Sova,Killjoy,Viper,Sage,Jett"
Ascent,EMUs,F9 Wonders,4,13,3,9,4,1,"Cypher,Sova,Omen,Yoru,Deadlock","Sova,Killjoy,Phoenix,Omen,Jett"
Icebox,last second,Formulation Gaming GC,13,6,4,3,3,9,"Sova,Killjoy,Viper,Reyna,Jett","Sova,Killjoy,Viper,Sage,Jett"
Ascent,Twisted Minds Orchid,Ravens GC,13,3,10,2,1,3,"Sova,Killjoy,Omen,Jett,KAY/O","Sova,Killjoy,Omen,Jett,KAY/O"
Lotus,Permitta Unicorns,ALTERNATE aTTaX,7,13,2,6,7,5,"Breach,Raze,Killjoy,Omen,Fade","Breach,Raze,Sova,Killjoy,Omen"
Sunset,axolotls and chips,Oserv Esport GC,13,3,11,1,2,2,"Breach,Cypher,Sova,Reyna,Harbor","Breach,Raze,Cypher,Omen,Gekko"
Lotus,Team PlayHard Glasterz,Soul Society,9,13,6,6,7,3,"Breach,Raze,Cypher,Omen,Fade","Breach,Killjoy,Omen,Neon,Fade"
Sunset,On Sight,Hidden Horizon GC,13,10,8,3,7,5,"Breach,Raze,Cypher,Omen,Gekko","Breach,Cypher,Sova,Omen,Jett"
Icebox,BLVKHVND,Scald eSport GC,13,4,4,1,3,9,"Sova,Killjoy,Viper,Jett,Harbor","Sova,Killjoy,Viper,Sage,Jett"
Split,Acient Freya,Idynomashimi,10,13,6,6,7,4,"Breach,Killjoy,Sage,Omen,Jett","Raze,Cypher,Omen,Jett,Skye"
Lotus,Solary,Valiant,12,14,5,8,6,7,"Cypher,Omen,KAY/O,Neon,Fade","Breach,Raze,Killjoy,Omen,Fade"
Breeze,?,Anonymo GC,7,13,3,5,8,4,"Sova,Viper,Jett,KAY/O,Chamber","Cypher,Sova,Viper,Jett,Yoru"
Sunset,MadWolves Esports,GnG White,10,13,7,5,8,3,"Breach,Raze,Cypher,Omen,Gekko","Breach,Raze,Cypher,Sova,Omen"
Lotus,Digity Esport,Crvena zvezda esports,5,13,5,7,6,0,"Breach,Raze,Killjoy,Omen,Gekko","Breach,Raze,Killjoy,Omen,Fade"
Bind,RIZON Sugar,Shine in Shade,13,3,3,1,2,10,"Raze,Cypher,Brimstone,Jett,Skye","Raze,Viper,Brimstone,Skye,Gekko"
Lotus,HOWL Esports,Eternal Fire,13,5,5,1,4,8,"Raze,Cypher,Viper,Omen,Fade","Breach,Raze,Cypher,Omen,Neon"
Split,Team Falcons,Unity Esports,13,7,7,1,6,6,"Breach,Raze,Cypher,Omen,Skye","Breach,Raze,Cypher,Omen,Skye"
Bind,FTW LEÇA FC,FUZOS,13,15,6,8,7,7,"Raze,Viper,Brimstone,Skye,Iso","Viper,Brimstone,Skye,Neon,Iso"
Breeze,ESC Gaming,Chipi Chapa's,14,16,6,9,7,8,"Cypher,Sova,Viper,Jett,KAY/O","Cypher,Sova,Viper,Jett,Yoru"
Icebox,EMUs,F9 Wonders,6,13,1,6,7,5,"Killjoy,Viper,Omen,KAY/O,Gekko","Sova,Killjoy,Viper,Sage,Jett"
Bind,TOG Kitsune,Team Galaga Kitsune,13,8,5,4,4,8,"Breach,Raze,Cypher,Brimstone,Gekko","Breach,Raze,Cypher,Brimstone,Yoru"
Sunset,Twisted Minds Orchid,Ravens GC,13,10,7,4,6,6,"Breach,Raze,Cypher,Omen,Gekko","Breach,Raze,Cypher,Omen,Gekko"
Lotus,RIZON Sugar,Shine in Shade,13,2,3,0,2,10,"Raze,Killjoy,Astra,Neon,Gekko","Breach,Cypher,Omen,Neon,Fade"
Lotus,ForsaKen GC,Saltire Sirens,13,10,8,4,6,5,"Breach,Raze,Cypher,Sova,Omen","Breach,Raze,Cypher,Omen,Skye"
Ascent,MadWolves Esports,GnG White,4,13,4,8,5,0,"Sova,Killjoy,Omen,Jett,KAY/O","Sova,Killjoy,Omen,Jett,KAY/O"
Ascent,Team PlayHard Glasterz,Soul Society,8,13,7,5,8,1,"Sova,Killjoy,Omen,Jett,KAY/O","Sova,Killjoy,Omen,Jett,KAY/O"
Lotus,BLVKHVND,Scald eSport GC,13,5,9,3,2,4,"Raze,Killjoy,Viper,Omen,Fade","Breach,Raze,Sova,Killjoy,Omen"
Icebox,axolotls and chips,Oserv Esport GC,13,6,5,2,4,8,"Killjoy,Viper,Chamber,Gekko,Clove","Sova,Killjoy,Viper,Jett,Gekko"
Lotus,last second,Formulation Gaming GC,13,10,6,5,5,7,"Breach,Killjoy,Omen,Neon,Gekko","Raze,Killjoy,Viper,Omen,Fade"
Bind,HGE Esports,DSYRE,10,13,7,5,8,3,"Raze,Sova,Viper,Omen,Gekko","Raze,Viper,Brimstone,Skye,Gekko"
Lotus,?,Anonymo GC,3,13,0,4,9,3,"Breach,Raze,Killjoy,Omen,Fade","Raze,Sova,Omen,Deadlock,Iso"
Ascent,On Sight,Hidden Horizon GC,13,6,6,1,5,7,"Sova,Killjoy,Omen,Jett,KAY/O","Cypher,Sova,Omen,Jett,KAY/O"
Lotus,Acient Freya,Idynomashimi,13,7,11,1,6,2,"Breach,Raze,Killjoy,Omen,Gekko","Breach,Raze,Killjoy,Omen,Gekko"
Sunset,Digity Esport,Crvena zvezda esports,4,13,3,9,4,1,"Breach,Raze,Cypher,Omen,Gekko","Breach,Raze,Sage,Omen,Gekko"
Split,REVOADA,TBS GC,20,18,9,10,8,11,"Raze,Cypher,Viper,Omen,Skye","Raze,Viper,Omen,Skye,Iso"
Icebox,SK Gaming,Ovation eSports,13,6,9,3,3,4,"Killjoy,Viper,KAY/O,Gekko,Clove","Sova,Killjoy,Viper,Sage,Jett"
Bind,Akroma,Zerance,7,13,4,4,9,3,"Raze,Viper,Omen,Skye,Gekko","Raze,Viper,Brimstone,Skye,Gekko"
Bind,HOWL Esports,Eternal Fire,13,9,6,6,3,7,"Raze,Viper,Brimstone,Skye,Gekko","Sova,Jett,Astra,KAY/O,Deadlock"
Sunset,B8 Esports,Acend,13,5,8,4,1,5,"Breach,Raze,Cypher,Sova,Omen","Raze,Cypher,Omen,KAY/O,Gekko"
Lotus,Team Falcons,Unity Esports,13,11,6,6,5,7,"Raze,Viper,Omen,Chamber,Gekko","Breach,Sova,Killjoy,Omen,Jett"
Icebox,REVOADA,TBS GC,1,13,1,11,2,0,"Sova,Killjoy,Viper,Jett,KAY/O","Sova,Killjoy,Viper,Jett,Gekko"
Split,LXT Esports GC,NOVO GC,13,6,6,6,0,7,"Breach,Raze,Cypher,Viper,Omen","Breach,Raze,Cypher,Omen,Jett"
Icebox,PPP,SAW,13,11,6,6,5,7,"Sova,Killjoy,Viper,Sage,Jett","Sova,Killjoy,Viper,Sage,Jett"
Lotus,Axolotl,RTZN,9,13,4,6,7,5,"Raze,Killjoy,Omen,Astra,Fade","Breach,Sova,Killjoy,Omen,Jett"
Lotus,SK Gaming,Ovation eSports,13,9,5,5,4,8,"Breach,Cypher,Sova,Omen,Neon","Raze,Killjoy,Viper,Omen,Fade"
Sunset,Akroma,Zerance,8,13,5,7,6,3,"Breach,Raze,Cypher,Omen,Gekko","Breach,Raze,Cypher,Sova,Omen"
Breeze,B8 Esports,Acend,8,13,4,8,5,4,"Cypher,Sova,Viper,Jett,Yoru","Cypher,Sova,Viper,Jett,KAY/O"
Lotus,LXT Esports GC,NOVO GC,13,2,11,1,1,2,"Raze,Killjoy,Viper,Omen,Fade","Breach,Sova,Killjoy,Omen,Neon"
Haven,Galatasaray Esports,Istanbul Wildcats,13,4,8,4,0,5,"Breach,Sova,Killjoy,Omen,Jett","Killjoy,Viper,Omen,Jett,Skye"
Ascent,HOF Esports,Impulse GW,7,13,4,8,5,3,"Sova,Killjoy,Omen,Jett,KAY/O","Sova,Killjoy,Omen,Jett,KAY/O"
Split,B8 Esports,Acend,13,7,6,2,5,7,"Raze,Viper,Omen,Yoru,Fade","Raze,Cypher,Sage,Omen,Jett"
Ascent,SK Gaming,Ovation eSports,7,13,3,9,4,4,"Breach,Cypher,Omen,Jett,Fade","Sova,Killjoy,Omen,Jett,KAY/O"
Bind,A One Man Army,Exceptional Gaming,10,13,6,5,8,4,"Breach,Raze,Brimstone,Sage,Skye","Raze,Viper,Brimstone,Skye,Gekko"
Breeze,LXT Esports GC,NOVO GC,13,1,11,1,0,2,"Cypher,Sova,Viper,Jett,Clove","Cypher,Sova,Viper,Jett,KAY/O"
Lotus,Galatasaray Esports,Istanbul Wildcats,14,12,9,4,8,5,"Raze,Killjoy,Yoru,Astra,Fade","Raze,Sova,Killjoy,Omen,Gekko"
Breeze,A One Man Army,Exceptional Gaming,8,13,5,7,6,3,"Viper,Yoru,Astra,KAY/O,Gekko","Cypher,Sova,Viper,Jett,KAY/O"
Lotus,EX0TIK GAMING,GTZ Esports,13,6,4,3,3,9,"Breach,Killjoy,Omen,Neon,Gekko","Breach,Raze,Cypher,Sova,Omen"
Icebox,Paper Rex,DRX,13,5,10,2,3,3,"Killjoy,Viper,Sage,Jett,KAY/O","Killjoy,Viper,Jett,KAY/O,Clove"
Bind,KONOHA,Exceptional Gaming,5,13,1,5,8,4,"Raze,Cypher,Brimstone,Skye,Fade","Raze,Viper,Brimstone,Skye,Gekko"
Haven,Paper Rex,DRX,8,13,7,5,8,1,"Killjoy,Omen,Yoru,Fade,Iso","Cypher,Sova,Omen,Jett,Clove"
Lotus,KONOHA,Exceptional Gaming,4,13,2,10,3,2,"Breach,Raze,Killjoy,Omen,Gekko","Breach,Sova,Killjoy,Omen,Neon"
Split,Paper Rex,DRX,13,4,9,3,1,4,"Raze,Viper,Omen,Jett,Skye","Raze,Cypher,Omen,Skye,Clove"
Sunset,Evergarden GC,VIXENS,13,8,5,7,1,8,"Cypher,Sova,Phoenix,Omen,Neon","Breach,Raze,Cypher,Omen,Gekko"
Icebox,Talon Esports,Rex Regum Qeon,13,10,10,2,8,3,"Sova,Killjoy,Harbor,Iso,Clove","Sova,Killjoy,Viper,KAY/O,Gekko"
Haven,Evergarden GC,VIXENS,7,13,2,6,7,5,"Sova,Killjoy,Omen,Yoru,Neon","Breach,Cypher,Jett,Astra,Gekko"
Sunset,Blossom,polar bear,13,6,6,1,5,7,"Breach,Cypher,Sova,Omen,Neon","Raze,Cypher,Sova,Omen,Gekko"
Bind,swaglord9000,Scissor Sisters,13,9,4,6,3,9,"Raze,Cypher,Viper,Brimstone,Skye","Raze,Cypher,Skye,Astra,Clove"
Ascent,Talon Esports,Rex Regum Qeon,10,13,5,6,7,5,"Sova,Killjoy,Omen,Jett,KAY/O","Sova,Killjoy,Omen,Jett,KAY/O"
Bind,Evergarden GC,VIXENS,13,9,6,4,5,7,"Raze,Cypher,Brimstone,Skye,Clove","Raze,Viper,Brimstone,Fade,Gekko"
Ascent,swaglord9000,Scissor Sisters,13,3,9,3,0,4,"Cypher,Sova,Omen,Yoru,Deadlock","Cypher,Sova,Omen,Jett,KAY/O"
Bind,Blossom,polar bear,13,5,9,3,2,4,"Raze,Cypher,Skye,Harbor,Clove","Raze,Viper,Brimstone,Skye,Neon"
Lotus,Talon Esports,Rex Regum Qeon,15,13,8,6,7,7,"Breach,Cypher,Sova,Astra,Neon","Breach,Omen,Chamber,Neon,Gekko"
Ascent,swaglord9000,Evergarden GC,13,6,7,5,1,6,"Cypher,Sova,Omen,Yoru,Deadlock","Sova,Killjoy,Phoenix,Omen,Jett"
Icebox,swaglord9000,Evergarden GC,13,7,7,5,2,6,"Sova,Killjoy,Viper,Jett,KAY/O","Raze,Killjoy,Viper,Yoru,Fade"
Icebox,Scissor Sisters,Clueless GC,13,7,9,3,4,4,"Sova,Killjoy,Viper,Reyna,Iso","Sova,Killjoy,Viper,Sage,Jett"
Sunset,ViBe,polar bear,5,13,0,6,7,5,"Breach,Cypher,Jett,Iso,Clove","Cypher,Sova,Omen,Neon,Gekko"
Bind,Blossom,VIXENS,6,13,5,7,6,1,"Raze,Cypher,Skye,Harbor,Clove","Raze,Viper,Brimstone,Fade,Gekko"
Ascent,ViBe,polar bear,7,13,6,6,7,1,"Sova,Killjoy,Jett,Skye,Clove","Sova,Killjoy,Omen,Jett,KAY/O"
Sunset,swaglord9000,Evergarden GC,9,13,5,5,8,4,"Breach,Raze,Cypher,Omen,Gekko","Cypher,Sova,Phoenix,Omen,Neon"
Lotus,Scissor Sisters,Clueless GC,13,8,4,5,3,9,"Raze,Killjoy,Reyna,Omen,Skye","Raze,Killjoy,Viper,Astra,Gekko"
Lotus,Blossom,VIXENS,9,13,7,5,8,2,"Breach,Raze,Killjoy,Omen,Fade","Breach,Raze,Cypher,Astra,Fade"
Split,Reven eClub,E-Xolos LAZER,3,13,1,11,2,2,"Breach,Raze,Cypher,Omen,Gekko","Raze,Cypher,Jett,Skye,Astra"
Lotus,Reven eClub,E-Xolos LAZER,10,13,8,4,9,2,"Breach,Raze,Cypher,Omen,Gekko","Breach,Cypher,Omen,Neon,Gekko"
Haven,YFP Gaming,Dough Bros,13,4,10,2,2,3,"Breach,Cypher,Sova,Omen,Jett","Breach,Sova,Omen,Neon,Deadlock"
Bind,RETA Esports,Illicit Gaming,13,7,5,3,4,8,"Raze,Viper,Brimstone,Skye,Gekko","Raze,Viper,Brimstone,Skye,Fade"
Lotus,M for Mini,Paranoia Esports,3,13,3,9,4,0,"Raze,Killjoy,Viper,Omen,Fade","Raze,Killjoy,Viper,Omen,Fade"
Ascent,YFP Gaming,Dough Bros,13,2,10,2,0,3,"Cypher,Sova,Omen,Jett,Deadlock","Sova,Sage,Omen,Deadlock,Iso"
Bind,Hero Base,XLD Gaming,13,9,6,4,5,7,"Raze,Viper,Brimstone,Skye,Gekko","Raze,Viper,Brimstone,Skye,Deadlock"
Lotus,RETA Esports,Illicit Gaming,13,10,7,4,6,6,"Raze,Killjoy,Viper,Omen,Fade","Breach,Raze,Killjoy,Omen,Gekko"
Bind,Omnipotence,M for Mini,10,13,5,6,7,5,"Raze,Cypher,Brimstone,Skye,Gekko","Raze,Cypher,Viper,Brimstone,Fade"
Ascent,Paranoia Esports,koupert and friends,13,10,4,8,2,9,"Sova,Killjoy,Omen,Jett,KAY/O","Cypher,Sova,Omen,Jett,KAY/O"
Icebox,Blinn Esports,DarkZero Esports,3,13,0,4,9,3,"Sova,Killjoy,Viper,Jett,Harbor","Killjoy,Viper,Jett,KAY/O,Gekko"
Ascent,Hero Base,XLD Gaming,13,5,5,1,4,8,"Breach,Viper,Omen,Jett,KAY/O","Sova,Killjoy,Omen,Jett,KAY/O"
Icebox,VEX ESPORTS,6TM ESPORTS,6,13,2,5,8,4,"Sova,Killjoy,Viper,KAY/O,Deadlock","Sova,Killjoy,Viper,Jett,Harbor"
Sunset,RETA Esports,Illicit Gaming,2,13,2,10,3,0,"Raze,Cypher,Sova,Omen,KAY/O","Breach,Raze,Cypher,Omen,Fade"
Bind,LA RUE,Reveal Multigaming,13,15,6,8,7,7,"Raze,Viper,Yoru,Gekko,Clove","Raze,Cypher,Brimstone,Skye,Gekko"
Lotus,Cataclysm Gaming,M for Mini,11,13,5,7,6,6,"Breach,Raze,Killjoy,Omen,Gekko","Raze,Killjoy,Viper,Omen,Fade"
Icebox,HONEYBADGER123,Lootcifer,7,13,2,10,3,5,"Killjoy,Viper,Jett,KAY/O,Gekko","Sova,Killjoy,Jett,Harbor,Clove"
Lotus,Digital Athletics,XXLv2,5,13,3,3,10,2,"Breach,Cypher,Omen,Neon,Fade","Breach,Killjoy,Omen,Neon,Fade"
Lotus,Outlast Gaming,Paranoia Esports,12,14,7,6,8,5,"Killjoy,Viper,Omen,Skye,Neon","Raze,Killjoy,Viper,Omen,Fade"
Haven,Blinn Esports,DarkZero Esports,13,11,7,5,6,6,"Breach,Omen,Chamber,Neon,Fade","Breach,Cypher,Sova,Omen,Jett"
Icebox,Cobweb eSports,Sky Esports,13,6,5,2,4,8,"Sova,Killjoy,Viper,Jett,Gekko","Sova,Killjoy,Viper,Sage,Jett"
Lotus,Dortmund Esports,MAJOR MONOGWAM,13,7,8,4,3,5,"Omen,Yoru,Neon,Gekko,Deadlock","Breach,Raze,Cypher,Omen,Iso"
Icebox,Flawless Esports Blue,koupert and friends,11,13,7,5,8,4,"Sova,Killjoy,Viper,Reyna,Jett","Sova,Viper,Jett,Harbor,Gekko"
Bind,BALD BUFF,Novita Esports,2,13,0,3,10,2,"Raze,Viper,Brimstone,Skye,Gekko","Raze,Viper,Fade,Gekko,Clove"
Lotus,Sissi State Punks,RIZON,13,10,9,2,8,4,"Breach,Cypher,Sova,Omen,Neon","Killjoy,Viper,Omen,Neon,Gekko"
Icebox,TBK Esports,The7,10,13,4,8,5,6,"Sova,Killjoy,Viper,Sage,Jett","Killjoy,Viper,Jett,KAY/O,Gekko"
Icebox,LA RUE,Reveal Multigaming,13,15,9,5,10,4,"Killjoy,Viper,Reyna,Gekko,Iso","Sova,Killjoy,Viper,Jett,Clove"
Lotus,VEX ESPORTS,6TM ESPORTS,17,15,10,6,9,7,"Raze,Reyna,Omen,Gekko,Deadlock","Breach,Raze,Cypher,Sova,Omen"
Ascent,Sissi State Punks Academy,IMPERIUM,1,13,1,11,2,0,"Sova,Killjoy,Omen,Jett,KAY/O","Sova,Killjoy,Omen,Jett,KAY/O"
Breeze,HONEYBADGER123,Lootcifer,6,13,5,7,6,1,"Cypher,Sova,Viper,Jett,Yoru","Cypher,Sova,Jett,Yoru,Harbor"
Breeze,Cobweb eSports,Sky Esports,13,3,9,3,0,4,"Cypher,Sova,Viper,Jett,KAY/O","Cypher,Sova,Viper,Jett,KAY/O"
Ascent,INF Esports,GJ Omen,13,8,5,7,1,8,"Cypher,Sova,Omen,Jett,KAY/O","Cypher,Sova,Omen,Jett,KAY/O"
Haven,ST x WTP,M for Mini,18,16,6,11,5,12,"Breach,Cypher,Sova,Omen,Jett","Breach,Cypher,Omen,Jett,KAY/O"
Ascent,BALD BUFF,Novita Esports,4,13,1,4,9,3,"Sova,Killjoy,Omen,Jett,KAY/O","Sova,Killjoy,Jett,KAY/O,Clove"
Ascent,Digital Athletics,XXLv2,10,13,8,4,9,2,"Sova,Killjoy,Omen,Jett,KAY/O","Sova,Killjoy,Omen,Jett,KAY/O"
Lotus,Akatsuki Aimers,Paranoia Esports,9,13,2,8,5,7,"Breach,Killjoy,Omen,Neon,Gekko","Raze,Killjoy,Viper,Omen,Fade"
Sunset,Glory,Cataclysm Gaming,2,13,0,3,10,2,"Raze,Cypher,Sova,Omen,Gekko","Breach,Cypher,Omen,Yoru,Neon"
Haven,Kaizen Esports Red,Omnipotence,11,13,6,6,7,5,"Breach,Sova,Killjoy,Omen,Jett","Breach,Sova,Killjoy,Omen,Neon"
Ascent,Outlast Gaming,Flawless Esports,13,8,5,7,1,8,"Sova,Killjoy,Omen,Jett,KAY/O","Sova,Killjoy,Omen,Jett,KAY/O"
Ascent,LA RUE,Reveal Multigaming,13,4,10,2,2,3,"Sova,Killjoy,Omen,Jett,KAY/O","Cypher,Sova,Killjoy,Omen,Jett"
Split,Sissi State Punks,RIZON,13,7,7,5,2,6,"Breach,Raze,Cypher,Omen,Skye","Raze,Cypher,Omen,Jett,Skye"
Ascent,Guardian Esports,silly squirters,13,9,6,4,5,7,"Sova,Killjoy,Omen,Jett,Deadlock","Sova,Killjoy,Omen,Jett,KAY/O"
Bind,True Synergy Gaming,Flawless Esports Blue,9,13,3,9,4,6,"Raze,Cypher,Skye,Iso,Clove","Raze,Cypher,Brimstone,Reyna,Skye"
Sunset,Blinn Esports,DarkZero Esports,7,13,5,7,6,2,"Breach,Raze,Cypher,Omen,Gekko","Breach,Cypher,Omen,KAY/O,Neon"
Sunset,TBK Esports,The7,2,13,2,10,3,0,"Cypher,Sova,Omen,KAY/O,Neon","Raze,Cypher,Omen,KAY/O,Gekko"
Bind,Dortmund Esports,MAJOR MONOGWAM,13,15,6,8,7,7,"Cypher,Viper,Omen,Yoru,Gekko","Raze,Viper,Brimstone,Fade,Iso"
Haven,TwentyStars,HUNTERS,13,5,6,0,5,7,"Cypher,Sova,Jett,Iso,Clove","Sova,Killjoy,Omen,Jett,Iso"
Ascent,Wooper Warriors,koupert and friends,4,13,4,8,5,0,"Sova,Killjoy,Omen,Jett,KAY/O","Cypher,Sova,Omen,Jett,KAY/O"
Ascent,VEX ESPORTS,6TM ESPORTS,11,13,3,9,4,8,"Cypher,Sova,Omen,Jett,KAY/O","Cypher,Sova,Omen,Jett,KAY/O"
Lotus,HONEYBADGER123,Lootcifer,13,9,6,6,3,7,"Raze,Killjoy,Omen,KAY/O,Gekko","Breach,Cypher,Sova,Omen,Neon"
Split,Sissi State Punks Academy,IMPERIUM,11,13,7,5,8,4,"Breach,Raze,Cypher,Omen,Skye","Cypher,Omen,Jett,Skye,Deadlock"
Lotus,BALD BUFF,Novita Esports,13,4,9,3,1,4,"Raze,Killjoy,Viper,Omen,Fade","Breach,Killjoy,Omen,Neon,Iso"
Sunset,INF Esports,GJ Omen,13,10,4,8,2,9,"Breach,Raze,Cypher,Sova,Omen","Breach,Neon,Deadlock,Iso,Clove"
Haven,M for Mini,Tahnos,13,11,7,5,6,6,"Breach,Cypher,Omen,Jett,KAY/O","Sova,Killjoy,Omen,Neon,Iso"
Split,Digital Athletics,XXLv2,13,8,6,3,5,7,"Breach,Cypher,Omen,Jett,Skye","Breach,Raze,Cypher,Omen,Skye"
Haven,Bill n the Bears,silly squirters,7,13,4,4,9,3,"Cypher,Sova,Omen,Jett,Gekko","Breach,Cypher,Sova,Omen,Jett"
Ascent,Dortmund Esports,MAJOR MONOGWAM,13,6,8,4,2,5,"Cypher,Sova,Omen,Jett,Yoru","Cypher,Sova,Omen,Jett,Deadlock"
Split,Digity Esport,Dortmund eSports Dynasty,13,11,8,4,7,5,"Breach,Raze,Cypher,Sage,Omen","Breach,Raze,Cypher,Omen,Deadlock"
Ascent,Shine in Shade,Alley Cats,13,11,5,7,4,8,"Cypher,Sova,Omen,Jett,KAY/O","Sova,Killjoy,Omen,Jett,KAY/O"
Ascent,Goated,Paranoia Esports,8,13,1,8,5,7,"Cypher,Sova,Omen,Jett,Gekko","Sova,Killjoy,Omen,Jett,KAY/O"
Ascent,Team PlayHard Glasterz,Venenum GC,13,6,6,1,5,7,"Sova,Killjoy,Omen,Jett,KAY/O","Sova,Killjoy,Omen,Jett,KAY/O"
Ascent,GoatFellas Tragos,ECO Akuma,13,7,3,5,2,10,"Sova,Killjoy,Omen,Jett,KAY/O","Sova,Killjoy,Omen,Jett,KAY/O"
Bind,WasTaken,Flawless Esports,3,13,2,2,11,1,"Raze,Cypher,Viper,Brimstone,Gekko","Raze,Viper,Brimstone,Skye,Gekko"
Haven,GroundX,Flawless Esports Blue,9,13,5,7,6,4,"Cypher,Sova,Phoenix,Omen,Jett","Cypher,Sova,Reyna,Omen,Neon"
Bind,Omnipotence,Fairy Tail,13,4,11,1,3,2,"Raze,Cypher,Brimstone,Skye,Gekko","Raze,Cypher,Brimstone,Skye,Gekko"
Lotus,ALTERNATE aTTaX Ruby,Last9,13,9,7,5,4,6,"Breach,Raze,Cypher,Omen,Fade","Breach,Raze,Cypher,Omen,Fade"
Lotus,Cataclysm Gaming,NO NAME Esports,13,6,11,1,5,2,"Breach,Raze,Killjoy,Omen,Gekko","Omen,Jett,KAY/O,Fade,Deadlock"
Icebox,VZN E-SPORTS,koupert and friends,4,13,1,4,9,3,"Sova,Killjoy,Viper,Jett,Gekko","Sova,Viper,Jett,Iso,Clove"
Sunset,RIZON,LA RUE,12,14,5,8,6,7,"Cypher,Sova,Omen,Neon,Iso","Breach,Raze,Cypher,Omen,Gekko"
Ascent,TwentyStars,HUNTERS,15,15,5,10,5,10,"Sova,Reyna,Omen,Deadlock,Iso","Killjoy,Reyna,Omen,Jett,Iso"
Sunset,Melilla Titans Aura,Hidden Horizon GC,9,13,6,4,9,3,"Breach,Raze,Cypher,Omen,Fade","Breach,Cypher,Sova,Omen,Jett"
Lotus,Natus Vincere,FUT Esports,5,13,5,7,6,0,"Breach,Cypher,Sova,Omen,Jett","Breach,Cypher,Viper,Omen,Jett"
Bind,RIZON Sugar,Lotus Karma,13,3,2,2,1,11,"Raze,Cypher,Brimstone,Jett,Skye","Raze,Cypher,Astra,Gekko,Iso"
Lotus,VEX ESPORTS,BALD BUFF,13,8,6,3,5,7,"Raze,Reyna,Omen,Gekko,Deadlock","Raze,Killjoy,Viper,Omen,Fade"
Breeze,INF Esports,HONEYBADGER123,8,13,5,7,6,3,"Breach,Sova,Viper,Yoru,Iso","Cypher,Sova,Viper,Jett,Yoru"
Lotus,Team PlayHard Glasterz,Venenum GC,13,5,9,3,2,4,"Breach,Raze,Cypher,Omen,Fade","Breach,Raze,Killjoy,Omen,Gekko"
Ascent,RIZON,LA RUE,13,8,8,1,7,5,"Sova,Killjoy,Omen,Jett,KAY/O","Sova,Killjoy,Omen,Jett,KAY/O"
Breeze,F9 Wonders,PSQ GC,13,1,2,0,1,11,"Cypher,Sova,Viper,Jett,Yoru","Cypher,Sova,Viper,Jett,KAY/O"
Sunset,On Sight,Playbay X VISION SYNC,13,8,8,4,4,5,"Breach,Raze,Cypher,Omen,Gekko","Raze,Cypher,Omen,KAY/O,Gekko"
Ascent,SPICY,?,11,13,8,4,9,3,"Cypher,Sova,Phoenix,Omen,Yoru","Sova,Killjoy,Omen,Jett,KAY/O"
Ascent,aNc Outplayed GC,MadWolves Esports,11,13,7,5,8,4,"Sova,Killjoy,Phoenix,Omen,Jett","Sova,Killjoy,Omen,Jett,KAY/O"
Bind,Sissi State Punks,Lootcifer,13,4,3,2,2,10,"Raze,Cypher,Brimstone,Skye,Gekko","Viper,Omen,Yoru,KAY/O,Gekko"
Bind,Anonymo GC,SiXSENSE GC,13,7,6,6,1,7,"Breach,Raze,Cypher,Brimstone,Iso","Cypher,Viper,Jett,Skye,Clove"
Ascent,Digity Esport,Dortmund eSports Dynasty,13,11,6,6,5,7,"Breach,Raze,Sova,Killjoy,Omen","Sova,Killjoy,Omen,Jett,KAY/O"
Bind,GoatFellas Tragos,ECO Akuma,13,15,4,10,5,9,"Breach,Cypher,Omen,Jett,Gekko","Breach,Raze,Cypher,Brimstone,Skye"
Sunset,MAJOR MONOGWAM,6TM ESPORTS,11,13,9,3,10,2,"Breach,Raze,Cypher,Omen,Iso","Cypher,Omen,KAY/O,Neon,Gekko"
Sunset,Shine in Shade,Alley Cats,13,15,8,6,9,5,"Breach,Raze,Cypher,Omen,Fade","Breach,Raze,Cypher,Omen,Gekko"
Breeze,AKA HERO,Novita Esports,11,13,5,7,6,6,"Cypher,Sova,Viper,Jett,KAY/O","Cypher,Sova,Viper,Jett,Yoru"
Lotus,NYAN Esports,TOG Kitsune,12,14,6,7,7,6,"Breach,Cypher,Sova,Omen,Yoru","Breach,Raze,Killjoy,Omen,Gekko"
Breeze,TeamOrangeGaming,Dortmund Esports,15,13,7,7,6,8,"Cypher,Sova,Viper,Yoru,Neon","Cypher,Sova,Viper,Yoru,Neon"
Breeze,Sissi State Punks,Dortmund Esports,15,13,7,7,6,8,"Cypher,Sova,Viper,Yoru,Neon","Cypher,Sova,Viper,Yoru,Neon"
Sunset,HOF Kitsune,Saltire Sirens,6,13,2,5,8,4,"Breach,Raze,Cypher,Omen,Gekko","Breach,Raze,Cypher,Omen,Gekko"
Ascent,XXLv2,Achtung5,14,12,6,7,5,8,"Sova,Killjoy,Omen,Jett,KAY/O","Sova,Killjoy,Omen,Jett,KAY/O"
Icebox,Reveal Multigaming Jushimori,Team Galaga Kitsune,1,13,1,1,12,0,"Sova,Killjoy,Viper,Jett,Skye","Sova,Killjoy,Viper,Sage,Jett"
Breeze,ALTERNATE aTTaX Ruby,Last9,15,13,6,8,5,9,"Cypher,Sova,Viper,Omen,Yoru","Cypher,Sova,Viper,Jett,Yoru"
Bind,Reveal Multigaming,GJ Omen,13,11,8,4,7,5,"Raze,Viper,Brimstone,Skye,Gekko","Raze,Cypher,Viper,Brimstone,Skye"
Ascent,TREMBLE,Acient Freya,0,13,0,12,1,0,"Sova,Killjoy,Omen,Jett,KAY/O","Sova,Killjoy,Phoenix,Omen,Jett"
Lotus,GMBLERS Esports,90 Seconds,13,8,7,5,3,6,"Breach,Raze,Killjoy,Omen,Jett","Raze,Killjoy,Viper,Omen,Fade"
Lotus,Colorful Radiation,ForsaKen GC,12,14,4,9,5,8,"Breach,Killjoy,Omen,Neon,Gekko","Breach,Raze,Cypher,Sova,Omen"
Split,Fishing Rods,Unlucky boys,13,4,5,0,4,8,"Raze,Cypher,Sage,Omen,Skye","Cypher,Sage,Omen,Jett,Skye"
Sunset,Red Velvet,Soul Society,14,16,8,7,9,6,"Breach,Raze,Cypher,Omen,Gekko","Breach,Cypher,Omen,Neon,Gekko"
Sunset,DuelsMix,GnG White,1,13,1,11,2,0,"Breach,Cypher,Omen,Jett,Gekko","Breach,Raze,Cypher,Sova,Omen"
Icebox,Zenithia,Oserv Esport GC,6,13,3,4,9,3,"Sova,Killjoy,Viper,Reyna,Jett","Sova,Killjoy,Viper,Jett,Gekko"
Split,The giornalisti,DSYRE Academy,12,14,4,9,5,8,"Raze,Cypher,Reyna,Omen,Skye","Raze,Cypher,Sage,Omen,Jett"
Lotus,Powerpuff GC,Idynomashimi,3,13,3,9,4,0,"Breach,Killjoy,Omen,Neon,Gekko","Breach,Raze,Killjoy,Omen,Gekko"
Ascent,Exanimis,Silly Weapons All Game,13,9,8,2,7,5,"Sova,Killjoy,Omen,Jett,KAY/O","Sova,Killjoy,Jett,Astra,KAY/O"
Icebox,BLVKHVND,No Pecan!,13,3,11,1,2,2,"Sova,Killjoy,Viper,Jett,Harbor","Killjoy,Viper,Jett,KAY/O,Gekko"
Sunset,VEX ESPORTS,BALD BUFF,10,13,3,8,5,7,"Breach,Cypher,Omen,Neon,Gekko","Raze,Cypher,Sova,Omen,KAY/O"
Lotus,Imperial Eagles White,Ravens GC,6,13,1,6,7,5,"Killjoy,Viper,Omen,Neon,Fade","Breach,Raze,Killjoy,Viper,Omen"
Bind,Celestials GC,last second,12,14,8,5,9,4,"Cypher,Reyna,Gekko,Iso,Clove","Raze,Cypher,Brimstone,Skye,Gekko"
Ascent,RIZON Sugar,Lotus Karma,10,13,6,5,8,4,"Killjoy,Jett,KAY/O,Iso,Clove","Sova,Killjoy,Omen,Jett,KAY/O"
Ascent,Crvena zvezda esports,Frags Of Fire Collective,13,3,10,2,1,3,"Sova,Killjoy,Phoenix,Omen,Jett","Sova,Killjoy,Omen,Jett,KAY/O"
Sunset,IMPERIUM,KONOHA,10,13,3,8,5,7,"Breach,Raze,Cypher,Omen,Gekko","Cypher,Sova,Omen,KAY/O,Neon"
Sunset,Leftovers Crew,axolotls and chips,6,13,2,5,8,4,"Breach,Raze,Cypher,Omen,Fade","Breach,Cypher,Sova,Reyna,Harbor"
Lotus,Melilla Titans Aura,Hidden Horizon GC,14,12,8,5,7,6,"Breach,Raze,Killjoy,Omen,Gekko","Breach,Raze,Sova,Omen,Chamber"
Icebox,OMNIA GC,Scald eSport GC,11,13,9,3,10,2,"Sova,Killjoy,Viper,Jett,Gekko","Sova,Killjoy,Viper,Sage,Jett"
Ascent,Natus Vincere,FUT Esports,11,13,7,5,8,4,"Cypher,Sova,Omen,Jett,KAY/O","Sova,Killjoy,Omen,Jett,KAY/O"
Icebox,Formulation Gaming GC,Giga Liba,13,3,10,2,1,3,"Sova,Killjoy,Viper,Sage,Jett","Sova,Killjoy,Viper,Reyna,Chamber"
Ascent,EMUs,BRUXA,13,1,11,1,0,2,"Cypher,Sova,Omen,Yoru,Deadlock","Breach,Sova,Killjoy,Omen,Jett"
Ascent,F9 Wonders,PSQ GC,13,3,3,1,2,10,"Sova,Killjoy,Phoenix,Omen,Jett","Sova,Killjoy,Omen,Jett,KAY/O"
Lotus,Digital Athletics,GO NEXT,13,2,3,0,2,10,"Breach,Cypher,Omen,Neon,Fade","Breach,Omen,Jett,Chamber,Gekko"
Lotus,AKA HERO,Novita Esports,9,13,3,9,4,6,"Breach,Cypher,Sova,Omen,Neon","Breach,Killjoy,Omen,Neon,Iso"
Ascent,INF Esports,HONEYBADGER123,10,13,6,6,7,4,"Breach,Viper,Brimstone,Sage,Neon","Cypher,Sova,Omen,Jett,Deadlock"
Bind,aNc Outplayed GC,MadWolves Esports,8,13,7,5,8,1,"Raze,Cypher,Brimstone,KAY/O,Gekko","Breach,Raze,Viper,Omen,Gekko"
Bind,TeamOrangeGaming,Dortmund Esports,13,6,7,5,1,6,"Viper,Brimstone,Skye,Yoru,Neon","Viper,Omen,Yoru,Gekko,Deadlock"
Lotus,RIZON,LA RUE,12,14,8,5,9,4,"Killjoy,Viper,Omen,Neon,Gekko","Raze,Killjoy,Omen,Gekko,Deadlock"
Ascent,HOF Kitsune,Saltire Sirens,3,13,2,10,3,1,"Sova,Killjoy,Omen,Jett,KAY/O","Sova,Killjoy,Omen,Jett,KAY/O"
Lotus,IMPERIUM,KONOHA,1,13,0,2,11,1,"Breach,Raze,Killjoy,Omen,Fade","Breach,Raze,Killjoy,Omen,Gekko"
Ascent,MAJOR MONOGWAM,6TM ESPORTS,7,13,5,7,6,2,"Sova,Killjoy,Omen,Jett,KAY/O","Cypher,Sova,Omen,Jett,KAY/O"
Sunset,NYAN Esports,TOG Kitsune,6,13,1,6,7,5,"Breach,Raze,Cypher,Omen,Yoru","Breach,Raze,Cypher,Omen,Gekko"
Lotus,Red Velvet,Soul Society,0,13,0,12,1,0,"Breach,Raze,Killjoy,Omen,Gekko","Breach,Killjoy,Omen,Neon,Fade"
Split,Sissi State Punks,Lootcifer,13,7,8,4,3,5,"Breach,Raze,Cypher,Omen,Skye","Cypher,Omen,Skye,Fade,Iso"
Bind,On Sight,Playbay X VISION SYNC,13,7,5,3,4,8,"Raze,Viper,Brimstone,Skye,KAY/O","Breach,Raze,Cypher,Brimstone,Skye"
Ascent,Imperial Eagles White,Ravens GC,4,13,2,10,3,2,"Sova,Killjoy,Omen,Jett,KAY/O","Sova,Killjoy,Omen,Jett,KAY/O"
Sunset,GMBLERS Esports,90 Seconds,6,13,3,4,9,3,"Breach,Raze,Cypher,Omen,Gekko","Raze,Cypher,Omen,KAY/O,Gekko"
Bind,Reveal Multigaming Jushimori,Team Galaga Kitsune,6,13,4,8,5,2,"Raze,Cypher,Brimstone,Skye,Iso","Breach,Raze,Cypher,Brimstone,Yoru"
Bind,VEX ESPORTS,BALD BUFF,13,5,7,5,0,6,"Raze,Brimstone,Skye,Gekko,Deadlock","Raze,Viper,Brimstone,Skye,Gekko"
Icebox,Reveal Multigaming,GJ Omen,13,8,7,5,3,6,"Sova,Killjoy,Viper,Jett,Clove","Sova,Killjoy,Viper,Jett,KAY/O"
Lotus,Shine in Shade,Alley Cats,13,8,7,5,3,6,"Breach,Cypher,Omen,Neon,Fade","Breach,Killjoy,Omen,Jett,Gekko"
Icebox,XXLv2,Achtung5,5,13,4,8,5,1,"Sova,Killjoy,Viper,Omen,Jett","Sova,Killjoy,Viper,Reyna,Jett"
Sunset,Fishing Rods,Unlucky boys,13,8,8,1,7,5,"Breach,Raze,Cypher,Omen,Gekko","Breach,Raze,Cypher,Omen,Gekko"
Bind,BLVKHVND,No Pecan!,13,5,8,4,1,5,"Raze,Viper,Brimstone,Skye,Gekko","Raze,Cypher,Viper,Gekko,Clove"
Icebox,Exanimis,Silly Weapons All Game,13,6,9,3,3,4,"Sova,Killjoy,Gekko,Iso,Clove","Sova,Killjoy,Viper,Jett,Gekko"
Lotus,GoatFellas Tragos,ECO Akuma,14,12,3,10,2,11,"Breach,Raze,Killjoy,Viper,Omen","Breach,Killjoy,Omen,Neon,Gekko"
Lotus,DuelsMix,GnG White,6,13,2,5,8,4,"Breach,Raze,Killjoy,Gekko,Clove","Breach,Raze,Killjoy,Omen,Fade"
Lotus,RIZON Sugar,Lotus Karma,13,4,9,3,1,4,"Raze,Killjoy,Neon,Gekko,Clove","Breach,Killjoy,Omen,Neon,Fade"
Icebox,Anonymo GC,SiXSENSE GC,13,10,7,5,5,6,"Sova,Killjoy,Viper,Jett,Harbor","Sova,Killjoy,Viper,Jett,Clove"
Bind,Team PlayHard Glasterz,Venenum GC,13,15,6,8,7,7,"Raze,Cypher,Viper,Brimstone,Skye","Raze,Cypher,Brimstone,Gekko,Iso"
Ascent,Melilla Titans Aura,Hidden Horizon GC,2,13,0,3,10,2,"Sova,Killjoy,Omen,Jett,KAY/O","Cypher,Sova,Omen,Jett,KAY/O"
Sunset,Powerpuff GC,Idynomashimi,7,13,3,5,8,4,"Breach,Cypher,Omen,Neon,Fade","Breach,Raze,Cypher,Omen,Gekko"
Lotus,SPICY,?,8,13,6,6,7,2,"Killjoy,Viper,Omen,Neon,Gekko","Breach,Raze,Killjoy,Omen,Fade"
Lotus,TREMBLE,Acient Freya,5,13,0,6,7,5,"Breach,Raze,Killjoy,Viper,Omen","Breach,Raze,Killjoy,Omen,Gekko"
Split,Formulation Gaming GC,Giga Liba,13,2,2,1,1,11,"Raze,Cypher,Viper,Omen,Skye","Cypher,Sage,Jett,Gekko,Clove"
Lotus,EMUs,BRUXA,13,0,1,0,0,12,"Breach,Raze,Cypher,Gekko,Clove","Raze,Killjoy,Sage,Omen,Fade"
Haven,The giornalisti,DSYRE Academy,13,7,4,4,3,9,"Cypher,Sova,Reyna,Omen,Jett","Breach,Sova,Killjoy,Omen,Jett"
Sunset,Digity Esport,Dortmund eSports Dynasty,9,13,3,7,6,6,"Breach,Raze,Cypher,Omen,Gekko","Breach,Raze,Cypher,Omen,Gekko"
Lotus,Leftovers Crew,axolotls and chips,1,13,1,11,2,0,"Raze,Killjoy,Omen,Gekko,Clove","Raze,Cypher,Omen,Fade,Deadlock"
Sunset,Colorful Radiation,ForsaKen GC,8,13,6,6,7,2,"Breach,Cypher,Sova,Omen,Neon","Breach,Raze,Cypher,Omen,Gekko"
Lotus,Crvena zvezda esports,Frags Of Fire Collective,13,2,10,2,0,3,"Breach,Raze,Killjoy,Omen,Fade","Raze,Killjoy,Viper,Omen,Gekko"
Lotus,OMNIA GC,Scald eSport GC,1,13,0,2,11,1,"Breach,Raze,Killjoy,Omen,Fade","Breach,Raze,Sova,Killjoy,Omen"
Lotus,Celestials GC,last second,5,13,1,5,8,4,"Raze,Viper,KAY/O,Harbor,Gekko","Breach,Killjoy,Omen,Neon,Gekko"
Lotus,Zenithia,Oserv Esport GC,8,13,5,4,9,3,"Breach,Raze,Killjoy,Omen,Fade","Breach,Raze,Killjoy,Omen,Fade"
Lotus,Exceptional Gaming,BÖSE BUBEN,13,9,7,5,4,6,"Breach,Sova,Killjoy,Omen,Neon","Breach,Raze,Cypher,Sova,Omen"
Sunset,BBL Esports,Karmine Corp,5,13,3,3,10,2,"Breach,Raze,Cypher,Omen,Gekko","Breach,Raze,Cypher,Omen,Jett"
Bind,XXLv2,Achtung5,13,9,8,4,5,5,"Breach,Viper,Brimstone,Yoru,Fade","Breach,Viper,Brimstone,Jett,Skye"
Icebox,Digital Athletics,GO NEXT,13,8,6,6,2,7,"Killjoy,Viper,Jett,KAY/O,Gekko","Sova,Killjoy,Viper,Jett,Gekko"
Bind,Exceptional Gaming,BÖSE BUBEN,13,9,8,4,5,5,"Raze,Viper,Brimstone,Skye,Gekko","Raze,Viper,Brimstone,Skye,Iso"
Lotus,BBL Esports,Karmine Corp,6,13,0,7,6,6,"Breach,Raze,Cypher,Omen,Fade","Cypher,Sova,Omen,Yoru,Fade"
Split,FULL SENSE,Made in Thailand,13,11,5,7,4,8,"Raze,Cypher,Sage,Omen,Skye","Raze,Cypher,Viper,Skye,Astra"
Bind,Reveal Multigaming Saphire,BÖSE BUBEN,8,13,6,6,7,2,"Raze,Viper,Brimstone,Skye,Yoru","Raze,Viper,Brimstone,Skye,Yoru"
Icebox,Twisted Minds Orchid,PURE GC,13,4,10,2,2,3,"Sova,Killjoy,Viper,Jett,Iso","Sova,Killjoy,Viper,Jett,Gekko"
Ascent,Reveal Multigaming Saphire,BÖSE BUBEN,6,13,4,8,5,2,"Sova,Killjoy,Omen,Jett,KAY/O","Sova,Killjoy,Omen,Jett,KAY/O"
Ascent,Team Big BAAM,Rapid Lofi,5,13,4,8,5,1,"Sova,Killjoy,Omen,Jett,KAY/O","Sova,Killjoy,Omen,Jett,KAY/O"
Ascent,Twisted Minds Orchid,PURE GC,13,0,1,0,0,12,"Sova,Killjoy,Omen,Jett,KAY/O","Sova,Killjoy,Omen,Jett,KAY/O"
Icebox,FULL SENSE,Made in Thailand,13,9,6,4,5,7,"Sova,Killjoy,Viper,Jett,KAY/O","Sova,Killjoy,Viper,Sage,Jett"
Lotus,Disguised,Ninjas in Galaxy,13,8,7,5,3,6,"Raze,Killjoy,Omen,Neon,Fade","Raze,Killjoy,Viper,Omen,Fade"
Icebox,Team Big BAAM,Rapid Lofi,4,13,2,3,10,2,"Sova,Killjoy,Viper,KAY/O,Iso","Killjoy,Viper,KAY/O,Gekko,Iso"
Ascent,Disguised,Ninjas in Galaxy,13,2,3,0,2,10,"Cypher,Sova,Omen,Jett,Iso","Sova,Killjoy,Omen,Jett,KAY/O"
Split,Sharper Esports, Santa Gang,13,5,4,2,3,9,"Raze,Viper,Omen,Skye,Chamber","Breach,Raze,Cypher,Omen,Skye"
Icebox,VIXENS,ViBe,13,4,9,3,1,4,"Killjoy,Viper,Jett,KAY/O,Gekko","Sova,Viper,Sage,Reyna,Jett"
Lotus,NEXGA,Reve Drift Arena,13,4,3,2,2,10,"Breach,Sova,Killjoy,Omen,Jett","Raze,Cypher,Viper,Omen,Skye"
Sunset,Clueless GC,Evergarden GC,3,13,0,4,9,3,"Cypher,Sova,Omen,Jett,Gekko","Cypher,Sova,Phoenix,Omen,Neon"
Bind,polar bear,Scissor Sisters,5,13,1,5,8,4,"Raze,Viper,Brimstone,Skye,Gekko","Raze,Cypher,Skye,Astra,Clove"
Lotus,Sharper Esports, Santa Gang,13,7,7,1,6,6,"Breach,Raze,Cypher,Omen,Fade","Raze,Killjoy,Viper,Omen,Fade"
Sunset,SCARZ,FENNEL,14,12,3,10,2,11,"Breach,Raze,Cypher,Omen,Gekko","Raze,Cypher,Sova,Omen,KAY/O"
Split,LAZY,Cyberking Esports,8,13,3,6,7,5,"Raze,Cypher,Viper,Omen,Skye","Raze,Cypher,Omen,Jett,Skye"
Icebox,JustUs,Carti World,0,13,0,12,1,0,"Sova,Killjoy,Viper,Reyna,Jett","Sova,Killjoy,Viper,Jett,Gekko"
Lotus,VIXENS,ViBe,13,9,9,1,8,4,"Breach,Raze,Cypher,Astra,Fade","Breach,Reyna,Chamber,Gekko,Clove"
Icebox,NEXGA,Reve Drift Arena,13,8,10,2,6,3,"Sova,Killjoy,Viper,Sage,Iso","Sova,Killjoy,Viper,Jett,Gekko"
Icebox,Clueless GC,Evergarden GC,5,13,2,10,3,3,"Sova,Killjoy,Viper,Sage,Jett","Raze,Killjoy,Viper,Yoru,Fade"
Ascent,polar bear,Scissor Sisters,10,13,3,9,4,7,"Sova,Killjoy,Omen,Jett,KAY/O","Sova,Killjoy,Phoenix,Reyna,Omen"
Bind,Sharper Esports, Santa Gang,8,13,4,5,8,4,"Raze,Viper,Brimstone,Fade,Gekko","Raze,Viper,Brimstone,Skye,Gekko"
Ascent,Blossom,swaglord9000,5,13,3,3,10,2,"Sova,Killjoy,Jett,KAY/O,Clove","Cypher,Sova,Reyna,Iso,Clove"
Ascent,BOOM Esports,THE HERO DETA,13,8,8,4,4,5,"Sova,Killjoy,Omen,Jett,KAY/O","Sova,Killjoy,Omen,Jett,KAY/O"
Haven,LAZY,Cyberking Esports,13,2,3,0,2,10,"Breach,Cypher,Sova,Omen,Jett","Breach,Sova,Killjoy,Omen,Jett"
Bind,SCARZ,FENNEL,7,13,2,6,7,5,"Raze,Viper,Brimstone,Skye,Gekko","Raze,Viper,Brimstone,Fade,Gekko"
Ascent,JustUs,Carti World,9,13,5,7,6,4,"Sova,Killjoy,Jett,KAY/O,Clove","Sova,Killjoy,Omen,Jett,KAY/O"
Bind,VIXENS,ViBe,12,14,7,6,8,5,"Raze,Viper,Brimstone,Fade,Gekko","Viper,Sage,Reyna,Skye,Clove"
Lotus,Blossom,swaglord9000,4,13,3,9,4,1,"Breach,Raze,Killjoy,Omen,Fade","Raze,Killjoy,Viper,Omen,Fade"
Bind,Clueless GC,polar bear,13,8,7,5,3,6,"Breach,Cypher,Jett,Fade,Clove","Raze,Cypher,Brimstone,Skye,Iso"
Sunset,LAZY,Cyberking Esports,6,13,4,8,5,2,"Cypher,Sova,Omen,Jett,KAY/O","Breach,Raze,Cypher,Omen,Fade"
Split,BOOM Esports,THE HERO DETA,13,8,5,4,4,8,"Breach,Raze,Cypher,Omen,Skye","Raze,Viper,Omen,Jett,Skye"
Lotus,SCARZ,FENNEL,13,10,6,5,5,7,"Breach,Raze,Sova,Killjoy,Omen","Breach,Raze,Cypher,Sova,Omen"
Haven,Evergarden GC,Scissor Sisters,13,1,11,1,0,2,"Sova,Killjoy,Omen,Yoru,Neon","Cypher,Sova,Phoenix,Omen,Jett"
Split,Subversive,ZOL Esports,4,13,0,5,8,4,"Breach,Raze,Viper,Omen,Fade","Raze,Cypher,Reyna,Omen,Skye"
Sunset,Clueless GC,polar bear,12,14,7,6,8,5,"Cypher,Sova,Omen,Jett,Gekko","Cypher,Sova,Omen,Neon,Gekko"
Lotus,Doa Ibu Selamanya,Cynical,7,13,0,8,5,7,"Raze,Killjoy,Viper,Omen,Skye","Breach,Raze,Cypher,Omen,Fade"
Icebox,VIXENS,swaglord9000,6,13,3,9,4,3,"Killjoy,Viper,Jett,KAY/O,Gekko","Sova,Killjoy,Viper,Jett,KAY/O"
Lotus,ViBe,Blossom,14,16,7,8,8,7,"Killjoy,Jett,Skye,Gekko,Clove","Breach,Raze,Killjoy,Omen,Fade"
Ascent,Evergarden GC,Scissor Sisters,13,11,4,8,3,9,"Sova,Killjoy,Phoenix,Omen,Jett","Cypher,Sova,Omen,Jett,KAY/O"
Bind,Subversive,ZOL Esports,5,13,1,5,8,4,"Raze,Cypher,Brimstone,Fade,Gekko","Raze,Cypher,Brimstone,Skye,Gekko"
Sunset,Murash Gaming,REJECT,13,11,6,6,5,7,"Sova,Phoenix,Sage,Omen,Clove","Raze,Cypher,Omen,KAY/O,Gekko"
Icebox,Clueless GC,polar bear,13,9,9,3,6,4,"Sova,Killjoy,Viper,Sage,Jett","Sova,Killjoy,Viper,Gekko,Iso"
Icebox,Doa Ibu Selamanya,Cynical,13,10,8,3,7,5,"Sova,Killjoy,Viper,Jett,Gekko","Killjoy,Viper,Omen,Jett,KAY/O"
Sunset,VIXENS,swaglord9000,9,13,6,4,9,3,"Breach,Raze,Cypher,Omen,Gekko","Breach,Raze,Cypher,Omen,Gekko"
Lotus,Evergarden GC,Scissor Sisters,3,13,1,11,2,2,"Raze,Killjoy,Phoenix,Omen,Fade","Raze,Killjoy,Reyna,Omen,Skye"
Bind,ViBe,Blossom,7,13,3,5,8,4,"Killjoy,Reyna,Jett,Skye,Clove","Raze,Cypher,Skye,Harbor,Clove"
Breeze,Murash Gaming,REJECT,3,13,0,4,9,3,"Sova,Viper,Jett,Yoru,Astra","Sova,Viper,Jett,Yoru,Astra"
Sunset,Rank El Cuties,Oasis Gaming,5,13,1,11,2,4,"Breach,Raze,Cypher,Omen,Gekko","Raze,Cypher,Sova,Omen,KAY/O"
Split,Doa Ibu Selamanya,Cynical,8,13,2,7,6,6,"Raze,Cypher,Viper,Omen,Skye","Raze,Cypher,Viper,Omen,Skye"
Lotus,Murash Gaming,REJECT,13,8,4,5,3,9,"Breach,Raze,Killjoy,Brimstone,Gekko","Raze,Killjoy,Viper,Omen,Fade"
Split,Rank El Cuties,Oasis Gaming,12,14,10,3,11,2,"Raze,Cypher,Viper,Omen,Skye","Raze,Cypher,Sage,Omen,Skye"
Bind,E-Xolos LAZER,Illicit Gaming,14,12,3,10,2,11,"Raze,Brimstone,Skye,Harbor,Gekko","Raze,Viper,Brimstone,Skye,Gekko"
Sunset,E-Xolos LAZER,Illicit Gaming,13,11,8,4,7,5,"Breach,Raze,Cypher,Omen,Gekko","Breach,Raze,Cypher,Omen,Gekko"
Icebox,QoR,TSM,11,13,6,6,7,5,"Sova,Killjoy,Viper,Jett,Gekko","Killjoy,Viper,Reyna,Omen,Gekko"
Ascent,RETA Esports,Reven eClub,12,14,5,8,6,7,"Sova,Killjoy,Omen,Jett,KAY/O","Cypher,Sova,Omen,Jett,KAY/O"
Bind,QoR,TSM,7,13,3,9,4,4,"Raze,Viper,Brimstone,Fade,Gekko","Raze,Brimstone,Skye,Gekko,Deadlock"
Icebox,RED Canids,Galorys,13,11,5,7,4,8,"Sova,Killjoy,Viper,Sage,Jett","Sova,Killjoy,Viper,Sage,Jett"
Icebox,RETA Esports,Reven eClub,9,13,1,9,4,8,"Sova,Killjoy,Viper,Jett,Harbor","Killjoy,Viper,Jett,KAY/O,Gekko"
Ascent,QoR,TSM,13,10,8,4,6,5,"Cypher,Sova,Omen,Jett,KAY/O","Cypher,Sova,Omen,Jett,KAY/O"
Lotus,RETA Esports,Reven eClub,13,0,12,0,0,1,"Raze,Killjoy,Viper,Omen,Fade","Breach,Cypher,Omen,Neon,Gekko"
Bind,RED Canids,Galorys,13,7,8,4,3,5,"Raze,Cypher,Viper,Brimstone,Skye","Raze,Viper,Brimstone,Skye,KAY/O"
Sunset,Moist x Shopify,SaD Esports,11,13,3,9,4,8,"Raze,Cypher,Omen,KAY/O,Gekko","Breach,Raze,Cypher,Sova,Omen"
Sunset,Stellae Gaming,SAGAZ,13,10,8,3,7,5,"Breach,Raze,Cypher,Omen,Gekko","Breach,Raze,Cypher,Omen,Gekko"
Icebox,Achtung5,BLOK6,13,10,8,3,7,5,"Sova,Killjoy,Viper,Reyna,Jett","Sova,Killjoy,Viper,Jett,Iso"
Lotus,Legacy,2Game Esports,11,13,6,6,7,5,"Raze,Killjoy,Omen,Astra,Fade","Breach,Killjoy,Omen,Neon,Fade"
Icebox,Team Vitality,Team Liquid,17,15,12,4,11,5,"Sova,Killjoy,Viper,Jett,Gekko","Sova,Killjoy,Viper,Sage,Jett"
Haven,Moist x Shopify,SaD Esports,9,13,5,5,8,4,"Cypher,Sova,Omen,Jett,Fade","Sova,Jett,Astra,Deadlock,Iso"
Sunset,HUNTERS,Fishing Rods,1,13,1,11,2,0,"Raze,Cypher,Omen,KAY/O,Gekko","Breach,Raze,Cypher,Omen,Gekko"
Bind,Legacy,2Game Esports,0,13,0,1,12,0,"Raze,Viper,Brimstone,Skye,Gekko","Viper,Brimstone,Skye,Neon,Iso"
Bind,90 Seconds,RevenantVAL,3,13,2,10,3,1,"Breach,Raze,Cypher,Brimstone,Skye","Raze,Cypher,Brimstone,Reyna,Skye"
Lotus,Stellae Gaming,SAGAZ,13,5,8,4,1,5,"Raze,Killjoy,Viper,Omen,Fade","Breach,Sova,Killjoy,Omen,Neon"
Sunset,DSYRE Academy,GMBLERS Esports,12,14,4,9,5,8,"Breach,Raze,Cypher,Omen,Fade","Breach,Raze,Cypher,Omen,Gekko"
Icebox,Digital Athletics,NAPOLYON,13,10,6,6,4,7,"Killjoy,Viper,Jett,KAY/O,Gekko","Sova,Killjoy,Viper,Sage,Jett"
Haven,Unlucky boys,The giornalisti,1,13,0,12,1,1,"Breach,Sova,Killjoy,Omen,Jett","Cypher,Sova,Reyna,Omen,Jett"
Ascent,BLOK6,FlameTeam,14,12,8,5,7,6,"Sova,Killjoy,Omen,Jett,Iso","Sova,Killjoy,Reyna,Jett,Clove"
Haven,HUNTERS,Fishing Rods,1,13,0,12,1,1,"Cypher,Sova,Omen,Jett,Neon","Breach,Sova,Killjoy,Omen,Jett"
Icebox,FuseTea,XXLv2,8,13,6,3,10,2,"Sova,Killjoy,Viper,Jett,Iso","Sova,Killjoy,Viper,Omen,Jett"
Bind,Sakura Breeze GC,Playbay X VISION SYNC,7,13,5,7,6,2,"Raze,Viper,Brimstone,Skye,Gekko","Breach,Raze,Cypher,Brimstone,Skye"
Ascent,NO Enemies,TwentyStars,2,13,2,10,3,0,"Sova,Killjoy,Phoenix,Omen,Jett","Sova,Killjoy,Omen,Jett,KAY/O"
Sunset,Imperium Livia,Giga Liba,12,14,8,5,9,4,"Breach,Raze,Cypher,Omen,Deadlock","Breach,Cypher,Reyna,Omen,Fade"
Ascent,SiXSENSE GC,Itz 2 EZzy,13,4,5,0,4,8,"Breach,Sova,Killjoy,Omen,Jett","Sova,Killjoy,Phoenix,Omen,Jett"
Icebox,GO NEXT,Slice and Dice,14,12,7,6,6,7,"Sova,Killjoy,Viper,Jett,Gekko","Killjoy,Viper,Jett,Gekko,Clove"
Icebox,K1 Kaisen,Southpaw,8,13,5,7,6,3,"Sova,Killjoy,Viper,Jett,KAY/O","Sova,Viper,Reyna,Chamber,Harbor"
Ascent,DSYRE Academy,GMBLERS Esports,9,13,6,6,7,3,"Sova,Killjoy,Omen,Jett,KAY/O","Sova,Killjoy,Omen,Jett,KAY/O"
Ascent,Sacos,Alley Cats,7,13,6,6,7,1,"Sova,Killjoy,Jett,Iso,Clove","Sova,Killjoy,Omen,Jett,KAY/O"
Lotus,90 Seconds,RevenantVAL,11,13,3,9,4,8,"Raze,Killjoy,Viper,Omen,Fade","Breach,Raze,Killjoy,Omen,Fade"
Bind,PSQ GC,Team Devochki,15,13,7,7,6,8,"Cypher,Omen,Skye,Neon,Gekko","Raze,Cypher,Brimstone,Yoru,Gekko"
Lotus,Team Vitality,Team Liquid,13,10,8,4,6,5,"Cypher,Omen,Neon,Fade,Gekko","Raze,Cypher,Omen,Yoru,Fade"
Lotus,pedro pedro,Digital Athletics,11,13,8,4,9,3,"Breach,Raze,Cypher,Omen,Fade","Breach,Cypher,Omen,Neon,Fade"
Icebox,RedPack GC,PURE GC,5,13,3,9,4,2,"Sova,Killjoy,Viper,Jett,Gekko","Sova,Killjoy,Viper,Jett,Gekko"
Lotus,FuseTea,United in Grief,13,11,8,4,7,5,"Breach,Raze,Killjoy,Omen,Gekko","Breach,Killjoy,Omen,Jett,Gekko"
Ascent,TEAM NEXUS,XXLv2,11,13,7,5,8,4,"Sova,Killjoy,Omen,Jett,KAY/O","Sova,Killjoy,Omen,Jett,KAY/O"
Split,Sakura Breeze GC,Playbay X VISION SYNC,8,13,4,8,5,4,"Raze,Cypher,Viper,Omen,Skye","Breach,Raze,Cypher,Yoru,Clove"
Bind,Imperium Livia,Giga Liba,7,13,4,4,9,3,"Breach,Brimstone,Sage,Gekko,Iso","Cypher,Brimstone,Sage,Reyna,Fade"
Icebox,BRUXA,Valkyrra GC,13,8,6,3,5,7,"Sova,Killjoy,Viper,Jett,Iso","Sova,Killjoy,Viper,Jett,Iso"
Ascent,Frags Of Fire Collective,AnakinCrew Esport GC,13,9,5,5,4,8,"Sova,Killjoy,Omen,Jett,KAY/O","Sova,Killjoy,Omen,Jett,KAY/O"
Ascent,PSQ GC,Team Devochki,13,7,8,4,3,5,"Sova,Killjoy,Omen,Jett,KAY/O","Sova,Killjoy,Phoenix,Jett,Clove"
Icebox,MUBAREK,GO NEXT,9,13,3,9,4,6,"Sova,Killjoy,Viper,Jett,Iso","Sova,Killjoy,Viper,Jett,Gekko"
Icebox,Achtung5,TeamEagles,13,5,4,2,3,9,"Sova,Killjoy,Viper,Reyna,Jett","Breach,Sova,Killjoy,Viper,Jett"
Lotus,ForsaKen GC,Hyper Divas,13,5,4,2,3,9,"Breach,Raze,Cypher,Sova,Omen","Breach,Raze,Killjoy,Omen,Jett"
Sunset,SiXSENSE GC,Itz 2 EZzy,11,13,7,5,8,4,"Raze,Cypher,Sova,Omen,KAY/O","Raze,Cypher,Skye,Astra,Gekko"
Lotus,NAPOLYON,Last Hope,13,6,3,4,2,10,"Breach,Sova,Killjoy,Omen,Jett","Breach,Killjoy,Omen,Jett,Gekko"
Lotus,Slice and Dice,CINO,13,4,10,2,2,3,"Killjoy,Viper,Omen,Neon,Gekko","Breach,Cypher,Omen,Jett,Gekko"
Ascent,ONEXT,Scald eSport GC,9,13,6,6,7,3,"Sova,Killjoy,Omen,Jett,KAY/O","Sova,Omen,Jett,Yoru,Deadlock"
Lotus,Sacos,Alley Cats,13,11,7,5,6,6,"Killjoy,Omen,Neon,Gekko,Iso","Breach,Raze,Killjoy,Omen,Gekko"
Sunset,EKO Esports GC,Acient Freya,7,13,1,7,6,6,"Breach,Raze,Cypher,Omen,Gekko","Breach,Cypher,Omen,Gekko,Iso"
Bind,K1 Kaisen,Southpaw,13,10,7,4,6,6,"Breach,Cypher,Omen,Jett,Skye","Breach,Raze,Cypher,Brimstone,Fade"
Ascent,Soul Society,poroflu,13,5,8,4,1,5,"Sova,Killjoy,Omen,Jett,KAY/O","Viper,Reyna,Jett,Skye,Harbor"
Lotus,DESTINY,Team Galaga Kitsune,9,13,6,4,9,3,"Breach,Raze,Killjoy,Viper,Omen","Breach,Sova,Killjoy,Omen,Neon"
Lotus,last second,5STARS GC,13,7,4,4,3,9,"Breach,Killjoy,Omen,Neon,Gekko","Breach,Raze,Cypher,Omen,Gekko"
Ascent,Oserv Esport GC,Luminary GC,14,12,9,4,8,4,"Sova,Killjoy,Omen,Jett,KAY/O","Sova,Killjoy,Omen,Jett,KAY/O"
Bind,Silly Weapons All Game,Banana Bandits,13,3,4,0,3,9,"Breach,Raze,Viper,Brimstone,Gekko","Raze,Cypher,Viper,Brimstone,Skye"
Lotus,PCIFIC Waves,TOG Kitsune,4,13,2,10,3,2,"Breach,Raze,Killjoy,Omen,Fade","Breach,Raze,Killjoy,Omen,Gekko"
Lotus,Cannes Esports,Lotus Karma,9,13,3,9,4,6,"Breach,Raze,Killjoy,Omen,Fade","Breach,Killjoy,Omen,Neon,Fade"
Icebox,Last9,EXALTY Kali,13,4,3,2,2,10,"Sova,Killjoy,Viper,Jett,Gekko","Killjoy,Reyna,Jett,Harbor,Gekko"
Ascent,Sisire Femer,Hidden Horizon GC,0,13,0,1,12,0,"Raze,Killjoy,Viper,Omen,Fade","Cypher,Sova,Omen,Jett,KAY/O"
Icebox,ECO Akuma,Projet Améthyste,13,2,2,1,1,11,"Killjoy,Viper,Jett,Harbor,Gekko","Sova,Killjoy,Viper,Reyna,Jett"
Lotus,MadWolves Esports,Team Genetix Queens,13,3,11,1,2,2,"Breach,Raze,Killjoy,Omen,Fade","Breach,Raze,Killjoy,Viper,Omen"
Bind,No Pecan!,TLS Lirio,13,6,6,6,0,7,"Raze,Cypher,Viper,Gekko,Clove","Raze,Viper,Brimstone,Sage,Skye"
Lotus,NOIR Aster,?,6,13,4,8,5,2,"Breach,Raze,Killjoy,Omen,Fade","Breach,Raze,Killjoy,Omen,Fade"
Ascent,Symbol GC,Dortmund eSports Dynasty,2,13,0,3,10,2,"Sova,Killjoy,Omen,Jett,KAY/O","Sova,Killjoy,Omen,Jett,KAY/O"
Sunset,CriTicS Roses,Saltire Sirens,2,13,0,12,1,2,"Cypher,Sova,Reyna,Omen,Iso","Breach,Raze,Cypher,Omen,Gekko"
Sunset,ATARAXIA,axolotls and chips,5,13,1,5,8,4,"Breach,Raze,Cypher,Omen,Gekko","Breach,Cypher,Sova,Reyna,Harbor"
Breeze,GIANTX,Gentle Mates,13,11,5,7,4,8,"Cypher,Sova,Viper,Jett,Yoru","Cypher,Sova,Viper,Yoru,KAY/O"
Lotus,Valkyriant,Venenum GC,3,13,2,2,11,1,"Breach,Raze,Killjoy,Viper,Omen","Breach,Raze,Killjoy,Omen,Gekko"
Icebox,Team Meaow,Ravens GC,2,13,0,3,10,2,"Sova,Viper,Sage,Yoru,Neon","Sova,Killjoy,Viper,Jett,Iso"
Split,PCIFIC Waves,TOG Kitsune,3,13,3,9,4,0,"Breach,Raze,Cypher,Omen,Skye","Breach,Cypher,Omen,Jett,Yoru"
Bind,DESTINY,Team Galaga Kitsune,4,13,1,11,2,3,"Raze,Viper,Brimstone,Skye,Gekko","Breach,Raze,Cypher,Brimstone,Yoru"
Lotus,Soul Society,poroflu,13,10,7,4,6,6,"Breach,Killjoy,Omen,Neon,Fade","Reyna,Jett,Yoru,Iso,Clove"
Ascent,Silly Weapons All Game,Banana Bandits,13,3,9,3,0,4,"Sova,Killjoy,Jett,Astra,KAY/O","Cypher,Sova,Omen,Jett,Skye"
Lotus,Sakura Breeze GC,Playbay X VISION SYNC,13,8,7,5,3,6,"Breach,Raze,Killjoy,Omen,Gekko","Breach,Raze,Cypher,Gekko,Clove"
Icebox,Imperium Livia,Giga Liba,13,9,5,7,2,8,"Sova,Killjoy,Viper,Harbor,Gekko","Sova,Killjoy,Viper,Jett,Chamber"
Sunset,Oserv Esport GC,Luminary GC,13,3,9,3,0,4,"Breach,Raze,Cypher,Omen,Gekko","Breach,Raze,Cypher,Omen,Gekko"
Lotus,ECO Akuma,Projet Améthyste,13,2,11,1,1,2,"Breach,Raze,Killjoy,Omen,Gekko","Breach,Killjoy,Omen,Jett,Fade"
Icebox,SiXSENSE GC,Itz 2 EZzy,13,6,9,3,3,4,"Sova,Killjoy,Viper,Jett,Clove","Sova,Killjoy,Viper,Reyna,Iso"
Sunset,Sacos,Alley Cats,9,13,5,5,8,4,"Breach,Raze,Cypher,Gekko,Clove","Breach,Raze,Cypher,Omen,Gekko"
Lotus,EKO Esports GC,Acient Freya,3,13,1,3,10,2,"Breach,Raze,Killjoy,Omen,Fade","Breach,Raze,Killjoy,Omen,Gekko"
Icebox,Sisire Femer,Hidden Horizon GC,3,13,0,4,9,3,"Raze,Killjoy,Viper,Harbor,Gekko","Killjoy,Viper,Omen,Jett,Gekko"
Ascent,Cannes Esports,Lotus Karma,4,13,3,2,11,1,"Sova,Killjoy,Omen,Jett,KAY/O","Sova,Killjoy,Omen,Jett,KAY/O"
Ascent,RedPack GC,PURE GC,9,13,5,5,8,4,"Sova,Killjoy,Omen,Jett,KAY/O","Sova,Killjoy,Omen,Jett,KAY/O"
Lotus,PSQ GC,Team Devochki,8,13,3,6,7,5,"Breach,Killjoy,Omen,Jett,Gekko","Breach,Raze,Killjoy,Gekko,Clove"
Lotus,ONEXT,Scald eSport GC,4,13,0,5,8,4,"Breach,Raze,Cypher,Omen,Gekko","Breach,Raze,Sova,Killjoy,Omen"
Lotus,Frags Of Fire Collective,AnakinCrew Esport GC,13,9,8,2,7,5,"Raze,Killjoy,Viper,Omen,Gekko","Breach,Raze,Killjoy,Omen,Gekko"
Bind,last second,5STARS GC,13,4,9,3,1,4,"Raze,Cypher,Brimstone,Skye,Gekko","Cypher,Brimstone,Yoru,Gekko,Iso"
Ascent,ForsaKen GC,Hyper Divas,13,11,4,8,3,9,"Sova,Killjoy,Omen,Jett,KAY/O","Sova,Killjoy,Phoenix,Omen,Jett"
Lotus,Last9,EXALTY Kali,13,6,8,4,2,5,"Breach,Raze,Cypher,Omen,Fade","Breach,Raze,Cypher,Omen,Gekko"
Ascent,CriTicS Roses,Saltire Sirens,0,13,0,12,1,0,"Cypher,Sova,Reyna,Omen,Iso","Sova,Killjoy,Omen,Jett,KAY/O"
Sunset,Symbol GC,Dortmund eSports Dynasty,3,13,0,4,9,3,"Breach,Raze,Cypher,Sova,Omen","Breach,Raze,Cypher,Omen,Gekko"
Sunset,NOIR Aster,?,3,13,0,4,9,3,"Breach,Cypher,Omen,Neon,Gekko","Breach,Raze,Cypher,Omen,Fade"
Bind,MadWolves Esports,Team Genetix Queens,13,2,3,0,2,10,"Breach,Raze,Viper,Omen,Gekko","Raze,Cypher,Viper,Brimstone,Gekko"
Bind,Valkyriant,Venenum GC,1,13,1,11,2,0,"Raze,Cypher,Viper,Omen,Skye","Raze,Cypher,Brimstone,Gekko,Iso"
Lotus,BRUXA,Valkyrra GC,13,10,8,3,7,5,"Raze,Killjoy,Sage,Omen,Fade","Breach,Raze,Killjoy,Omen,Skye"
Sunset,K1 Kaisen,Southpaw,11,13,7,5,8,4,"Breach,Cypher,Sova,Omen,Jett","Raze,Cypher,Phoenix,Omen,Gekko"
Lotus,ATARAXIA,axolotls and chips,3,13,3,9,4,0,"Raze,Killjoy,Omen,Skye,Gekko","Raze,Cypher,Omen,Fade,Deadlock"
Sunset,No Pecan!,TLS Lirio,13,3,4,0,3,9,"Raze,Cypher,Neon,Fade,Clove","Breach,Cypher,Omen,Neon,Fade"
Sunset,Team Meaow,Ravens GC,0,13,0,1,12,0,"Breach,Cypher,Jett,Fade,Clove","Breach,Raze,Cypher,Omen,Gekko"
Sunset,GIANTX,Gentle Mates,13,11,6,6,5,7,"Breach,Raze,Cypher,Omen,Gekko","Cypher,Sova,Omen,KAY/O,Neon"
Split,GIANTX,Gentle Mates,1,13,0,2,11,1,"Breach,Raze,Killjoy,Omen,Jett","Breach,Raze,Cypher,Omen,Yoru"
Split,Team Kobolds,Hungkuang Falcon,13,8,6,6,2,7,"Raze,Cypher,Omen,Jett,Skye","Raze,Cypher,Omen,Jett,Skye"
Lotus,XERXIA Esports,Team NKT,13,11,7,5,6,6,"Breach,Raze,Cypher,Omen,Fade","Raze,Killjoy,Viper,Omen,Fade"
Icebox,Crocodile Tear,Rapid Lofi,9,13,8,4,9,1,"Killjoy,Viper,Jett,KAY/O,Gekko","Sova,Killjoy,Viper,Jett,Iso"
Bind,Elevate (SG),Kizuna Esports,13,5,9,3,2,4,"Raze,Cypher,Viper,Brimstone,KAY/O","Raze,Cypher,Brimstone,Skye,Iso"
Sunset,Team Kobolds,Hungkuang Falcon,10,13,6,5,8,4,"Raze,Cypher,Omen,KAY/O,Gekko","Breach,Raze,Omen,Gekko,Deadlock"
Ascent,XERXIA Esports,Team NKT,13,7,6,2,5,7,"Sova,Killjoy,Omen,Jett,KAY/O","Cypher,Sova,Omen,Jett,KAY/O"
Haven,Crocodile Tear,Rapid Lofi,13,4,9,3,1,4,"Breach,Sova,Killjoy,Astra,Neon","Breach,Cypher,Sova,Omen,Jett"
Lotus,Elevate (SG),Kizuna Esports,13,6,5,2,4,8,"Raze,Killjoy,Viper,Omen,Fade","Breach,Raze,Omen,Fade,Iso"
Icebox,XERXIA Esports,Team NKT,4,13,3,9,4,1,"Killjoy,Viper,Jett,KAY/O,Gekko","Sova,Killjoy,Viper,Jett,Gekko"
Lotus,Team Kobolds,Hungkuang Falcon,15,13,9,5,8,6,"Breach,Raze,Killjoy,Omen,Skye","Raze,Killjoy,Viper,Omen,Fade"
Lotus,LaZe,Ninjas in Galaxy,13,6,6,6,0,7,"Breach,Cypher,Sova,Omen,Neon","Raze,Killjoy,Viper,Omen,Fade"
Lotus,Crocodile Tear,Rapid Lofi,8,13,4,8,5,4,"Killjoy,Omen,Jett,Astra,Fade","Raze,Killjoy,Viper,Omen,Fade"
Split,XOXO-01,Barn nong chok,4,13,0,5,8,4,"Raze,Cypher,Viper,Omen,Skye","Raze,Cypher,Viper,Omen,Skye"
Bind,JustUs,NAOS Esports,4,13,4,8,5,0,"Cypher,Phoenix,Brimstone,Jett,Skye","Raze,Cypher,Viper,Brimstone,Skye"
Ascent, ROA,PAPA ESPORTS,7,13,2,6,7,5,"Viper,Phoenix,Omen,Jett,Gekko","Sova,Killjoy,Omen,Jett,KAY/O"
Sunset,Five Ace e-Sports,Oblivion Force,6,13,3,9,4,3,"Cypher,Sova,Omen,Neon,Iso","Raze,Cypher,Omen,KAY/O,Gekko"
Ascent,Da Feng Gou,ONE Team Esports,10,13,6,5,8,4,"Sova,Killjoy,Omen,Jett,KAY/O","Sova,Killjoy,Omen,Jett,KAY/O"
Icebox,LaZe,Ninjas in Galaxy,13,10,7,4,6,6,"Sova,Killjoy,Viper,Jett,Gekko","Sova,Killjoy,Viper,Jett,Harbor"
Split,JustUs,NAOS Esports,0,13,0,1,12,0,"Breach,Raze,Reyna,Omen,Skye","Raze,Cypher,Omen,Jett,Skye"
Icebox,Team Big BAAM,Unicorn Cyber Esports,13,7,8,4,3,5,"Sova,Killjoy,Viper,KAY/O,Iso","Sova,Killjoy,Viper,Jett,Gekko"
Lotus,Da Feng Gou,ONE Team Esports,2,13,0,3,10,2,"Cypher,Omen,Neon,Gekko,Iso","Raze,Killjoy,Viper,Omen,Fade"
Haven, ROA,PAPA ESPORTS,6,13,0,7,6,6,"Breach,Killjoy,Omen,Neon,Gekko","Sova,Reyna,Omen,Jett,Iso"
Split,Five Ace e-Sports,Oblivion Force,4,13,0,5,8,4,"Breach,Raze,Cypher,Omen,Skye","Raze,Cypher,Omen,Jett,Skye"
Bind,Nongshim RedForce,Team IAM,13,7,11,1,6,2,"Omen,Yoru,Fade,Gekko,Clove","Raze,Brimstone,Yoru,Harbor,Gekko"
Sunset,XOXO-01,Barn nong chok,11,13,6,6,7,5,"Raze,Cypher,Omen,KAY/O,Gekko","Breach,Raze,Cypher,Omen,Gekko"
Sunset,Sengoku Gaming,VARREL,13,9,8,4,5,5,"Breach,Raze,Cypher,Sova,Omen","Raze,Cypher,Sova,Phoenix,Omen"
Haven,Team Big BAAM,Unicorn Cyber Esports,13,8,6,3,5,7,"Breach,Sova,Killjoy,Omen,Jett","Cypher,Sova,Phoenix,Omen,Jett"
Split,Nongshim RedForce,Team IAM,13,11,5,7,4,8,"Raze,Omen,Jett,Skye,Astra","Raze,Cypher,Viper,Omen,Skye"
Icebox,Carti World,Tyrant Esports PH,13,7,7,1,6,6,"Sova,Killjoy,Viper,Jett,Gekko","Killjoy,Viper,Sage,Jett,Gekko"
Breeze,Sengoku Gaming,VARREL,2,13,2,10,3,0,"Cypher,Sova,Viper,Yoru,KAY/O","Cypher,Sova,Viper,Jett,Yoru"
Lotus,Doa Ibu Selamanya,Bigetron Arctic,2,13,0,3,10,2,"Raze,Killjoy,Viper,Omen,Skye","Raze,Killjoy,Omen,Skye,Fade"
Lotus,Nongshim RedForce,Team IAM,3,13,0,4,9,3,"Raze,Cypher,Omen,Astra,Fade","Raze,Killjoy,Viper,Omen,Fade"
Lotus,Carti World,Tyrant Esports PH,13,9,7,5,4,6,"Raze,Killjoy,Viper,Omen,Fade","Raze,Viper,Omen,Skye,Chamber"
Lotus,Sengoku Gaming,VARREL,13,6,6,1,5,7,"Raze,Killjoy,Viper,Omen,Fade","Raze,Killjoy,Viper,Omen,Fade"
Ascent,Doa Ibu Selamanya,Bigetron Arctic,8,13,4,5,8,4,"Sova,Killjoy,Omen,Jett,KAY/O","Sova,Killjoy,Omen,Jett,KAY/O"
Ascent,Carti World,Tyrant Esports PH,9,13,1,11,2,8,"Sova,Killjoy,Omen,Jett,KAY/O","Sova,Killjoy,Omen,Jett,KAY/O"
Lotus,SLT Seongam,Superfect Esports Academy,13,7,6,2,5,7,"Raze,Killjoy,Viper,Omen,Fade","Raze,Killjoy,Omen,Astra,Fade"
Sunset,NORTHEPTION,RIDDLE ORDER,6,13,0,7,6,6,"Breach,Raze,Cypher,Sage,Omen","Breach,Raze,Cypher,Omen,Gekko"
Ascent,BOOM Esports,Le Crapaud,13,11,8,4,7,5,"Sova,Killjoy,Omen,Jett,KAY/O","Sova,Killjoy,Omen,Jett,KAY/O"
Lotus,Rank El Cuties,Subversive,13,7,3,5,2,10,"Raze,Killjoy,Viper,Omen,Fade","Raze,Killjoy,Viper,Omen,Gekko"
Split,NORTHEPTION,RIDDLE ORDER,7,13,0,8,5,7,"Raze,Viper,Omen,Jett,Skye","Raze,Viper,Omen,Jett,Skye"
Bind,SLT Seongam,Superfect Esports Academy,13,9,8,2,7,5,"Raze,Viper,Brimstone,Skye,Gekko","Raze,Cypher,Viper,Brimstone,Skye"
Sunset,BOOM Esports,Le Crapaud,13,9,8,2,7,5,"Raze,Cypher,Omen,KAY/O,Gekko","Breach,Raze,Cypher,Omen,Gekko"
Ascent,Rank El Cuties,Subversive,13,4,3,2,2,10,"Sova,Killjoy,Omen,Jett,KAY/O","Sova,Killjoy,Omen,Jett,KAY/O"
Icebox,Cynical,THE HERO DETA,9,13,4,6,7,5,"Killjoy,Viper,Omen,Jett,KAY/O","Killjoy,Viper,Jett,KAY/O,Gekko"
Lotus,Cynical,THE HERO DETA,3,13,2,2,11,1,"Breach,Raze,Cypher,Omen,Fade","Raze,Killjoy,Viper,Omen,Fade"
Lotus,True Synergy Gaming,Jamookie Bears,13,2,3,0,2,10,"Raze,Killjoy,Gekko,Iso,Clove","Breach,Raze,Killjoy,Omen,Gekko"
Haven,Jamookie Bears,winners circle,13,8,9,3,5,4,"Breach,Sova,Killjoy,Omen,Jett","Cypher,Sova,Omen,Jett,Iso"
Lotus,BRAND RISK,True Synergy Gaming,5,13,2,4,9,3,"Cypher,Omen,Skye,Neon,Deadlock","Raze,Killjoy,Gekko,Iso,Clove"
Icebox,Akatsuki Aimers,Jamookie Bears,7,13,3,5,8,4,"Sova,Killjoy,Jett,Harbor,Iso","Sova,Killjoy,Viper,Jett,Clove"
Ascent,ST x WTP,True Synergy Gaming,10,13,6,6,7,4,"Sova,Killjoy,Omen,Jett,Iso","Sova,Killjoy,Omen,KAY/O,Iso"
Lotus,BRAND RISK,Cinz is back,13,5,9,3,2,4,"Cypher,Omen,Skye,Neon,Deadlock","Raze,Killjoy,Viper,Omen,Gekko"
Ascent,FLUFFY AIMERS,M80,6,13,0,7,6,6,"Sova,Killjoy,Omen,Jett,KAY/O","Cypher,Sova,Omen,Yoru,Deadlock"
Lotus,nf,True Synergy Gaming,3,13,2,10,3,1,"Breach,Killjoy,Omen,Neon,Fade","Reyna,Jett,Deadlock,Iso,Clove"
Ascent,Flare,BRAND RISK,3,13,1,11,2,2,"Cypher,Sova,Omen,Jett,Deadlock","Cypher,Sova,Omen,Jett,KAY/O"
Lotus,Tempers,Akatsuki Aimers,6,13,4,8,5,2,"Raze,Killjoy,Viper,Omen,Fade","Breach,Killjoy,Omen,Neon,Gekko"
Haven,ST x WTP,Goated,13,3,11,1,2,2,"Cypher,Sova,Omen,Jett,Iso","Cypher,Sova,Omen,Jett,Iso"
Haven,winners circle,Risk,16,14,8,7,7,8,"Cypher,Sova,Omen,Jett,Iso","Breach,Sova,Killjoy,Omen,Jett"
Lotus,Hasbulla,Mango Slices,9,13,5,5,8,4,"Raze,Killjoy,Omen,Skye,Gekko","Raze,Killjoy,Viper,Omen,Fade"
Lotus,FLUFFY AIMERS,M80,9,13,2,8,5,7,"Breach,Raze,Skye,Astra,Deadlock","Breach,Raze,Cypher,Omen,Fade"
Bind,True Synergy Gaming,ShaBoingBoing Esports,13,7,9,3,4,4,"Raze,Cypher,Skye,Iso,Clove","Breach,Brimstone,Yoru,Fade,Deadlock"
Lotus,4ceZ Lux,Cinz is back,3,13,2,10,3,1,"Raze,Killjoy,Viper,Omen,Fade","Raze,Killjoy,Viper,Omen,Gekko"
Ascent,Mango Slices,NO NAME Esports,13,2,10,2,0,3,"Sova,Killjoy,Omen,Jett,KAY/O","Cypher,Sova,Omen,Jett,KAY/O"
Lotus,Omnipotence,Akatsuki Aimers,4,13,1,11,2,3,"Raze,Killjoy,Omen,Fade,Gekko","Breach,Killjoy,Omen,Neon,Gekko"
Haven,Goated,Defiant Ducklings,13,9,6,4,5,7,"Cypher,Sova,Omen,Jett,Iso","Breach,Sova,Killjoy,Omen,Neon"
Haven,Death be Happen,Jamookie Bears,10,13,6,5,8,4,"Breach,Cypher,Sova,Omen,Neon","Breach,Sova,Killjoy,Omen,Jett"
Lotus,BRAND RISK,MimicGG,13,7,6,2,5,7,"Cypher,Omen,Skye,Neon,Deadlock","Jett,Gekko,Deadlock,Iso,Clove"
Haven,vamps,Risk,3,13,2,10,3,1,"Breach,Sova,Killjoy,Omen,Jett","Breach,Sova,Killjoy,Omen,Jett"
Split,9z Team,OXEN,13,6,9,3,3,4,"Breach,Raze,Viper,Omen,Skye","Raze,Cypher,Skye,Astra,Deadlock"
Sunset,FLUFFY AIMERS,M80,13,5,9,3,2,4,"Breach,Raze,Cypher,Omen,Skye","Breach,Raze,Cypher,Omen,Gekko"
Bind,9z Team,OXEN,13,4,9,3,1,4,"Raze,Sova,Viper,Brimstone,KAY/O","Raze,Viper,Omen,Skye,KAY/O"
Bind,Oxygen Esports,Winthrop University,13,9,9,3,6,4,"Raze,Viper,Brimstone,Skye,Gekko","Viper,Brimstone,Skye,Neon,Iso"
Bind,Team Heretics,Natus Vincere,13,5,9,3,2,4,"Raze,Viper,Brimstone,Fade,Gekko","Raze,Viper,Brimstone,Fade,Gekko"
Lotus,Fishing Rods,NO Enemies,13,4,8,4,0,5,"Raze,Killjoy,Viper,Omen,Skye","Raze,Killjoy,Omen,Fade,Iso"
Lotus,Oxygen Esports,Winthrop University,13,5,5,1,4,8,"Breach,Raze,Cypher,Gekko,Clove","Breach,Cypher,Omen,Neon,Iso"
Icebox,All Knights,Furious Gaming,13,11,7,5,6,6,"Sova,Killjoy,Viper,Jett,Harbor","Sova,Killjoy,Viper,Jett,Harbor"
Sunset,The giornalisti,HUNTERS,13,7,5,3,4,8,"Breach,Raze,Cypher,Sova,Clove","Cypher,Omen,Jett,KAY/O,Neon"
Bind,90 Seconds,DSYRE Academy,1,13,0,2,11,1,"Raze,Viper,Brimstone,Fade,Gekko","Raze,Brimstone,Skye,Yoru,Gekko"
Sunset,Team Heretics,Natus Vincere,13,3,2,2,1,11,"Cypher,Sova,Omen,KAY/O,Neon","Cypher,Sova,Omen,Jett,KAY/O"
Sunset,SK Nebula,RIZON Sugar,13,8,5,4,4,8,"Raze,Cypher,Viper,Omen,Fade","Raze,Cypher,Gekko,Iso,Clove"
Haven,Fishing Rods,NO Enemies,14,12,7,6,6,7,"Breach,Sova,Killjoy,Omen,Jett","Sova,Killjoy,Omen,Jett,Iso"
Sunset,90 Seconds,DSYRE Academy,4,13,2,10,3,2,"Raze,Cypher,Omen,KAY/O,Gekko","Breach,Raze,Cypher,Omen,Fade"
Haven,The giornalisti,HUNTERS,13,7,8,4,3,5,"Breach,Cypher,Sova,Omen,Jett","Sova,Killjoy,Omen,Neon,Iso"
Sunset,All Knights,Furious Gaming,13,3,4,0,3,9,"Breach,Raze,Cypher,Omen,Fade","Breach,Raze,Cypher,Omen,Gekko"
Lotus,BBL Esports,FNATIC,11,13,3,9,4,8,"Breach,Raze,Cypher,Omen,Fade","Raze,Killjoy,Viper,Omen,Fade"
Bind,TwentyStars,RevenantVAL,8,13,5,4,9,3,"Raze,Viper,Omen,Yoru,Fade","Raze,Cypher,Brimstone,Reyna,Skye"
Icebox,SK Nebula,RIZON Sugar,13,6,8,4,2,5,"Sova,Killjoy,Viper,Sage,Jett","Sova,Killjoy,Viper,Reyna,Jett"
Bind,Playbay X VISION SYNC,Permitta Unicorns GC,7,13,6,6,7,1,"Breach,Raze,Cypher,Brimstone,Skye","Raze,Viper,Brimstone,Jett,Skye"
Ascent,GMBLERS Esports,Unlucky boys,13,5,11,1,4,2,"Sova,Killjoy,Omen,Jett,KAY/O","Sova,Killjoy,Omen,Jett,KAY/O"
Lotus,Playbay X VISION SYNC,Permitta Unicorns GC,7,13,6,6,7,1,"Breach,Raze,Cypher,Gekko,Clove","Raze,Killjoy,Viper,Omen,Fade"
Bind,BBL Esports,FNATIC,13,11,5,7,4,8,"Raze,Viper,Brimstone,Fade,Gekko","Raze,Viper,Brimstone,Skye,Gekko"
Lotus,SK Nebula,RIZON Sugar,12,14,5,8,6,7,"Raze,Killjoy,Viper,Omen,Fade","Raze,Killjoy,Neon,Gekko,Clove"
Lotus,TwentyStars,RevenantVAL,15,13,4,10,3,11,"Sova,Killjoy,Viper,Omen,Jett","Breach,Raze,Killjoy,Omen,Fade"
Sunset,Please Don't Fire,Reve Drift Arena,11,13,6,6,7,5,"Raze,Cypher,Omen,Gekko,Iso","Breach,Raze,Cypher,Omen,Gekko"
Ascent,BBL Esports,FNATIC,9,13,6,6,7,3,"Cypher,Sova,Omen,Jett,KAY/O","Cypher,Sova,Omen,Jett,Deadlock"
Split,Made in Thailand,Sharper Esports,13,6,3,4,2,10,"Raze,Cypher,Viper,Skye,Astra","Raze,Viper,Omen,Skye,Chamber"
Haven,Please Don't Fire,Reve Drift Arena,13,11,8,4,7,5,"Breach,Killjoy,Omen,Neon,Iso","Sova,Skye,Astra,Chamber,Neon"
Lotus,Made in Thailand,Sharper Esports,6,13,1,6,7,5,"Raze,Killjoy,Viper,Omen,Gekko","Breach,Raze,Cypher,Omen,Fade"
Ascent,Five Ace e-Sports,ONE Team Esports,10,13,3,8,5,7,"Sova,Killjoy,Omen,Jett,KAY/O","Sova,Killjoy,Omen,Jett,KAY/O"
Haven,Made in Thailand,Sharper Esports,13,5,8,4,1,5,"Breach,Sova,Killjoy,Jett,Astra","Breach,Sova,Killjoy,Jett,Astra"
Lotus,Five Ace e-Sports,ONE Team Esports,4,13,0,5,8,4,"Killjoy,Omen,Neon,Gekko,Iso","Raze,Killjoy,Viper,Omen,Fade"
Icebox,Hungkuang Falcon,PAPA ESPORTS,5,13,2,4,9,3,"Killjoy,Viper,Omen,Jett,Gekko","Sova,Killjoy,Viper,Jett,Iso"
Icebox,FULL SENSE, Santa Gang,13,3,9,3,0,4,"Sova,Killjoy,Viper,Jett,KAY/O","Sova,Killjoy,Viper,Jett,Harbor"
Lotus,Please Don't Fire,Reve Drift Arena,8,13,4,8,5,4,"Breach,Raze,Cypher,Omen,Skye","Raze,Cypher,Viper,Omen,Skye"
Sunset,Five Ace e-Sports,ONE Team Esports,13,10,6,6,4,7,"Cypher,Sova,Omen,Neon,Iso","Breach,Raze,Cypher,Omen,Gekko"
Icebox,NEXGA,Disguised,4,13,2,3,10,2,"Killjoy,Viper,Jett,KAY/O,Gekko","Sova,Killjoy,Viper,Jett,Iso"
Ascent,FULL SENSE, Santa Gang,13,8,8,1,7,5,"Sova,Killjoy,Omen,Jett,KAY/O","Sova,Killjoy,Omen,Jett,KAY/O"
Icebox,Da Feng Gou, ROA,8,13,4,8,5,4,"Sova,Killjoy,Viper,Reyna,Jett","Killjoy,Viper,Jett,KAY/O,Iso"
Split,Team Kobolds,Oblivion Force,10,13,4,7,6,6,"Raze,Viper,Omen,Jett,Skye","Raze,Cypher,Omen,Jett,Skye"
Icebox,Avernus Esports,OLD STINKY CAT,5,13,3,3,10,2,"Sova,Killjoy,Jett,Harbor,Clove","Killjoy,Viper,Jett,Gekko,Clove"
Sunset,Hungkuang Falcon,PAPA ESPORTS,13,11,7,5,6,6,"Breach,Raze,Omen,Gekko,Deadlock","Raze,Cypher,Omen,Gekko,Iso"
Lotus,NEXGA,Disguised,10,13,6,6,7,4,"Breach,Sova,Killjoy,Omen,Jett","Viper,Omen,Chamber,Neon,Fade"
Sunset,Team Kobolds,Oblivion Force,3,13,1,11,2,2,"Cypher,Sova,Omen,Jett,KAY/O","Raze,Cypher,Omen,KAY/O,Gekko"
Sunset,FULL SENSE, Santa Gang,9,13,6,4,9,3,"Breach,Raze,Cypher,Omen,Gekko","Raze,Cypher,Sova,Omen,KAY/O"
Bind,Da Feng Gou, ROA,7,13,6,6,7,1,"Raze,Viper,Omen,Skye,Iso","Raze,Phoenix,Brimstone,Skye,Gekko"
Ascent,Hungkuang Falcon,PAPA ESPORTS,5,13,1,5,8,4,"Sova,Killjoy,Omen,Jett,KAY/O","Sova,Killjoy,Omen,Jett,KAY/O"
Split,Avernus Esports,OLD STINKY CAT,5,13,2,10,3,3,"Raze,Cypher,Viper,Omen,Skye","Raze,Cypher,Omen,Jett,Skye"
Haven,FearX,Sin Prisa Gaming,4,13,0,5,8,4,"Yoru,Astra,KAY/O,Neon,Gekko","Cypher,Sova,Omen,Yoru,Iso"
Bind,Oasis Gaming,ZOL Esports,14,12,10,3,9,4,"Raze,Cypher,Viper,Brimstone,Skye","Raze,Cypher,Brimstone,Skye,Gekko"
Bind,FearX,Sin Prisa Gaming,4,13,1,4,9,3,"Raze,Brimstone,Skye,Harbor,Gekko","Raze,Cypher,Brimstone,Skye,Deadlock"
Lotus,Cynical,Bigetron Arctic,11,13,6,6,7,5,"Breach,Raze,Cypher,Omen,Fade","Raze,Killjoy,Omen,Skye,Fade"
Breeze,Oasis Gaming,ZOL Esports,13,2,10,2,0,3,"Sova,Viper,Jett,Yoru,Astra","Cypher,Sova,Viper,Jett,KAY/O"
Ascent,Cynical,Bigetron Arctic,4,13,0,5,8,4,"Sova,Viper,Omen,Jett,Skye","Sova,Killjoy,Omen,Jett,KAY/O"
Ascent,VEC DAEJEON,Dplus Esports,2,13,2,10,3,0,"Breach,Sova,Killjoy,Omen,Jett","Sova,Killjoy,Omen,Jett,KAY/O"
Icebox,Carti World,NAOS Esports,8,13,3,6,7,5,"Sova,Killjoy,Viper,Jett,Gekko","Killjoy,Viper,Jett,KAY/O,Gekko"
Split,Alter Ego,ARF TEAM,9,13,7,5,8,2,"Raze,Cypher,Omen,Jett,Skye","Raze,Cypher,Sage,Omen,Skye"
Sunset,Carti World,NAOS Esports,9,13,3,9,4,6,"Breach,Raze,Cypher,Omen,Gekko","Raze,Cypher,Omen,KAY/O,Gekko"
Lotus,VEC DAEJEON,Dplus Esports,13,15,2,12,3,11,"Breach,Raze,Omen,Jett,Skye","Killjoy,Omen,Jett,KAY/O,Gekko"
Icebox,Alter Ego,ARF TEAM,2,13,1,11,2,1,"Raze,Sova,Killjoy,Viper,KAY/O","Killjoy,Viper,Jett,KAY/O,Gekko"
Split,THE HERO DETA,Le Crapaud,13,5,8,4,1,5,"Raze,Viper,Omen,Jett,Skye","Breach,Raze,Cypher,Omen,Jett"
Ascent,THE HERO DETA,Le Crapaud,13,8,6,3,5,7,"Sova,Killjoy,Omen,Jett,KAY/O","Breach,Sova,Killjoy,Omen,Jett"
Bind,All Knights,9z Team,14,12,7,6,6,7,"Raze,Viper,Brimstone,Fade,Gekko","Raze,Sova,Viper,Brimstone,KAY/O"
Sunset,All Knights,9z Team,8,13,4,8,5,4,"Breach,Raze,Cypher,Omen,Fade","Breach,Raze,Cypher,Omen,Gekko"
Sunset,All Knights,9z Team,8,13,4,8,5,4,"Breach,Raze,Cypher,Omen,Fade","Breach,Raze,Cypher,Omen,Gekko"
Ascent,OXEN,Furious Gaming,13,8,8,1,7,5,"Cypher,Sova,Omen,Jett,KAY/O","Sova,Killjoy,Omen,Jett,KAY/O"
Sunset,OXEN,Furious Gaming,13,10,6,5,5,7,"Viper,Sage,Omen,KAY/O,Gekko","Breach,Raze,Cypher,Omen,Gekko"
Sunset,FUT Esports,KOI,13,6,10,2,4,3,"Breach,Raze,Cypher,Omen,Gekko","Cypher,Omen,KAY/O,Neon,Gekko"
Lotus,AKA HERO,VEX ESPORTS,13,4,11,1,3,2,"Breach,Cypher,Sova,Omen,Neon","Raze,Cypher,Reyna,Omen,Gekko"
Breeze,OXEN,Furious Gaming,9,13,4,6,7,5,"Cypher,Sova,Viper,Yoru,Astra","Sova,Viper,Jett,Yoru,Astra"
Ascent,RIZON,Lootcifer,13,7,4,4,3,9,"Sova,Killjoy,Omen,Jett,KAY/O","Cypher,Sova,Omen,Jett,KAY/O"
Sunset,Dortmund Esports,6TM ESPORTS,13,3,4,0,3,9,"Breach,Cypher,Omen,Neon,Gekko","Cypher,Omen,KAY/O,Neon,Gekko"
Lotus,FUT Esports,KOI,7,13,4,4,9,3,"Breach,Cypher,Viper,Omen,Jett","Cypher,Omen,Yoru,Neon,Fade"
Bind,Reveal Multigaming,HONEYBADGER123,13,7,9,3,4,4,"Raze,Cypher,Brimstone,Skye,Gekko","Raze,Viper,Brimstone,Skye,Gekko"
Icebox,TeamOrangeGaming,Novita Esports,14,12,6,7,5,8,"Sova,Killjoy,Viper,Neon,Iso","Killjoy,Viper,Jett,Gekko,Clove"
Bind,RIZON,Lootcifer,13,5,3,3,2,10,"Raze,Viper,Brimstone,Skye,Gekko","Raze,Viper,Omen,KAY/O,Gekko"
Bind,AKA HERO,VEX ESPORTS,10,13,5,6,7,5,"Raze,Cypher,Viper,Brimstone,Skye","Breach,Raze,Brimstone,Gekko,Deadlock"
Sunset,Sissi State Punks,INF Esports,14,12,5,8,4,9,"Breach,Cypher,Sova,Omen,Jett","Breach,Raze,Cypher,Sova,Omen"
Ascent,Dortmund Esports,6TM ESPORTS,13,9,8,2,7,5,"Cypher,Sova,Omen,Jett,Yoru","Cypher,Sova,Omen,Jett,KAY/O"
Sunset,MAJOR MONOGWAM,BALD BUFF,13,9,7,3,6,6,"Breach,Raze,Cypher,Omen,Iso","Raze,Cypher,Sova,Omen,KAY/O"
Icebox,IMPERIUM,A One Man Army,4,13,1,4,9,3,"Sova,Killjoy,Viper,Gekko,Iso","Sova,Killjoy,Viper,Gekko,Iso"
Bind,LA RUE,GJ Omen,13,11,10,2,9,3,"Skye,Neon,Deadlock,Iso,Clove","Raze,Viper,Brimstone,Skye,Gekko"
Icebox,Reveal Multigaming,HONEYBADGER123,13,9,6,4,5,7,"Sova,Killjoy,Viper,Jett,Clove","Killjoy,Viper,Jett,KAY/O,Gekko"
Icebox,KONOHA,BÖSE BUBEN,11,13,4,8,5,7,"Sova,Killjoy,Viper,Jett,KAY/O","Sova,Killjoy,Viper,Jett,Clove"
Lotus,Exceptional Gaming,ARROW,13,4,8,4,0,5,"Breach,Cypher,Omen,Skye,Neon","Raze,Killjoy,Viper,Omen,Fade"
Split,FUT Esports,KOI,13,7,5,3,4,8,"Breach,Raze,Cypher,Omen,Gekko","Raze,Viper,Omen,Yoru,Fade"
Ascent,Sissi State Punks Academy,Reveal Multigaming Saphire,10,13,4,7,6,6,"Killjoy,Omen,Jett,KAY/O,Fade","Sova,Killjoy,Omen,Jett,KAY/O"
Lotus,RIZON,Lootcifer,8,13,6,6,7,2,"Killjoy,Viper,Omen,Neon,Gekko","Breach,Cypher,Omen,KAY/O,Neon"
Sunset,TeamOrangeGaming,Novita Esports,13,11,6,6,5,7,"Breach,Cypher,Sova,Omen,Neon","Breach,Cypher,Sova,Omen,Neon"
Ascent,AKA HERO,VEX ESPORTS,13,6,8,4,2,5,"Cypher,Sova,Omen,Jett,KAY/O","Cypher,Sova,Omen,Yoru,Deadlock"
Ascent,LA RUE,GJ Omen,13,5,9,3,2,4,"Sova,Killjoy,Omen,Jett,KAY/O","Sova,Killjoy,Omen,Jett,KAY/O"
Breeze,Reveal Multigaming,HONEYBADGER123,4,13,3,9,4,1,"Cypher,Sova,Viper,Neon,Iso","Cypher,Sova,Viper,Jett,Yoru"
Icebox,Sissi State Punks,INF Esports,13,8,5,4,4,8,"Sova,Killjoy,Viper,Reyna,Jett","Sova,Killjoy,Viper,KAY/O,Iso"
Icebox,Sissi State Punks Academy,Reveal Multigaming Saphire,1,13,0,2,11,1,"Sova,Killjoy,Viper,Reyna,Jett","Sova,Killjoy,Viper,Iso,Clove"
Ascent,IMPERIUM,A One Man Army,4,13,3,9,4,1,"Sova,Killjoy,Omen,Jett,KAY/O","Breach,Raze,Cypher,Omen,Fade"
Ascent,MAJOR MONOGWAM,BALD BUFF,13,6,5,2,4,8,"Sova,Killjoy,Omen,Jett,KAY/O","Sova,Killjoy,Omen,Jett,KAY/O"
Lotus,Dortmund Esports,6TM ESPORTS,8,13,2,7,6,6,"Omen,Yoru,Neon,Gekko,Deadlock","Breach,Raze,Cypher,Sova,Omen"
Bind,Exceptional Gaming,ARROW,13,2,10,2,0,3,"Raze,Viper,Brimstone,Skye,Gekko","Raze,Cypher,Viper,Skye,Clove"
Lotus,KONOHA,BÖSE BUBEN,5,13,4,2,11,1,"Breach,Raze,Killjoy,Omen,Neon","Breach,Raze,Cypher,Sova,Omen"
Sunset,Team Leveling,PS5Patas,14,12,5,8,4,9,"Breach,Cypher,Omen,Neon,Gekko","Breach,Raze,Cypher,Omen,Fade"
Icebox,REVOADA,FURIA GC,13,11,5,7,4,8,"Sova,Killjoy,Viper,Jett,KAY/O","Sova,Killjoy,Viper,Jett,Gekko"
Icebox,TBS GC,paprica picante,14,12,4,9,3,10,"Sova,Killjoy,Viper,Jett,Gekko","Sova,Killjoy,Viper,Jett,Gekko"
Ascent,Team Leveling,PS5Patas,10,13,6,5,8,4,"Sova,Killjoy,Omen,Jett,KAY/O","Sova,Killjoy,Omen,Jett,KAY/O"
Bind,LOUD GC,Fourth Wall,14,12,7,6,6,7,"Raze,Viper,Brimstone,Skye,Gekko","Raze,Cypher,Viper,Brimstone,Skye"
Lotus,FUZOS,GTZ Esports,8,13,5,4,9,3,"Raze,Killjoy,Viper,Omen,Fade","Breach,Raze,Cypher,Sova,Omen"
Bind,REVOADA,FURIA GC,13,10,5,7,3,8,"Raze,Viper,Brimstone,Skye,Gekko","Raze,Viper,Brimstone,Skye,Gekko"
Bind,Team Leveling,PS5Patas,13,10,8,4,6,5,"Breach,Viper,Brimstone,Neon,Gekko","Raze,Viper,Brimstone,Skye,Gekko"
Icebox,LOUD GC,Fourth Wall,13,6,10,2,4,3,"Killjoy,Viper,Jett,KAY/O,Gekko","Sova,Killjoy,Viper,Jett,Gekko"
Lotus,TBS GC,paprica picante,13,10,6,6,4,7,"Killjoy,Viper,Omen,Neon,Fade","Breach,Killjoy,Omen,Neon,Gekko"
Sunset,EMUs,Playbay X VISION SYNC,13,8,7,5,3,6,"Breach,Raze,Cypher,Omen,KAY/O","Cypher,Phoenix,Neon,Iso,Clove"
Icebox,Impulse GW,PPP,13,9,5,5,4,8,"Killjoy,Viper,Jett,KAY/O,Gekko","Sova,Killjoy,Viper,Sage,Jett"
Ascent,EMUs,Playbay X VISION SYNC,13,6,4,3,3,9,"Cypher,Sova,Omen,Yoru,Deadlock","Sova,Killjoy,Omen,Jett,KAY/O"
Bind,SAW,EX0TIK GAMING,13,2,10,2,0,3,"Raze,Viper,Brimstone,Skye,Gekko","Raze,Viper,Brimstone,Skye,Yoru"
Split,Barça eSports,UCAM Esports Club,5,13,4,8,5,1,"Raze,Viper,Sage,Skye,Astra","Breach,Raze,Cypher,Omen,Fade"
Bind,SK Nebula,TOG Kitsune,11,13,7,5,8,4,"Breach,Cypher,Yoru,Astra,Gekko","Breach,Raze,Cypher,Brimstone,Gekko"
Lotus,ALTERNATE aTTaX Ruby,FOKUS Sakura,13,7,10,2,5,3,"Breach,Raze,Cypher,Omen,Fade","Breach,Raze,Killjoy,Omen,Skye"
Bind,Permitta Unicorns GC,RIZON Sugar,13,10,4,8,2,9,"Raze,Cypher,Viper,Brimstone,Skye","Raze,Cypher,Brimstone,Gekko,Iso"
Bind,ALTERNATE aTTaX Ruby,FOKUS Sakura,9,13,2,8,5,7,"Raze,Omen,Yoru,Gekko,Clove","Raze,Viper,Omen,Skye,Chamber"
Ascent,FTW LEÇA FC,HOF Esports,13,9,6,6,3,7,"Cypher,Sova,Phoenix,Omen,Jett","Sova,Killjoy,Omen,Jett,KAY/O"
Sunset,SK Nebula,TOG Kitsune,7,13,1,7,6,6,"Raze,Cypher,Viper,Omen,Fade","Breach,Raze,Cypher,Omen,Gekko"
Icebox,Imperium Gaming,Falke Esports,11,13,6,6,7,5,"Killjoy,Viper,Jett,KAY/O,Gekko","Killjoy,Viper,Jett,KAY/O,Gekko"
Lotus,G2 Gozen,Team Falcons Vega,13,8,6,3,5,7,"Raze,Killjoy,Viper,Omen,Fade","Raze,Viper,Omen,Chamber,Gekko"
Breeze,ALTERNATE aTTaX Ruby,FOKUS Sakura,13,11,6,6,5,7,"Cypher,Sova,Viper,Omen,Yoru","Cypher,Sova,Viper,Jett,Yoru"
Sunset,Permitta Unicorns GC,RIZON Sugar,13,11,8,4,7,5,"Raze,Cypher,Omen,Gekko,Deadlock","Raze,Cypher,Gekko,Iso,Clove"
Lotus,SK Nebula,TOG Kitsune,13,9,7,3,6,6,"Raze,Killjoy,Viper,Omen,Fade","Breach,Raze,Killjoy,Omen,Gekko"
Split,KPI Gaming,Ramboot Club,13,0,12,0,0,1,"Breach,Raze,Cypher,Omen,Skye","Raze,Viper,Omen,Jett,Skye"
Icebox,Melilla Titans,Team Galaga,13,15,6,8,7,7,"Killjoy,Viper,Reyna,Harbor,Gekko","Sova,Killjoy,Viper,Sage,Jett"
Split,G2 Gozen,Team Falcons Vega,13,9,6,4,5,7,"Breach,Raze,Cypher,Omen,Fade","Breach,Raze,Cypher,Omen,Skye"
Ascent,Five Media Clan,ZETA Gaming,13,7,7,5,2,6,"Sova,Killjoy,Omen,Jett,KAY/O","Cypher,Sova,Phoenix,Omen,Jett"
Ascent,Melilla Titans,Team Galaga,3,13,2,10,3,1,"Sova,Killjoy,Omen,Jett,KAY/O","Sova,Killjoy,Omen,Jett,KAY/O"
Breeze,G2 Gozen,Team Falcons Vega,13,11,8,4,7,5,"Cypher,Sova,Viper,Jett,KAY/O","Sova,Viper,Reyna,Jett,Yoru"
Sunset,Melilla Titans,Team Galaga,6,13,2,5,8,4,"Breach,Raze,Cypher,Omen,Gekko","Breach,Raze,Cypher,Omen,Gekko"
Ascent,Team Secret,Global Esports,13,10,8,3,7,5,"Sova,Killjoy,Omen,Jett,KAY/O","Sova,Killjoy,Omen,Jett,KAY/O"
Sunset,Team Secret,Global Esports,13,8,2,7,1,11,"Breach,Raze,Cypher,Sova,Omen","Cypher,Sova,Omen,Jett,KAY/O"
Ascent,Rex Regum Qeon,DetonatioN FocusMe,13,9,6,6,3,7,"Sova,Killjoy,Omen,Jett,KAY/O","Sova,Killjoy,Omen,Jett,KAY/O"
Icebox,Rex Regum Qeon,DetonatioN FocusMe,15,13,9,5,8,6,"Sova,Killjoy,Viper,KAY/O,Gekko","Sova,Killjoy,Viper,Jett,Harbor"
Sunset,Blue Otter,Goon that jawn,11,13,7,5,8,4,"Breach,Cypher,Sova,Omen,Neon","Raze,Cypher,Sova,Omen,Iso"
Icebox,Akave Esports Black,FUSION X,13,4,8,4,0,5,"Sova,Killjoy,Viper,Sage,Gekko","Sova,Killjoy,Reyna,Jett,Harbor"
Breeze,Shopify Rebellion,FlyQuest RED,13,8,6,6,2,7,"Cypher,Sova,Viper,Jett,KAY/O","Cypher,Sova,Viper,Reyna,Jett"
Haven,Blue Otter,Goon that jawn,14,12,8,5,7,6,"Breach,Sova,Killjoy,Omen,Jett","Breach,Cypher,Sova,Omen,Yoru"
Sunset,Akave Esports Black,FUSION X,13,1,2,0,1,11,"Breach,Raze,Cypher,Omen,Gekko","Raze,Cypher,Omen,KAY/O,Gekko"
Sunset,Shopify Rebellion,FlyQuest RED,13,8,10,2,6,3,"Breach,Raze,Cypher,Omen,Gekko","Breach,Raze,Cypher,Sova,Omen"
Ascent,Blue Otter,Goon that jawn,9,13,2,8,5,7,"Sova,Killjoy,Omen,Jett,KAY/O","Sova,Killjoy,Omen,Yoru,Iso"
Lotus,Akave Esports Black,FUSION X,14,12,8,5,7,6,"Breach,Raze,Cypher,Omen,Gekko","Breach,Raze,Killjoy,Omen,Skye"
Haven,Nats kitten koup,Goon that jawn,5,13,2,4,9,3,"Breach,Sova,Killjoy,Omen,Jett","Breach,Cypher,Sova,Omen,Yoru"
Icebox,Shopify Rebellion,FlyQuest RED,9,13,6,4,9,3,"Sova,Killjoy,Viper,Jett,Harbor","Sova,Killjoy,Viper,Sage,Gekko"
Haven,Blue Otter,Special Grade,14,12,8,5,7,6,"Breach,Sova,Killjoy,Omen,Jett","Breach,Sova,Killjoy,Omen,Jett"
Split,Akave Esports Black,FUSION X,11,13,4,8,5,7,"Raze,Cypher,Omen,Jett,Skye","Raze,Sage,Astra,Gekko,Deadlock"
Ascent,Shopify Rebellion,FlyQuest RED,13,6,5,2,4,8,"Sova,Killjoy,Omen,Jett,KAY/O","Sova,Killjoy,Omen,Jett,KAY/O"
Sunset,Nats kitten koup,Goon that jawn,10,13,5,7,6,5,"Breach,Raze,Cypher,Sova,Omen","Raze,Cypher,Sova,Omen,Iso"
Ascent,Blue Otter,Special Grade,13,6,6,1,5,7,"Sova,Killjoy,Omen,Jett,KAY/O","Sova,Killjoy,Omen,Jett,KAY/O"
Bind,Nats kitten koup,Goon that jawn,13,6,8,4,2,5,"Raze,Viper,Brimstone,Skye,Gekko","Cypher,Viper,Skye,Yoru,Clove"
Lotus,Shopify Rebellion,FlyQuest RED,5,13,1,5,8,4,"Breach,Raze,Cypher,Omen,Fade","Raze,Killjoy,Viper,Omen,Skye"
Ascent,Skout Esports,New Origins Esports,13,7,3,5,2,10,"Breach,Sova,Killjoy,Phoenix,Omen","Sova,Killjoy,Omen,Jett,KAY/O"
Lotus,Zerance,Mandatory,13,4,4,1,3,9,"Raze,Killjoy,Viper,Omen,Skye","Raze,Killjoy,Viper,Omen,Fade"
Icebox,REVOADA,Karasuno Crows,13,3,9,3,0,4,"Sova,Killjoy,Viper,Jett,KAY/O","Sova,Killjoy,Viper,Sage,Jett"
Bind,Blue Otter,1337 (NA),13,6,10,2,4,3,"Raze,Viper,Brimstone,Skye,Yoru","Raze,Viper,Brimstone,Fade,Gekko"
Sunset,Skout Esports,New Origins Esports,13,3,10,2,1,3,"Breach,Raze,Cypher,Omen,Gekko","Breach,Raze,Cypher,Omen,Gekko"
Sunset,Zerance,Mandatory,7,13,4,4,9,3,"Breach,Raze,Cypher,Sova,Omen","Breach,Raze,Cypher,Omen,Gekko"
Bind,XPERION NXT,FOKUS,3,13,0,4,9,3,"Raze,Cypher,Brimstone,Skye,Gekko","Viper,Brimstone,Skye,Yoru,Gekko"
Bind,Team Leveling,Athena's e-Sports,13,11,2,10,1,11,"Breach,Viper,Brimstone,Neon,Gekko","Raze,Viper,Brimstone,Skye,Gekko"
Icebox,Nats kitten koup,Winthrop University,13,10,9,2,8,4,"Killjoy,Viper,Jett,KAY/O,Gekko","Sova,Killjoy,Viper,Iso,Clove"
Lotus,REVOADA,Karasuno Crows,13,9,7,5,4,6,"Raze,Killjoy,Viper,Omen,Fade","Raze,Killjoy,Viper,Omen,Fade"
Lotus,Blue Otter,1337 (NA),9,13,2,8,5,7,"Breach,Raze,Cypher,Omen,Gekko","Breach,Raze,Cypher,Omen,Gekko"
Split,Zerance,Mandatory,13,5,6,0,5,7,"Raze,Viper,Omen,Jett,Skye","Raze,Cypher,Viper,Omen,Skye"
Icebox,The Final Shape,Special Grade,10,13,4,7,6,6,"Sova,Viper,Reyna,Jett,Clove","Sova,Killjoy,Viper,Jett,Clove"
Haven,SaD Esports,Goon that jawn,14,16,8,7,9,6,"Breach,Sova,Killjoy,Omen,Jett","Breach,Cypher,Sova,Yoru,Clove"
Sunset,Nats kitten koup,Winthrop University,13,5,5,1,4,8,"Breach,Raze,Cypher,Sova,Omen","Breach,Cypher,Omen,Neon,Iso"
Icebox,NOVO Esports,LONETEAM,13,3,9,3,0,4,"Sova,Killjoy,Viper,Sage,Jett","Sova,Killjoy,Viper,Jett,Gekko"
Split,Ramboot Club,Barça eSports,7,13,4,4,9,3,"Raze,Viper,Omen,Jett,Skye","Raze,Viper,Sage,Skye,Astra"
Lotus,LOUD GC,2K Gaming Lunar,13,4,2,3,1,11,"Raze,Killjoy,Viper,Omen,Fade","Breach,Raze,Killjoy,Omen,Gekko"
Lotus,Team Leveling,Athena's e-Sports,13,10,4,8,2,9,"Breach,Cypher,Omen,Neon,Gekko","Breach,Raze,Killjoy,Viper,Omen"
Split,XPERION NXT,FOKUS,6,13,1,6,7,5,"Raze,Cypher,Viper,Omen,Skye","Raze,Omen,Yoru,Astra,Fade"
Haven,Blue Otter,1337 (NA),14,12,5,8,4,9,"Breach,Sova,Killjoy,Omen,Jett","Sova,Killjoy,Omen,Jett,Iso"
Ascent,SaD Esports,Goon that jawn,8,13,4,5,8,4,"Sova,Killjoy,Omen,Jett,KAY/O","Sova,Killjoy,Omen,Yoru,Iso"
Haven,The Final Shape,Special Grade,10,13,6,6,7,4,"Breach,Cypher,Sova,Omen,Jett","Breach,Sova,Killjoy,Omen,Jett"
Lotus,Nats kitten koup,Winthrop University,10,13,5,7,6,5,"Breach,Killjoy,Omen,Neon,Gekko","Breach,Cypher,Omen,Neon,Iso"
Bind,LOUD GC,2K Gaming Lunar,13,4,9,3,1,4,"Raze,Viper,Brimstone,Skye,Gekko","Raze,Viper,Brimstone,Skye,Gekko"
Icebox,Valiant,Akroma,13,9,9,3,6,4,"Killjoy,Viper,Jett,KAY/O,Gekko","Killjoy,Viper,Jett,KAY/O,Gekko"
Bind,RTZN,HGE Esports,7,13,4,8,5,3,"Raze,Viper,Brimstone,Fade,Gekko","Raze,Sova,Viper,Omen,Gekko"
Sunset,UCAM Esports Club,Five Media Clan,7,13,3,9,4,4,"Breach,Raze,Cypher,Sova,Omen","Cypher,Sova,Omen,Jett,KAY/O"
Lotus,TBS GC,Vila das Flores,13,8,5,7,1,8,"Killjoy,Viper,Omen,Neon,Fade","Raze,Omen,Chamber,Fade,Deadlock"
Bind,GIANTX GC,Team Falcons Vega,13,15,7,7,8,6,"Breach,Raze,Viper,Omen,Fade","Raze,Viper,Brimstone,Skye,Gekko"
Lotus,DIVIZON,MOUZ,9,13,5,7,6,4,"Breach,Raze,Sova,Killjoy,Omen","Breach,Cypher,Omen,Yoru,Fade"
Lotus,sem fazer careta,paprica picante,3,13,2,2,11,1,"Breach,Raze,Killjoy,Omen,Gekko","Breach,Killjoy,Omen,Neon,Gekko"
Icebox,FURIA GC,Aposentadas,13,6,7,5,1,6,"Sova,Killjoy,Viper,Jett,Gekko","Sova,Killjoy,Jett,Harbor,Gekko"
Bind,GTZ Esports,SAW,13,15,7,7,8,6,"Breach,Raze,Cypher,Viper,Brimstone","Raze,Viper,Brimstone,Skye,Gekko"
Ascent,PS5Patas,Variants GC,13,1,2,0,1,11,"Sova,Killjoy,Omen,Jett,KAY/O","Sova,Killjoy,Omen,Jett,KAY/O"
Lotus,Valiant,Akroma,13,8,8,4,4,5,"Raze,Killjoy,Omen,Fade,Deadlock","Cypher,Omen,Yoru,Fade,Deadlock"
Breeze,Falke Esports,KPI Gaming,4,13,2,3,10,2,"Cypher,Sova,Viper,Omen,Jett","Cypher,Sova,Viper,Yoru,Astra"
Ascent,Fourth Wall,bom dia sofia e amigas,13,8,6,3,5,7,"Sova,Killjoy,Omen,Jett,KAY/O","Sova,Killjoy,Omen,Jett,KAY/O"
Breeze,TBS GC,Vila das Flores,13,10,7,4,6,6,"Cypher,Sova,Viper,Jett,KAY/O","Sova,Viper,Jett,Yoru,Astra"
Bind,Outplayed,Axolotl,13,6,7,5,1,6,"Raze,Cypher,Viper,Brimstone,Skye","Breach,Raze,Omen,Skye,Deadlock"
Icebox,GIANTX GC,Team Falcons Vega,13,7,8,0,7,5,"Killjoy,Viper,Jett,KAY/O,Gekko","Reyna,Omen,Jett,Harbor,Gekko"
Bind,sem fazer careta,paprica picante,4,13,2,3,10,2,"Raze,Cypher,Brimstone,Skye,Gekko","Raze,Viper,Brimstone,Skye,Gekko"
Lotus,PS5Patas,Variants GC,13,6,6,1,5,7,"Raze,Killjoy,Viper,Omen,Fade","Breach,Raze,Killjoy,Omen,Gekko"
Split,FURIA GC,Aposentadas,13,9,6,4,5,7,"Breach,Raze,Cypher,Omen,Skye","Breach,Killjoy,Omen,Neon,Iso"
Sunset,F9 Wonders,Zerance Mint,7,13,2,10,3,5,"Breach,Raze,Cypher,Omen,Yoru","Breach,Raze,Cypher,Sova,Omen"
Bind,Fourth Wall,bom dia sofia e amigas,13,5,7,5,0,6,"Raze,Cypher,Brimstone,Skye,Neon","Cypher,Brimstone,Jett,Skye,Gekko"
Icebox,HOF Esports,FUZOS,11,13,2,10,3,9,"Killjoy,Viper,Jett,KAY/O,Gekko","Sova,Killjoy,Viper,Reyna,Jett"
Bind,DIVIZON,MOUZ,16,14,8,7,7,8,"Raze,Cypher,Viper,Omen,Skye","Breach,Raze,Viper,Brimstone,Gekko"
Sunset,GIANTX GC,Team Falcons Vega,5,13,5,7,6,0,"Breach,Raze,Cypher,Omen,Gekko","Breach,Raze,Cypher,Omen,Gekko"
Lotus,ZETA Gaming,Imperium Gaming,13,8,9,0,8,4,"Breach,Raze,Cypher,Omen,Fade","Raze,Killjoy,Viper,Omen,Fade"
Ascent,Valiant,Akroma,11,13,6,6,7,5,"Sova,Killjoy,Omen,Jett,KAY/O","Sova,Killjoy,Phoenix,Omen,Jett"
Bind,DSYRE,VX300 Gaming,13,3,9,3,0,4,"Raze,Viper,Brimstone,Skye,Gekko","Raze,Cypher,Viper,Brimstone,Skye"
Sunset,NOMAD GC,Zerance Mint,2,13,0,3,10,2,"Breach,Cypher,Sova,Omen,Jett","Breach,Raze,Cypher,Sova,Omen"
Icebox,PPP,FTW LEÇA FC,13,5,8,4,1,5,"Sova,Killjoy,Viper,Sage,Jett","Sova,Killjoy,Viper,Reyna,Jett"
Ascent,GIANTX GC,Team Falcons Vega,8,13,4,8,5,4,"Sova,Killjoy,Omen,Jett,KAY/O","Sova,Jett,Astra,KAY/O,Fade"
Ascent,charbon,F9 Wonders,13,11,4,8,3,9,"Sova,Killjoy,Omen,Jett,KAY/O","Sova,Killjoy,Phoenix,Omen,Jett"
Bind,Zerance Mint,ForsaKen GC,13,7,7,5,2,6,"Raze,Viper,Brimstone,Skye,Gekko","Breach,Raze,Cypher,Omen,Gekko"
Sunset,DIVIZON,MOUZ,17,19,6,12,7,11,"Breach,Raze,Cypher,Sova,Omen","Raze,Cypher,Viper,Omen,Gekko"
Lotus,EXALTY Kali,NOMAD GC,8,13,1,8,5,7,"Breach,Raze,Cypher,Omen,Gekko","Breach,Raze,Killjoy,Omen,Fade"
Ascent,EX0TIK GAMING,Impulse GW,3,13,1,11,2,2,"Sova,Killjoy,Omen,Jett,KAY/O","Sova,Killjoy,Omen,Jett,KAY/O"
Sunset,HUGE Esports GC,ForsaKen GC,5,13,3,9,4,2,"Breach,Raze,Cypher,Omen,Iso","Breach,Raze,Cypher,Omen,Gekko"
Icebox,F9 Wonders,EXALTY Kali,13,4,8,4,0,5,"Sova,Killjoy,Viper,Sage,Jett","Killjoy,Reyna,Jett,Harbor,Gekko"
Icebox,NOMAD GC,R1 BebeW,13,8,8,4,4,5,"Sova,Killjoy,Jett,Harbor,Gekko","Sova,Viper,Sage,Jett,Clove"
Sunset,Eintracht Frankfurt,Permitta Unicorns,5,13,2,4,9,3,"Raze,Cypher,Sage,Omen,Gekko","Breach,Raze,Cypher,Omen,Fade"
Lotus,Zerance Mint,charbon,8,13,4,5,8,4,"Raze,Killjoy,Viper,Omen,Gekko","Omen,KAY/O,Neon,Gekko,Deadlock"
Sunset,Paper Rex,Talon Esports,13,7,9,3,4,4,"Breach,Raze,Sage,Omen,Gekko","Breach,Raze,Cypher,Omen,Gekko"
Sunset,Zerance Mint,NOMAD GC,13,2,3,0,2,10,"Breach,Raze,Cypher,Sova,Omen","Breach,Cypher,Sova,Omen,Jett"
Sunset,F9 Wonders,HUGE Esports GC,13,7,8,4,3,5,"Breach,Raze,Cypher,Omen,Yoru","Breach,Raze,Cypher,Omen,Gekko"
Bind,EXALTY Kali,ForsaKen GC,16,14,9,6,8,7,"Raze,Cypher,Brimstone,Skye,Gekko","Breach,Raze,Cypher,Omen,Gekko"
Bind,charbon,R1 BebeW,13,3,3,1,2,10,"Breach,Raze,Cypher,Omen,Yoru","Raze,Cypher,Viper,Brimstone,Skye"
Ascent,Eintracht Frankfurt,Permitta Unicorns,13,15,5,9,6,8,"Cypher,Sova,Sage,Omen,Jett","Breach,Sova,Killjoy,Omen,Jett"
Icebox,Paper Rex,Talon Esports,13,4,9,3,1,4,"Killjoy,Viper,Sage,Jett,KAY/O","Killjoy,Viper,Jett,KAY/O,Gekko"
Sunset,T1,Gen.G Esports,9,13,4,6,7,5,"Breach,Raze,Sage,Omen,Gekko","Cypher,Sova,Omen,Jett,KAY/O"
Lotus,T1,Gen.G Esports,13,5,4,2,3,9,"Raze,Viper,Omen,Chamber,Fade","Raze,Killjoy,Viper,Omen,Fade"
Split,T1,Gen.G Esports,13,15,7,7,8,6,"Raze,Viper,Omen,Skye,Chamber","Raze,Cypher,Viper,Omen,Skye"
Bind,Special Grade,Shifty505,13,8,9,3,5,4,"Raze,Viper,Brimstone,Skye,Iso","Raze,Viper,Skye,Gekko,Clove"
Haven,Paranoia Vortex,1337 (NA),8,13,5,7,6,3,"Killjoy,Viper,Astra,KAY/O,Gekko","Sova,Killjoy,Omen,Jett,Iso"
Haven,Special Grade,Shifty505,15,17,8,8,9,7,"Breach,Sova,Killjoy,Omen,Jett","Breach,Cypher,Sova,Omen,Jett"
Icebox,Paranoia Vortex,1337 (NA),9,13,7,5,8,2,"Sova,Viper,Chamber,Harbor,Iso","Sova,Killjoy,Viper,Reyna,Gekko"
Lotus,Winthrop University,BHOP Esports,13,2,10,2,0,3,"Breach,Cypher,Omen,Neon,Iso","Breach,Raze,Omen,Chamber,Gekko"
Sunset,Alphaware Olympians,5 gecs,13,9,7,5,4,6,"Breach,Raze,Cypher,Sova,Omen","Raze,Cypher,Sova,Omen,Gekko"
Haven,The Final Shape,Be Like Matt,13,9,5,7,2,8,"Breach,Cypher,Sova,Omen,Jett","Breach,Cypher,Sova,Neon,Clove"
Ascent,Paranoia Vortex,1337 (NA),13,8,5,4,4,8,"Sova,Killjoy,Omen,Jett,Iso","Cypher,Sova,Omen,Jett,Deadlock"
Ascent,Special Grade,Shifty505,15,13,8,6,7,7,"Sova,Killjoy,Omen,Jett,KAY/O","Sova,Killjoy,Omen,Jett,KAY/O"
Lotus,Berzerkers,Goon that jawn,8,13,1,8,5,7,"Breach,Raze,Cypher,Omen,Fade","Raze,Cypher,Omen,Skye,Yoru"
Sunset,SaD Esports,SEN SHAHZAM,15,13,9,5,8,6,"Breach,Raze,Cypher,Sova,Omen","Raze,Cypher,Reyna,Gekko,Clove"
Ascent,Winthrop University,BHOP Esports,13,6,4,3,3,9,"Cypher,Sova,Omen,Deadlock,Iso","Cypher,Sova,Omen,Jett,KAY/O"
Bind,Alphaware Olympians,5 gecs,7,13,5,7,6,2,"Raze,Cypher,Brimstone,Skye,KAY/O","Raze,Cypher,Brimstone,Skye,Yoru"
Lotus,SaD Purple,Ions Day Care,10,13,7,4,9,3,"Raze,Cypher,Viper,Omen,Fade","Killjoy,Viper,Omen,Neon,Gekko"
Haven,Blue Otter,Six Figures,13,7,9,3,4,4,"Breach,Sova,Killjoy,Omen,Jett","Breach,Cypher,Sova,Omen,Neon"
Split,The Final Shape,Be Like Matt,13,10,6,5,5,7,"Raze,Cypher,Omen,Skye,Iso","Raze,Viper,Skye,Iso,Clove"
Lotus,Nats kitten koup,Flowstate,13,6,6,1,5,7,"Breach,Killjoy,Omen,Neon,Gekko","Breach,Cypher,Neon,Fade,Clove"
Ascent,Berzerkers,Goon that jawn,8,13,3,6,7,5,"Sova,Killjoy,Omen,Jett,KAY/O","Sova,Killjoy,Omen,Jett,Iso"
Icebox,Paranoia Vortex,ABG luvrs,13,5,10,2,3,3,"Sova,Viper,Chamber,Harbor,Iso","Sova,Killjoy,Viper,KAY/O,Iso"
Split,TOADS,Forsaken Shadows,13,10,9,3,7,4,"Raze,Cypher,Omen,Skye,Iso","Raze,Cypher,Omen,Skye,Iso"
Icebox,KRÜ BLAZE,9z Team GC,14,12,8,5,7,6,"Sova,Killjoy,Viper,Jett,Harbor","Killjoy,Viper,Jett,KAY/O,Gekko"
Ascent,Special Grade,Dan's Minions,13,6,8,4,2,5,"Sova,Killjoy,Omen,Jett,KAY/O","Sova,Killjoy,Omen,Jett,KAY/O"
Haven,SaD Esports,SEN SHAHZAM,14,12,6,7,5,8,"Breach,Sova,Killjoy,Omen,Jett","Sova,Killjoy,Jett,Iso,Clove"
Lotus,Blue Otter,Six Figures,13,1,11,1,0,2,"Breach,Raze,Cypher,Gekko,Clove","Breach,Killjoy,Omen,Neon,Gekko"
Split,Alphaware Olympians,5 gecs,13,6,7,5,1,6,"Raze,Cypher,Viper,Omen,Skye","Raze,Cypher,Viper,Omen,Skye"
Sunset,Nats kitten koup,Flowstate,13,1,2,0,1,11,"Breach,Raze,Cypher,Sova,Omen","Breach,Cypher,Sova,Neon,Clove"
Ascent,SaD Purple,Ions Day Care,6,13,3,4,9,3,"Sova,Killjoy,Omen,Jett,KAY/O","Sova,Killjoy,Omen,Jett,KAY/O"
Sunset,Mad Science,BHOP Esports,11,13,5,7,6,6,"Breach,Raze,Cypher,Omen,Gekko","Breach,Raze,Cypher,Sova,Omen"
Ascent,The Final Shape,overcook,13,3,3,1,2,10,"Sova,Killjoy,Omen,Jett,KAY/O","Sova,Killjoy,Omen,Jett,KAY/O"
Haven,Berzerkers,Dog Team Club Org,13,1,2,0,1,11,"Breach,Cypher,Sova,Omen,Jett","Cypher,Sova,Omen,Jett,Iso"
Sunset,Paranoia Vortex,ABG luvrs,13,9,6,6,3,7,"Raze,Cypher,Omen,KAY/O,Gekko","Breach,Raze,Cypher,Omen,Gekko"
Bind,TOADS,Forsaken Shadows,13,10,5,6,4,8,"Raze,Brimstone,Skye,Harbor,Iso","Raze,Cypher,Brimstone,Skye,Iso"
Bind,Special Grade,Dan's Minions,13,4,5,0,4,8,"Raze,Viper,Brimstone,Skye,Iso","Raze,Viper,Brimstone,Skye,Gekko"
Haven,Blue Otter,bricknodes,13,3,11,1,2,2,"Breach,Sova,Killjoy,Omen,Jett","Breach,Sova,Killjoy,Omen,Jett"
Sunset,The GRID,SEN SHAHZAM,8,13,7,5,8,1,"Breach,Cypher,Sova,Omen,Neon","Raze,Cypher,Gekko,Iso,Clove"
Lotus,Shifty505,Last Chance (NA),13,5,4,2,3,9,"Breach,Reyna,Omen,Skye,Neon","Breach,Raze,Cypher,Omen,Gekko"
Ascent,KRÜ BLAZE,9z Team GC,13,9,7,3,6,6,"Sova,Killjoy,Omen,Jett,KAY/O","Sova,Killjoy,Omen,Jett,KAY/O"
Lotus,Toads,Flowstate,5,13,1,5,8,4,"Breach,Cypher,Omen,Neon,Gekko","Breach,Cypher,Neon,Fade,Clove"
Haven,Mad Science,BHOP Esports,13,3,3,1,2,10,"Cypher,Sova,Jett,Iso,Clove","Breach,Cypher,Sova,Omen,Jett"
Sunset,Area of Effect,Goon that jawn,7,13,1,7,6,6,"Raze,Cypher,Omen,Gekko,Iso","Cypher,Sova,Omen,Jett,Yoru"
Lotus,Berzerkers,Dog Team Club Org,13,3,10,2,1,3,"Breach,Raze,Cypher,Omen,Fade","Killjoy,Omen,Jett,Gekko,Iso"
Haven,Winthrop University,Clinic,13,6,9,3,3,4,"Breach,Cypher,Omen,Neon,Iso","Breach,Cypher,Omen,Jett,Deadlock"
Lotus,League of Losers,5 gecs,10,13,4,7,6,6,"Raze,Killjoy,Fade,Gekko,Clove","Raze,Killjoy,Omen,Fade,Gekko"
Haven,PLACEHOLDER LAG,Six Figures,6,13,5,7,6,1,"Sova,Killjoy,Omen,Jett,Iso","Breach,Cypher,Sova,Omen,Neon"
Split,1337 (NA),reddots daycare,13,5,3,3,2,10,"Raze,Cypher,Omen,Skye,Iso","Raze,Cypher,Skye,Astra,Neon"
Ascent,Alphaware Olympians,Mountain Beasts,13,1,2,0,1,11,"Cypher,Sova,Omen,Jett,KAY/O","Cypher,Sova,Omen,Jett,KAY/O"
Lotus,Nats kitten koup,Canadia Compooters,13,0,12,0,0,1,"Breach,Killjoy,Omen,Neon,Gekko","Breach,Raze,Cypher,Omen,Fade"
Breeze,Passion Project,FlyQuest RED,9,13,4,6,7,5,"Cypher,Sova,Viper,Jett,Yoru","Cypher,Sova,Viper,Reyna,Jett"
Haven,Be Like Matt,THE ROUND TABLE,13,8,6,6,2,7,"Breach,Cypher,Sova,Omen,Neon","Sova,Killjoy,Reyna,Omen,Jett"
Bind,Sky Esports,NAMI eSports,11,13,3,9,4,8,"Cypher,Viper,Brimstone,Jett,Skye","Raze,Cypher,Brimstone,Skye,Gekko"
Icebox,The Final Shape,overcook,13,8,8,4,4,5,"Sova,Viper,Reyna,Jett,Clove","Sova,Killjoy,Viper,Reyna,Gekko"
Bind,SaD Esports,Faphouse,13,4,8,4,0,5,"Raze,Cypher,Viper,Brimstone,Skye","Raze,Cypher,Brimstone,Skye,Iso"
Sunset,Blue Otter,bricknodes,13,5,3,3,2,10,"Breach,Cypher,Sova,Omen,Neon","Breach,Raze,Cypher,Omen,Gekko"
Split,Ions Day Care,Forsaken Shadows,13,4,4,1,3,9,"Raze,Cypher,Viper,Skye,Astra","Raze,Cypher,Omen,Skye,Iso"
Haven,Paranoia Vortex,ABG luvrs,13,15,6,8,7,7,"Killjoy,Viper,Astra,KAY/O,Gekko","Cypher,Sova,Phoenix,Omen,Jett"
Haven,SaD Purple,TOADS,13,7,5,3,4,8,"Sova,Killjoy,Omen,Jett,Neon","Killjoy,Omen,Jett,Skye,Iso"
Ascent,Area of Effect,Goon that jawn,4,13,0,5,8,4,"Sova,Killjoy,Omen,Jett,Deadlock","Sova,Killjoy,Omen,Jett,Iso"
Haven,1337 (NA),reddots daycare,13,6,6,1,5,7,"Sova,Killjoy,Omen,Jett,Iso","Breach,Cypher,Astra,Fade,Iso"
Sunset,Toads,Flowstate,7,13,5,7,6,2,"Cypher,Omen,KAY/O,Neon,Gekko","Breach,Cypher,Sova,Neon,Clove"
Ascent,Berzerkers,Dog Team Club Org,7,13,2,6,7,5,"Sova,Killjoy,Omen,Jett,KAY/O","Sova,Killjoy,Omen,Jett,Iso"
Ascent,Mad Science,BHOP Esports,12,14,5,8,6,7,"Breach,Brimstone,Reyna,Neon,Iso","Cypher,Sova,Omen,Jett,KAY/O"
Lotus,Be Like Matt,THE ROUND TABLE,13,3,10,2,1,3,"Raze,Cypher,Viper,Fade,Clove","Raze,Killjoy,Reyna,Omen,Gekko"
Haven,The GRID,SEN SHAHZAM,13,15,7,7,8,6,"Breach,Cypher,Sova,Omen,Neon","Sova,Killjoy,Jett,Iso,Clove"
Lotus,Variety,League of Losers,5,13,2,10,3,3,"Breach,Raze,Killjoy,Gekko,Clove","Raze,Killjoy,Fade,Gekko,Clove"
Haven,Shifty505,Last Chance (NA),13,11,8,4,7,5,"Breach,Cypher,Sova,Omen,Jett","Breach,Cypher,Sova,Omen,Jett"
Lotus,PLACEHOLDER LAG,Six Figures,7,13,3,9,4,4,"Omen,Skye,Chamber,Neon,Iso","Breach,Killjoy,Omen,Neon,Gekko"
Haven,Nats kitten koup,Canadia Compooters,13,7,8,4,3,5,"Breach,Sova,Killjoy,Omen,Neon","Killjoy,Viper,Yoru,Fade,Clove"
Ascent,Dan's Minions,Omnipotent Gaming,13,7,6,6,1,7,"Sova,Killjoy,Omen,Jett,KAY/O","Sova,Killjoy,Omen,Jett,KAY/O"
Haven,The Final Shape,overcook,2,13,0,3,10,2,"Breach,Sova,Killjoy,Omen,Jett","Breach,Sova,Killjoy,Omen,Jett"
Icebox,Passion Project,FlyQuest RED,5,13,1,11,2,4,"Killjoy,Viper,Jett,KAY/O,Gekko","Sova,Killjoy,Viper,Sage,Gekko"
Bind,Winthrop University,Clinic,13,8,6,3,5,7,"Viper,Brimstone,Skye,Neon,Iso","Cypher,Viper,Brimstone,Gekko,Iso"
Split,KRÜ BLAZE,9z Team GC,13,6,7,0,6,6,"Raze,Viper,Omen,Skye,Astra","Raze,Viper,Omen,Fade,Gekko"
Haven,SaD Esports,Faphouse,13,6,7,5,1,6,"Breach,Sova,Killjoy,Omen,Jett","Sova,Killjoy,Omen,Neon,Iso"
Ascent,Sky Esports,NAMI eSports,4,13,1,4,9,3,"Sova,Killjoy,Omen,Jett,KAY/O","Sova,Killjoy,Omen,Jett,KAY/O"
Ascent,Alphaware Olympians,UNM Esports,13,10,6,5,5,7,"Cypher,Sova,Omen,Jett,KAY/O","Sova,Killjoy,Reyna,Omen,Iso"
Haven,ABG luvrs,Relapse,13,1,11,1,0,2,"Cypher,Sova,Phoenix,Omen,Jett","Breach,Cypher,Sova,Omen,Jett"
Haven,Only Going A,Dog Team Club Org,7,13,3,9,4,4,"Breach,Cypher,Sova,Omen,Iso","Cypher,Sova,Omen,Jett,Iso"
Bind,Forsaken Shadows,Akatsuki Aimers,13,10,9,3,7,4,"Raze,Cypher,Brimstone,Skye,Iso","Raze,Cypher,Brimstone,Skye,Gekko"
Ascent,SaD Purple,University of Oklahoma,13,4,8,4,0,5,"Sova,Killjoy,Omen,Jett,KAY/O","Sova,Killjoy,Omen,Jett,KAY/O"
Haven,Pro Noobs,bricknodes,10,13,7,4,9,3,"Breach,Cypher,Sova,Omen,Jett","Breach,Sova,Killjoy,Omen,Jett"
Split,TOADS,Dexterity Gaming,13,7,7,5,2,6,"Raze,Cypher,Omen,Skye,Iso","Raze,Cypher,Viper,Omen,Skye"
Ascent,Variety,GroundX,14,12,9,4,8,5,"Killjoy,Omen,Jett,Skye,KAY/O","Sova,Killjoy,Omen,Jett,KAY/O"
Bind,Passion Project,FlyQuest RED,7,13,1,7,6,6,"Raze,Cypher,Viper,Brimstone,Skye","Raze,Viper,Skye,Astra,Gekko"
Icebox,Mountain Beasts,The 5-Stack,13,6,3,4,2,10,"Sova,Killjoy,Viper,Jett,Gekko","Sova,Killjoy,Viper,Jett,Gekko"
Ascent,Gamax Lite,GnG White,13,9,8,4,5,5,"Sova,Killjoy,Omen,Jett,KAY/O","Sova,Killjoy,Omen,Jett,KAY/O"
Lotus,BOMB IMPOUNDMENT SQUADRON,5 gecs,10,13,4,7,6,6,"Breach,Raze,Cypher,Omen,Fade","Raze,Killjoy,Omen,Fade,Gekko"
Icebox,Ions Day Care,Lavender,13,5,10,2,3,3,"Sova,Killjoy,Viper,Reyna,Iso","Killjoy,Viper,Reyna,Iso,Clove"
Lotus,Canadia Compooters,Cal Blue,13,8,6,3,5,7,"Breach,Raze,Cypher,Omen,Fade","Breach,Cypher,Omen,Neon,Gekko"
Split,Shinjitsu,overcook,2,13,2,10,3,0,"Raze,Viper,Jett,Skye,Clove","Raze,Cypher,Viper,Omen,Skye"
Icebox,Clinic,Goated,13,5,8,4,1,5,"Killjoy,Viper,Jett,Gekko,Clove","Sova,Killjoy,Viper,Gekko,Iso"
Sunset,Only Going A,Dog Team Club Org,1,13,0,2,11,1,"Raze,Cypher,Omen,Gekko,Iso","Breach,Cypher,Omen,Iso,Clove"
Sunset,Sky Esports,NAMI eSports,13,8,5,4,4,8,"Breach,Raze,Cypher,Omen,Gekko","Breach,Raze,Cypher,Sova,Omen"
Icebox,Faphouse,ShaBoingBoing Esports,13,8,5,4,4,8,"Sova,Killjoy,Viper,Neon,Iso","Killjoy,Viper,Jett,KAY/O,Gekko"
Split,Six Karma,Reven eClub,7,13,4,4,9,3,"Raze,Cypher,Viper,Omen,Skye","Breach,Raze,Cypher,Omen,Gekko"
Lotus,ABG luvrs,Relapse,13,15,8,6,9,5,"Breach,Killjoy,Yoru,Gekko,Clove","Breach,Killjoy,Omen,Neon,Gekko"
Sunset,Dan's Minions,Omnipotent Gaming,15,17,7,9,8,8,"Breach,Raze,Cypher,Omen,Gekko","Raze,Cypher,Reyna,Omen,Gekko"
Ascent,League of Losers,Asura Violet,13,10,5,6,4,8,"Sova,Killjoy,Jett,Astra,KAY/O","Sova,Killjoy,Omen,Jett,KAY/O"
Bind,XPL Esports,Alphaware Olympians,11,13,6,6,7,5,"Raze,Cypher,Viper,Brimstone,Skye","Raze,Cypher,Brimstone,Skye,KAY/O"
Sunset,BOMB IMPOUNDMENT SQUADRON,Outcast Gaming,13,4,10,2,2,3,"Breach,Raze,Cypher,Omen,Gekko","Breach,Raze,Cypher,Omen,Gekko"
Bind,Ions Day Care,Malecient NA,13,5,5,1,4,8,"Cypher,Viper,Brimstone,Skye,Iso","Cypher,Viper,Brimstone,Jett,Gekko"
Lotus,Akatsuki Aimers,Space Rabbit Esports,13,10,9,3,7,4,"Breach,Killjoy,Omen,Neon,Gekko","Raze,Killjoy,Reyna,Astra,Gekko"
Lotus,Gamax Lite,GnG White,13,6,4,3,3,9,"Breach,Raze,Killjoy,Iso,Clove","Breach,Raze,Killjoy,Omen,Fade"
Icebox,SaD Purple,koupert and friends,13,8,6,3,5,7,"Sova,Killjoy,Viper,Jett,Iso","Sova,Killjoy,Viper,Jett,Gekko"
Bind,The 5-Stack,AURA Ruby,13,6,6,1,5,7,"Raze,Cypher,Brimstone,Skye,Gekko","Breach,Raze,Viper,Brimstone,KAY/O"
Ascent,Mountain Beasts,womp womp,13,8,3,6,2,10,"Cypher,Sova,Omen,Jett,KAY/O","Sova,Killjoy,Omen,Jett,KAY/O"
Ascent,UNM Esports,Good China Esports,13,5,4,2,3,9,"Sova,Killjoy,Reyna,Omen,Iso","Sova,Killjoy,Omen,Jett,KAY/O"
Split,TOADS,Omnipotence,13,3,10,2,1,3,"Raze,Cypher,Omen,Skye,Iso","Breach,Raze,Cypher,Omen,Skye"
Haven,Shinjitsu,overcook,9,13,3,7,6,6,"Breach,Killjoy,Omen,Jett,Harbor","Breach,Sova,Killjoy,Omen,Jett"
Haven,Dan's Minions,Omnipotent Gaming,13,3,4,0,3,9,"Breach,Cypher,Omen,Neon,Gekko","Breach,Sova,Killjoy,Omen,Jett"
Bind,Clinic,Goated,13,7,6,2,5,7,"Cypher,Viper,Brimstone,Gekko,Iso","Raze,Brimstone,Reyna,Skye,Gekko"
Lotus,Decend,5 gecs,4,13,1,4,9,3,"Breach,Raze,Omen,Jett,Gekko","Raze,Killjoy,Omen,Fade,Gekko"
Haven,University of Oklahoma,>.<,13,3,4,0,3,9,"Breach,Sova,Killjoy,Jett,Astra","Breach,Sova,Killjoy,Omen,Jett"
Sunset,Pro Noobs,bricknodes,12,14,7,6,8,5,"Breach,Raze,Cypher,Omen,Gekko","Breach,Raze,Cypher,Omen,Gekko"
Ascent,Canadia Compooters,Cal Blue,13,9,3,7,2,10,"Cypher,Sova,Omen,Jett,Yoru","Sova,Killjoy,Omen,Jett,KAY/O"
Haven,Faphouse,ShaBoingBoing Esports,13,3,4,0,3,9,"Sova,Killjoy,Omen,Neon,Iso","Breach,Sova,Killjoy,Omen,Neon"
Lotus,Only Going A,Dog Team Club Org,13,10,8,4,6,5,"Breach,Raze,Killjoy,Omen,Fade","Raze,Killjoy,Omen,Gekko,Iso"
Bind,Dexterity Gaming,Senchigami,13,2,11,1,1,2,"Raze,Viper,Brimstone,Fade,Gekko","Raze,Cypher,Fade,Gekko,Clove"
Ascent,Kaizen Esports Red,Lavender,5,13,3,3,10,2,"Sova,Killjoy,Omen,Jett,KAY/O","Sova,Jett,Fade,Iso,Clove"
Icebox,ABG luvrs,Relapse,13,6,4,3,3,9,"Sova,Killjoy,Viper,KAY/O,Iso","Sova,Killjoy,Viper,Reyna,Gekko"
Lotus,DVM Esport,Joblife,11,13,2,10,3,9,"Raze,Cypher,Phoenix,Omen,Fade","Breach,Raze,Killjoy,Omen,Fade"
Split,Outlast Gaming,Forsaken Shadows,2,13,2,10,3,0,"Breach,Raze,Viper,Omen,Skye","Raze,Cypher,Omen,Skye,Neon"
Icebox,Six Karma,Reven eClub,10,13,5,7,6,5,"Sova,Killjoy,Viper,Jett,Harbor","Killjoy,Viper,Jett,KAY/O,Gekko"
Haven,Omnipotence,submissive eboys,13,6,7,5,1,6,"Breach,Sova,Killjoy,Omen,Neon","Breach,Cypher,Sova,Omen,Iso"
Split,GroundX,koupert and friends,3,13,3,9,4,0,"Raze,Cypher,Reyna,Omen,Skye","Breach,Raze,Cypher,Omen,Fade"
Lotus,Malecient NA,promise (NA),13,10,6,5,5,7,"Breach,Killjoy,Omen,Neon,Gekko","Raze,Cypher,Omen,Fade,Gekko"
Haven,EXOTICK,>.<,6,13,2,5,8,4,"Breach,Cypher,Sova,Omen,Jett","Breach,Sova,Killjoy,Omen,Jett"
Lotus,GOSU Cowgirls VAL,Space Rabbit Esports,10,13,5,6,7,5,"Raze,Killjoy,Viper,Omen,Gekko","Raze,Killjoy,Reyna,Astra,Gekko"
Bind,Forsaken Shadows,One Tap Gaming,13,6,4,3,3,9,"Raze,Cypher,Brimstone,Skye,Iso","Raze,Cypher,Brimstone,Skye,Gekko"
Ascent,The Ultimates Odyssey,Twisted Minds Orchid,13,3,9,3,0,4,"Sova,Killjoy,Omen,Jett,KAY/O","Sova,Killjoy,Omen,Jett,KAY/O"
Bind,The 5 Musketeers,Senchigami,2,13,0,3,10,2,"Raze,Cypher,Reyna,Omen,Gekko","Raze,Cypher,Fade,Gekko,Clove"
Bind,Outplayed,RTZN,13,6,11,1,5,2,"Raze,Cypher,Viper,Brimstone,Skye","Raze,Viper,Brimstone,Fade,Gekko"
Haven,Conviction,Lavender,9,13,5,7,6,4,"Breach,Sova,Killjoy,Omen,Neon","Sova,Killjoy,Jett,Iso,Clove"
Bind,DVM Esport,Joblife,9,13,4,6,7,5,"Raze,Viper,Brimstone,Fade,Gekko","Raze,Viper,Brimstone,Skye,Gekko"
Lotus,Formulation Gaming,Metizport,13,11,6,6,5,7,"Breach,Raze,Cypher,Omen,Fade","Raze,Killjoy,Viper,Omen,Fade"
Ascent,R1 BebeW,AnakinCrew Esport GC,13,5,8,4,1,5,"Sova,Killjoy,Omen,Jett,KAY/O","Sova,Killjoy,Omen,Jett,KAY/O"
Bind,Zerance Mint,EXALTY Kali,13,4,9,3,1,4,"Raze,Viper,Brimstone,Skye,Gekko","Raze,Cypher,Brimstone,Skye,Gekko"
Ascent,Furious Gaming,Zen Esports,13,5,8,4,1,5,"Sova,Killjoy,Omen,Jett,KAY/O","Sova,Killjoy,Omen,Jett,KAY/O"
Sunset,LONETEAM,DSYRE,6,13,3,9,4,3,"Breach,Raze,Cypher,Sova,Omen","Cypher,Sova,Omen,KAY/O,Neon"
Lotus,The Ultimates Odyssey,Twisted Minds Orchid,13,11,7,5,6,6,"Breach,Cypher,Sova,Omen,Neon","Breach,Raze,Cypher,Omen,Fade"
Bind,charbon,ForsaKen GC,13,8,9,3,5,4,"Breach,Raze,Cypher,Omen,Yoru","Breach,Raze,Cypher,Omen,Gekko"
Icebox,ALTERNATE aTTaX,SK Gaming,13,4,4,1,3,9,"Killjoy,Viper,Jett,KAY/O,Gekko","Killjoy,Viper,KAY/O,Gekko,Clove"
Split,DRAKAINAS,PG Team,2,13,2,10,3,0,"Breach,Raze,Cypher,Omen,Skye","Raze,Reyna,Yoru,Iso,Clove"
Bind,Team PlayHard Glasterz,NOMAD GC,11,13,9,3,10,2,"Breach,Raze,Cypher,Viper,Brimstone","Breach,Raze,Cypher,Omen,Fade"
Ascent,Formulation Gaming,Metizport,13,8,5,7,1,8,"Sova,Killjoy,Omen,Jett,KAY/O","Breach,Sova,Omen,Jett,KAY/O"
Split,Cicadas Gaming,Solary,13,7,6,2,5,7,"Breach,Raze,Cypher,Sage,Omen","Raze,Cypher,Viper,Omen,Skye"
Bind,Zerance Mint,HUGE Esports GC,13,3,11,1,2,2,"Raze,Viper,Brimstone,Skye,Gekko","Raze,Cypher,Brimstone,Skye,Fade"
Bind,Team Falcons Vega,NASR Ignite,13,2,11,1,1,2,"Raze,Viper,Brimstone,Skye,Gekko","Breach,Raze,Omen,Gekko,Deadlock"
Icebox,R1 BebeW,EXALTY Kali,11,13,6,6,7,5,"Sova,Killjoy,Viper,Sage,Jett","Killjoy,Reyna,Jett,Harbor,Gekko"
Icebox,Furious Gaming,Zen Esports,14,12,6,7,5,8,"Sova,Killjoy,Viper,Jett,Harbor","Sova,Killjoy,Viper,Sage,KAY/O"
Icebox,Axolotl,VX300 Gaming,1,13,0,2,11,1,"Killjoy,Viper,Omen,Jett,Gekko","Killjoy,Viper,Jett,KAY/O,Gekko"
Split,Vanir,Andromeda Gaming,13,10,6,5,5,7,"Raze,Cypher,Omen,Yoru,Iso","Breach,Raze,Viper,Omen,Skye"
Sunset,The Ultimates Odyssey,Twisted Minds Orchid,8,13,8,4,9,0,"Breach,Raze,Cypher,Omen,Gekko","Breach,Raze,Cypher,Omen,Gekko"
Lotus,NOMAD GC,PG Team,13,1,1,1,0,12,"Breach,Raze,Killjoy,Omen,Fade","Breach,Raze,Killjoy,Omen,Gekko"
Ascent,ALTERNATE aTTaX,SK Gaming,13,5,7,5,0,6,"Sova,Killjoy,Omen,Jett,KAY/O","Breach,Cypher,Omen,Jett,Fade"
Ascent,DRAKAINAS,ForsaKen GC,9,13,4,8,5,5,"Sova,Killjoy,Phoenix,Reyna,Omen","Sova,Killjoy,Omen,Jett,KAY/O"
Ascent,charbon,F9 Wonders,6,13,4,8,5,2,"Sova,Killjoy,Omen,Jett,KAY/O","Sova,Killjoy,Phoenix,Omen,Jett"
Icebox,Cicadas Gaming,Solary,6,13,3,4,9,3,"Sova,Killjoy,Viper,Jett,Harbor","Sova,Killjoy,Viper,Sage,Jett"
Split,Team Falcons Vega,NASR Ignite,13,3,9,3,0,4,"Breach,Raze,Cypher,Omen,Skye","Raze,Cypher,Viper,Omen,Skye"
Sunset,Apinaorkesteri,OnlyFins,3,13,0,4,9,3,"Cypher,Sova,Omen,Jett,Deadlock","Breach,Raze,Cypher,Omen,Gekko"
Icebox,Zerance Mint,R1 BebeW,13,10,5,6,4,8,"Sova,Killjoy,Viper,Jett,Gekko","Sova,Killjoy,Viper,Sage,Jett"
Bind,NUXERIA GC,HUGE Esports GC,4,13,0,5,8,4,"Raze,Viper,Brimstone,Skye,Gekko","Raze,Cypher,Brimstone,Skye,Fade"
Icebox,Vanir,Andromeda Gaming,13,10,7,4,6,6,"Sova,Killjoy,Viper,Sage,Jett","Sova,Killjoy,Viper,Jett,Harbor"
Sunset,Team PlayHard Glasterz,F9 Wonders,2,13,0,3,10,2,"Breach,Raze,Cypher,Omen,Fade","Breach,Raze,Cypher,Omen,Yoru"
Split,charbon,DRAKAINAS,13,3,9,3,0,4,"Raze,Cypher,Viper,Omen,Skye","Breach,Raze,Cypher,Omen,Skye"
Lotus,NOMAD GC,ForsaKen GC,4,13,4,8,5,0,"Breach,Raze,Killjoy,Omen,Fade","Breach,Raze,Cypher,Sova,Omen"
Lotus,Furious Gaming,Zen Esports,15,17,7,9,8,8,"Raze,Killjoy,Viper,Omen,Fade","Breach,Raze,Sova,Killjoy,Omen"
Icebox,HGE Esports,NOVO Esports,1,13,0,2,11,1,"Sova,Killjoy,Viper,Jett,Gekko","Sova,Killjoy,Viper,Sage,Jett"
Sunset,Cicadas Gaming,Solary,13,10,7,5,5,6,"Breach,Raze,Cypher,Omen,Yoru","Breach,Raze,Cypher,Omen,Fade"
Sunset,G2 Gozen,GIANTX GC,13,7,4,4,3,9,"Breach,Raze,Cypher,Omen,Fade","Breach,Raze,Cypher,Omen,Gekko"
Lotus,Ovation eSports,CGN Esports,8,13,4,8,5,4,"Raze,Killjoy,Viper,Omen,Fade","Raze,Sova,Killjoy,Omen,Gekko"
Sunset,AnakinCrew Esport GC,HUGE Esports GC,2,13,2,10,3,0,"Breach,Raze,Cypher,Omen,Gekko","Breach,Raze,Cypher,Omen,Gekko"
Ascent,MouzKings eSports,NAMI eSports,12,14,6,7,7,6,"Sova,Killjoy,Omen,Jett,KAY/O","Sova,Killjoy,Omen,Jett,KAY/O"
Icebox,PG Team,F9 Wonders,2,13,2,10,3,0,"Killjoy,Viper,Jett,Skye,Gekko","Sova,Killjoy,Viper,Sage,Jett"
Icebox,Apinaorkesteri,OnlyFins,8,13,6,3,10,2,"Sova,Killjoy,Viper,Jett,Harbor","Killjoy,Viper,Jett,KAY/O,Gekko"
Sunset,Zerance Mint,NUXERIA GC,13,8,7,2,6,6,"Breach,Raze,Cypher,Sova,Omen","Breach,Raze,Cypher,Omen,Gekko"
Lotus,Vanir,Andromeda Gaming,13,10,7,5,5,6,"Breach,Raze,Cypher,Harbor,Deadlock","Breach,Raze,Killjoy,Omen,Fade"
Ascent,charbon,Team PlayHard Glasterz,13,7,9,3,4,4,"Sova,Killjoy,Omen,Jett,KAY/O","Sova,Killjoy,Omen,Jett,KAY/O"
Lotus,NOMAD GC,DRAKAINAS,13,5,9,3,2,4,"Breach,Raze,Killjoy,Omen,Fade","Breach,Raze,Killjoy,Omen,Fade"
Split,G2 Gozen,GIANTX GC,13,7,9,3,4,4,"Breach,Raze,Cypher,Omen,Fade","Raze,Cypher,Viper,Omen,Skye"
Ascent,Ovation eSports,CGN Esports,5,13,4,8,5,1,"Sova,Killjoy,Omen,Jett,KAY/O","Sova,Killjoy,Phoenix,Jett,Astra"
Lotus,active girls,R1 BebeW,8,13,2,7,6,6,"Breach,Raze,Killjoy,Omen,Fade","Breach,Raze,Killjoy,Viper,Omen"
Lotus,MouzKings eSports,NAMI eSports,13,4,3,2,2,10,"Killjoy,Omen,Neon,Fade,Gekko","Breach,Raze,Killjoy,Omen,Fade"
Ascent,AnakinCrew Esport GC,NUXERIA GC,1,13,1,11,2,0,"Sova,Killjoy,Omen,Jett,KAY/O","Sova,Killjoy,Omen,Jett,KAY/O"
Bind,EXALTY Kali,HUGE Esports GC,13,9,9,3,6,4,"Raze,Cypher,Brimstone,Skye,Gekko","Raze,Cypher,Brimstone,Skye,Fade"
Sunset,ForsaKen GC,F9 Wonders,9,13,6,4,9,3,"Breach,Raze,Cypher,Omen,Gekko","Breach,Raze,Cypher,Omen,Yoru"
Lotus,Apinaorkesteri,OnlyFins,13,10,8,4,6,5,"Breach,Sova,Killjoy,Omen,Jett","Breach,Raze,Killjoy,Omen,Gekko"
Sunset,PG Team,Team PlayHard Glasterz,1,13,1,11,2,0,"Raze,Cypher,Omen,KAY/O,Gekko","Breach,Raze,Cypher,Omen,Fade"
Sunset,Zerance Mint,active girls,13,1,2,0,1,11,"Breach,Raze,Cypher,Sova,Omen","Breach,Raze,Cypher,Viper,Omen"
Bind,charbon,NOMAD GC,13,6,8,4,2,5,"Breach,Raze,Cypher,Omen,Yoru","Breach,Raze,Cypher,Omen,Fade"
Sunset,MouzKings eSports,NAMI eSports,10,13,2,9,4,8,"Breach,Cypher,Sova,Omen,Neon","Breach,Raze,Cypher,Sova,Omen"
Sunset,EXALTY Kali,NUXERIA GC,14,12,5,8,4,9,"Breach,Raze,Cypher,Omen,Gekko","Breach,Raze,Cypher,Omen,Gekko"
Lotus,HUGE Esports GC,R1 BebeW,3,13,1,3,10,2,"Breach,Raze,Cypher,Omen,Gekko","Breach,Raze,Killjoy,Viper,Omen"
Lotus,ForsaKen GC,Team PlayHard Glasterz,13,2,3,0,2,10,"Breach,Raze,Cypher,Sova,Omen","Breach,Raze,Cypher,Omen,Fade"
Breeze,F9 Wonders,DRAKAINAS,13,2,10,2,0,3,"Cypher,Sova,Viper,Jett,Yoru","Cypher,Sova,Viper,Reyna,Jett"
Lotus,Zerance Mint,AnakinCrew Esport GC,13,3,10,2,1,3,"Raze,Killjoy,Viper,Omen,Gekko","Breach,Raze,Killjoy,Omen,Gekko"
Lotus,charbon,PG Team,13,1,11,1,0,2,"Omen,KAY/O,Neon,Gekko,Deadlock","Breach,Raze,Killjoy,Omen,Gekko"
Split,Team Secret,Bleed Esports,13,8,5,4,4,8,"Raze,Cypher,Viper,Omen,Skye","Raze,Cypher,Omen,Fade,Deadlock"
Lotus,EXALTY Kali,AnakinCrew Esport GC,13,1,12,0,1,1,"Breach,Raze,Cypher,Omen,Gekko","Breach,Raze,Killjoy,Omen,Gekko"
Sunset,F9 Wonders,NOMAD GC,13,6,7,0,6,6,"Breach,Raze,Cypher,Omen,Yoru","Breach,Cypher,Sova,Omen,Jett"
Lotus,ForsaKen GC,PG Team,13,4,4,1,3,9,"Breach,Raze,Cypher,Sova,Omen","Breach,Raze,Killjoy,Omen,Gekko"
Lotus,DRAKAINAS,Team PlayHard Glasterz,11,13,5,7,6,6,"Breach,Raze,Killjoy,Omen,Fade","Breach,Raze,Cypher,Omen,Fade"
Lotus,R1 BebeW,NUXERIA GC,14,16,10,5,11,4,"Breach,Raze,Killjoy,Viper,Omen","Breach,Raze,Killjoy,Omen,Gekko"
Ascent,HUGE Esports GC,active girls,13,9,6,4,5,7,"Sova,Killjoy,Omen,Jett,KAY/O","Sova,Killjoy,Omen,Jett,KAY/O"
Sunset,Team Secret,Bleed Esports,13,8,8,1,7,5,"Breach,Raze,Cypher,Sova,Omen","Raze,Cypher,Sova,Omen,KAY/O"
Ascent,Team Secret,Bleed Esports,10,13,0,11,2,10,"Sova,Killjoy,Omen,Jett,KAY/O","Sova,Killjoy,Omen,Jett,KAY/O"
Breeze,ZETA DIVISION,DRX,4,13,2,3,10,2,"Cypher,Sova,Viper,Jett,KAY/O","Cypher,Sova,Viper,Jett,Astra"
Sunset,ZETA DIVISION,DRX,13,11,5,7,4,8,"Breach,Raze,Cypher,Omen,Gekko","Raze,Cypher,Omen,KAY/O,Gekko"
Icebox,ZETA DIVISION,DRX,0,13,0,1,12,0,"Killjoy,Viper,Omen,KAY/O,Gekko","Killjoy,Viper,Jett,KAY/O,Clove"
Icebox,Reven eClub,RETA Esports,10,13,5,6,7,5,"Killjoy,Viper,Jett,KAY/O,Gekko","Sova,Killjoy,Viper,Jett,Harbor"
Sunset,FlyQuest RED,Solstice GC,13,8,9,3,5,4,"Breach,Raze,Cypher,Sova,Omen","Raze,Cypher,Omen,Gekko,Clove"
Ascent,Reven eClub,RETA Esports,13,15,3,11,4,10,"Cypher,Sova,Omen,Jett,KAY/O","Sova,Killjoy,Omen,Jett,KAY/O"
Icebox,FlyQuest RED,Solstice GC,13,11,8,4,7,5,"Sova,Killjoy,Viper,Sage,Gekko","Sova,Viper,Jett,KAY/O,Deadlock"
Ascent,E-Xolos LAZER,Illicit Gaming,13,9,6,4,5,7,"Cypher,Sova,Omen,Jett,KAY/O","Sova,Killjoy,Omen,Jett,KAY/O"
Bind,SAGAZ,Legacy,8,13,2,7,6,6,"Raze,Viper,Brimstone,Skye,Chamber","Raze,Viper,Brimstone,Skye,Gekko"
Ascent,Passion Project,Shopify Rebellion,12,14,2,11,3,10,"Sova,Killjoy,Omen,Jett,KAY/O","Sova,Killjoy,Omen,Jett,KAY/O"
Sunset,E-Xolos LAZER,Illicit Gaming,10,13,7,4,9,3,"Breach,Raze,Cypher,Omen,Gekko","Breach,Raze,Cypher,Omen,Gekko"
Sunset,Oxygen Esports,Dough Bros,13,7,5,7,0,8,"Breach,Raze,Cypher,Omen,KAY/O","Breach,Raze,Cypher,Omen,Gekko"
Lotus,SAGAZ,Legacy,9,13,7,3,10,2,"Raze,Killjoy,Viper,Omen,Fade","Raze,Killjoy,Omen,Astra,Fade"
Ascent,New Origins Esports,Team 7 Esports,13,6,6,1,5,7,"Sova,Killjoy,Omen,Jett,KAY/O","Sova,Killjoy,Omen,Jett,KAY/O"
Bind,Passion Project,Shopify Rebellion,14,12,8,5,7,6,"Raze,Cypher,Viper,Brimstone,Skye","Raze,Brimstone,Skye,Harbor,Gekko"
Ascent,Oxygen Esports,Dough Bros,13,4,4,1,3,9,"Sova,Killjoy,Omen,Jett,KAY/O","Sova,Killjoy,Omen,Jett,KAY/O"
Bind,E-Xolos LAZER,Illicit Gaming,13,9,6,4,5,7,"Raze,Brimstone,Skye,Harbor,Gekko","Raze,Viper,Brimstone,Skye,Gekko"
Lotus,GnG White,Team Occupy Feminine Fusion,13,9,5,5,4,8,"Breach,Raze,Killjoy,Omen,Fade","Raze,Killjoy,Viper,Omen,Fade"
Breeze,New Origins Esports,Team 7 Esports,13,11,7,5,6,6,"Cypher,Sova,Viper,Jett,KAY/O","Cypher,Sova,Viper,Jett,KAY/O"
Lotus,Passion Project,Shopify Rebellion,10,13,5,7,6,5,"Breach,Raze,Killjoy,Omen,Gekko","Breach,Raze,Cypher,Omen,Fade"
Ascent,RED Canids,2Game Esports,5,13,5,7,6,0,"Sova,Killjoy,Omen,Jett,KAY/O","Sova,Killjoy,Omen,Jett,KAY/O"
Icebox,QoR,M80,8,13,1,11,2,7,"Sova,Killjoy,Viper,Jett,Gekko","Killjoy,Viper,Omen,KAY/O,Gekko"
Sunset,TwentyStars,Fishing Rods,9,13,6,4,9,3,"Breach,Raze,Cypher,Omen,Gekko","Breach,Raze,Cypher,Omen,Gekko"
Ascent,Karmine Corp GC,NASR Ignite,10,13,8,4,9,2,"Sova,Killjoy,Omen,Jett,KAY/O","Cypher,Sova,Phoenix,Omen,Jett"
Breeze,GnG White,Team Occupy Feminine Fusion,13,10,9,3,7,4,"Cypher,Sova,Viper,Reyna,Jett","Cypher,Sova,Viper,Reyna,Jett"
Sunset,New Origins Esports,Team 7 Esports,7,13,2,6,7,5,"Breach,Raze,Cypher,Omen,Gekko","Breach,Raze,Cypher,Omen,Gekko"
Icebox,Unlucky boys,90 Seconds,14,12,6,7,5,8,"Sova,Killjoy,Viper,Jett,Gekko","Sova,Killjoy,Viper,Sage,Jett"
Lotus,RED Canids,2Game Esports,8,13,4,8,5,4,"Raze,Killjoy,Viper,Omen,Skye","Breach,Killjoy,Omen,Neon,Fade"
Ascent,QoR,M80,4,13,3,9,4,1,"Sova,Killjoy,Omen,Jett,KAY/O","Cypher,Sova,Omen,Yoru,Deadlock"
Sunset,TOG Kitsune,FOKUS Sakura,13,1,11,1,0,2,"Breach,Raze,Cypher,Omen,Gekko","Raze,Cypher,Omen,Yoru,Gekko"
Bind,RevenantVAL,DSYRE Academy,9,13,2,10,3,7,"Raze,Cypher,Brimstone,Reyna,Skye","Raze,Brimstone,Skye,Yoru,Gekko"
Breeze,Karmine Corp GC,NASR Ignite,10,13,3,9,4,7,"Cypher,Sova,Viper,Jett,KAY/O","Cypher,Sova,Viper,Jett,Gekko"
Bind,MOUZ,XPERION NXT,13,11,10,2,9,3,"Breach,Raze,Viper,Brimstone,Gekko","Raze,Cypher,Brimstone,Skye,Gekko"
Sunset,Unlucky boys,90 Seconds,4,13,2,10,3,2,"Breach,Raze,Cypher,Omen,Gekko","Raze,Cypher,Omen,KAY/O,Gekko"
Lotus,TOG Kitsune,FOKUS Sakura,13,8,8,4,4,5,"Breach,Raze,Killjoy,Omen,Gekko","Breach,Raze,Killjoy,Omen,Skye"
Lotus,TwentyStars,Fishing Rods,16,18,11,6,12,5,"Breach,Raze,Killjoy,Omen,Gekko","Raze,Killjoy,Viper,Omen,Skye"
Icebox,GnG White,Team Occupy Feminine Fusion,10,13,3,8,5,7,"Sova,Killjoy,Viper,Reyna,Gekko","Sova,Killjoy,Viper,Jett,Gekko"
Icebox,R8 Blues,Twisted Minds Orchid,15,17,7,9,8,8,"Sova,Killjoy,Viper,Sage,Neon","Killjoy,Viper,Jett,KAY/O,Gekko"
Split,Coalesce,EXO Clan,16,14,8,7,7,8,"Raze,Viper,Omen,Jett,Skye","Breach,Raze,Cypher,Omen,Fade"
Ascent,RevenantVAL,DSYRE Academy,10,13,4,8,5,6,"Sova,Killjoy,Omen,Jett,KAY/O","Sova,Killjoy,Omen,Jett,KAY/O"
Lotus,MOUZ,XPERION NXT,13,2,3,0,2,10,"Breach,Cypher,Omen,Yoru,Fade","Raze,Killjoy,Viper,Omen,Fade"
Icebox,Karmine Corp GC,NASR Ignite,13,10,8,4,6,5,"Sova,Killjoy,Viper,Sage,Jett","Sova,Killjoy,Viper,Jett,Gekko"
Lotus,Coalesce,EXO Clan,7,13,3,5,8,4,"Raze,Cypher,Omen,Jett,Skye","Raze,Killjoy,Viper,Omen,Fade"
Lotus,R8 Blues,Twisted Minds Orchid,8,13,2,7,6,6,"Raze,Viper,Skye,Chamber,Clove","Breach,Raze,Cypher,Omen,Fade"
Breeze,NO Enemies,The giornalisti,10,13,6,6,7,4,"Cypher,Sova,Viper,Jett,Yoru","Cypher,Sova,Viper,Reyna,Jett"
Icebox,Dragons Esports,Twisted Minds Esports,4,13,0,5,8,4,"Sova,Killjoy,Viper,Jett,Harbor","Sova,Killjoy,Viper,Jett,KAY/O"
Sunset,Coalesce,EXO Clan,13,10,7,5,5,6,"Raze,Cypher,Sova,Omen,Gekko","Cypher,Omen,Neon,Gekko,Iso"
Icebox,NO Enemies,The giornalisti,7,13,4,8,5,3,"Sova,Killjoy,Viper,Jett,Gekko","Sova,Killjoy,Viper,Reyna,Jett"
Bind,BBL Queens,Team Falcons Vega,9,13,4,8,5,5,"Raze,Viper,Brimstone,Fade,Gekko","Raze,Viper,Brimstone,Skye,Gekko"
Sunset,Permitta Unicorns,DIVIZON,13,11,9,3,8,4,"Breach,Raze,Cypher,Omen,Fade","Raze,Cypher,Sage,Omen,Skye"
Icebox,SweetNsour,Apeks,13,8,7,2,6,6,"Killjoy,Viper,Jett,KAY/O,Gekko","Killjoy,Viper,Jett,KAY/O,Gekko"
Sunset,Dragons Esports,Twisted Minds Esports,10,13,4,8,5,6,"Raze,Cypher,Viper,Omen,Fade","Raze,Cypher,Omen,KAY/O,Gekko"
Bind,SweetNsour,Apeks,13,4,10,2,2,3,"Viper,Brimstone,Skye,Yoru,Gekko","Raze,Viper,Brimstone,Skye,Gekko"
Lotus,Permitta Unicorns,DIVIZON,13,9,7,5,4,6,"Breach,Raze,Killjoy,Omen,Fade","Breach,Raze,Sova,Killjoy,Omen"
Sunset,BBL Queens,Team Falcons Vega,12,14,6,7,7,6,"Breach,Raze,Sage,Omen,Gekko","Breach,Raze,Cypher,Omen,Gekko"
Bind,Kizuna Esports,Reve Drift Arena,11,13,6,6,7,5,"Raze,Cypher,Viper,Brimstone,Skye","Raze,Cypher,Brimstone,Skye,Gekko"
Sunset,Kizuna Esports,Reve Drift Arena,11,13,4,8,5,7,"Breach,Raze,Cypher,Omen,Gekko","Breach,Raze,Cypher,Omen,Gekko"
Lotus,Barn nong chok, Santa Gang,9,13,3,7,6,6,"Raze,Killjoy,Viper,Omen,Fade","Raze,Killjoy,Viper,Omen,Fade"
Lotus,Kizuna Esports,Reve Drift Arena,13,11,9,3,8,4,"Raze,Killjoy,Viper,Omen,Fade","Raze,Cypher,Viper,Omen,Skye"
Icebox,LAZY,Fancy United Esports,5,13,2,4,9,3,"Sova,Killjoy,Viper,Reyna,KAY/O","Cypher,Viper,KAY/O,Gekko,Clove"
Sunset,Barn nong chok, Santa Gang,10,13,9,3,10,1,"Breach,Raze,Cypher,Omen,Gekko","Raze,Cypher,Sova,Omen,KAY/O"
Icebox,Rank El Cuties,Avernus Esports,5,13,1,5,8,4,"Killjoy,Viper,Reyna,Omen,Gekko","Sova,Killjoy,Jett,Harbor,Clove"
Bind,Elevate (SG),Ninjas in Galaxy,13,6,9,3,3,4,"Raze,Cypher,Viper,Brimstone,KAY/O","Raze,Cypher,Brimstone,Reyna,Skye"
Ascent,LAZY,Fancy United Esports,7,13,1,11,2,6,"Sova,Killjoy,Omen,Jett,KAY/O","Killjoy,Viper,Omen,Jett,KAY/O"
Bind,Made in Thailand,XERXIA Esports,13,2,3,0,2,10,"Raze,Cypher,Viper,Brimstone,Skye","Raze,Viper,Brimstone,Skye,Gekko"
Ascent,Rank El Cuties,Avernus Esports,13,8,5,4,4,8,"Sova,Killjoy,Omen,Jett,KAY/O","Breach,Viper,Phoenix,Omen,KAY/O"
Sunset,Elevate (SG),Ninjas in Galaxy,13,10,9,3,7,4,"Breach,Raze,Cypher,Omen,Gekko","Raze,Cypher,Phoenix,Omen,Gekko"
Lotus,Alter Ego,THE HERO DETA,13,6,7,0,6,6,"Raze,Cypher,Viper,Omen,Skye","Raze,Killjoy,Viper,Omen,Fade"
Ascent,Made in Thailand,XERXIA Esports,13,4,3,2,2,10,"Cypher,Sova,Phoenix,Omen,Jett","Sova,Killjoy,Omen,Jett,KAY/O"
Ascent,Cyberking Esports,Team Flash,9,13,5,7,6,4,"Sova,Killjoy,Omen,Jett,KAY/O","Sova,Killjoy,Omen,Jett,KAY/O"
Ascent,EDGE (OCE),Koopa Troopas,14,12,5,8,4,9,"Cypher,Sova,Reyna,Omen,KAY/O","Sova,Killjoy,Omen,Jett,KAY/O"
Sunset,Alter Ego,THE HERO DETA,13,1,2,0,1,11,"Breach,Raze,Cypher,Omen,Gekko","Breach,Raze,Cypher,Omen,Gekko"
Split,Murash Gaming,RIDDLE ORDER,8,13,5,4,9,3,"Raze,Cypher,Sage,Omen,Skye","Raze,Viper,Omen,Jett,Skye"
Split,Dplus Esports,Superfect Esports Academy,13,10,3,9,1,10,"Raze,Cypher,Omen,Jett,Skye","Raze,Omen,Jett,Skye,Astra"
Lotus,Rub n' Pug,Tiny Turtle Squad,13,7,8,4,3,5,"Raze,Omen,KAY/O,Neon,Gekko","Raze,Omen,Chamber,Fade,Gekko"
Bind,JustUs,Oasis Gaming,15,17,8,8,9,7,"Raze,Cypher,Brimstone,Skye,Gekko","Raze,Cypher,Viper,Brimstone,Skye"
Sunset,Cyberking Esports,Team Flash,6,13,0,7,6,6,"Breach,Raze,Cypher,Omen,Fade","Breach,Raze,Cypher,Omen,Gekko"
Split,Nongshim RedForce,SLT Seongam,7,13,4,8,5,3,"Raze,Omen,Jett,Skye,Astra","Raze,Cypher,Viper,Omen,Skye"
Bind,EDGE (OCE),Koopa Troopas,13,11,7,5,6,6,"Cypher,Brimstone,Reyna,Jett,Skye","Raze,Viper,Brimstone,Skye,Yoru"
Icebox,Justice For Tomorrow,Peace & Love,13,10,7,5,5,6,"Sova,Killjoy,Viper,Jett,Iso","Sova,Killjoy,Viper,Reyna,Neon"
Sunset,JustUs,Oasis Gaming,1,13,1,11,2,0,"Raze,Cypher,Omen,KAY/O,Gekko","Raze,Cypher,Sova,Omen,KAY/O"
Icebox,Alter Ego,THE HERO DETA,10,13,5,6,7,5,"Raze,Sova,Killjoy,Viper,KAY/O","Killjoy,Viper,Jett,KAY/O,Gekko"
Ascent,Murash Gaming,RIDDLE ORDER,10,13,3,8,5,7,"Sova,Killjoy,Omen,Jett,KAY/O","Sova,Killjoy,Omen,Jett,KAY/O"
Ascent,Rub n' Pug,Tiny Turtle Squad,11,13,7,5,8,4,"Sova,Killjoy,Omen,Jett,KAY/O","Breach,Sova,Killjoy,Omen,Jett"
Icebox,Dplus Esports,Superfect Esports Academy,13,8,5,4,4,8,"Killjoy,Viper,Jett,KAY/O,Gekko","Sova,Killjoy,Viper,Reyna,Jett"
Sunset,EDGE (OCE),Koopa Troopas,7,13,1,7,6,6,"Breach,Cypher,Sova,Omen,Jett","Breach,Raze,Cypher,Omen,Fade"
Ascent,Justice For Tomorrow,Peace & Love,13,7,6,2,5,7,"Sova,Killjoy,Omen,Jett,Iso","Sova,Killjoy,Phoenix,Omen,Neon"
Lotus,Nongshim RedForce,SLT Seongam,9,13,5,5,8,4,"Raze,Cypher,Omen,Astra,Fade","Raze,Killjoy,Viper,Omen,Fade"
Breeze,Rub n' Pug,Tiny Turtle Squad,13,4,9,3,1,4,"Sova,Viper,Jett,Yoru,Astra","Sova,Viper,Jett,KAY/O,Chamber"
Split,OLD STINKY CAT,Subversive,13,3,2,2,1,11,"Raze,Cypher,Omen,Jett,Skye","Breach,Raze,Viper,Omen,Fade"
Lotus,Dplus Esports,Superfect Esports Academy,10,13,9,3,10,1,"Killjoy,Omen,Jett,KAY/O,Gekko","Raze,Killjoy,Omen,Astra,Fade"
Bind,BOOM Esports,Bigetron Arctic,13,11,7,5,6,6,"Raze,Cypher,Viper,Brimstone,Skye","Raze,Cypher,Viper,Brimstone,Skye"
Lotus,NORTHEPTION,REJECT,11,13,6,6,7,5,"Breach,Raze,Cypher,Omen,Gekko","Raze,Killjoy,Viper,Omen,Fade"
Icebox,FearX,VEC DAEJEON,9,13,2,8,5,7,"Raze,Viper,Reyna,Fade,Gekko","Killjoy,Viper,Jett,KAY/O,Gekko"
Bind,OLD STINKY CAT,Subversive,14,12,7,6,6,7,"Raze,Viper,Brimstone,Skye,Gekko","Raze,Cypher,Brimstone,Fade,Gekko"
Ascent,BOOM Esports,Bigetron Arctic,13,9,7,3,6,6,"Sova,Killjoy,Omen,Jett,KAY/O","Sova,Killjoy,Omen,Jett,KAY/O"
Ascent,NORTHEPTION,REJECT,8,13,3,6,7,5,"Sova,Killjoy,Omen,Jett,KAY/O","Sova,Killjoy,Omen,Jett,KAY/O"
Split,Team IAM,Sin Prisa Gaming,3,13,0,12,1,3,"Raze,Viper,Omen,Jett,Skye","Raze,Cypher,Omen,Fade,Deadlock"
Lotus,FearX,VEC DAEJEON,13,10,4,7,3,9,"Breach,Raze,Omen,Jett,Skye","Raze,Viper,Reyna,Omen,Skye"
Lotus,OLD STINKY CAT,Subversive,12,14,11,2,12,1,"Raze,Cypher,Omen,Skye,Gekko","Raze,Killjoy,Viper,Omen,Gekko"
Bind,Team IAM,Sin Prisa Gaming,11,13,2,10,3,9,"Raze,Brimstone,Yoru,Harbor,Gekko","Raze,Cypher,Brimstone,Skye,Deadlock"
Ascent,FearX,VEC DAEJEON,8,13,2,7,6,6,"Sova,Killjoy,Omen,Jett,KAY/O","Breach,Sova,Killjoy,Omen,Jett"
Sunset,FUSION,Six Karma,11,13,7,5,8,4,"Breach,Raze,Cypher,Sova,Brimstone","Breach,Raze,Cypher,Omen,Fade"
Ascent,Moist x Shopify,Winthrop University,13,1,11,1,0,2,"Cypher,Sova,Omen,Jett,Deadlock","Sova,Killjoy,Omen,Jett,KAY/O"
Ascent,FUSION,Six Karma,6,13,5,7,6,1,"Cypher,Sova,Omen,Jett,Deadlock","Sova,Killjoy,Omen,Jett,KAY/O"
Icebox,Stellae Gaming,XLD Gaming,6,13,1,6,7,5,"Sova,Killjoy,Viper,Jett,KAY/O","Sova,Killjoy,Viper,Sage,Jett"
Icebox,Moist x Shopify,Winthrop University,11,13,7,5,8,4,"Killjoy,Viper,Jett,KAY/O,Gekko","Sova,Killjoy,Viper,Jett,Clove"
Sunset,Stellae Gaming,XLD Gaming,12,14,5,8,6,7,"Breach,Raze,Cypher,Omen,Gekko","Breach,Raze,Cypher,Sova,Omen"
Bind,E-Xolos LAZER,RETA Esports,11,13,3,9,4,8,"Raze,Brimstone,Skye,Harbor,Gekko","Raze,Viper,Brimstone,Skye,Gekko"
Bind,Moist x Shopify,Winthrop University,13,6,7,5,1,6,"Raze,Viper,Brimstone,Skye,Gekko","Raze,Viper,Brimstone,Fade,Gekko"
Ascent,Hero Base,TBK Esports,3,13,3,9,4,0,"Breach,Viper,Omen,Jett,KAY/O","Sova,Killjoy,Omen,Jett,KAY/O"
Split,FLUFFY AIMERS,TSM,13,9,4,6,3,9,"Breach,Raze,Cypher,Astra,Fade","Raze,Cypher,Omen,Skye,Deadlock"
Lotus,E-Xolos LAZER,RETA Esports,13,15,8,6,9,5,"Breach,Raze,Cypher,Omen,Gekko","Raze,Killjoy,Viper,Omen,Fade"
Lotus,Hero Base,TBK Esports,14,16,10,5,11,4,"Killjoy,Viper,Omen,Neon,Gekko","Raze,Killjoy,Viper,Omen,Fade"
Split,Galorys,The7,5,13,1,5,8,4,"Raze,Viper,Omen,Jett,Skye","Raze,Viper,Omen,Jett,Skye"
Lotus,SK Gaming,Eintracht Frankfurt,16,18,10,7,11,6,"Breach,Cypher,Sova,Omen,Jett","Raze,Cypher,Sova,Omen,Astra"
Bind,FLUFFY AIMERS,TSM,11,13,8,4,9,3,"Raze,Viper,Omen,Skye,Gekko","Raze,Brimstone,Skye,Gekko,Deadlock"
Ascent,R8 Blues,The Ultimates Odyssey,7,13,4,8,5,3,"Sova,Killjoy,Astra,KAY/O,Neon","Sova,Killjoy,Omen,Jett,KAY/O"
Lotus,GMBLERS Esports,NO Enemies,13,4,11,1,3,2,"Breach,Raze,Killjoy,Omen,Jett","Breach,Raze,Cypher,Omen,Fade"
Sunset,FLUFFY AIMERS,TSM,13,1,11,1,0,2,"Breach,Raze,Cypher,Omen,Skye","Breach,Raze,Cypher,Omen,KAY/O"
Lotus,Team Occupy Feminine Fusion,XProjekt Lioness,13,7,8,4,3,5,"Raze,Killjoy,Viper,Omen,Fade","Breach,Raze,Killjoy,Omen,Gekko"
Lotus,Fishing Rods,RevenantVAL,8,13,7,5,8,1,"Raze,Killjoy,Viper,Omen,Skye","Breach,Raze,Killjoy,Omen,Fade"
Sunset,90 Seconds,HUNTERS,10,13,2,9,4,8,"Raze,Cypher,Omen,KAY/O,Gekko","Raze,Cypher,Omen,Jett,KAY/O"
Ascent,Galorys,The7,11,13,5,7,6,6,"Sova,Killjoy,Omen,Jett,KAY/O","Sova,Killjoy,Omen,Jett,KAY/O"
Sunset,The giornalisti,TwentyStars,13,11,10,2,9,3,"Breach,Raze,Cypher,Reyna,Omen","Breach,Raze,Cypher,Omen,Gekko"
Icebox,Gamax Lite,GnG White,13,4,4,1,3,9,"Sova,Killjoy,Viper,Reyna,Gekko","Sova,Killjoy,Viper,Reyna,Jett"
Bind,Hero Base,TBK Esports,14,12,9,4,8,5,"Raze,Viper,Brimstone,KAY/O,Gekko","Raze,Viper,Brimstone,Sage,Skye"
Bind,Playbay X VISION SYNC,RIZON Sugar,7,13,3,9,4,4,"Breach,Raze,Cypher,Brimstone,Skye","Raze,Cypher,Brimstone,Gekko,Iso"
Sunset,DSYRE Academy,Unlucky boys,13,11,5,7,4,8,"Breach,Raze,Cypher,Omen,Fade","Breach,Raze,Cypher,Omen,Gekko"
Ascent,SK Gaming,Eintracht Frankfurt,15,17,5,11,6,10,"Breach,Cypher,Omen,Jett,Fade","Cypher,Sova,Sage,Omen,Jett"
Lotus,R8 Blues,The Ultimates Odyssey,6,13,1,6,7,5,"Raze,Viper,Skye,Chamber,Clove","Breach,Cypher,Sova,Omen,Neon"
Ascent,GMBLERS Esports,NO Enemies,13,9,4,8,1,9,"Sova,Killjoy,Omen,Jett,KAY/O","Sova,Killjoy,Phoenix,Omen,Jett"
Ascent,DSYRE Academy,Unlucky boys,13,3,2,2,1,11,"Sova,Killjoy,Omen,Jett,KAY/O","Sova,Killjoy,Omen,Jett,KAY/O"
Ascent,The giornalisti,TwentyStars,8,13,4,8,5,4,"Sova,Killjoy,Reyna,Omen,Jett","Sova,Killjoy,Omen,Jett,KAY/O"
Sunset,Fishing Rods,RevenantVAL,13,15,4,10,5,9,"Breach,Raze,Cypher,Omen,Gekko","Breach,Raze,Cypher,Omen,Gekko"
Sunset,Gamax Lite,GnG White,13,9,8,4,5,5,"Breach,Raze,Cypher,Omen,Gekko","Breach,Raze,Cypher,Omen,Fade"
Sunset,Team Occupy Feminine Fusion,XProjekt Lioness,13,11,8,4,7,5,"Breach,Raze,Cypher,Omen,Gekko","Breach,Raze,Cypher,Omen,Gekko"
Lotus,90 Seconds,HUNTERS,13,10,8,4,6,5,"Raze,Killjoy,Viper,Omen,Fade","Breach,Raze,Cypher,Omen,Fade"
Sunset,GIANTX GC,BBL Queens,14,12,6,7,5,8,"Breach,Raze,Cypher,Omen,Gekko","Breach,Raze,Sage,Omen,Gekko"
Lotus,Playbay X VISION SYNC,RIZON Sugar,9,13,6,6,7,3,"Breach,Raze,Cypher,Omen,Fade","Breach,Raze,Killjoy,Neon,Clove"
Ascent,GIANTX GC,BBL Queens,13,2,10,2,0,3,"Sova,Killjoy,Omen,Jett,KAY/O","Sova,Killjoy,Omen,Jett,KAY/O"
Bind,R8 Blues,The Ultimates Odyssey,14,12,10,3,9,4,"Viper,Phoenix,Sage,Skye,Clove","Breach,Raze,Viper,Brimstone,Gekko"
Split,Twisted Minds Orchid,FOG Vortex,13,9,5,5,4,8,"Breach,Raze,Cypher,Viper,Omen","Breach,Raze,Cypher,Omen,Jett"
Ascent,Permitta Unicorns GC,TOG Kitsune,6,13,6,6,7,0,"Sova,Killjoy,Omen,Jett,KAY/O","Sova,Killjoy,Omen,Jett,KAY/O"
Sunset,CGN Esports,ALTERNATE aTTaX,14,12,6,7,5,8,"Raze,Cypher,Sova,Sage,Omen","Raze,Cypher,Omen,KAY/O,Gekko"
Lotus,EMUs,FOKUS Sakura,4,13,0,5,8,4,"Breach,Raze,Cypher,Gekko,Clove","Breach,Raze,Killjoy,Omen,Skye"
Lotus,ALTERNATE aTTaX Ruby,SK Nebula,13,0,12,0,0,1,"Breach,Raze,Cypher,Omen,Fade","Raze,Killjoy,Viper,Omen,Fade"
Sunset,Twisted Minds Esports,Underground Gaming,5,13,0,6,7,5,"Raze,Cypher,Omen,KAY/O,Gekko","Breach,Raze,Cypher,Omen,Fade"
Ascent,Requiem,NXT,7,13,4,8,5,3,"Cypher,Sova,Omen,Jett,KAY/O","Cypher,Sova,Omen,Jett,KAY/O"
Bind,EMUs,FOKUS Sakura,8,13,5,4,9,3,"Breach,Raze,Cypher,Brimstone,Gekko","Raze,Viper,Omen,Skye,Chamber"
Sunset,Twisted Minds Orchid,FOG Vortex,13,4,5,0,4,8,"Breach,Raze,Cypher,Omen,Gekko","Breach,Raze,Cypher,Omen,Fade"
Bind,GIANTX GC,BBL Queens,13,15,9,5,10,4,"Breach,Raze,Viper,Omen,Fade","Raze,Viper,Brimstone,Fade,Gekko"
Sunset,ALTERNATE aTTaX Ruby,SK Nebula,13,3,9,3,0,4,"Breach,Raze,Cypher,Sova,Omen","Raze,Cypher,Viper,Omen,Fade"
Split,Permitta Unicorns GC,TOG Kitsune,11,13,7,5,8,4,"Raze,Cypher,Viper,Omen,Skye","Breach,Cypher,Omen,Yoru,Neon"
Lotus,CGN Esports,ALTERNATE aTTaX,13,5,9,3,2,4,"Raze,Sova,Killjoy,Omen,Gekko","Breach,Raze,Sova,Killjoy,Omen"
Breeze,Twisted Minds Esports,Underground Gaming,13,7,10,2,5,3,"Sova,Viper,Reyna,Jett,Harbor","Cypher,Sova,Viper,Jett,Yoru"
Bind,Twisted Minds Esports,Underground Gaming,2,13,2,10,3,0,"Raze,Brimstone,Reyna,Skye,Harbor","Raze,Cypher,Viper,Omen,Skye"
Icebox,Requiem,NXT,12,14,5,8,6,7,"Killjoy,Viper,Jett,KAY/O,Gekko","Sova,Killjoy,Viper,Reyna,Jett"
Ascent,CGN Esports,ALTERNATE aTTaX,7,13,4,8,5,3,"Sova,Killjoy,Phoenix,Omen,Jett","Sova,Killjoy,Omen,Jett,KAY/O"
Ascent,LaZe,Disguised,8,13,2,7,6,6,"Sova,Killjoy,Omen,Jett,KAY/O","Sova,Killjoy,Phoenix,Omen,Jett"
Icebox,G2 Gozen,Karmine Corp GC,13,9,7,3,6,6,"Sova,Killjoy,Viper,Jett,Clove","Sova,Killjoy,Viper,Sage,Jett"
Breeze,G2 Gozen,Karmine Corp GC,13,4,2,3,1,11,"Cypher,Sova,Viper,Jett,KAY/O","Cypher,Sova,Viper,Jett,KAY/O"
Split,XOXO-01,Sharper Esports,9,13,6,6,7,3,"Raze,Cypher,Viper,Omen,Skye","Cypher,Viper,Omen,Skye,Clove"
Bind,LaZe,Disguised,11,13,6,6,7,5,"Raze,Cypher,Brimstone,Skye,Gekko","Raze,Viper,Omen,Skye,Yoru"
Icebox,Cyberking Esports,Team Big BAAM,13,10,7,5,5,6,"Sova,Killjoy,Viper,Jett,Gekko","Sova,Killjoy,Viper,Jett,KAY/O"
Split,PAPA ESPORTS,Oblivion Force,6,13,2,5,8,4,"Raze,Cypher,Viper,Omen,Skye","Raze,Cypher,Omen,Jett,Skye"
Bind,XOXO-01,Sharper Esports,7,13,4,4,9,3,"Raze,Viper,Brimstone,Skye,Gekko","Raze,Viper,Brimstone,Fade,Gekko"
Icebox,LaZe,Disguised,15,13,5,9,4,10,"Sova,Killjoy,Viper,Jett,Gekko","Sova,Killjoy,Viper,Reyna,Jett"
Bind,PAPA ESPORTS,Oblivion Force,7,13,4,8,5,3,"Raze,Viper,Fade,Gekko,Clove","Raze,Viper,Omen,Skye,Gekko"
Lotus,Team Kobolds,Five Ace e-Sports,13,3,10,2,1,3,"Breach,Raze,Killjoy,Omen,Skye","Raze,Killjoy,Viper,Omen,Fade"
Bind,FULL SENSE,Team NKT,13,7,8,4,3,5,"Raze,Brimstone,Omen,KAY/O,Gekko","Raze,Viper,Brimstone,Skye,Gekko"
Breeze,Cyberking Esports,Team Big BAAM,13,6,10,2,4,3,"Cypher,Sova,Viper,Jett,Yoru","Cypher,Sova,Viper,Jett,KAY/O"
Breeze,OLD STINKY CAT,Tyrant Esports PH,13,10,9,2,8,4,"Cypher,Sova,Viper,Jett,KAY/O","Cypher,Sova,Viper,Reyna,Jett"
Sunset,NEXGA,Please Don't Fire,13,6,4,3,3,9,"Breach,Raze,Cypher,Sova,Omen","Breach,Raze,Phoenix,Omen,Gekko"
Icebox,Da Feng Gou,Hungkuang Falcon,12,14,7,6,8,5,"Breach,Killjoy,Viper,Reyna,Jett","Killjoy,Viper,Omen,Jett,Gekko"
Ascent,Team Kobolds,Five Ace e-Sports,5,13,4,8,5,1,"Sova,Killjoy,Omen,Jett,KAY/O","Sova,Killjoy,Omen,Jett,KAY/O"
Icebox, ROA,ONE Team Esports,9,13,7,3,10,2,"Viper,Sage,Reyna,Gekko,Clove","Killjoy,Viper,Jett,KAY/O,Gekko"
Bind,Cyberking Esports,Team Big BAAM,5,13,4,2,11,1,"Raze,Cypher,Brimstone,Reyna,Skye","Raze,Cypher,Viper,Omen,Skye"
Breeze,FULL SENSE,Team NKT,5,13,2,10,3,3,"Sova,Viper,Jett,Yoru,Astra","Cypher,Sova,Viper,Jett,KAY/O"
Ascent,OLD STINKY CAT,Tyrant Esports PH,13,10,8,3,7,5,"Breach,Killjoy,Viper,Skye,Clove","Sova,Killjoy,Reyna,Omen,Jett"
Lotus,NEXGA,Please Don't Fire,13,8,10,2,6,3,"Breach,Sova,Killjoy,Omen,Jett","Breach,Raze,Omen,Jett,Skye"
Ascent,Da Feng Gou,Hungkuang Falcon,5,13,3,9,4,2,"Sova,Killjoy,Omen,Jett,KAY/O","Sova,Killjoy,Omen,Jett,KAY/O"
Sunset,Team Kobolds,Five Ace e-Sports,13,10,3,9,1,10,"Cypher,Sova,Omen,Jett,KAY/O","Breach,Raze,Cypher,Sova,Omen"
Lotus, ROA,ONE Team Esports,7,13,5,3,10,2,"Raze,Cypher,Omen,Astra,Gekko","Raze,Killjoy,Viper,Omen,Fade"
Ascent,FULL SENSE,Team NKT,13,3,4,0,3,9,"Sova,Killjoy,Omen,Jett,KAY/O","Raze,Viper,Omen,Fade,Gekko"
Sunset,Team Flash,Unicorn Cyber Esports,13,3,4,0,3,9,"Breach,Raze,Cypher,Omen,Gekko","Breach,Raze,Cypher,Omen,Gekko"
Bind,Sengoku Gaming,FENNEL,13,8,8,1,7,5,"Raze,Viper,Brimstone,Sage,Skye","Viper,Brimstone,Yoru,Fade,Gekko"
Sunset,Avernus Esports,Carti World,10,13,6,6,7,4,"Breach,Raze,Cypher,Omen,Fade","Breach,Raze,Cypher,Omen,Gekko"
Split,Team Flash,Unicorn Cyber Esports,13,8,9,3,5,4,"Raze,Viper,Omen,Jett,Skye","Raze,Cypher,Viper,Omen,Skye"
Breeze,Dplus Esports,SLT Seongam,13,6,10,2,4,3,"Cypher,Sova,Viper,Yoru,KAY/O","Cypher,Sova,Viper,Jett,KAY/O"
Sunset,Sengoku Gaming,FENNEL,13,9,6,6,3,7,"Breach,Raze,Cypher,Sova,Omen","Cypher,Sova,Omen,KAY/O,Neon"
Sunset,Alter Ego,Cynical,13,2,3,0,2,10,"Breach,Raze,Cypher,Omen,Gekko","Breach,Raze,Cypher,Omen,Fade"
Ascent,Avernus Esports,Carti World,8,13,3,6,7,5,"Breach,Viper,Phoenix,Omen,KAY/O","Sova,Killjoy,Omen,Jett,KAY/O"
Sunset,Dplus Esports,SLT Seongam,13,9,8,4,5,5,"Cypher,Sova,Omen,Jett,KAY/O","Breach,Raze,Cypher,Sova,Omen"
Lotus,Alter Ego,Cynical,13,8,6,3,5,7,"Raze,Cypher,Viper,Omen,Skye","Breach,Raze,Cypher,Omen,Fade"
Lotus,Avernus Esports,Carti World,13,9,7,3,6,6,"Raze,Killjoy,Viper,Omen,Fade","Raze,Killjoy,Viper,Omen,Fade"
Icebox,SCARZ,VARREL,6,13,4,3,10,2,"Raze,Killjoy,Viper,KAY/O,Gekko","Sova,Killjoy,Viper,Reyna,Gekko"
Lotus,Doa Ibu Selamanya,THE HERO DETA,5,13,2,4,9,3,"Raze,Viper,Omen,Skye,Chamber","Raze,Killjoy,Viper,Omen,Fade"
Split,Superfect Esports Academy,Sin Prisa Gaming,7,13,2,6,7,5,"Raze,Omen,Jett,Skye,Astra","Raze,Cypher,Omen,Fade,Deadlock"
Ascent,JustUs,Subversive,13,5,10,2,3,3,"Sova,Killjoy,Omen,Jett,KAY/O","Sova,Killjoy,Omen,Jett,KAY/O"
Lotus,SCARZ,VARREL,12,14,8,5,9,4,"Breach,Raze,Sova,Killjoy,Omen","Raze,Killjoy,Viper,Omen,Fade"
Sunset,Superfect Esports Academy,Sin Prisa Gaming,1,13,0,2,11,1,"Raze,Cypher,Sova,Omen,KAY/O","Breach,Raze,Cypher,Gekko,Clove"
Sunset,Doa Ibu Selamanya,THE HERO DETA,11,13,6,6,7,5,"Raze,Cypher,Sage,Omen,Gekko","Breach,Raze,Cypher,Omen,Gekko"
Split,JustUs,Subversive,13,7,5,3,4,8,"Raze,Cypher,Omen,Skye,KAY/O","Breach,Raze,Viper,Omen,Fade"
Lotus,ARF TEAM,Le Crapaud,13,8,4,5,3,9,"Raze,Killjoy,Viper,Omen,Skye","Breach,Raze,Killjoy,Omen,Skye"
Sunset,ARF TEAM,Le Crapaud,13,10,5,6,4,8,"Breach,Raze,Cypher,Omen,Gekko","Breach,Raze,Cypher,Omen,Gekko"
Bind,Dexterity Gaming,the Krash outs,8,13,5,7,6,3,"Raze,Viper,Brimstone,Skye,Gekko","Raze,Cypher,Skye,Iso,Clove"
Lotus,Jack n Frens ,Dexterity Gaming,7,13,4,4,9,3,"Breach,Raze,Killjoy,Omen,Neon","Breach,Raze,Cypher,Omen,Fade"
Lotus,the Krash outs,Team Digital,13,6,6,1,5,7,"Raze,Killjoy,Gekko,Iso,Clove","Raze,Viper,Omen,Fade,Deadlock"
Ascent,The GRID,Dexterity Gaming,12,14,5,8,6,7,"Sova,Killjoy,Omen,Jett,KAY/O","Cypher,Sova,Omen,Jett,KAY/O"
Haven,Outlast Gaming,Team Digital,9,13,4,6,7,5,"Breach,Sova,Killjoy,Omen,Neon","Sage,Skye,Astra,KAY/O,Neon"
Bind,Brute Force,Jack n Frens ,12,14,7,6,8,5,"Raze,Omen,Skye,Gekko,Deadlock","Raze,Viper,Brimstone,Skye,Iso"
Bind,Blinn Esports,SaD Esports,13,11,8,4,7,5,"Raze,Viper,Brimstone,KAY/O,Gekko","Raze,Cypher,Viper,Brimstone,Skye"
Lotus,CSU Vikes Green ,the Krash outs,8,13,4,8,5,4,"Breach,Killjoy,Omen,Neon,Gekko","Raze,Killjoy,Gekko,Iso,Clove"
Icebox,Reformed GC,FlyQuest RED,6,13,3,4,9,3,"Killjoy,Viper,Sage,Jett,Gekko","Sova,Killjoy,Viper,Sage,Gekko"
Bind,Volcano Gang,Dexterity Gaming,12,14,8,5,9,4,"Raze,Cypher,Viper,Brimstone,Skye","Raze,Viper,Brimstone,Skye,Gekko"
Ascent,The GRID,Risk,13,5,8,4,1,5,"Sova,Killjoy,Omen,Jett,KAY/O","Cypher,Sova,Omen,Jett,KAY/O"
Lotus,the Krash outs,Hyperion Gold,13,2,10,2,0,3,"Raze,Killjoy,Gekko,Iso,Clove","Raze,Killjoy,Viper,Omen,Fade"
Lotus,Akatsuki Aimers,Outlast Gaming,6,13,5,7,6,1,"Raze,Cypher,Omen,Gekko,Iso","Killjoy,Viper,Omen,Skye,Neon"
Bind,Flare,Team Digital,11,13,8,4,9,3,"Breach,Raze,Brimstone,Neon,Gekko","Raze,Viper,Brimstone,Fade,Gekko"
Ascent,Brute Force,Goated,13,6,4,3,3,9,"Cypher,Sova,Omen,Jett,KAY/O","Sova,Killjoy,Omen,Jett,KAY/O"
Split,Blinn Esports,SaD Esports,7,13,1,7,6,6,"Raze,Cypher,Viper,Omen,Skye","Raze,Yoru,Astra,Fade,Deadlock"
Sunset,Jack n Frens ,Exegoat e-meowmeow,13,7,6,2,5,7,"Breach,Raze,Cypher,Omen,Neon","Breach,Raze,Cypher,Omen,Gekko"
Sunset,Reformed GC,FlyQuest RED,3,13,3,9,4,0,"Raze,Cypher,Sage,Skye,Astra","Breach,Raze,Cypher,Sova,Omen"
Haven,CSU Vikes Green ,Adderall Addicts,13,9,7,5,4,6,"Breach,Cypher,Sova,Omen,Neon","Breach,Cypher,Sova,Omen,Neon"
Lotus,Somali Pirates,Dexterity Gaming,12,14,6,7,7,6,"Breach,Raze,Killjoy,Omen,Fade","Breach,Raze,Killjoy,Omen,Fade"
Ascent,Baby Goats,The GRID,10,13,6,5,8,4,"Sova,Killjoy,Omen,Jett,KAY/O","Sova,Killjoy,Omen,Jett,KAY/O"
Lotus,Volcano Gang,Defiant Ducklings,13,11,5,7,4,8,"Breach,Raze,Killjoy,Omen,Gekko","Breach,Raze,Cypher,Omen,Deadlock"
Haven,Jack n Frens ,ST x WTP,13,7,7,1,6,6,"Sova,Killjoy,Reyna,Omen,Jett","Breach,Cypher,Sova,Omen,Neon"
Lotus,Akatsuki Aimers,ShaBoingBoing Esports,13,6,7,5,1,6,"Raze,Cypher,Omen,Gekko,Iso","Breach,Raze,Killjoy,Omen,Gekko"
Ascent,Outlast Gaming,Neglected,13,3,4,0,3,9,"Sova,Killjoy,Omen,Jett,KAY/O","Sova,Killjoy,Omen,Jett,KAY/O"
Haven,Hyperion Gold,Washed Up,13,9,8,4,5,5,"Breach,Sova,Killjoy,Astra,Neon","Cypher,Omen,Skye,Neon,Iso"
Bind,Sky Esports (NA),Team Digital,3,13,3,9,4,0,"Raze,Cypher,Brimstone,Skye,Gekko","Raze,Viper,Brimstone,Fade,Gekko"
Bind,6ix Stock,Flare,8,13,5,4,9,3,"Raze,Cypher,Astra,Fade,Gekko","Breach,Raze,Brimstone,Neon,Gekko"
Sunset,the Krash outs,Borpa,13,2,11,1,1,2,"Raze,Cypher,Neon,Iso,Clove","Cypher,Reyna,Yoru,Gekko,Clove"
Lotus,2Game Esports,The7,13,8,5,4,4,8,"Breach,Killjoy,Omen,Neon,Fade","Breach,Raze,Omen,Jett,Skye"
Haven,Brute Force,Forsaken Shadows,13,6,4,3,3,9,"Breach,Cypher,Sova,Neon,Clove","Breach,Sova,Killjoy,Omen,Jett"
Bind,Supernova Nebula,Risk,11,13,6,6,7,5,"Breach,Raze,Cypher,Brimstone,Gekko","Raze,Cypher,Brimstone,Skye,Fade"
Lotus,Omnipotence,Exegoat e-meowmeow,9,13,5,7,6,4,"Breach,Raze,Killjoy,Omen,Fade","Breach,Killjoy,Omen,Neon,Gekko"
Lotus,CSU Vikes Green ,Shameless Timing,13,3,9,3,0,4,"Breach,Killjoy,Omen,Neon,Gekko","Killjoy,Reyna,Jett,Astra,Gekko"
Sunset,Blinn Esports,SaD Esports,14,12,7,6,6,7,"Breach,Raze,Cypher,Omen,Gekko","Breach,Raze,Cypher,Sova,Omen"
Ascent,All Knights,9z Team,13,7,7,1,6,6,"Sova,Killjoy,Omen,Jett,KAY/O","Killjoy,Viper,Omen,Jett,Skye"
Breeze,Solstice GC,mesos millionaires,13,10,9,3,7,4,"Sova,Viper,Jett,Astra,KAY/O","Cypher,Sova,Viper,Reyna,Jett"
Icebox,RYZE CANADA,ST x WTP,10,13,3,8,5,7,"Sova,Killjoy,Viper,Harbor,Gekko","Sova,Killjoy,Viper,Reyna,Jett"
Sunset,Team Digital,Conviction,13,3,2,2,1,11,"Breach,Raze,Cypher,Fade,Clove","Breach,Raze,Cypher,Omen,Gekko"
Bind,Vibin Out Vex,Risk,2,13,2,10,3,0,"Raze,Brimstone,Reyna,Fade,Gekko","Raze,Cypher,Brimstone,Skye,Fade"
Icebox,Dexterity Gaming,Luminescent Sapphire,13,7,10,2,5,3,"Sova,Killjoy,Viper,Harbor,Gekko","Killjoy,Viper,Jett,Harbor,Gekko"
Lotus,WasTaken,Defiant Ducklings,7,13,2,6,7,5,"Raze,Killjoy,Viper,Omen,Gekko","Breach,Raze,Cypher,Omen,Deadlock"
Bind,Flare,Bandits NA,13,1,2,0,1,11,"Breach,Raze,Brimstone,Neon,Gekko","Raze,Phoenix,Brimstone,Gekko,Clove"
Haven,USV,ShaBoingBoing Esports,4,13,0,5,8,4,"Breach,Cypher,Sova,Omen,Jett","Breach,Sova,Killjoy,Omen,Neon"
Bind,Goated,Dallas Coyotes,13,2,3,0,2,10,"Raze,Brimstone,Reyna,Skye,Gekko","Viper,Brimstone,Skye,Yoru,Fade"
Sunset,Outlaw Academy,Forsaken Shadows,0,13,0,1,12,0,"Breach,Sova,Viper,Phoenix,Omen","Raze,Cypher,Omen,KAY/O,Gekko"
Bind,The GRID,guady e amigos,13,6,3,4,2,10,"Raze,Cypher,Gekko,Deadlock,Clove","Raze,Viper,Brimstone,Fade,Gekko"
Ascent,GroundX,Neglected,5,13,2,4,9,3,"Sova,Killjoy,Omen,Jett,KAY/O","Sova,Killjoy,Omen,Jett,KAY/O"
Sunset,1 carry and 4 boosted,Washed Up,0,13,0,1,12,0,"Raze,Cypher,Omen,KAY/O,Gekko","Cypher,Sova,Omen,Neon,Iso"
Ascent,Variety,Shameless Timing,2,13,0,3,10,2,"Killjoy,Phoenix,Omen,Jett,Fade","Sova,Killjoy,Jett,Gekko,Clove"
Ascent,Borpa,The 5 Musketeers,13,1,11,1,0,2,"Sova,Killjoy,Omen,Jett,KAY/O","Sova,Killjoy,Phoenix,Astra,KAY/O"
Ascent,Exegoat e-meowmeow,Labyrinth Red,13,4,8,4,0,5,"Sova,Killjoy,Omen,Jett,KAY/O","Sova,Killjoy,Omen,Jett,KAY/O"
Bind,2Game Esports,The7,13,11,6,6,5,7,"Raze,Viper,Brimstone,Fade,Gekko","Raze,Viper,Brimstone,Skye,Chamber"
Sunset,Solstice GC,mesos millionaires,13,3,2,2,1,11,"Raze,Cypher,Omen,Gekko,Clove","Raze,Cypher,Sova,Gekko,Clove"
Icebox,YFP Gaming,DarkZero Esports,10,13,3,8,5,7,"Sova,Killjoy,Viper,Reyna,Clove","Killjoy,Viper,Jett,KAY/O,Gekko"
Lotus,All Knights,9z Team,13,11,7,5,6,6,"Raze,Killjoy,Viper,Omen,Fade","Breach,Raze,Cypher,Omen,Fade"
Sunset,HOF Esports,PPP,4,13,0,5,8,4,"Breach,Raze,Cypher,Sova,Omen","Breach,Raze,Cypher,Omen,Gekko"
Ascent,Solstice GC,mesos millionaires,9,13,5,5,8,4,"Sova,Killjoy,Omen,Jett,KAY/O","Sova,Killjoy,Jett,Astra,KAY/O"
Ascent,Hero Base,Stellae Gaming,6,13,3,9,4,3,"Breach,Viper,Omen,Jett,KAY/O","Sova,Killjoy,Omen,Jett,KAY/O"
Sunset,YFP Gaming,DarkZero Esports,12,14,7,6,8,5,"Breach,Raze,Cypher,Omen,Gekko","Breach,Raze,Cypher,Omen,Gekko"
Sunset,Zen Esports,OXEN,11,13,8,4,9,3,"Breach,Raze,Cypher,Omen,Gekko","Viper,Sage,Omen,KAY/O,Gekko"
Ascent,XPERION NXT,Permitta Unicorns,13,9,5,5,4,8,"Sova,Killjoy,Omen,Jett,KAY/O","Sova,Killjoy,Omen,Jett,KAY/O"
Breeze,FTW LEÇA FC,EX0TIK GAMING,2,13,0,3,10,2,"Cypher,Sova,Viper,Jett,KAY/O","Cypher,Sova,Viper,Jett,Yoru"
Sunset,Hero Base,Stellae Gaming,9,13,4,8,5,5,"Breach,Raze,Viper,Omen,KAY/O","Breach,Raze,Cypher,Omen,Gekko"
Lotus,YFP Gaming,DarkZero Esports,13,6,8,4,2,5,"Breach,Cypher,Neon,Gekko,Clove","Breach,Raze,Cypher,Omen,Fade"
Lotus,XPERION NXT,Permitta Unicorns,10,13,9,3,10,1,"Raze,Viper,Omen,Chamber,Fade","Breach,Raze,Killjoy,Omen,Fade"
Icebox,FUZOS,SAW,10,13,6,5,8,4,"Killjoy,Viper,Jett,KAY/O,Gekko","Sova,Killjoy,Viper,Sage,Jett"
Bind,Zen Esports,OXEN,12,14,7,6,8,5,"Raze,Viper,Brimstone,Skye,Chamber","Raze,Viper,Omen,Skye,KAY/O"
Breeze,Galatasaray Esports,S2G Esports,13,6,6,1,5,7,"Cypher,Sova,Viper,Jett,KAY/O","Cypher,Sova,Viper,Jett,Yoru"
Icebox,HEROIC Valkyries,NASR Ignite,11,13,9,3,10,2,"Killjoy,Viper,Jett,KAY/O,Gekko","Sova,Killjoy,Viper,Jett,Gekko"
Breeze,Zero Tenacity,Acend,13,10,4,8,2,9,"Sova,Viper,Jett,Yoru,Astra","Cypher,Sova,Viper,Jett,KAY/O"
Sunset,Impulse GW,GTZ Esports,13,2,10,2,0,3,"Viper,Sage,Omen,KAY/O,Gekko","Breach,Raze,Cypher,Omen,Gekko"
Bind,Andromeda Gaming,EXO Clan,13,11,6,6,5,7,"Raze,Viper,Brimstone,Skye,Gekko","Raze,Viper,Omen,Skye,KAY/O"
Ascent,HEROIC Valkyries,NASR Ignite,4,13,3,9,4,1,"Sova,Killjoy,Omen,Jett,KAY/O","Cypher,Sova,Phoenix,Omen,Jett"
Bind,INF Esports,Reveal Multigaming,13,11,8,4,7,5,"Raze,Viper,Brimstone,Skye,Gekko","Raze,Cypher,Brimstone,Skye,Gekko"
Breeze,XPERION NXT,Permitta Unicorns,19,17,11,7,10,8,"Cypher,Sova,Viper,Yoru,Clove","Cypher,Sova,Viper,Jett,Harbor"
Lotus,QUE PASA,Lootcifer,4,13,2,10,3,2,"Cypher,Omen,Yoru,Neon,Gekko","Breach,Cypher,Omen,Jett,KAY/O"
Lotus,Galatasaray Esports,S2G Esports,17,15,9,7,8,8,"Raze,Killjoy,Yoru,Astra,Fade","Raze,Killjoy,Viper,Omen,Fade"
Split,QUE PASA,Lootcifer,1,13,1,11,2,0,"Raze,Cypher,Omen,Jett,Skye","Breach,Cypher,Omen,Neon,Iso"
Ascent,INF Esports,Reveal Multigaming,13,4,8,4,0,5,"Breach,Viper,Brimstone,Sage,Neon","Cypher,Sova,Killjoy,Omen,Jett"
Lotus,Andromeda Gaming,EXO Clan,13,8,7,5,3,6,"Breach,Raze,Killjoy,Omen,Fade","Raze,Killjoy,Viper,Omen,Fade"
Split,Unity Esports,The Ultimates,12,14,4,9,5,8,"Raze,Cypher,Viper,Omen,Skye","Breach,Raze,Viper,Omen,Fade"
Sunset,Zero Tenacity,Acend,17,15,5,11,4,12,"Raze,Cypher,Sova,Omen,KAY/O","Raze,Cypher,Omen,KAY/O,Gekko"
Lotus,Melilla Titans,Wygers,13,8,6,6,2,7,"Killjoy,Viper,Omen,Neon,Fade","Reyna,Chamber,Neon,Gekko,Clove"
Bind,Underground Gaming,Dragons Esports,13,6,4,3,3,9,"Raze,Cypher,Viper,Omen,Skye","Raze,Viper,Brimstone,Skye,Chamber"
Icebox,SZK Esports,Team Galaga,10,13,9,3,10,1,"Killjoy,Viper,Jett,KAY/O,Gekko","Sova,Killjoy,Viper,Sage,Jett"
Ascent,Team Kobolds,ONE Team Esports,13,5,9,3,2,4,"Sova,Killjoy,Omen,Jett,KAY/O","Sova,Killjoy,Omen,Jett,KAY/O"
Split,FOKUS,Ovation eSports,13,5,7,5,0,6,"Raze,Omen,Yoru,Astra,Fade","Breach,Cypher,Viper,Omen,Jett"
Icebox,Galakticos,Istanbul Wildcats,13,6,7,5,1,6,"Sova,Omen,Jett,KAY/O,Clove","Killjoy,Jett,KAY/O,Harbor,Gekko"
Lotus,Underground Gaming,Dragons Esports,13,2,3,0,2,10,"Raze,Killjoy,Omen,Fade,Gekko","Raze,Killjoy,Viper,Omen,Fade"
Lotus,Unity Esports,The Ultimates,6,13,4,3,10,2,"Breach,Cypher,Sova,Omen,Jett","Raze,Killjoy,Viper,Omen,Fade"
Icebox,Melilla Titans,Wygers,13,3,11,1,2,2,"Killjoy,Viper,Yoru,Harbor,Gekko","Sova,Viper,Reyna,Jett,Chamber"
Icebox,INF Esports,Reveal Multigaming,11,13,7,5,8,4,"Sova,Killjoy,Viper,Omen,Jett","Sova,Killjoy,Viper,Jett,Clove"
Split,SZK Esports,Team Galaga,2,13,2,10,3,0,"Raze,Cypher,Viper,Omen,Skye","Raze,Cypher,Omen,Jett,Skye"
Bind,Team Falcons Vega,Odd 1 OUT,13,11,3,9,2,10,"Raze,Viper,Brimstone,Skye,Gekko","Breach,Cypher,Sova,Omen,Neon"
Ascent,FOKUS,Ovation eSports,13,1,2,0,1,11,"Sova,Killjoy,Omen,Jett,KAY/O","Sova,Killjoy,Omen,Jett,KAY/O"
Icebox,GoNext Esports,NOM Esports,13,8,5,7,1,8,"Sova,Killjoy,Viper,Sage,Jett","Sova,Killjoy,Viper,Sage,Jett"
Breeze,Galakticos,Istanbul Wildcats,13,2,10,2,0,3,"Cypher,Sova,Viper,Jett,Yoru","Cypher,Sova,Viper,Omen,Yoru"
Sunset,Team Kobolds,ONE Team Esports,11,13,8,4,9,3,"Cypher,Sova,Omen,Jett,KAY/O","Raze,Cypher,Omen,KAY/O,Gekko"
Sunset,SZK Esports,Team Galaga,13,8,3,6,2,10,"Breach,Cypher,Omen,Neon,Gekko","Breach,Raze,Cypher,Omen,Gekko"
Lotus,GoNext Esports,NOM Esports,13,10,8,3,7,5,"Breach,Sova,Killjoy,Omen,Jett","Raze,Killjoy,Viper,Omen,Fade"
Sunset,Team Falcons Vega,Odd 1 OUT,13,10,8,4,6,5,"Breach,Raze,Cypher,Omen,Gekko","Cypher,Sova,KAY/O,Neon,Clove"
Ascent,XERXIA Esports, Santa Gang,13,8,6,3,5,7,"Sova,Killjoy,Omen,Jett,KAY/O","Sova,Killjoy,Omen,Jett,KAY/O"
Lotus,Team Kobolds,ONE Team Esports,15,13,6,8,5,9,"Breach,Raze,Killjoy,Omen,Skye","Raze,Killjoy,Viper,Omen,Fade"
Icebox,XERXIA Esports, Santa Gang,13,3,4,0,3,9,"Killjoy,Viper,Jett,KAY/O,Gekko","Sova,Killjoy,Viper,Jett,Harbor"
Bind,Elevate (SG),Disguised,16,14,8,7,7,8,"Raze,Cypher,Viper,Brimstone,KAY/O","Raze,Viper,Omen,Skye,Yoru"
Icebox,Fancy United Esports,Rapid Lofi,13,5,8,4,1,5,"Cypher,Viper,KAY/O,Gekko,Clove","Sova,Killjoy,Viper,Jett,KAY/O"
Icebox,True Rippers,Reckoning Esports,13,5,11,1,4,2,"Sova,Killjoy,Viper,Jett,Gekko","Sova,Killjoy,Viper,Sage,Jett"
Split, ROA,Hungkuang Falcon,10,13,7,5,8,3,"Breach,Raze,Reyna,Omen,Yoru","Raze,Cypher,Omen,Jett,Skye"
Bind,XERXIA Esports, Santa Gang,8,13,3,6,7,5,"Raze,Viper,Brimstone,Skye,Gekko","Raze,Viper,Brimstone,Skye,Gekko"
Lotus,Elevate (SG),Disguised,13,10,10,1,9,3,"Raze,Killjoy,Viper,Omen,Fade","Raze,Viper,Omen,Chamber,Fade"
Ascent,PAPA ESPORTS,Five Ace e-Sports,7,13,1,7,6,6,"Sova,Killjoy,Omen,Jett,KAY/O","Sova,Killjoy,Omen,Jett,KAY/O"
Ascent,True Rippers,Reckoning Esports,13,4,5,0,4,8,"Sova,Killjoy,Omen,Jett,KAY/O","Sova,Killjoy,Omen,Jett,KAY/O"
Ascent,Fancy United Esports,Rapid Lofi,13,6,3,4,2,10,"Killjoy,Viper,Omen,Jett,KAY/O","Cypher,Omen,Jett,KAY/O,Gekko"
Icebox,PAPA ESPORTS,Five Ace e-Sports,13,4,8,4,0,5,"Sova,Killjoy,Viper,Reyna,Jett","Sova,Viper,Sage,Reyna,Chamber"
Icebox,Made in Thailand,Barn nong chok,13,5,9,3,2,4,"Sova,Killjoy,Viper,Sage,Jett","Sova,Killjoy,Viper,Sage,Jett"
Lotus, ROA,Hungkuang Falcon,16,14,8,7,7,8,"Raze,Cypher,Omen,Astra,Gekko","Raze,Killjoy,Viper,Omen,Fade"
Bind,Ninjas in Galaxy,Reve Drift Arena,12,14,9,4,10,3,"Raze,Cypher,Brimstone,Reyna,Skye","Raze,Cypher,Brimstone,Skye,Gekko"
Split,Da Feng Gou,Oblivion Force,5,13,3,3,10,2,"Raze,Viper,Sage,Omen,Fade","Raze,Cypher,Omen,Jett,Skye"
Lotus,Sengoku Gaming,REJECT,16,14,12,3,11,4,"Raze,Killjoy,Viper,Omen,Fade","Raze,Killjoy,Viper,Omen,Fade"
Lotus,LAZY,Crocodile Tear,13,4,5,0,4,8,"Raze,Killjoy,Viper,Omen,Fade","Raze,Killjoy,Viper,Omen,Fade"
Sunset,NAOS Esports,ZOL Esports,13,5,3,3,2,10,"Raze,Cypher,Omen,KAY/O,Gekko","Raze,Cypher,Sova,Omen,KAY/O"
Icebox,Medal Esports,Velocity Gaming,5,13,1,5,8,4,"Sova,Killjoy,Viper,Jett,Gekko","Sova,Killjoy,Viper,Sage,Jett"
Bind,Team IAM,VEC DAEJEON,13,8,6,3,5,7,"Raze,Brimstone,Yoru,Harbor,Gekko","Breach,Raze,Cypher,Brimstone,Skye"
Lotus,Ninjas in Galaxy,Reve Drift Arena,4,13,2,10,3,2,"Raze,Killjoy,Omen,Jett,Fade","Raze,Cypher,Viper,Omen,Skye"
Icebox, ROA,Hungkuang Falcon,4,13,3,9,4,1,"Viper,Sage,Reyna,Gekko,Clove","Killjoy,Viper,Omen,Jett,Gekko"
Lotus,PAPA ESPORTS,Five Ace e-Sports,10,13,7,5,8,3,"Raze,Killjoy,Viper,Omen,Fade","Raze,Killjoy,Viper,Omen,Fade"
Lotus,Da Feng Gou,Oblivion Force,5,13,4,8,5,1,"Raze,Killjoy,Viper,Omen,Fade","Raze,Viper,Omen,Chamber,Fade"
Lotus,Made in Thailand,Barn nong chok,13,7,7,1,6,6,"Raze,Killjoy,Viper,Omen,Gekko","Raze,Killjoy,Viper,Omen,Fade"
Ascent,LAZY,Crocodile Tear,6,13,4,8,5,2,"Sova,Killjoy,Omen,Jett,KAY/O","Sova,Killjoy,Omen,Jett,KAY/O"
Icebox,NAOS Esports,ZOL Esports,13,6,10,2,4,3,"Killjoy,Viper,Jett,KAY/O,Gekko","Sova,Killjoy,Viper,Jett,KAY/O"
Breeze,Medal Esports,Velocity Gaming,6,13,1,6,7,5,"Cypher,Sova,Viper,Jett,KAY/O","Cypher,Sova,Viper,Jett,KAY/O"
Breeze,Sengoku Gaming,REJECT,12,14,5,8,6,7,"Cypher,Sova,Viper,Yoru,KAY/O","Sova,Viper,Jett,Yoru,Astra"
Icebox,Team IAM,VEC DAEJEON,13,6,6,1,5,7,"Killjoy,Viper,Jett,KAY/O,Gekko","Killjoy,Viper,Reyna,KAY/O,Gekko"
Sunset,LAZY,Crocodile Tear,13,7,5,3,4,8,"Raze,Cypher,Omen,KAY/O,Gekko","Raze,Cypher,Omen,KAY/O,Gekko"
Breeze,ARF TEAM,Bigetron Arctic,14,16,9,6,10,5,"Cypher,Sova,Viper,Yoru,Astra","Cypher,Sova,Viper,Omen,Yoru"
Ascent,Medal Esports,Velocity Gaming,13,7,6,2,5,7,"Sova,Killjoy,Omen,Jett,KAY/O","Breach,Raze,Sova,Killjoy,Omen"
Icebox,OLD STINKY CAT,Carti World,10,13,5,7,6,5,"Killjoy,Viper,Jett,Gekko,Clove","Sova,Killjoy,Viper,Jett,Gekko"
Sunset,ARF TEAM,Bigetron Arctic,9,13,5,5,8,4,"Breach,Raze,Cypher,Omen,Gekko","Breach,Raze,Cypher,Omen,Gekko"
Ascent,Sengoku Gaming,REJECT,16,14,10,5,9,6,"Sova,Killjoy,Omen,Jett,KAY/O","Sova,Killjoy,Omen,Jett,KAY/O"
Sunset,OLD STINKY CAT,Carti World,7,13,4,8,5,3,"Breach,Raze,Cypher,Omen,Gekko","Breach,Raze,Cypher,Omen,Gekko"
Split,Nongshim RedForce,FearX,13,8,8,4,4,5,"Raze,Omen,Jett,Skye,Astra","Raze,Cypher,Omen,Jett,Skye"
Bind,ARF TEAM,Bigetron Arctic,13,9,5,5,4,8,"Raze,Cypher,Brimstone,Reyna,Skye","Raze,Cypher,Viper,Brimstone,Skye"
Ascent,NORTHEPTION,FENNEL,5,13,1,5,8,4,"Sova,Killjoy,Omen,Jett,KAY/O","Sova,Killjoy,Omen,Jett,KAY/O"
Ascent,BOOM Esports,Doa Ibu Selamanya,13,6,8,4,2,5,"Sova,Killjoy,Omen,Jett,KAY/O","Sova,Killjoy,Omen,Jett,KAY/O"
Icebox,Rank El Cuties,Tyrant Esports PH,13,8,6,3,5,7,"Killjoy,Viper,Reyna,Omen,Gekko","Sage,Jett,Yoru,KAY/O,Harbor"
Sunset,NORTHEPTION,FENNEL,5,13,1,5,8,4,"Breach,Raze,Cypher,Sage,Astra","Cypher,Sova,Omen,KAY/O,Neon"
Ascent,Nongshim RedForce,FearX,15,13,8,6,7,7,"Viper,Yoru,Fade,Gekko,Clove","Sova,Killjoy,Omen,Jett,KAY/O"
Lotus,BOOM Esports,Doa Ibu Selamanya,13,2,3,0,2,10,"Raze,Killjoy,Viper,Omen,Fade","Raze,Viper,Omen,Skye,Chamber"
Ascent,Rank El Cuties,Tyrant Esports PH,13,11,6,6,5,7,"Sova,Killjoy,Omen,Jett,KAY/O","Sova,Killjoy,Reyna,Omen,Jett"
Split,Cynical,Le Crapaud,13,7,7,1,6,6,"Raze,Cypher,Viper,Omen,Skye","Breach,Raze,Cypher,Omen,Jett"
Lotus,Cynical,Le Crapaud,13,10,6,5,5,7,"Breach,Raze,Cypher,Omen,Fade","Breach,Raze,Killjoy,Omen,Skye"
Sunset,XLD Gaming,Legacy,13,9,5,7,2,8,"Breach,Raze,Cypher,Sova,Omen","Breach,Raze,Cypher,Omen,Gekko"
Sunset,Shopify Rebellion,Reformed GC,13,7,8,0,7,5,"Breach,Raze,Cypher,Omen,Gekko","Raze,Cypher,Sage,Skye,Astra"
Bind,XLD Gaming,Legacy,6,13,5,7,6,1,"Raze,Viper,Brimstone,Skye,Gekko","Raze,Viper,Brimstone,Skye,Gekko"
Bind,Shopify Rebellion,Reformed GC,13,6,9,3,3,4,"Raze,Brimstone,Skye,Harbor,Gekko","Raze,Viper,Brimstone,Skye,Deadlock"
Bind,floppers,mesos millionaires,11,13,4,8,5,7,"Breach,Cypher,Brimstone,Skye,Yoru","Raze,Viper,Skye,Chamber,Clove"
Icebox,XLD Gaming,Legacy,13,9,7,3,6,6,"Sova,Killjoy,Viper,Sage,Jett","Sova,Killjoy,Viper,Jett,Gekko"
Ascent,floppers,mesos millionaires,9,13,5,7,6,4,"Omen,Jett,KAY/O,Fade,Deadlock","Sova,Killjoy,Jett,Astra,KAY/O"
Bind,Galorys,TBK Esports,8,13,3,6,7,5,"Raze,Viper,Brimstone,Skye,Chamber","Raze,Viper,Brimstone,Sage,Skye"
Ascent,Passion Project,Solstice GC,13,5,7,5,0,6,"Sova,Killjoy,Omen,Jett,KAY/O","Sova,Killjoy,Omen,Jett,KAY/O"
Breeze,XSOUL,Furious Gaming,11,13,7,5,8,4,"Cypher,Sova,Viper,Jett,KAY/O","Sova,Viper,Jett,Yoru,Astra"
Ascent,Teddy Tactics,FlyQuest RED,6,13,5,7,6,1,"Sova,Killjoy,Omen,Jett,KAY/O","Sova,Killjoy,Omen,Jett,KAY/O"
Lotus,Passion Project,Solstice GC,13,9,7,5,4,6,"Breach,Raze,Killjoy,Omen,Gekko","Raze,Killjoy,Viper,Gekko,Clove"
Icebox,SAW,Impulse GW,11,13,4,8,5,7,"Sova,Killjoy,Viper,Sage,Jett","Killjoy,Viper,Jett,KAY/O,Gekko"
Lotus,Galorys,TBK Esports,3,13,2,2,11,1,"Breach,Raze,Cypher,Omen,Gekko","Raze,Killjoy,Viper,Omen,Fade"
Bind,XSOUL,Furious Gaming,6,13,5,7,6,1,"Raze,Cypher,Viper,Brimstone,Skye","Raze,Viper,Yoru,Harbor,Gekko"
Icebox,Teddy Tactics,FlyQuest RED,3,13,1,3,10,2,"Sova,Killjoy,Viper,Sage,Jett","Sova,Killjoy,Viper,Sage,Gekko"
Icebox,RED Canids,SAGAZ,18,16,13,4,12,5,"Sova,Killjoy,Viper,Sage,Jett","Sova,Killjoy,Viper,Sage,Jett"
Icebox,Dragons Esports GC,Team Falcons Vega,3,13,1,11,2,2,"Sova,Killjoy,Viper,Reyna,Jett","Sova,Killjoy,Viper,Jett,Gekko"
Bind,Twisted Minds Orchid,The Ultimates Odyssey,13,6,7,5,1,6,"Raze,Viper,Brimstone,KAY/O,Gekko","Breach,Raze,Viper,Brimstone,Gekko"
Breeze,GTZ Esports,FTW LEÇA FC,13,7,5,3,4,8,"Cypher,Sova,Viper,Jett,Yoru","Cypher,Sova,Viper,Jett,Yoru"
Split,Dragons Esports GC,Team Falcons Vega,7,13,3,9,4,4,"Breach,Raze,Cypher,Omen,Skye","Breach,Raze,Cypher,Omen,Skye"
Breeze,Galorys,TBK Esports,13,11,7,5,6,6,"Cypher,Sova,Viper,Jett,KAY/O","Cypher,Sova,Viper,Jett,Yoru"
Split,RED Canids,SAGAZ,13,9,2,8,1,11,"Raze,Killjoy,Viper,Skye,Astra","Raze,Cypher,Viper,Omen,Skye"
Ascent,Chipi Chapa's,NOM Esports,9,13,7,5,8,2,"Cypher,Sova,Phoenix,Omen,Jett","Sova,Killjoy,Omen,Jett,KAY/O"
Split,R8 Esports,top gz,13,3,4,0,3,9,"Raze,Cypher,Viper,Omen,Skye","Breach,Raze,Cypher,Deadlock,Clove"
Ascent,All Knights,Zen Esports,13,9,7,5,4,6,"Sova,Killjoy,Omen,Jett,KAY/O","Sova,Killjoy,Omen,Jett,KAY/O"
Bind,NASR Esports,Team Occupy,13,3,9,3,0,4,"Viper,Omen,Yoru,Fade,Gekko","Raze,Cypher,Brimstone,Reyna,Skye"
Sunset,ARROW,POTATO ABUSERS,13,10,8,3,7,5,"Breach,Raze,Cypher,Omen,Gekko","Breach,Raze,Cypher,Omen,Gekko"
Sunset,Twisted Minds Orchid,The Ultimates Odyssey,13,4,5,0,4,8,"Breach,Raze,Cypher,Omen,Gekko","Breach,Raze,Cypher,Omen,Gekko"
Ascent,GIANTX GC,HEROIC Valkyries,13,2,2,1,1,11,"Sova,Killjoy,Omen,Jett,KAY/O","Sova,Killjoy,Omen,Jett,KAY/O"
Split,Onyx Ravens,GAMAX eSports,6,13,3,4,9,3,"Raze,Viper,Omen,Skye,Chamber","Breach,Raze,Cypher,Omen,Fade"
Lotus,R8 Esports,top gz,13,3,11,1,2,2,"Raze,Killjoy,Omen,Skye,Astra","Breach,Raze,Killjoy,Omen,Fade"
Ascent,DIVIZON,SK Gaming,13,5,9,3,2,4,"Sova,Killjoy,Omen,Jett,KAY/O","Breach,Cypher,Omen,Jett,Fade"
Lotus,FOG Vortex,Gamax Lite,2,13,2,10,3,0,"Breach,Raze,Killjoy,Omen,Skye","Breach,Raze,Killjoy,Omen,Fade"
Sunset,Reveal Multigaming Saphire,Sissi State Punks Academy,13,4,5,0,4,8,"Raze,Cypher,Reyna,Gekko,Clove","Raze,Cypher,Sova,Omen,KAY/O"
Lotus,All Knights,Zen Esports,13,3,9,3,0,4,"Raze,Killjoy,Viper,Omen,Fade","Breach,Raze,Sova,Killjoy,Omen"
Icebox,Five Media Clan,Ramboot Club,13,11,5,7,4,8,"Killjoy,Viper,Jett,KAY/O,Gekko","Sova,Killjoy,Viper,Jett,Gekko"
Sunset,LA RUE,RIZON,13,8,7,2,6,6,"Breach,Raze,Cypher,Omen,Gekko","Raze,Cypher,Sova,Omen,KAY/O"
Ascent,NASR Esports,Team Occupy,13,7,6,6,1,7,"Cypher,Sova,Phoenix,Omen,Jett","Sova,Killjoy,Omen,Jett,KAY/O"
Bind,EX0TIK GAMING,HOF Esports,10,13,4,7,6,6,"Raze,Brimstone,Skye,Yoru,Astra","Raze,Viper,Brimstone,Skye,Gekko"
Icebox,ARROW,POTATO ABUSERS,9,13,5,5,8,4,"Sova,Killjoy,Viper,Reyna,Jett","Sova,Killjoy,Viper,Reyna,Jett"
Sunset,Chipi Chapa's,NOM Esports,14,12,11,2,10,3,"Breach,Raze,Cypher,Omen,Yoru","Breach,Raze,Cypher,Omen,Fade"
Icebox,GIANTX GC,HEROIC Valkyries,13,0,12,0,0,1,"Killjoy,Viper,Jett,KAY/O,Gekko","Killjoy,Viper,Jett,KAY/O,Gekko"
Bind,R8 Blues,Team Falcons Vega,13,5,5,1,4,8,"Viper,Phoenix,Sage,Skye,Clove","Raze,Viper,Reyna,Gekko,Clove"
Bind,TeamOrangeGaming,Dortmund Esports,13,2,3,0,2,10,"Raze,Cypher,Brimstone,Sage,Skye","Viper,Omen,Yoru,Gekko,Deadlock"
Breeze,Exceptional Gaming,Novita Esports,13,5,4,2,3,9,"Cypher,Sova,Viper,Jett,KAY/O","Cypher,Sova,Viper,Jett,Yoru"
Icebox,Reveal Multigaming Saphire,Sissi State Punks Academy,9,13,3,7,6,6,"Sova,Killjoy,Viper,Reyna,Jett","Sova,Killjoy,Viper,Omen,Jett"
Split,DIVIZON,SK Gaming,13,10,5,6,4,8,"Breach,Raze,Cypher,Omen,Skye","Breach,Cypher,Sova,Jett,Astra"
Sunset,Onyx Ravens,GAMAX eSports,11,13,8,4,9,3,"Breach,Raze,Cypher,Sova,Omen","Breach,Raze,Cypher,Omen,Fade"
Split,FOG Vortex,Gamax Lite,9,13,3,9,4,6,"Breach,Raze,Cypher,Omen,Jett","Breach,Raze,Cypher,Fade,Clove"
Bind,ARROW,POTATO ABUSERS,13,8,7,5,3,6,"Raze,Cypher,Viper,Skye,Clove","Raze,Viper,Skye,Gekko,Clove"
Bind,HONEYBADGER123,BÖSE BUBEN,13,10,6,5,5,7,"Raze,Viper,Brimstone,Skye,Gekko","Raze,Viper,Brimstone,Yoru,Gekko"
Lotus,PPP,FUZOS,13,2,10,2,0,3,"Breach,Raze,Cypher,Sova,Omen","Breach,Raze,Killjoy,Omen,Fade"
Lotus,LA RUE,RIZON,10,13,3,8,5,7,"Raze,Killjoy,Viper,Omen,Fade","Killjoy,Viper,Omen,Neon,Gekko"
Icebox,UCAN ESPORTS,Sissi State Punks,7,13,2,6,7,5,"Sova,Killjoy,Viper,Jett,Gekko","Sova,Killjoy,Viper,Reyna,Jett"
Breeze,Unity Esports,Twisted Minds Esports,13,10,8,3,7,5,"Breach,Cypher,Sova,Viper,Jett","Sova,Viper,Reyna,Jett,Harbor"
Lotus,Chipi Chapa's,NOM Esports,10,13,8,4,9,2,"Breach,Raze,Sova,Omen,Jett","Raze,Killjoy,Viper,Omen,Fade"
Ascent,Barça eSports,Falke Esports,13,9,5,5,4,8,"Killjoy,Viper,Omen,Jett,Skye","Killjoy,Viper,Omen,Jett,Skye"
Bind,Munich Esports,A One Man Army,3,13,0,4,9,3,"Brimstone,Reyna,Jett,Skye,Deadlock","Raze,Cypher,Viper,Skye,Clove"
Bind,6TM ESPORTS,MAJOR MONOGWAM,2,13,1,2,11,1,"Breach,Raze,Viper,Omen,Gekko","Raze,Cypher,Brimstone,Skye,Gekko"
Ascent,Underground Gaming,Fraggerz,13,11,10,2,9,3,"Sova,Killjoy,Omen,Jett,KAY/O","Sova,Killjoy,Omen,Jett,Skye"
Icebox,R8 Blues,Team Falcons Vega,9,13,8,4,9,1,"Sova,Killjoy,Viper,Sage,Neon","Viper,Reyna,Jett,Chamber,Gekko"
Lotus,Karmine Corp GC,Odd 1 OUT,14,12,6,7,5,8,"Breach,Raze,Killjoy,Omen,Fade","Breach,Raze,Cypher,Sova,Astra"
Bind,Reveal Multigaming Saphire,Sissi State Punks Academy,13,7,7,1,6,6,"Breach,Raze,Cypher,Yoru,Clove","Raze,Cypher,Viper,Brimstone,Skye"
Lotus,UCAN ESPORTS,Sissi State Punks,3,13,2,10,3,1,"Breach,Raze,Killjoy,Omen,Gekko","Breach,Raze,Sova,Killjoy,Omen"
Sunset,Exceptional Gaming,Novita Esports,13,10,5,7,3,8,"Breach,Raze,Cypher,Omen,Gekko","Breach,Cypher,Sova,Omen,Neon"
Ascent,TeamOrangeGaming,Dortmund Esports,15,13,10,4,9,5,"Sova,Killjoy,Omen,Jett,KAY/O","Cypher,Sova,Omen,Jett,Yoru"
Lotus,HONEYBADGER123,BÖSE BUBEN,13,8,3,6,2,10,"Raze,Killjoy,Omen,KAY/O,Gekko","Breach,Raze,Cypher,Sova,Omen"
Ascent,Munich Esports,A One Man Army,4,13,4,8,5,0,"Sova,Killjoy,Omen,Jett,KAY/O","Sova,Killjoy,Jett,KAY/O,Clove"
Lotus,HOWL Esports,Fenerbahçe Esports,13,11,6,6,5,7,"Raze,Cypher,Viper,Omen,Fade","Breach,Raze,Cypher,Omen,Fade"
Icebox,The Ultimates,Dragons Esports,13,6,7,5,1,6,"Sova,Killjoy,Viper,Reyna,Gekko","Sova,Killjoy,Viper,Reyna,Harbor"
Ascent,LA RUE,RIZON,13,10,7,5,5,6,"Sova,Killjoy,Omen,Jett,KAY/O","Sova,Killjoy,Omen,Jett,KAY/O"
Lotus,6TM ESPORTS,MAJOR MONOGWAM,1,13,0,2,11,1,"Breach,Raze,Cypher,Sova,Omen","Breach,Raze,Killjoy,Omen,Gekko"
Bind,Unity Esports,Twisted Minds Esports,7,13,2,6,7,5,"Breach,Raze,Cypher,Omen,Skye","Raze,Brimstone,Reyna,Skye,Harbor"
Sunset,Diamant Esports,ESC Gaming,13,5,5,1,4,8,"Raze,Killjoy,Omen,Astra,Fade","Breach,Raze,Cypher,Omen,KAY/O"
Bind,Eintracht Frankfurt,CGN Esports,11,13,7,5,8,4,"Raze,Viper,Yoru,Gekko,Clove","Raze,Viper,Brimstone,Sage,Gekko"
Icebox,KPI Gaming,Imperium Gaming,13,7,8,4,3,5,"Killjoy,Viper,Jett,KAY/O,Gekko","Killjoy,Viper,Jett,KAY/O,Gekko"
Bind,Underground Gaming,Fraggerz,5,13,2,4,9,3,"Raze,Viper,Omen,Skye,Yoru","Raze,Cypher,Omen,Jett,Skye"
Breeze,Karmine Corp GC,Odd 1 OUT,13,3,3,1,2,10,"Cypher,Sova,Viper,Jett,KAY/O","Cypher,Sova,Jett,KAY/O,Harbor"
Ascent,HOWL Esports,Fenerbahçe Esports,13,7,7,1,6,6,"Cypher,Sova,Omen,Jett,KAY/O","Sova,Killjoy,Omen,Jett,KAY/O"
Ascent,Unity Esports,Twisted Minds Esports,13,11,5,7,4,8,"Breach,Cypher,Sova,Omen,Jett","Sova,Killjoy,Omen,Jett,KAY/O"
Lotus,The Ultimates,Dragons Esports,13,11,8,4,7,5,"Raze,Killjoy,Viper,Omen,Fade","Raze,Killjoy,Viper,Omen,Fade"
Lotus,Underground Gaming,Fraggerz,13,7,9,3,4,4,"Breach,Raze,Killjoy,Omen,Gekko","Raze,Killjoy,Omen,Skye,Gekko"
Bind,Diamant Esports,ESC Gaming,10,13,4,7,6,6,"Raze,Viper,Omen,Skye,Fade","Raze,Cypher,Viper,Brimstone,Skye"
Lotus,ZETA Gaming,UCAM Esports Club,6,13,4,8,5,2,"Breach,Raze,Cypher,Omen,Fade","Breach,Sova,Killjoy,Omen,Jett"
Icebox,Eintracht Frankfurt,CGN Esports,7,13,1,7,6,6,"Sova,Killjoy,Viper,Omen,Jett","Raze,Cypher,Viper,Sage,Jett"
Bind,Kizuna Esports,Please Don't Fire,13,8,9,3,5,4,"Raze,Cypher,Viper,Brimstone,Skye","Raze,Omen,Skye,Harbor,Gekko"
Ascent,Eternal Fire,PCIFIC Espor,4,13,2,10,3,2,"Cypher,Sova,Omen,Jett,KAY/O","Sova,Killjoy,Omen,Jett,KAY/O"
Sunset,Team NKT,Sharper Esports,9,13,5,5,8,4,"Raze,Cypher,Omen,KAY/O,Gekko","Breach,Raze,Sage,Omen,Gekko"
Ascent,Karmine Corp GC,Odd 1 OUT,15,17,7,9,8,8,"Sova,Killjoy,Omen,Jett,KAY/O","Sova,Killjoy,Omen,Jett,KAY/O"
Lotus,Diamant Esports,ESC Gaming,14,12,8,5,7,6,"Raze,Killjoy,Viper,Omen,Skye","Raze,Killjoy,Viper,Omen,Fade"
Sunset,Eternal Fire,PCIFIC Espor,9,13,5,7,6,4,"Breach,Cypher,Sova,Jett,Astra","Breach,Raze,Cypher,Omen,Gekko"
Sunset,Kizuna Esports,Please Don't Fire,14,12,9,4,8,5,"Breach,Raze,Cypher,Omen,Gekko","Breach,Raze,Phoenix,Omen,Gekko"
Breeze,Team NKT,Sharper Esports,13,5,4,2,3,9,"Cypher,Sova,Viper,Jett,KAY/O","Sova,Viper,Yoru,Astra,KAY/O"
Bind,Team NKT,Sharper Esports,12,14,8,5,9,4,"Raze,Viper,Brimstone,Skye,Gekko","Raze,Viper,Brimstone,Fade,Gekko"
Haven,NEXGA,LaZe,11,13,8,4,9,3,"Breach,Sova,Killjoy,Omen,Jett","Breach,Cypher,Sova,Omen,Jett"
Lotus,FULL SENSE,XOXO-01,13,4,4,1,3,9,"Raze,Killjoy,Viper,Omen,Gekko","Raze,Killjoy,Viper,Omen,Fade"
Lotus,NEXGA,LaZe,13,6,9,3,3,4,"Breach,Sova,Killjoy,Omen,Jett","Breach,Raze,Sova,Killjoy,Omen"
Sunset,NEXGA,LaZe,9,13,2,8,5,7,"Breach,Raze,Cypher,Sova,Omen","Breach,Raze,Cypher,Sova,Omen"
Icebox,SCARZ,RIDDLE ORDER,13,7,3,5,2,10,"Raze,Killjoy,Viper,KAY/O,Gekko","Viper,Omen,Jett,KAY/O,Gekko"
Sunset,FULL SENSE,XOXO-01,13,9,9,3,6,4,"Breach,Raze,Cypher,Omen,Gekko","Raze,Cypher,Omen,KAY/O,Gekko"
Lotus,Justice For Tomorrow,iPGN,3,13,2,10,3,1,"Raze,Killjoy,Viper,Omen,Fade","Breach,Raze,Killjoy,Omen,Fade"
Icebox,Velocity Gaming,Alternate Realities,13,11,7,5,6,6,"Sova,Killjoy,Viper,Sage,Jett","Sova,Killjoy,Viper,Reyna,Jett"
Bind,Rub n' Pug,Wolf Pack (OCE),13,3,2,2,1,11,"Raze,Jett,Astra,KAY/O,Gekko","Raze,Viper,Omen,Skye,Deadlock"
Bind,SCARZ,RIDDLE ORDER,13,9,8,4,5,5,"Raze,Viper,Brimstone,Skye,Gekko","Raze,Viper,Brimstone,Fade,Gekko"
Ascent,Xu Gang,Tiny Turtle Squad,5,13,3,9,4,2,"Sova,Killjoy,Omen,Jett,KAY/O","Breach,Sova,Killjoy,Omen,Jett"
Icebox,JiJieHao Bonkers,Peace & Love,13,10,8,4,6,5,"Killjoy,Viper,Jett,KAY/O,Gekko","Sova,Killjoy,Viper,Reyna,Jett"
Bind,Justice For Tomorrow,iPGN,8,13,5,7,6,3,"Raze,Viper,Brimstone,Fade,Gekko","Raze,Viper,Brimstone,Fade,Gekko"
Sunset,Velocity Gaming,Alternate Realities,13,6,7,5,1,6,"Breach,Raze,Cypher,Omen,Gekko","Raze,Cypher,Omen,KAY/O,Gekko"
Lotus,Rub n' Pug,Wolf Pack (OCE),14,12,10,3,9,4,"Raze,Omen,KAY/O,Neon,Gekko","Breach,Raze,Killjoy,Viper,Omen"
Lotus,Bandits OCE,Koopa Troopas,3,13,3,9,4,0,"Breach,Raze,Killjoy,Omen,Fade","Raze,Killjoy,Viper,Omen,Fade"
Lotus,BOBO,EDGE (OCE),13,6,5,2,4,8,"Raze,Killjoy,Viper,Omen,Fade","Raze,Cypher,Omen,Skye,Neon"
Sunset,Xu Gang,Tiny Turtle Squad,8,13,6,6,7,2,"Breach,Raze,Cypher,Sova,Omen","Breach,Raze,Cypher,Omen,Gekko"
Sunset,Bandits OCE,Koopa Troopas,4,13,2,10,3,2,"Breach,Raze,Cypher,Omen,Gekko","Breach,Raze,Cypher,Omen,Fade"
Ascent,JiJieHao Bonkers,Peace & Love,13,8,4,5,3,9,"Sova,Killjoy,Omen,Jett,KAY/O","Sova,Killjoy,Phoenix,Omen,Neon"
Ascent,BOBO,EDGE (OCE),13,1,2,0,1,11,"Sova,Killjoy,Omen,Jett,KAY/O","Cypher,Sova,Omen,Jett,Deadlock"
Ascent,Justice For Tomorrow,iPGN,13,9,6,4,5,7,"Sova,Killjoy,Reyna,Omen,Jett","Sova,Killjoy,Omen,Jett,KAY/O"
Icebox,Rub n' Pug,Wolf Pack (OCE),7,13,2,6,7,5,"Sova,Viper,Jett,Yoru,Deadlock","Sova,Killjoy,Viper,Jett,Gekko"
Breeze,Murash Gaming,VARREL,9,13,4,8,5,5,"Sova,Viper,Jett,Yoru,Astra","Cypher,Sova,Viper,Jett,Yoru"
Sunset,Murash Gaming,VARREL,9,13,3,9,4,6,"Sova,Phoenix,Sage,Omen,Clove","Raze,Cypher,Sova,Phoenix,Omen"
Icebox,Reformed GC,mesos millionaires,13,7,7,5,2,6,"Killjoy,Viper,Sage,Jett,Gekko","Sova,Killjoy,Viper,Jett,KAY/O"
Bind,Reformed GC,mesos millionaires,13,7,7,1,6,6,"Raze,Viper,Brimstone,Skye,Deadlock","Raze,Viper,Skye,Chamber,Clove"
Lotus,MYVRA,FUSION X,8,13,6,6,7,2,"Breach,Raze,Cypher,Omen,Gekko","Breach,Raze,Killjoy,Omen,Skye"
Icebox,Shopify Rebellion,floppers,13,3,11,1,2,2,"Sova,Killjoy,Viper,Jett,Harbor","Sova,Killjoy,Viper,Gekko,Clove"
Sunset,FlyQuest RED,Solstice GC,11,13,7,5,8,4,"Breach,Raze,Cypher,Sova,Omen","Raze,Cypher,Omen,Gekko,Clove"
Bind,MYVRA,FUSION X,11,13,8,4,9,3,"Breach,Raze,Cypher,Brimstone,Gekko","Raze,Cypher,Brimstone,Skye,Gekko"
Sunset,Shopify Rebellion,floppers,13,4,9,3,1,4,"Breach,Raze,Cypher,Omen,Gekko","Breach,Raze,Omen,Fade,Deadlock"
Split,FlyQuest RED,Solstice GC,13,10,6,6,4,7,"Raze,Cypher,Omen,Jett,Skye","Raze,Cypher,Viper,Skye,Clove"
Sunset,MYVRA,FUSION X,8,13,2,10,3,6,"Breach,Raze,Cypher,Omen,Gekko","Raze,Cypher,Omen,KAY/O,Gekko"
Ascent,Passion Project,Teddy Tactics,13,5,10,2,3,3,"Sova,Killjoy,Omen,Jett,KAY/O","Sova,Killjoy,Omen,Jett,KAY/O"
Lotus,EX0TIK GAMING,PPP,6,13,2,5,8,4,"Breach,Raze,Killjoy,Omen,Fade","Breach,Raze,Cypher,Sova,Omen"
Ascent,ALTERNATE aTTaX,Ovation eSports,11,13,5,7,6,6,"Sova,Killjoy,Omen,Jett,KAY/O","Sova,Killjoy,Omen,Jett,KAY/O"
Lotus,Passion Project,Teddy Tactics,13,1,11,1,0,2,"Breach,Raze,Killjoy,Omen,Gekko","Raze,Killjoy,Viper,Omen,Fade"
Lotus,FlyQuest RED,Solstice GC,7,13,5,7,6,2,"Raze,Killjoy,Viper,Omen,Skye","Raze,Killjoy,Viper,Gekko,Clove"
Bind,DIVINE,Cuban Raft Raiders,13,4,5,0,4,8,"Raze,Cypher,Viper,Brimstone,Gekko","Raze,Viper,Brimstone,Fade,Gekko"
Icebox,Signum Reges,Wygers,7,13,6,6,7,1,"Killjoy,Viper,Jett,KAY/O,Gekko","Sova,Viper,Reyna,Jett,Chamber"
Lotus,ALTERNATE aTTaX,Ovation eSports,13,6,6,1,5,7,"Breach,Raze,Sova,Killjoy,Omen","Raze,Killjoy,Viper,Omen,Fade"
Bind,GTZ Esports,HOF Esports,13,7,6,2,5,7,"Breach,Raze,Cypher,Viper,Brimstone","Breach,Raze,Viper,Brimstone,Gekko"
Icebox,Team Occupy,R8 Esports,5,13,2,4,9,3,"Sova,Killjoy,Viper,Sage,Jett","Killjoy,Viper,Sage,Reyna,Gekko"
Lotus,DIVINE,Cuban Raft Raiders,13,7,6,6,1,7,"Raze,Killjoy,Viper,Omen,Gekko","Raze,Killjoy,Viper,Omen,Fade"
Ascent,Team RA'AD,Onyx Ravens,13,8,9,0,8,4,"Breach,Raze,Cypher,Sova,Omen","Sova,Killjoy,Omen,Jett,KAY/O"
Ascent,Team RA'AD,Onyx Ravens,13,8,9,0,8,4,"Breach,Raze,Cypher,Sova,Omen","Sova,Killjoy,Omen,Jett,KAY/O"
Icebox,Dragons Esports GC,R8 Blues,1,13,1,11,2,0,"Sova,Killjoy,Viper,Sage,Jett","Sova,Killjoy,Viper,Sage,Neon"
Lotus,GAMAX eSports,NASR Esports,13,3,9,3,0,4,"Breach,Raze,Cypher,Sova,Omen","Raze,Killjoy,Viper,Omen,Skye"
Lotus,Team Falcons Vega,The Ultimates Odyssey,11,13,4,8,5,7,"Raze,Killjoy,Viper,Omen,Fade","Breach,Cypher,Sova,Omen,Neon"
Sunset,Signum Reges,Wygers,13,8,8,4,4,5,"Breach,Raze,Cypher,Omen,Gekko","Raze,Sova,Phoenix,Omen,Chamber"
Icebox,Skulls Esports,top gz,11,13,5,7,6,6,"Viper,Sage,Reyna,Jett,Gekko","Sova,Killjoy,Viper,Jett,Clove"
Breeze,RIZON Sugar,TOG Kitsune,1,13,0,2,11,1,"Cypher,Sova,Viper,Jett,Yoru","Cypher,Sova,Viper,Jett,KAY/O"
Breeze,Sissi State Punks Academy,HONEYBADGER123,2,13,2,10,3,0,"Cypher,Sova,Viper,Jett,KAY/O","Cypher,Sova,Viper,Jett,Yoru"
Icebox,ALTERNATE aTTaX,Ovation eSports,11,13,3,9,4,8,"Killjoy,Viper,Jett,KAY/O,Gekko","Sova,Killjoy,Viper,Sage,Jett"
Sunset,Ramboot Club,UCAM Esports Club,12,14,4,9,5,8,"Sova,Killjoy,Brimstone,Omen,Yoru","Breach,Raze,Cypher,Sova,Omen"
Bind,Team RA'AD,Onyx Ravens,8,13,3,6,7,5,"Raze,Viper,Brimstone,Skye,Gekko","Raze,Viper,Brimstone,Skye,Gekko"
Lotus,Dragons Esports GC,R8 Blues,5,13,5,7,6,0,"Raze,Killjoy,Viper,Omen,Fade","Raze,Viper,Skye,Chamber,Clove"
Lotus,GJ Omen,AKA HERO,13,6,4,3,3,9,"Breach,Raze,Cypher,Omen,Fade","Breach,Sova,Killjoy,Omen,Neon"
Icebox,FUZOS,Impulse GW,10,13,8,4,9,2,"Killjoy,Viper,Jett,KAY/O,Gekko","Killjoy,Viper,Jett,KAY/O,Gekko"
Bind,Team Occupy,R8 Esports,11,13,8,4,9,3,"Raze,Cypher,Brimstone,Reyna,Skye","Raze,Cypher,Viper,Brimstone,Skye"
Sunset,Team Falcons Vega,The Ultimates Odyssey,11,13,6,6,7,5,"Breach,Raze,Cypher,Omen,Fade","Breach,Raze,Cypher,Omen,Gekko"
Split,GAMAX eSports,NASR Esports,13,9,8,2,7,5,"Breach,Raze,Cypher,Omen,Fade","Breach,Raze,Cypher,Sova,Omen"
Ascent,Vanir,Coalesce,13,10,6,6,4,7,"Cypher,Sova,Omen,Jett,Deadlock","Cypher,Sova,Phoenix,Omen,Jett"
Lotus,BBL Queens,NASR Ignite,13,8,4,5,3,9,"Raze,Viper,Omen,Chamber,Fade","Breach,Raze,Viper,Omen,Gekko"
Bind,RIZON Sugar,TOG Kitsune,1,13,1,11,2,0,"Breach,Raze,Cypher,Brimstone,Skye","Breach,Raze,Cypher,Brimstone,Gekko"
Bind,EMUs,SK Nebula,10,13,7,5,8,3,"Raze,Viper,Brimstone,Skye,Gekko","Breach,Cypher,Yoru,Astra,Gekko"
Lotus,Fire Flux Esports,S2G Esports,13,6,8,4,2,5,"Breach,Raze,Cypher,Omen,Gekko","Raze,Killjoy,Viper,Omen,Fade"
Ascent,Signum Reges,Wygers,11,13,6,6,7,5,"Sova,Killjoy,Omen,Jett,KAY/O","Cypher,Sova,Reyna,Omen,Jett"
Sunset,Sissi State Punks Academy,HONEYBADGER123,15,13,5,9,4,10,"Raze,Cypher,Sova,Omen,KAY/O","Breach,Raze,Sage,Omen,Gekko"
Ascent,Falke Esports,Five Media Clan,7,13,3,9,4,4,"Killjoy,Viper,Omen,Jett,Skye","Sova,Killjoy,Omen,Jett,KAY/O"
Icebox,Twisted Minds Esports,Team Falcons,3,13,3,9,4,0,"Sova,Killjoy,Viper,Jett,KAY/O","Reyna,Omen,KAY/O,Harbor,Gekko"
Lotus,Gamax Lite,Twisted Minds Orchid,4,13,2,3,10,2,"Breach,Raze,Cypher,Sova,Clove","Breach,Raze,Cypher,Omen,Fade"
Lotus,Vanir,Coalesce,10,13,5,6,7,5,"Breach,Raze,Cypher,Harbor,Deadlock","Raze,Cypher,Omen,Jett,Skye"
Ascent,GJ Omen,AKA HERO,13,6,7,0,6,6,"Sova,Killjoy,Omen,Jett,KAY/O","Sova,Killjoy,Omen,Jett,KAY/O"
Bind,MOUZ,FOKUS,13,9,8,2,7,5,"Breach,Raze,Viper,Brimstone,Gekko","Viper,Brimstone,Skye,Yoru,Gekko"
Lotus,EMUs,SK Nebula,6,13,4,3,10,2,"Breach,Raze,Cypher,Gekko,Clove","Raze,Killjoy,Viper,Omen,Fade"
Icebox,SAW,FTW LEÇA FC,13,4,9,3,1,4,"Sova,Killjoy,Viper,Sage,Jett","Killjoy,Viper,Reyna,Jett,Gekko"
Split,BBL Queens,NASR Ignite,13,8,4,5,3,9,"Breach,Raze,Cypher,Omen,Skye","Raze,Cypher,Viper,Omen,Skye"
Ascent,Permitta Unicorns GC,ALTERNATE aTTaX Ruby,2,13,2,10,3,0,"Sova,Killjoy,Omen,Jett,KAY/O","Sova,Killjoy,Omen,Jett,KAY/O"
Icebox,FOKUS Sakura,Playbay X VISION SYNC,13,3,10,2,1,3,"Sova,Killjoy,Viper,Reyna,Jett","Sova,Killjoy,Viper,Jett,Gekko"
Bind,Fire Flux Esports,S2G Esports,8,13,6,6,7,2,"Sova,Viper,Omen,Jett,Gekko","Raze,Brimstone,KAY/O,Gekko,Clove"
Ascent,The Ultimates,Underground Gaming,13,9,7,3,6,6,"Sova,Killjoy,Omen,Jett,KAY/O","Sova,Killjoy,Omen,Jett,KAY/O"
Sunset,Gamax Lite,Twisted Minds Orchid,0,13,0,12,1,0,"Breach,Raze,Cypher,Omen,Gekko","Breach,Raze,Cypher,Omen,Gekko"
Split,Twisted Minds Esports,Team Falcons,8,13,2,7,6,6,"Raze,Viper,Omen,Jett,Skye","Breach,Raze,Cypher,Omen,Skye"
Lotus,KPI Gaming,ZETA Gaming,13,8,9,0,8,4,"Raze,Viper,Omen,Chamber,Fade","Breach,Raze,Cypher,Omen,Fade"
Icebox,Sissi State Punks Academy,HONEYBADGER123,10,13,6,5,8,4,"Sova,Killjoy,Viper,Sage,Jett","Sova,Killjoy,Viper,Jett,Gekko"
Sunset,trashcan,Incognito,13,3,3,1,2,10,"Raze,Cypher,Viper,Omen,Skye","Breach,Raze,Cypher,Sova,Omen"
Split,Vanir,Coalesce,13,9,8,2,7,5,"Cypher,Sage,Omen,Jett,Chamber","Raze,Viper,Omen,Jett,Skye"
Lotus,The Ultimates,Underground Gaming,5,13,3,3,10,2,"Raze,Killjoy,Viper,Omen,Fade","Breach,Raze,Killjoy,Omen,Gekko"
Sunset,Permitta Unicorns GC,ALTERNATE aTTaX Ruby,2,13,0,3,10,2,"Breach,Raze,Cypher,Omen,Gekko","Breach,Raze,Cypher,Sova,Omen"
Lotus,Fraggerz,Unity Esports,8,13,3,6,7,5,"Breach,Killjoy,Omen,Jett,Skye","Breach,Cypher,Sova,Omen,Jett"
Lotus,FOKUS Sakura,Playbay X VISION SYNC,13,1,11,1,0,2,"Breach,Raze,Killjoy,Omen,Skye","Breach,Raze,Cypher,Omen,Fade"
Icebox,MOUZ,FOKUS,14,12,8,5,7,6,"Sova,Killjoy,Viper,Sage,Jett","Killjoy,Viper,Sage,KAY/O,Gekko"
Sunset,Fire Flux Esports,S2G Esports,13,6,7,0,6,6,"Breach,Raze,Sage,Omen,Gekko","Breach,Raze,Cypher,Omen,Gekko"
Lotus,G2 Gozen,Team Falcons Vega,13,7,9,3,4,4,"Raze,Killjoy,Viper,Omen,Fade","Raze,Viper,Omen,Chamber,Gekko"
Split,trashcan,Incognito,13,5,4,2,3,9,"Cypher,Viper,Omen,Jett,Skye","Raze,Cypher,Viper,Omen,Skye"
Icebox,Fraggerz,Unity Esports,10,13,6,6,7,4,"Sova,Killjoy,Viper,Reyna,Jett","Sova,Killjoy,Viper,Sage,Jett"
Bind,Twisted Minds Esports,Team Falcons,17,15,8,8,7,9,"Raze,Brimstone,Reyna,Skye,Harbor","Raze,Viper,Sage,Skye,Clove"
Breeze,G2 Gozen,Team Falcons Vega,13,3,3,1,2,10,"Cypher,Sova,Viper,Jett,KAY/O","Cypher,Sova,Viper,Jett,KAY/O"
Lotus,Imperium Gaming,Barça eSports,11,13,6,6,7,5,"Raze,Killjoy,Viper,Omen,Fade","Killjoy,Omen,KAY/O,Neon,Gekko"
Split,MOUZ,FOKUS,7,13,4,4,9,3,"Breach,Raze,Cypher,Omen,Skye","Raze,Omen,Yoru,Astra,Fade"
Breeze,Papara SuperMassive,Istanbul Wildcats,13,10,3,8,2,10,"Cypher,Sova,Viper,Jett,Yoru","Cypher,Sova,Viper,Omen,Yoru"
Ascent,Zero Tenacity,GoNext Esports,3,13,1,11,2,2,"Sova,Killjoy,Omen,Jett,KAY/O","Sova,Killjoy,Omen,Jett,KAY/O"
Sunset,G2 Gozen,Team Falcons Vega,10,13,3,8,5,7,"Breach,Raze,Cypher,Omen,Fade","Breach,Raze,Cypher,Omen,Gekko"
Bind,Zero Tenacity,GoNext Esports,3,13,0,4,9,3,"Raze,Cypher,Viper,Brimstone,Skye","Raze,Viper,Brimstone,Skye,Gekko"
Sunset,Papara SuperMassive,Istanbul Wildcats,13,7,4,4,3,9,"Raze,Cypher,Omen,KAY/O,Gekko","Breach,Raze,Cypher,Sova,Omen"
Lotus,Orangutan,Reckoning Esports,13,8,7,5,3,6,"Breach,Raze,Sova,Killjoy,Omen","Breach,Raze,Sova,Omen,Chamber"
Bind,Orangutan,Reckoning Esports,13,2,3,0,2,10,"Raze,Viper,Brimstone,Skye,Gekko","Breach,Raze,Cypher,Sova,Brimstone"
Lotus,Revenant Esports,Medal Esports,13,6,8,4,2,5,"Raze,Viper,Omen,Chamber,Fade","Raze,Killjoy,Viper,Omen,Fade"
Breeze,iPGN,Koopa Troopas,13,2,11,1,1,2,"Cypher,Sova,Viper,Jett,Yoru","Sova,Viper,Reyna,Jett,Harbor"
Bind,JiJieHao Bonkers,FOCUSGG,12,14,7,6,8,5,"Raze,Cypher,Viper,Brimstone,Gekko","Raze,Viper,Brimstone,Fade,Gekko"
Bind,EDGE (OCE),Tiny Turtle Squad,13,7,9,3,4,4,"Raze,Omen,Skye,Gekko,Clove","Raze,Viper,Brimstone,Skye,Gekko"
Bind,Rub n' Pug,Peace & Love,15,17,11,5,12,4,"Raze,Brimstone,Jett,Gekko,Deadlock","Raze,Brimstone,Sage,Skye,Neon"
Icebox,Arena Internet Cafe,BOBO,15,13,7,7,6,8,"Sova,Killjoy,Viper,Sage,Jett","Sova,Killjoy,Viper,Jett,KAY/O"
Ascent,iPGN,Koopa Troopas,11,13,7,5,8,4,"Sova,Killjoy,Omen,Jett,KAY/O","Sova,Killjoy,Phoenix,Omen,Jett"
Ascent,EDGE (OCE),Tiny Turtle Squad,13,7,5,3,4,8,"Cypher,Sova,Omen,Jett,KAY/O","Breach,Sova,Killjoy,Omen,Jett"
Breeze,JiJieHao Bonkers,FOCUSGG,13,8,7,2,6,6,"Cypher,Sova,Viper,Jett,Yoru","Cypher,Sova,Viper,Omen,Yoru"
Icebox,Justice For Tomorrow,Bandits OCE,13,4,4,1,3,9,"Sova,Killjoy,Viper,Reyna,Jett","Killjoy,Viper,Jett,KAY/O,Gekko"
Ascent,Revenant Esports,Medal Esports,13,10,6,5,5,7,"Cypher,Sova,Omen,Jett,KAY/O","Sova,Killjoy,Omen,Jett,KAY/O"
Icebox,Rub n' Pug,Peace & Love,13,15,7,7,8,6,"Sova,Viper,Jett,Yoru,Deadlock","Sova,Killjoy,Viper,Jett,Neon"
Bind,Justice For Tomorrow,Bandits OCE,13,9,7,3,6,6,"Raze,Viper,Brimstone,Fade,Gekko","Raze,Viper,Brimstone,Gekko,Deadlock"
Sunset,iPGN,Koopa Troopas,13,11,8,4,7,5,"Breach,Raze,Cypher,Omen,Gekko","Breach,Raze,Cypher,Omen,Fade"
Ascent,Rub n' Pug,Peace & Love,13,5,4,2,3,9,"Sova,Killjoy,Omen,Jett,KAY/O","Sova,Killjoy,Phoenix,Omen,Neon"
Ascent,JiJieHao Bonkers,FOCUSGG,12,14,2,11,3,10,"Sova,Killjoy,Omen,Jett,KAY/O","Sova,Killjoy,Omen,Jett,KAY/O"
Ascent,Arena Internet Cafe,BOBO,14,12,6,7,5,8,"Sova,Killjoy,Omen,Jett,KAY/O","Sova,Killjoy,Omen,Jett,KAY/O"
Sunset,Ions Day Care,Blue Otter,13,10,7,4,6,6,"Raze,Cypher,Omen,Fade,Deadlock","Raze,Cypher,Omen,KAY/O,Gekko"
Ascent,Ions Day Care,Blue Otter,10,13,1,11,2,9,"Sova,Killjoy,Reyna,Omen,Jett","Sova,Killjoy,Omen,Jett,KAY/O"
Icebox,Ions Day Care,Blue Otter,13,10,9,3,7,4,"Killjoy,Viper,Phoenix,Reyna,Clove","Killjoy,Viper,Jett,KAY/O,Gekko"
Sunset,UST Esports,TAMU Maroon,7,13,2,6,7,5,"Breach,Raze,Cypher,Omen,Gekko","Breach,Raze,Cypher,Omen,Gekko"
Breeze,UST Esports,TAMU Maroon,6,13,3,9,4,3,"Cypher,Sova,Viper,Jett,KAY/O","Cypher,Sova,Viper,Jett,Yoru"
Icebox,The Final Shape,Blue Otter,8,13,3,6,7,5,"Sova,Killjoy,Jett,Harbor,Clove","Killjoy,Viper,Jett,KAY/O,Gekko"
Haven,Special Grade,Ions Day Care,9,13,2,8,5,7,"Breach,Sova,Killjoy,Omen,Jett","Cypher,Sova,Phoenix,Omen,Jett"
Split,UST Esports,TAMU Maroon,10,13,2,9,4,8,"Raze,Killjoy,Viper,Skye,Astra","Raze,Cypher,Viper,Omen,Skye"
Haven,The Final Shape,Blue Otter,9,13,4,8,5,5,"Breach,Sova,Killjoy,Omen,Jett","Breach,Sova,Killjoy,Omen,Jett"
Ascent,The Ultimates Odyssey,Gamax Lite,13,4,2,3,1,11,"Sova,Killjoy,Omen,Jett,KAY/O","Sova,Killjoy,Omen,Jett,KAY/O"
Lotus,The Final Shape,Blue Otter,13,9,7,3,6,6,"Raze,Cypher,Omen,Fade,Clove","Breach,Raze,Cypher,Omen,Gekko"
Lotus,UST Esports,TAMU Maroon,14,12,6,7,5,8,"Breach,Raze,Killjoy,Omen,Gekko","Raze,Killjoy,Viper,Omen,Fade"
Lotus,The Ultimates Odyssey,Gamax Lite,13,7,7,5,2,6,"Breach,Cypher,Sova,Omen,Neon","Breach,Raze,Cypher,Omen,Gekko"
Ascent,Vanir,TheSecretClub,13,1,2,0,1,11,"Cypher,Sova,Omen,Jett,Deadlock","Cypher,Sova,Omen,Jett,KAY/O"
Ascent,BLAZE GC,NEON BLADE,11,13,3,9,4,8,"Sova,Killjoy,Omen,Jett,KAY/O","Sova,Killjoy,Phoenix,Omen,Jett"
Split,R8 Blues,FOG Vortex,13,8,5,4,4,8,"Raze,Viper,Skye,Chamber,Clove","Breach,Raze,Cypher,Omen,Jett"
Sunset,Tropadobagaço,New Origins Esports,13,9,10,2,7,3,"Breach,Raze,Cypher,Phoenix,Omen","Breach,Raze,Cypher,Omen,Gekko"
Lotus,Vanir,TheSecretClub,13,6,10,2,4,3,"Breach,Raze,Cypher,Harbor,Deadlock","Raze,Killjoy,Viper,Omen,Fade"
Breeze,MIBR GC,REVOADA,13,10,10,1,9,3,"Cypher,Sova,Viper,Jett,KAY/O","Cypher,Sova,Viper,Jett,KAY/O"
Ascent,AquaPoney,lesptitesnieces,5,13,2,10,3,3,"Sova,Killjoy,Phoenix,Jett,Astra","Sova,Killjoy,Omen,Jett,KAY/O"
Sunset,Formulation Gaming GC,NEON BLADE,2,13,2,10,3,0,"Breach,Raze,Cypher,Omen,Gekko","Breach,Cypher,Sova,Omen,Jett"
Icebox,R8 Blues,FOG Vortex,13,4,10,2,2,3,"Sova,Killjoy,Viper,Sage,Neon","Sova,Killjoy,Viper,Reyna,Jett"
Lotus,Tropadobagaço,New Origins Esports,13,5,7,5,0,6,"Raze,Killjoy,Viper,Omen,Gekko","Raze,Killjoy,Viper,Omen,Fade"
Breeze,Colors Esport,WanderBlaze,13,9,5,5,4,8,"Cypher,Sova,Viper,Jett,Yoru","Sova,Viper,Jett,Yoru,Astra"
Ascent,MIBR GC,REVOADA,13,3,3,1,2,10,"Sova,Killjoy,Omen,Jett,KAY/O","Sova,Killjoy,Omen,Jett,KAY/O"
Icebox,Team Galaga,eQuizers,13,11,4,8,3,9,"Sova,Killjoy,Viper,Sage,Jett","Killjoy,Viper,Jett,KAY/O,Gekko"
Breeze,AquaPoney,lesptitesnieces,8,13,3,6,7,5,"Cypher,Sova,Viper,Reyna,Jett","Cypher,Sova,Viper,Jett,Skye"
Lotus,Formulation Gaming GC,NEON BLADE,13,4,8,4,0,5,"Raze,Cypher,Viper,Omen,Gekko","Breach,Raze,Killjoy,Omen,Fade"
Sunset,Colors Esport,WanderBlaze,13,4,4,1,3,9,"Breach,Raze,Cypher,Sova,Omen","Breach,Raze,Cypher,Omen,Gekko"
Lotus,Team Kuara,Luminaria,7,13,6,6,7,1,"Breach,Raze,Killjoy,Omen,Gekko","Breach,Raze,Killjoy,Omen,Gekko"
Lotus,MIBR GC,REVOADA,13,0,12,0,0,1,"Raze,Killjoy,Viper,Omen,Fade","Raze,Killjoy,Viper,Omen,Fade"
Icebox,tfup,Xanary Anima,13,9,7,3,6,6,"Raze,Sova,Killjoy,Viper,Sage","Sova,Killjoy,Viper,Jett,Harbor"
Bind,Lootcifer,Exceptional Gaming,14,12,9,4,8,5,"Raze,Viper,Omen,KAY/O,Gekko","Raze,Viper,Brimstone,Skye,Gekko"
Lotus,LA RUE,BÖSE BUBEN,13,8,7,2,6,6,"Raze,Killjoy,Viper,Omen,Fade","Breach,Raze,Cypher,Sova,Omen"
Ascent,Ketçaplı Ruffles,PCIFIC Waves,13,6,8,4,2,5,"Sova,Killjoy,Jett,Astra,Gekko","Sova,Killjoy,Omen,Jett,KAY/O"
Sunset,Team Galaga,eQuizers,13,10,6,6,4,7,"Breach,Raze,Cypher,Omen,Gekko","Breach,Raze,Cypher,Omen,Yoru"
Breeze,lesptitesnieces,Colors Esport,13,2,3,0,2,10,"Cypher,Sova,Viper,Jett,Skye","Cypher,Sova,Viper,Jett,KAY/O"
Breeze,Formulation Gaming GC,NEON BLADE,9,13,6,4,9,3,"Cypher,Sova,Viper,Jett,KAY/O","Cypher,Sova,Viper,Jett,KAY/O"
Sunset,AquaPoney,WanderBlaze,13,7,5,3,4,8,"Breach,Raze,Cypher,Gekko,Clove","Breach,Raze,Cypher,Omen,Gekko"
Lotus,tfup,Xanary Anima,13,10,8,3,7,5,"Breach,Raze,Cypher,Omen,Gekko","Breach,Raze,Killjoy,Omen,Gekko"
Ascent,Team Kuara,Luminaria,9,13,7,5,8,2,"Sova,Killjoy,Reyna,Omen,Jett","Sova,Killjoy,Omen,Jett,KAY/O"
Ascent,BÖSE BUBEN,Exceptional Gaming,8,13,1,8,5,7,"Sova,Killjoy,Omen,Jett,KAY/O","Sova,Killjoy,Omen,Jett,KAY/O"
Split,Ketçaplı Ruffles,PCIFIC Waves,13,10,10,2,8,3,"Breach,Raze,Sage,Omen,Chamber","Breach,Raze,Cypher,Omen,Skye"
Lotus,LA RUE,Lootcifer,5,13,2,4,9,3,"Raze,Killjoy,Viper,Omen,Fade","Breach,Raze,Cypher,Omen,KAY/O"
Split,Team Galaga,eQuizers,10,13,4,7,6,6,"Raze,Cypher,Omen,Jett,Skye","Breach,Raze,Cypher,Omen,Yoru"
Lotus,AquaPoney,WanderBlaze,5,13,2,10,3,3,"Breach,Raze,Killjoy,Gekko,Clove","Breach,Killjoy,Omen,Neon,Gekko"
Bind,lesptitesnieces,Colors Esport,14,12,8,5,7,6,"Raze,Cypher,Viper,Brimstone,Skye","Breach,Reyna,Astra,Neon,Fade"
Icebox,aNc Outplayed GC,NOVO GC,5,13,3,9,4,2,"Sova,Killjoy,Viper,Yoru,Gekko","Sova,Killjoy,Viper,Sage,Jett"
Ascent,A One Man Army,Exceptional Gaming,5,13,1,5,8,4,"Sova,Killjoy,Omen,Jett,KAY/O","Sova,Killjoy,Omen,Jett,KAY/O"
Sunset,Xanary Anima,FAUX ESPORT,13,5,8,4,1,5,"Cypher,Sova,Omen,KAY/O,Chamber","Raze,Cypher,Sova,Omen,KAY/O"
Bind,Dortmund Esports,BÖSE BUBEN,4,13,2,3,10,2,"Viper,Omen,Yoru,Gekko,Deadlock","Raze,Viper,Brimstone,Yoru,Gekko"
Bind,Lootcifer,INF Esports,13,9,7,3,6,6,"Raze,Viper,Omen,KAY/O,Gekko","Raze,Viper,Brimstone,Skye,Gekko"
Sunset,LA RUE,RIZON,13,6,5,2,4,8,"Breach,Raze,Cypher,Omen,Gekko","Raze,Cypher,Sova,Omen,Gekko"
Lotus,lesptitesnieces,Colors Esport,5,13,0,6,7,5,"Raze,Killjoy,Omen,Skye,Astra","Breach,Sova,Killjoy,Omen,Neon"
Ascent,Oserv Esport,tfup,9,13,3,7,6,6,"Sova,Killjoy,Omen,Jett,KAY/O","Cypher,Sova,Sage,Omen,Jett"
Lotus,Xanary Anima,FAUX ESPORT,13,7,9,3,4,4,"Breach,Raze,Killjoy,Omen,Gekko","Breach,Killjoy,Omen,Neon,Gekko"
Breeze,AquaPoney,WanderBlaze,13,11,8,4,7,5,"Cypher,Sova,Viper,Reyna,Jett","Sova,Viper,Jett,Yoru,Astra"
Sunset,axolotls and chips,NEON BLADE,7,13,7,5,8,0,"Breach,Raze,Cypher,Sova,Harbor","Breach,Raze,Cypher,Sova,Clove"
Bind,Exceptional Gaming,Reveal Multigaming Saphire,16,14,8,7,7,8,"Raze,Viper,Brimstone,Skye,Gekko","Breach,Raze,Cypher,Brimstone,Yoru"
Lotus,aNc Outplayed GC,NOVO GC,13,15,7,7,8,6,"Breach,Raze,Killjoy,Omen,Gekko","Breach,Sova,Killjoy,Omen,Neon"
Lotus,LA RUE,MAJOR MONOGWAM,13,4,4,1,3,9,"Raze,Killjoy,Viper,Omen,Fade","Breach,Raze,Killjoy,Omen,Gekko"
Bind,GJ Omen,A One Man Army,7,13,2,6,7,5,"Raze,Viper,Brimstone,Skye,Gekko","Raze,Cypher,Viper,Skye,Clove"
Icebox,Xanary Anima,FAUX ESPORT,5,13,4,2,11,1,"Sova,Killjoy,Viper,Jett,Harbor","Sova,Killjoy,Jett,Harbor,Gekko"
Breeze,Novita Esports,Lootcifer,5,13,1,5,8,4,"Cypher,Sova,Viper,Jett,Yoru","Cypher,Sova,Viper,Jett,Yoru"
Sunset,RIZON,TeamOrangeGaming,13,4,4,1,3,9,"Raze,Cypher,Sova,Omen,Gekko","Breach,Raze,Cypher,Sova,Omen"
Lotus,AKA HERO,BÖSE BUBEN,12,14,6,7,7,6,"Breach,Sova,Killjoy,Omen,Neon","Breach,Raze,Cypher,Sova,Omen"
Sunset,Oserv Esport,tfup,9,13,5,7,6,4,"Breach,Raze,Cypher,Yoru,Astra","Cypher,Sova,Omen,Jett,Gekko"
Sunset,INF Esports,HONEYBADGER123,13,10,8,4,1,1,"Breach,Raze,Cypher,Sova,Omen","Breach,Raze,Sage,Omen,Gekko"
Lotus,Reveal Multigaming,Dortmund Esports,11,13,5,7,6,6,"Breach,Raze,Cypher,Sova,Omen","Raze,Omen,Yoru,Gekko,Deadlock"
Sunset,Colors Esport,Exalty,14,12,5,8,4,9,"Breach,Raze,Cypher,Sova,Omen","Breach,Raze,Cypher,Sova,Omen"
Icebox,Lootcifer,Sissi State Punks Academy,13,3,4,0,3,9,"Sova,Killjoy,Jett,Harbor,Clove","Sova,Killjoy,Viper,Sage,Jett"
Split,Sissi State Punks,Reveal Multigaming Saphire,10,13,5,6,7,5,"Breach,Raze,Cypher,Omen,Skye","Breach,Raze,Cypher,Jett,Clove"
Sunset,TeamOrangeGaming,IMPERIUM,13,3,3,1,2,10,"Breach,Raze,Cypher,Sova,Omen","Breach,Raze,Cypher,Omen,Gekko"
Ascent,BÖSE BUBEN,REH Gaming,13,4,5,0,4,8,"Sova,Killjoy,Omen,Jett,KAY/O","Sova,Killjoy,Reyna,Omen,Jett"
Ascent,A One Man Army,6TM ESPORTS,13,5,3,3,2,10,"Sova,Killjoy,Omen,Jett,KAY/O","Cypher,Sova,Omen,Jett,KAY/O"
Lotus,Xanary Anima,Upset Esport,13,9,9,3,6,4,"Breach,Raze,Killjoy,Omen,Gekko","Breach,Raze,Killjoy,Omen,Fade"
Ascent,NEON BLADE,Mulieres Vires,13,11,6,6,5,7,"Killjoy,Phoenix,Omen,Jett,Fade","Sova,Killjoy,Omen,Jett,KAY/O"
Lotus,axolotls and chips,TOG Kitsune,13,9,7,3,6,6,"Raze,Cypher,Omen,Fade,Deadlock","Breach,Raze,Killjoy,Omen,Gekko"
Ascent,WanderBlaze,yes bebe alors ca marche,13,1,2,0,1,11,"Killjoy,Phoenix,Omen,Jett,KAY/O","Sova,Killjoy,Phoenix,Omen,Jett"
Icebox,EVOLVE,tfup,8,13,3,6,7,5,"Sova,Killjoy,Viper,Sage,Reyna","Raze,Sova,Killjoy,Viper,Sage"
Ascent,5Man Stuck,Oserv Esport,1,13,1,11,2,0,"Sova,Killjoy,Omen,Jett,KAY/O","Sova,Killjoy,Omen,Jett,KAY/O"
Ascent,FAUX ESPORT,HL Tauri eSports Rising Stars,13,9,4,6,3,9,"Sova,Killjoy,Omen,Jett,KAY/O","Sova,Killjoy,Omen,Jett,KAY/O"
Ascent,AquaPoney,Last Minute Mix,13,3,4,0,3,9,"Sova,Killjoy,Phoenix,Jett,Astra","Cypher,Sova,Omen,Jett,KAY/O"
Breeze,lesptitesnieces,FAKE ESPORT,13,8,7,2,6,6,"Cypher,Sova,Viper,Jett,Skye","Cypher,Sova,Viper,Yoru,Chamber"
Sunset,lesptitesnieces,FAKE ESPORT,13,1,2,0,1,11,"Breach,Raze,Cypher,Omen,Gekko","Breach,Cypher,Omen,Jett,Gekko"
Sunset,5Man Stuck,Oserv Esport,2,13,0,3,10,2,"Breach,Raze,Cypher,Omen,Gekko","Breach,Raze,Cypher,Yoru,Astra"
Lotus,Colors Esport,Exalty,13,11,9,3,8,4,"Breach,Sova,Killjoy,Omen,Neon","Breach,Raze,Killjoy,Omen,Gekko"
Lotus,WanderBlaze,yes bebe alors ca marche,13,9,7,3,6,6,"Breach,Killjoy,Omen,Neon,Gekko","Breach,Raze,Cypher,Omen,Fade"
Sunset,Xanary Anima,Upset Esport,14,12,10,3,9,4,"Cypher,Sova,Omen,KAY/O,Chamber","Raze,Cypher,Sova,Omen,KAY/O"
Sunset,FAUX ESPORT,HL Tauri eSports Rising Stars,13,8,9,3,5,4,"Raze,Cypher,Sova,Omen,KAY/O","Raze,Cypher,Omen,KAY/O,Gekko"
Lotus,EVOLVE,tfup,6,13,4,8,5,2,"Breach,Raze,Killjoy,Omen,Gekko","Breach,Raze,Cypher,Omen,Gekko"
Icebox,AquaPoney,Last Minute Mix,13,2,10,2,0,3,"Sova,Killjoy,Viper,Reyna,Jett","Sova,Killjoy,Viper,Jett,KAY/O"
Haven,RyZ Knights,Special Grade,12,14,7,6,8,5,"Breach,Sova,Killjoy,Omen,Jett","Breach,Sova,Killjoy,Omen,Jett"
Lotus,Ugly Hamsters,Blue Otter,7,13,4,4,9,3,"Raze,Cypher,Skye,Gekko,Clove","Breach,Raze,Cypher,Omen,Gekko"
Lotus,Ions Day Care,Winthrop University,13,5,7,5,0,6,"Raze,Killjoy,Omen,Fade,Gekko","Breach,Raze,Cypher,Omen,Fade"
Lotus,Area of Effect,The Final Shape,6,13,3,4,9,3,"Breach,Raze,Killjoy,Omen,Gekko","Raze,Cypher,Omen,Fade,Clove"
Lotus,RyZ Knights,Special Grade,13,4,10,2,2,3,"Raze,Sova,Killjoy,Viper,Omen","Raze,Killjoy,Viper,Omen,Fade"
Haven,Ugly Hamsters,Blue Otter,5,13,4,8,5,1,"Breach,Sova,Killjoy,Jett,Clove","Breach,Sova,Killjoy,Omen,Jett"
Sunset,Ions Day Care,Winthrop University,13,7,7,1,6,6,"Raze,Cypher,Omen,Fade,Deadlock","Breach,Raze,Cypher,Omen,Fade"
Bind,Bunch of Apes,One Tap Gaming,16,14,9,6,8,7,"Raze,Cypher,Brimstone,Skye,Yoru","Breach,Raze,Cypher,Brimstone,Gekko"
Icebox,Ions Day Care,Winthrop University,5,13,1,5,8,4,"Sova,Killjoy,Viper,Reyna,Jett","Sova,Killjoy,Viper,Jett,Clove"
Sunset,Area of Effect,The Final Shape,13,8,4,5,3,9,"Breach,Raze,Cypher,Sova,Omen","Breach,Raze,Cypher,Omen,Gekko"
Icebox,RyZ Knights,Special Grade,9,13,6,6,7,3,"Sova,Killjoy,Viper,Reyna,Jett","Sova,Killjoy,Viper,Jett,Clove"
Ascent,Bunch of Apes,One Tap Gaming,13,7,6,2,5,7,"Sova,Killjoy,Reyna,Omen,Jett","Breach,Sova,Killjoy,Omen,Jett"
Lotus,Blue Otter,SUPERCLAN,13,11,5,7,4,8,"Breach,Raze,Cypher,Omen,Gekko","Raze,Killjoy,Jett,Skye,Clove"
Haven,Area of Effect,The Final Shape,9,13,4,6,7,5,"Breach,Cypher,Sova,Omen,Jett","Breach,Sova,Killjoy,Omen,Jett"
Bind,Winthrop University,Power Rangers Jungle Fury,13,4,4,1,3,9,"Raze,Viper,Brimstone,Fade,Gekko","Raze,Brimstone,Skye,Yoru,Gekko"
Haven,Special Grade,Paranoia Vortex,14,12,6,7,5,8,"Breach,Sova,Killjoy,Omen,Jett","Sova,Killjoy,Phoenix,Omen,Jett"
Bind,Ions Day Care,Sexy Gang,13,10,5,6,4,8,"Raze,Cypher,Brimstone,Fade,Deadlock","Raze,Cypher,Brimstone,Skye,Gekko"
Haven,Blue Otter,SUPERCLAN,13,9,6,6,3,7,"Breach,Sova,Killjoy,Omen,Jett","Sova,Killjoy,Sage,Jett,Clove"
Ascent,Winthrop University,Power Rangers Jungle Fury,13,1,2,0,1,11,"Sova,Killjoy,Omen,Jett,KAY/O","Sova,Killjoy,Jett,KAY/O,Clove"
Breeze,One Tap Gaming,Spate Esports,14,12,6,7,5,8,"Cypher,Sova,Viper,Jett,KAY/O","Sova,Viper,Yoru,Astra,Neon"
Lotus,IOUNL,Ugly Hamsters,6,13,3,9,4,3,"Breach,Raze,Cypher,Fade,Clove","Raze,Cypher,Fade,Gekko,Clove"
Ascent,Shifty505,The Final Shape,8,13,2,10,3,6,"Sova,Killjoy,Omen,Jett,KAY/O","Sova,Killjoy,Omen,Jett,KAY/O"
Lotus,Bunch of Apes,freakybob incorporated,13,5,2,4,1,11,"Raze,Killjoy,Jett,Gekko,Clove","Raze,Killjoy,Viper,Omen,Fade"
Ascent,Ions Day Care,Sexy Gang,13,7,6,6,1,7,"Sova,Killjoy,Reyna,Omen,Jett","Sova,Killjoy,Omen,Jett,KAY/O"
Ascent,Special Grade,Paranoia Vortex,13,11,5,7,4,8,"Sova,Killjoy,Omen,Jett,KAY/O","Sova,Killjoy,Omen,Jett,KAY/O"
Haven,RyZ Knights,Lemonade Stand,13,11,7,5,6,6,"Breach,Sova,Killjoy,Omen,Jett","Breach,Sova,Killjoy,Omen,Jett"
Lotus,Shifty505,The Final Shape,7,13,4,8,5,3,"Breach,Raze,Omen,Jett,Skye","Raze,Cypher,Omen,Fade,Clove"
Bind,Bunch of Apes,Risk,13,6,5,2,4,8,"Raze,Cypher,Brimstone,Skye,Yoru","Raze,Viper,Brimstone,Skye,Yoru"
Haven,IOUNL,Ugly Hamsters,11,13,6,6,7,5,"Breach,Sova,Killjoy,Omen,Jett","Breach,Sova,Killjoy,Jett,Clove"
Split,Spate Esports,Alphaware Olympians,13,10,5,7,3,8,"Raze,Cypher,Omen,Jett,Skye","Raze,Cypher,Viper,Omen,Skye"
Sunset,Outlaw Merchants,Power Rangers Jungle Fury,11,13,7,5,8,4,"Breach,Raze,Cypher,Omen,Gekko","Breach,Raze,Cypher,Omen,Gekko"
Lotus,freakybob incorporated,Casablanca,13,2,3,0,2,10,"Raze,Killjoy,Viper,Omen,Fade","Breach,Raze,Viper,Omen,Jett"
Ascent,Nightblood Gaming,SUPERCLAN,11,13,4,8,5,7,"Sova,Killjoy,Omen,Jett,KAY/O","Sova,Killjoy,Phoenix,Jett,Clove"
Icebox,Omnipotence,One Tap Gaming,1,13,0,2,11,1,"Sova,Killjoy,Viper,Jett,Harbor","Sova,Killjoy,Viper,Jett,Gekko"
Lotus,RyZ Knights,Lemonade Stand,13,3,4,0,3,9,"Raze,Sova,Killjoy,Viper,Omen","Breach,Raze,Omen,Chamber,Gekko"
Split,Twisted Minds Orchid,R8 Blues,13,4,5,0,4,8,"Breach,Raze,Cypher,Viper,Omen","Raze,Killjoy,Viper,Omen,Skye"
Ascent,Paranoia Vortex,Orangutan Gang,13,5,9,3,2,4,"Sova,Killjoy,Omen,Jett,KAY/O","Sova,Killjoy,Omen,Jett,KAY/O"
Bind,Sexy Gang,Be Like Matt,13,7,5,3,4,8,"Raze,Cypher,Brimstone,Skye,Gekko","Raze,Viper,Brimstone,Skye,Chamber"
Ascent,Baby Goats,Risk,6,13,1,6,7,5,"Sova,Killjoy,Omen,Jett,KAY/O","Cypher,Sova,Omen,Jett,Deadlock"
Lotus,Casablanca,The 5 Musketeers,13,1,1,1,0,12,"Breach,Raze,Viper,Omen,Jett","Cypher,Phoenix,Omen,Chamber,Gekko"
Bind,Spate Esports,BOOSTIOS PIGS,13,4,9,3,1,4,"Viper,Jett,Yoru,Gekko,Clove","Viper,Jett,Fade,Gekko,Clove"
Haven,Outlaw Merchants,Power Rangers Jungle Fury,13,11,7,5,6,6,"Breach,Sova,Killjoy,Omen,Jett","Breach,Sova,Killjoy,Jett,Clove"
Lotus,Omnipotence,skibdi,13,3,11,1,2,2,"Breach,Raze,Killjoy,Omen,Fade","Sova,Jett,KAY/O,Deadlock,Clove"
Bind,Nightblood Gaming,SUPERCLAN,10,13,5,7,6,5,"Raze,Viper,Omen,Skye,Gekko","Raze,Cypher,Reyna,Fade,Clove"
Sunset,The Final Shape,Flowstate,15,13,11,3,10,4,"Breach,Raze,Cypher,Omen,Gekko","Breach,Raze,Cypher,Sova,Clove"
Lotus,freakybob incorporated,ST x WTP,14,12,4,9,3,10,"Raze,Killjoy,Viper,Omen,Fade","Raze,Killjoy,Fade,Gekko,Clove"
Bind,Alphaware Olympians,Neglected,13,10,9,3,7,4,"Raze,Cypher,Brimstone,Skye,KAY/O","Raze,Cypher,Brimstone,Skye,Gekko"
Sunset,Area of Effect,BALLZ V3.0,13,3,4,0,3,9,"Breach,Raze,Cypher,Sova,Omen","Raze,Cypher,Omen,KAY/O,Gekko"
Ascent,RTL Bonkers,One Tap Gaming,4,13,1,11,2,3,"Sova,Killjoy,Omen,Jett,KAY/O","Sova,Killjoy,Omen,Jett,KAY/O"
Sunset,Paranoia Vortex,Orangutan Gang,13,4,10,2,2,3,"Raze,Cypher,Omen,KAY/O,Gekko","Raze,Cypher,Omen,KAY/O,Gekko"
Haven,Nearest Airport,Ugly Hamsters,9,13,1,9,4,8,"Breach,Cypher,Sova,Omen,Jett","Breach,Sova,Killjoy,Jett,Clove"
Ascent,Prospects,Lemonade Stand,8,13,2,7,6,6,"Cypher,Sova,Phoenix,Omen,Jett","Sova,Killjoy,Brimstone,Sage,KAY/O"
Lotus,Sexy Gang,Be Like Matt,8,13,3,6,7,5,"Raze,Sage,Fade,Deadlock,Clove","Raze,Killjoy,Viper,Omen,Skye"
Lotus,pugin n thugin,Bunch of Apes,4,13,2,3,10,2,"Raze,Killjoy,Viper,Omen,Fade","Raze,Cypher,Gekko,Deadlock,Clove"
Bind,92' Dream Team,Risk,6,13,4,3,10,2,"Raze,Cypher,Brimstone,Skye,Gekko","Raze,Viper,Brimstone,Skye,Yoru"
Lotus,Spate Esports,Asura Violet,13,6,7,0,6,6,"Breach,Raze,Cypher,Omen,Gekko","Raze,Killjoy,Viper,Omen,Fade"
Lotus,T2G Esports,Omnipotence,6,13,4,8,5,2,"Raze,Killjoy,Omen,Jett,Gekko","Breach,Raze,Killjoy,Omen,Fade"
Ascent,Twisted Minds Orchid,R8 Blues,9,13,2,8,5,7,"Sova,Killjoy,Omen,Jett,KAY/O","Sova,Killjoy,Astra,KAY/O,Neon"
Breeze,Team NGA,One Tap Gaming,1,13,1,11,2,0,"Cypher,Phoenix,KAY/O,Harbor,Gekko","Cypher,Sova,Viper,Reyna,Jett"
Bind,Hot Fudge,The 5 Musketeers,11,13,6,6,7,5,"Raze,Cypher,Jett,Skye,Clove","Raze,Cypher,Brimstone,Reyna,Skye"
Icebox,Area of Effect,BALLZ V3.0,13,4,4,1,3,9,"Sova,Killjoy,Viper,Jett,Gekko","Sova,Killjoy,Viper,Jett,KAY/O"
Lotus,Neglected,UNM Esports,13,5,5,1,4,8,"Raze,Killjoy,Viper,Omen,Fade","Breach,Raze,Killjoy,Omen,Gekko"
Sunset,Prospects,Lemonade Stand,2,13,0,3,10,2,"Breach,Raze,Cypher,Omen,Gekko","Breach,Raze,Sage,Omen,Gekko"
Sunset,BOOSTIOS PIGS,Tahm Kenchers,13,6,6,6,0,7,"Breach,Raze,Cypher,Omen,Gekko","Raze,Cypher,Omen,Chamber,Gekko"
Split,Gommata,Alphaware Olympians,4,13,4,8,5,0,"Raze,Cypher,Omen,Jett,Skye","Raze,Cypher,Viper,Omen,Skye"
Lotus,Paranoia Vortex,Orangutan Gang,6,13,5,7,6,1,"Breach,Raze,Cypher,Omen,Gekko","Raze,Killjoy,Viper,Omen,Fade"
Haven,Sexy Gang,Be Like Matt,13,6,5,2,4,8,"Breach,Skye,Chamber,Neon,Clove","Breach,Sova,Killjoy,Omen,Jett"
Ascent,Outlaw Merchants,Power Rangers Jungle Fury,13,15,6,8,7,7,"Sova,Killjoy,Omen,Jett,KAY/O","Sova,Killjoy,Jett,KAY/O,Clove"
Breeze,freakybob incorporated,Sneakydignus,13,3,10,2,1,3,"Cypher,Sova,Viper,Jett,Yoru","Cypher,Sova,Viper,Jett,Yoru"
Haven,Nightblood Gaming,SUPERCLAN,13,11,8,4,7,5,"Breach,Cypher,Sova,Omen,Jett","Sova,Killjoy,Jett,Yoru,Clove"
Lotus,Ibreon Esports,RTL Bonkers,1,13,0,2,11,1,"Raze,Cypher,Omen,Fade,Gekko","Breach,Raze,Killjoy,Omen,Fade"
Bind,Casablanca,CONTROLLERS,13,8,7,5,3,6,"Raze,Viper,Brimstone,Fade,Gekko","Raze,Killjoy,Jett,KAY/O,Clove"
Lotus,Bunch of Apes,GroundX,13,5,10,2,3,3,"Raze,Killjoy,Jett,Gekko,Clove","Killjoy,Viper,Omen,Jett,Gekko"
Ascent,Free Orbs,EXO Clan,3,13,3,9,4,0,"Viper,Omen,Jett,Skye,KAY/O","Sova,Killjoy,Omen,Jett,KAY/O"
Haven,The Final Shape,Flowstate,16,14,6,9,5,10,"Breach,Cypher,Sova,Omen,Neon","Breach,Sova,Killjoy,Jett,Clove"
Lotus,skibdi,Defiant Esports,13,4,4,1,3,9,"Sova,Sage,Jett,KAY/O,Clove","Raze,Sage,Jett,Skye,Clove"
Ascent,ST x WTP,AURA Ruby,13,2,11,1,1,2,"Sova,Killjoy,Reyna,Omen,Jett","Sova,Killjoy,Omen,Jett,KAY/O"
Ascent,Shinjitsu,Baby Goats,3,13,1,11,2,2,"Sova,Killjoy,Omen,Jett,KAY/O","Sova,Killjoy,Omen,Jett,KAY/O"
Split,pugin n thugin,Broskis,13,2,10,2,0,3,"Raze,Cypher,Viper,Omen,Skye","Raze,Cypher,Phoenix,Skye,Clove"
Lotus,Nearest Airport,Ugly Hamsters,6,13,2,5,8,4,"Breach,Raze,Cypher,Gekko,Clove","Breach,Raze,Killjoy,Gekko,Clove"
Breeze,REVOADA,Team Leveling,13,6,6,1,5,7,"Cypher,Sova,Viper,Jett,KAY/O","Cypher,Sova,Viper,Jett,KAY/O"
Lotus,Twisted Minds Orchid,R8 Blues,13,7,9,3,4,4,"Breach,Raze,Cypher,Omen,Fade","Killjoy,Viper,Omen,Skye,Neon"
Lotus,Free Orbs,EXO Clan,6,13,6,6,7,0,"Breach,Killjoy,Omen,Neon,Fade","Raze,Killjoy,Viper,Omen,Fade"
Bind,FOG Vortex,Dragons Esports GC,5,13,1,5,8,4,"Raze,Brimstone,Reyna,Skye,Harbor","Raze,Viper,Brimstone,Skye,Gekko"
Ascent,REVOADA,Team Leveling,13,10,6,6,4,7,"Sova,Killjoy,Omen,Jett,KAY/O","Sova,Killjoy,Omen,Jett,KAY/O"
Sunset,boy kissers v2,delman,13,9,4,6,3,9,"Breach,Raze,Cypher,Gekko,Clove","Raze,Cypher,Viper,Omen,Gekko"
Bind,Free Orbs,EXO Clan,13,6,7,0,6,6,"Breach,Viper,Omen,Yoru,Fade","Raze,Viper,Omen,Skye,KAY/O"
Split,Team Falcons Vega,Gamax Lite,13,1,2,0,1,11,"Breach,Raze,Cypher,Omen,Skye","Breach,Raze,Cypher,Sage,Omen"
Lotus,boy kissers v2,delman,13,6,6,1,5,7,"Raze,Killjoy,Omen,Jett,Fade","Breach,Raze,Cypher,Omen,Fade"
Breeze,BB Esports,As Of Late,8,13,4,5,8,4,"Cypher,Sova,Viper,Jett,Yoru","Viper,Reyna,Jett,Yoru,Chamber"
Sunset,Team Falcons,The Ultimates,13,6,3,4,2,10,"Breach,Raze,Cypher,Omen,Fade","Breach,Raze,Sage,Omen,Gekko"
Sunset,FOG Vortex,Dragons Esports GC,10,13,5,7,6,5,"Breach,Raze,Cypher,Omen,Fade","Raze,Cypher,Viper,Omen,Skye"
Sunset,Team Falcons Vega,Gamax Lite,13,6,10,2,4,3,"Breach,Raze,Cypher,Omen,Fade","Breach,Raze,Cypher,Omen,Gekko"
Lotus,Formulation Gaming GC,BLAZE GC,6,13,5,7,6,1,"Raze,Cypher,Viper,Omen,Gekko","Breach,Raze,Sova,Killjoy,Omen"
Lotus,boy kissers v2,BB Esports,13,3,10,2,1,3,"Raze,Killjoy,Omen,Jett,Fade","Raze,Killjoy,Viper,Omen,Fade"
Ascent,Silly Weapons All Game,Mulieres Vires,12,14,8,5,9,4,"Sova,Killjoy,Jett,Astra,KAY/O","Sova,Killjoy,Omen,Jett,KAY/O"
Lotus,Celestials GC,TOG Kitsune,1,13,0,2,11,1,"Raze,Viper,KAY/O,Harbor,Gekko","Breach,Raze,Killjoy,Omen,Gekko"
Sunset,MIBR GC,TBS GC,14,12,9,4,8,5,"Raze,Cypher,Omen,Fade,Gekko","Breach,Raze,Cypher,Omen,Gekko"
Breeze,Formulation Gaming GC,BLAZE GC,5,13,2,4,9,3,"Cypher,Sova,Viper,Jett,KAY/O","Cypher,Sova,Viper,Jett,KAY/O"
Bind,Team Falcons,The Ultimates,13,11,9,3,8,4,"Raze,Viper,Sage,Skye,Clove","Raze,Viper,Omen,KAY/O,Gekko"
Ascent,As Of Late,delman,12,14,5,8,6,7,"Sova,Killjoy,Phoenix,Omen,Jett","Breach,Sova,Killjoy,Jett,Clove"
Bind,BB Esports,Potato aims,13,8,7,5,3,6,"Raze,Viper,Omen,Skye,Gekko","Raze,Cypher,Brimstone,Skye,Gekko"
Breeze,MIBR GC,TBS GC,13,1,11,1,0,2,"Cypher,Sova,Viper,Jett,KAY/O","Cypher,Sova,Viper,Jett,KAY/O"
Icebox,boy kissers v2,Atake Esports,13,6,9,3,3,4,"Sova,Killjoy,Viper,Jett,Gekko","Sova,Killjoy,Viper,Sage,Jett"
Ascent,GoatFellas Tragos,PCIFIC Waves,3,13,0,4,9,3,"Sova,Killjoy,Omen,Jett,KAY/O","Sova,Killjoy,Omen,Jett,KAY/O"
Icebox,Formulation Gaming GC,BLAZE GC,13,4,4,1,3,9,"Sova,Killjoy,Viper,Sage,Jett","Sova,Killjoy,Viper,Jett,Clove"
Ascent,delman,Origammi dinók,13,3,11,1,2,2,"Cypher,Sova,Sage,Jett,Clove","Sova,Killjoy,Omen,Jett,KAY/O"
Ascent,HOF Kitsune,Silly Weapons All Game,6,13,3,9,4,3,"Sova,Killjoy,Omen,Jett,KAY/O","Sova,Killjoy,Jett,Astra,KAY/O"
Split,Team Falcons,The Ultimates,13,2,10,2,0,3,"Breach,Raze,Cypher,Omen,Skye","Raze,Killjoy,Viper,Omen,Skye"
Bind,SQX Queens,Ketçaplı Ruffles,3,13,3,9,4,0,"Raze,Cypher,Brimstone,Jett,Skye","Raze,Viper,Brimstone,Jett,Gekko"
Bind,Fine Vision Queens,Luminaria,2,13,1,11,2,1,"Breach,Cypher,Sova,Jett,Clove","Breach,Raze,Brimstone,Gekko,Deadlock"
Icebox,Celestials GC,5STARS GC,13,3,10,2,1,3,"Killjoy,Sage,KAY/O,Harbor,Gekko","Sova,Killjoy,Viper,Jett,Gekko"
Breeze,TOG Kitsune,Last9,13,11,5,7,4,8,"Cypher,Sova,Viper,Jett,KAY/O","Cypher,Sova,Viper,Jett,Yoru"
Lotus,As Of Late,Kiraria Esports,13,2,12,0,2,1,"Raze,Omen,Yoru,Gekko,Deadlock","Raze,Killjoy,Viper,Omen,Fade"
Icebox,Neira Esports,Team Kuara,1,13,0,2,11,1,"Sova,Killjoy,Reyna,Jett,Harbor","Sova,Killjoy,Viper,Reyna,Jett"
Lotus,Saltire Sirens,Mulieres Vires,5,13,3,3,10,2,"Breach,Raze,Cypher,Omen,Skye","Breach,Raze,Sova,Omen,Chamber"
Ascent,Sky Esports,DIVINE,11,13,6,6,7,5,"Sova,Killjoy,Omen,Jett,KAY/O","Breach,Viper,Omen,Jett,KAY/O"
Breeze,As Of Late,Just a girl,13,2,10,2,0,3,"Cypher,Sova,Viper,Jett,Yoru","Viper,Jett,Astra,Fade,Gekko"
Split,SQX Queens,Ketçaplı Ruffles,4,13,3,2,11,1,"Breach,Raze,Cypher,Omen,Fade","Breach,Raze,Sage,Omen,Chamber"
Breeze,Jabba Enjoyers,Coalesce,8,13,4,8,5,4,"Cypher,Sova,Viper,Reyna,Jett","Cypher,Sova,Viper,Jett,Yoru"
Sunset,Fine Vision Queens,Luminaria,6,13,4,8,5,2,"Breach,Cypher,Sage,Jett,Harbor","Breach,Cypher,Sova,Omen,Jett"
Bind,Komore GC,Origammi dinók,5,13,4,8,5,1,"Breach,Raze,Cypher,Brimstone,Gekko","Raze,Viper,Brimstone,Skye,Deadlock"
Split,GoatFellas Tragos,PCIFIC Waves,8,13,7,5,8,1,"Breach,Raze,Killjoy,Sage,Omen","Breach,Raze,Cypher,Omen,Skye"
Lotus,Nova Elite GC,5STARS GC,1,13,0,2,11,1,"Breach,Raze,Killjoy,Omen,Gekko","Breach,Raze,Killjoy,Omen,Gekko"
Ascent,Neira Esports,Team Kuara,2,13,0,3,10,2,"Sova,Killjoy,Omen,Jett,KAY/O","Sova,Killjoy,Reyna,Omen,Jett"
Sunset,Silly Weapons All Game,Hidden Horizon GC,13,7,3,5,2,10,"Breach,Raze,Cypher,Gekko,Clove","Breach,Raze,Cypher,Omen,Gekko"
Lotus,Shadow5,Kiraria Esports,2,13,2,10,3,0,"Breach,Raze,Cypher,Astra,Fade","Raze,Killjoy,Viper,Omen,Fade"
Lotus,Team ARI,boy kissers v2,3,13,1,3,10,2,"Killjoy,Reyna,Omen,Jett,Fade","Raze,Killjoy,Omen,Jett,Fade"
Icebox,Last9,Coalesce Roses,13,7,9,3,4,4,"Sova,Killjoy,Viper,Jett,Gekko","Sova,Killjoy,Viper,Sage,Jett"
Breeze,BLAZE GC,axolotls and chips,14,12,7,6,6,7,"Cypher,Sova,Viper,Jett,KAY/O","Cypher,Sova,Viper,Jett,Yoru"
Sunset,NEON BLADE,Formulation Gaming GC,8,13,2,10,3,6,"Raze,Cypher,Reyna,Omen,Gekko","Breach,Raze,Cypher,Omen,Gekko"
Lotus,Mulieres Vires,Itz 2 EZzy,13,3,4,0,3,9,"Breach,Raze,Sova,Omen,Chamber","Breach,Raze,Cypher,Astra,Gekko"
Sunset,delman,No NamerS,13,4,5,0,4,8,"Raze,Cypher,Viper,Omen,Gekko","Breach,Raze,Cypher,Omen,Gekko"
Icebox,Underground Gaming,The Vicious,7,13,4,8,5,3,"Killjoy,Viper,Reyna,Gekko,Clove","Sova,Killjoy,Viper,Sage,Jett"
Split,Sky Esports,DIVINE,13,15,6,8,7,7,"Breach,Cypher,Omen,Jett,Skye","Breach,Raze,Cypher,Viper,Omen"
Sunset,Jabba Enjoyers,Coalesce,11,13,4,8,5,7,"Raze,Cypher,Omen,Jett,Gekko","Raze,Cypher,Sova,Omen,Gekko"
Icebox,axolotls and chips,HOF Kitsune,13,4,10,2,2,3,"Killjoy,Viper,Chamber,Gekko,Clove","Sova,Killjoy,Viper,Jett,Gekko"
Icebox,TwentyStars GC,NOVO GC,11,13,7,5,8,4,"Sova,Killjoy,Viper,Reyna,Jett","Sova,Killjoy,Viper,Sage,Jett"
Lotus,Mulieres Vires,Sakura Breeze GC,13,1,11,1,0,2,"Breach,Raze,Sova,Omen,Chamber","Breach,Raze,Killjoy,Omen,Gekko"
Icebox,Hidden Horizon GC,Frags Of Fire Collective,13,3,3,1,2,10,"Sova,Killjoy,Viper,Jett,Gekko","Sova,Killjoy,Viper,Jett,Gekko"
Ascent,Silly Weapons All Game,Fluffy Women,13,7,5,3,4,8,"Sova,Killjoy,Jett,KAY/O,Clove","Sova,Killjoy,Phoenix,Omen,Jett"
Lotus,5STARS GC,Fruit Basket,13,1,2,0,1,11,"Breach,Raze,Killjoy,Omen,Gekko","Breach,Raze,Killjoy,Harbor,Gekko"
Sunset,NEON BLADE,TOG Kitsune,13,7,8,4,3,5,"Raze,Cypher,Reyna,Omen,Gekko","Breach,Raze,Cypher,Omen,Gekko"
Bind,Formulation Gaming GC,Celestials GC,13,6,8,4,2,5,"Raze,Viper,Brimstone,Fade,Gekko","Raze,Yoru,Gekko,Deadlock,Clove"
Sunset,Kaizen Esports Aqua,BB Esports,5,13,4,8,5,1,"Raze,Cypher,Omen,KAY/O,Gekko","Breach,Raze,Cypher,Omen,Gekko"
Lotus,Atake Esports,Vanguard Vipers,13,6,2,5,1,11,"Raze,Killjoy,Viper,Omen,Fade","Breach,Raze,Omen,Chamber,Fade"
Icebox,Last9,NOIR Aster,13,9,6,6,3,7,"Sova,Killjoy,Viper,Jett,Gekko","Sova,Killjoy,Viper,Sage,Jett"
Sunset,BLAZE GC,Saltire Sirens,13,11,4,8,3,9,"Breach,Raze,Cypher,Sova,Omen","Breach,Raze,Cypher,Omen,Gekko"
Sunset,Itz 2 EZzy,Klutz Esports,13,8,6,3,5,7,"Raze,Cypher,Skye,Astra,Gekko","Raze,Cypher,Sova,Omen,Clove"
Bind,Southpaw,Coalesce Roses,3,13,0,4,9,3,"Raze,Cypher,Viper,Brimstone,Gekko","Raze,Killjoy,Brimstone,Gekko,Deadlock"
Ascent,axolotls and chips,Nova Elite GC,13,4,11,1,3,2,"Breach,Cypher,Sova,Omen,Jett","Sova,Killjoy,Omen,Jett,KAY/O"
Lotus,Underground Gaming,The Vicious,11,13,7,5,8,4,"Breach,Raze,Killjoy,Omen,Gekko","Raze,Killjoy,Omen,Jett,Skye"
Sunset,Sky Esports,DIVINE,13,7,7,5,2,6,"Breach,Raze,Cypher,Omen,Gekko","Raze,Cypher,Sova,Omen,KAY/O"
Lotus,TwentyStars GC,NOVO GC,8,13,4,8,5,4,"Breach,Raze,Killjoy,Omen,Jett","Breach,Sova,Killjoy,Omen,Neon"
Sunset,Mulieres Vires,TOG Kitsune,4,13,4,8,5,0,"Breach,Raze,Cypher,Omen,Skye","Breach,Raze,Cypher,Omen,Gekko"
Lotus,Formulation Gaming GC,Hidden Horizon GC,13,4,5,0,4,8,"Raze,Cypher,Viper,Omen,Gekko","Breach,Raze,Killjoy,Omen,Gekko"
Sunset,Celestials GC,Silly Weapons All Game,13,5,4,2,3,9,"Raze,Cypher,KAY/O,Harbor,Gekko","Breach,Raze,Cypher,Gekko,Clove"
Sunset,5STARS GC,HOF Kitsune,7,13,5,7,6,2,"Breach,Raze,Cypher,Omen,Gekko","Breach,Raze,Cypher,Omen,Gekko"
Ascent,NEON BLADE,Itz 2 EZzy,13,3,11,1,2,2,"Killjoy,Phoenix,Omen,Jett,Fade","Cypher,Sova,Jett,Astra,Deadlock"
Sunset,BLAZE GC,Southpaw,13,1,11,1,0,2,"Breach,Raze,Cypher,Sova,Omen","Raze,Cypher,Phoenix,Omen,Gekko"
Sunset,Last9,Saltire Sirens,7,13,5,7,6,2,"Cypher,Sova,Omen,KAY/O,Neon","Breach,Raze,Cypher,Omen,Gekko"
Lotus,Saltire Sirens,Frags Of Fire Collective,13,0,1,0,0,12,"Breach,Raze,Cypher,Omen,Skye","Raze,Killjoy,Viper,Omen,Gekko"
Lotus,Nova Elite GC,Sakura Breeze GC,16,14,9,6,8,7,"Breach,Raze,Killjoy,Omen,Gekko","Breach,Raze,Killjoy,Omen,Gekko"
Sunset,Silly Weapons All Game,Coalesce Roses,13,3,4,0,3,9,"Breach,Raze,Cypher,Gekko,Clove","Breach,Raze,Cypher,Omen,Yoru"
Ascent,HOF Kitsune,Klutz Esports,13,1,2,0,1,11,"Sova,Killjoy,Omen,Jett,KAY/O","Sova,Killjoy,Phoenix,Omen,Jett"
Ascent,Hidden Horizon GC,NOIR Aster,13,2,10,2,0,3,"Sova,Killjoy,Omen,Jett,KAY/O","Sova,Killjoy,Omen,Jett,KAY/O"
Bind,Southpaw,Fluffy Women,13,6,5,2,4,8,"Raze,Cypher,Viper,Brimstone,Gekko","Cypher,Brimstone,Reyna,Skye,Harbor"
Ascent,Itz 2 EZzy,Fruit Basket,13,5,4,2,3,9,"Cypher,Sova,Jett,Astra,Deadlock","Sova,Killjoy,Omen,Jett,KAY/O"
Ascent,SUPERCLAN,LazerrFreeks Mythic,13,5,4,2,3,9,"Sova,Killjoy,Phoenix,Jett,Clove","Sova,Killjoy,Omen,Jett,KAY/O"
Lotus,SUPERCLAN,LazerrFreeks Mythic,13,8,9,3,5,4,"Raze,Killjoy,Jett,Fade,Clove","Raze,Killjoy,Viper,Omen,Fade"
Icebox,Koala Pound,Be Like Matt,7,13,5,7,6,2,"Sova,Killjoy,Viper,Jett,Gekko","Sova,Killjoy,Viper,Reyna,Jett"
Bind,Sky Esports (NA),Ugly Hamsters,9,13,3,7,6,6,"Raze,Cypher,Skye,Fade,Clove","Raze,Cypher,Skye,Gekko,Clove"
Lotus,Sexy Gang,overcook,13,1,11,1,0,2,"Raze,Sage,Fade,Deadlock,Clove","Raze,Killjoy,Viper,Omen,Skye"
Lotus,Koala Pound,Be Like Matt,6,13,3,4,9,3,"Breach,Raze,Cypher,Omen,Gekko","Raze,Killjoy,Viper,Omen,Skye"
Haven,Sky Esports (NA),Ugly Hamsters,8,13,5,4,9,3,"Breach,Sova,Killjoy,Jett,Clove","Breach,Sova,Killjoy,Jett,Clove"
Bind,SUPERCLAN,LazerrFreeks Mythic,9,13,8,4,9,1,"Raze,Cypher,Skye,Yoru,Clove","Raze,Viper,Brimstone,Skye,Gekko"
Icebox,Sexy Gang,overcook,13,10,6,5,5,7,"Sova,Killjoy,Viper,Jett,KAY/O","Sova,Killjoy,Viper,Reyna,Clove"
Sunset,Toads,Prospects,7,13,3,5,8,4,"Breach,Raze,Cypher,Sova,Omen","Breach,Raze,Cypher,Omen,Gekko"
Haven,Koala Pound,Be Like Matt,13,7,9,3,4,4,"Breach,Sova,Killjoy,Jett,Clove","Breach,Sova,Killjoy,Omen,Jett"
Haven,Six Figures,Nearest Airport,11,13,3,9,4,8,"Breach,Cypher,Sova,Omen,Jett","Cypher,Sova,Phoenix,Omen,Jett"
Split,Sky Esports (NA),Ugly Hamsters,15,13,6,8,5,9,"Raze,Cypher,Jett,Skye,Clove","Raze,Cypher,Omen,Jett,Skye"
Split,Outlaw Merchants,Lionheart eSports,13,9,6,6,3,7,"Raze,Cypher,Viper,Omen,Skye","Breach,Raze,Cypher,Omen,Skye"
Lotus,Lemonade Stand,Dexterity Gaming,13,9,5,5,4,8,"Breach,Raze,Omen,Chamber,Gekko","Breach,Raze,Cypher,Omen,Fade"
Lotus,ROSE,BALLZ V3.0,9,13,2,8,5,7,"Raze,Cypher,Viper,Omen,Fade","Killjoy,Viper,Omen,Jett,Fade"
Ascent,Flowstate,1Millisecond,13,7,6,6,1,7,"Sova,Killjoy,Omen,Jett,KAY/O","Sova,Killjoy,Omen,Jett,KAY/O"
Ascent,Area of Effect,Paranoia Esports,13,8,7,2,6,6,"Cypher,Sova,Omen,Jett,Deadlock","Sova,Killjoy,Omen,Jett,KAY/O"
Ascent,Sexy Gang,Nightblood Gaming,4,13,3,9,4,1,"Sova,Killjoy,Omen,Jett,KAY/O","Sova,Killjoy,Omen,Jett,KAY/O"
Split,Toads,Prospects,10,13,3,8,5,7,"Raze,Cypher,Jett,Skye,Astra","Breach,Raze,Cypher,Omen,Yoru"
Lotus,Six Figures,Nearest Airport,7,13,6,6,7,1,"Breach,Killjoy,Omen,Neon,Gekko","Breach,Raze,Cypher,Gekko,Clove"
Icebox,Volcano Gang,LazerrFreeks Mythic,9,13,8,4,9,1,"Sova,Killjoy,Viper,Jett,Harbor","Killjoy,Viper,Jett,KAY/O,Gekko"
Ascent,Blue Otter,Koala Pound,13,5,8,4,1,5,"Sova,Killjoy,Omen,Jett,KAY/O","Breach,Cypher,Sova,Omen,Neon"
Icebox,Predator X Gaming,Be Like Matt,11,13,9,3,10,2,"Sova,Killjoy,Viper,Jett,Gekko","Sova,Killjoy,Viper,Reyna,Jett"
Sunset,Flowstate,1Millisecond,13,4,8,4,0,5,"Breach,Raze,Cypher,Sova,Clove","Breach,Raze,Cypher,Omen,Fade"
Split,Area of Effect,Paranoia Esports,13,3,10,2,1,3,"Raze,Cypher,Viper,Omen,Skye","Raze,Cypher,Viper,Omen,Skye"
Sunset,Outlaw Merchants,Lionheart eSports,13,7,7,5,2,6,"Raze,Cypher,Sova,Omen,Gekko","Breach,Cypher,Sova,Omen,Neon"
Icebox,DOOMSDAY,Orangutan Gang,5,13,0,6,7,5,"Killjoy,Viper,KAY/O,Gekko,Deadlock","Sova,Killjoy,Viper,Omen,Jett"
Bind,Lemonade Stand,Dexterity Gaming,14,12,11,2,10,3,"Raze,Viper,Brimstone,Skye,Gekko","Raze,Viper,Brimstone,Skye,Gekko"
Ascent,ROSE,BALLZ V3.0,13,8,6,6,2,7,"Sova,Killjoy,Omen,Jett,KAY/O","Sova,Killjoy,Omen,Jett,KAY/O"
Bind,Sexy Gang,Nightblood Gaming,9,13,4,6,7,5,"Raze,Cypher,Brimstone,Fade,Gekko","Raze,Viper,Omen,Skye,Gekko"
Ascent,Spate Esports,Nearest Airport,2,13,2,10,3,0,"Sova,Omen,Jett,KAY/O,Clove","Cypher,Sova,Omen,Jett,KAY/O"
Icebox,Ions Day Care,SUPERCLAN,13,1,11,1,0,2,"Sova,Killjoy,Viper,Reyna,Jett","Sova,Killjoy,Viper,Reyna,Jett"
Lotus,Toads,Prospects,13,9,8,4,5,5,"Raze,Killjoy,Viper,Omen,Fade","Raze,Killjoy,Viper,Omen,Fade"
Icebox,Winthrop University,Six Figures,13,10,6,6,4,7,"Sova,Killjoy,Viper,Jett,Clove","Sova,Killjoy,Viper,KAY/O,Chamber"
Haven,Blue Otter,Koala Pound,13,11,6,6,5,7,"Breach,Sova,Killjoy,Omen,Jett","Breach,Sova,Killjoy,Jett,Clove"
Split,Sky Esports (NA),Ugly Hamsters,13,10,8,4,6,5,"Raze,Cypher,Jett,Skye,Clove","Raze,Viper,Omen,Jett,Skye"
Sunset,Volcano Gang,LazerrFreeks Mythic,13,11,4,8,3,9,"Raze,Cypher,Omen,KAY/O,Gekko","Breach,Raze,Cypher,Omen,Fade"
Lotus,Flowstate,1Millisecond,11,13,7,5,8,4,"Breach,Raze,Killjoy,Omen,Fade","Breach,Raze,Cypher,Omen,Fade"
Haven,Predator X Gaming,Be Like Matt,13,8,8,1,7,5,"Breach,Sova,Killjoy,Omen,Jett","Breach,Sova,Killjoy,Omen,Jett"
Lotus,DOOMSDAY,Orangutan Gang,9,13,4,6,7,5,"Raze,Killjoy,Viper,Omen,Fade","Raze,Killjoy,Viper,Omen,Fade"
Haven,overcook,Forsaken Shadows,13,11,5,7,4,8,"Breach,Sova,Killjoy,Omen,Jett","Breach,Sova,Killjoy,Omen,Jett"
Lotus,Paranoia Vortex,Area of Effect,14,12,10,3,9,4,"Breach,Raze,Cypher,Omen,Gekko","Raze,Cypher,Viper,Omen,Fade"
Haven,ROSE,BALLZ V3.0,9,13,6,6,7,3,"Breach,Sova,Killjoy,Omen,Jett","Breach,Cypher,Sova,Omen,Jett"
Ascent,Outlaw Merchants,IOUNL,10,13,7,5,8,3,"Sova,Killjoy,Omen,Jett,KAY/O","Cypher,Sova,Omen,Jett,Deadlock"
Bind,Dexterity Gaming,Miracle Esports,13,9,7,3,6,6,"Raze,Viper,Brimstone,Skye,Gekko","Raze,Cypher,Jett,Skye,Clove"
Ascent,Ions Day Care,SUPERCLAN,13,5,6,0,5,7,"Sova,Killjoy,Reyna,Omen,Jett","Sova,Killjoy,Sage,Jett,Clove"
Bind,Lemonade Stand,Shifty505,8,13,3,9,4,5,"Raze,Viper,Brimstone,Skye,Gekko","Raze,Viper,Skye,Gekko,Clove"
Ascent,Paranoia Esports,Goated,13,7,9,3,4,4,"Sova,Killjoy,Omen,Jett,KAY/O","Sova,Killjoy,Reyna,Omen,Jett"
Haven,Spate Esports,Nearest Airport,13,10,6,6,4,7,"Breach,Cypher,Sova,Harbor,Clove","Breach,Cypher,Sova,Omen,Jett"
Haven,Sexy Gang,Nightblood Gaming,15,13,8,6,7,7,"Breach,Cypher,Sova,Jett,Clove","Breach,Cypher,Sova,Omen,Jett"
Haven,Sky Esports (NA),Ugly Hamsters,13,10,6,5,5,7,"Breach,Sova,Killjoy,Jett,Clove","Sova,Killjoy,Reyna,Omen,Jett"
Ascent,Winthrop University,Six Figures,13,11,5,7,4,8,"Cypher,Sova,Omen,Jett,KAY/O","Sova,Killjoy,Sage,Omen,Jett"
Sunset,overcook,Forsaken Shadows,13,6,8,4,2,5,"Breach,Raze,Cypher,Omen,Gekko","Breach,Raze,Cypher,Omen,Jett"
Sunset,The Final Shape,Toads,13,9,4,6,3,9,"Breach,Raze,Cypher,Omen,Gekko","Breach,Raze,Cypher,Sova,Omen"
Lotus,Blue Otter,Koala Pound,10,13,7,5,8,3,"Breach,Raze,Cypher,Omen,Gekko","Breach,Raze,Cypher,Omen,Gekko"
Ascent,Abyss Blueming,1Millisecond,5,13,4,8,5,1,"Sova,Killjoy,Omen,Jett,KAY/O","Sova,Killjoy,Omen,Jett,KAY/O"
Lotus,Predator X Gaming,Be Like Matt,10,13,5,6,7,5,"Raze,Killjoy,Viper,Omen,Fade","Raze,Killjoy,Viper,Omen,Skye"
Lotus,Volcano Gang,LazerrFreeks Mythic,12,14,6,7,7,6,"Breach,Raze,Killjoy,Omen,Gekko","Raze,Killjoy,Viper,Omen,Fade"
Icebox,Guppies,Orangutan Gang,5,13,3,3,10,2,"Sova,Killjoy,Viper,Reyna,Jett","Sova,Killjoy,Viper,Omen,Jett"
Lotus,Prospects,MERC CLAN,13,2,11,1,1,2,"Raze,Killjoy,Viper,Omen,Fade","Raze,Killjoy,Omen,Fade,Gekko"
Ascent,whats a pretzel,DOOMSDAY,13,8,6,6,2,7,"Sova,Killjoy,Omen,Jett,KAY/O","Sova,Killjoy,Omen,Jett,KAY/O"
Haven,Ions Day Care,SUPERCLAN,7,13,4,4,9,3,"Killjoy,Omen,Jett,Fade,Gekko","Sova,Killjoy,Sage,Jett,Clove"
Lotus,RyZ Knights,Flowstate,15,13,8,6,7,7,"Raze,Sova,Killjoy,Viper,Omen","Breach,Raze,Killjoy,Omen,Fade"
Icebox,Dexterity Gaming,Miracle Esports,13,6,8,4,2,5,"Sova,Killjoy,Viper,Harbor,Gekko","Sova,Killjoy,Jett,Harbor,Gekko"
Haven,Outlaw Merchants,IOUNL,13,10,5,7,3,8,"Breach,Sova,Killjoy,Omen,Jett","Breach,Cypher,Sova,Omen,Jett"
Sunset,Paranoia Vortex,Area of Effect,13,8,6,3,5,7,"Raze,Cypher,Omen,KAY/O,Gekko","Breach,Raze,Cypher,Sova,Omen"
Lotus,Lemonade Stand,Shifty505,15,13,9,5,8,6,"Breach,Raze,Omen,Chamber,Gekko","Breach,Raze,Omen,Jett,Skye"
Sunset,ROSE,Special Grade,5,13,4,8,5,1,"Raze,Cypher,Omen,KAY/O,Gekko","Breach,Raze,Cypher,Omen,Gekko"
Sunset,Prospects Amethyst,Lionheart eSports,8,13,8,4,9,0,"Raze,Cypher,Omen,KAY/O,Gekko","Breach,Cypher,Sova,Omen,Neon"
Lotus,Winthrop University,Six Figures,8,13,8,4,9,0,"Breach,Raze,Cypher,Omen,Fade","Breach,Killjoy,Omen,Neon,Gekko"
Ascent,Guppies,Orangutan Gang,2,13,2,10,3,0,"Cypher,Sova,Jett,KAY/O,Clove","Sova,Killjoy,Omen,Jett,KAY/O"
Bind,Paranoia Esports,Goated,13,11,10,2,9,3,"Raze,Viper,Brimstone,Fade,Gekko","Raze,Brimstone,Reyna,Gekko,Deadlock"
Lotus,Team Leveling,sou proplayer lixo?,13,5,10,2,3,3,"Breach,Raze,Killjoy,Omen,Gekko","Raze,Killjoy,Viper,Omen,Fade"
Haven,whats a pretzel,DOOMSDAY,13,0,12,0,0,1,"Breach,Cypher,Sova,Omen,Jett","Breach,Cypher,Omen,Jett,Gekko"
Lotus,Spate Esports,Nearest Airport,10,13,9,2,11,1,"Breach,Raze,Cypher,Omen,Gekko","Breach,Raze,Cypher,Gekko,Clove"
Sunset,RyZ Knights,Flowstate,13,6,5,2,4,8,"Breach,Raze,Cypher,Sova,Omen","Breach,Raze,Cypher,Sova,Clove"
Ascent,BALLZ V3.0,Beto's Mexican Food,13,2,3,0,2,10,"Sova,Killjoy,Jett,KAY/O,Clove","Cypher,Reyna,Omen,Jett,KAY/O"
Lotus,Abyss Blueming,1Millisecond,6,13,2,5,8,4,"Breach,Raze,Omen,Jett,Fade","Breach,Raze,Cypher,Omen,Fade"
Haven,Prospects,MERC CLAN,13,5,4,2,3,9,"Breach,Sova,Killjoy,Omen,Neon","Cypher,Viper,Jett,Skye,Harbor"
Lotus,The Final Shape,Toads,16,14,7,8,6,9,"Raze,Killjoy,Omen,Fade,Clove","Raze,Killjoy,Viper,Omen,Fade"
Lotus,Sexy Gang,overcook,13,9,5,7,2,8,"Raze,Killjoy,Jett,Skye,Clove","Raze,Killjoy,Viper,Omen,Skye"
Haven,Dexterity Gaming,Miracle Esports,10,13,7,4,9,3,"Breach,Sova,Killjoy,Omen,Jett","Killjoy,Omen,Jett,Skye,Neon"
Lotus,LazerrFreeks Mythic,SUPERCLAN,10,13,5,6,7,5,"Breach,Raze,Cypher,Omen,Fade","Breach,Raze,Killjoy,Fade,Clove"
Bind,Be Like Matt,Koala Pound,11,13,8,4,9,3,"Raze,Viper,Brimstone,Skye,Chamber","Raze,Cypher,Viper,Brimstone,Skye"
Lotus,Prospects Amethyst,Lionheart eSports,6,13,1,6,7,5,"Breach,Raze,Cypher,Omen,Gekko","Breach,Killjoy,Omen,Neon,Fade"
Haven,ROSE,Special Grade,10,13,7,5,8,3,"Breach,Sova,Killjoy,Omen,Jett","Breach,Sova,Killjoy,Omen,Jett"
Lotus,Outlaw Merchants,IOUNL,8,13,5,4,9,3,"Raze,Cypher,Omen,Fade,Gekko","Raze,Killjoy,Viper,Omen,Fade"
Ascent,Lemonade Stand,Shifty505,13,15,11,3,12,2,"Sova,Killjoy,Brimstone,Sage,KAY/O","Sova,Killjoy,Omen,Jett,KAY/O"
Lotus,BALLZ V3.0,Beto's Mexican Food,13,2,10,2,0,3,"Raze,Killjoy,Viper,Omen,Fade","Raze,Killjoy,Omen,Fade,Gekko"
Bind,Team Leveling,sou proplayer lixo?,13,5,9,3,2,4,"Raze,Viper,Brimstone,Skye,Gekko","Raze,Viper,Brimstone,Skye,Gekko"
Lotus,Ugly Hamsters,PRO CITY FOUNDERS,11,13,7,5,8,4,"Breach,Omen,Neon,Gekko,Deadlock","Raze,Cypher,Viper,Skye,Clove"
Icebox,Paranoia Vortex,Paranoia Esports,13,7,4,4,3,9,"Sova,Killjoy,Viper,Omen,Jett","Sova,Killjoy,Viper,Reyna,Jett"
Haven,Toads,MERC CLAN,13,2,10,2,0,3,"Breach,Sova,Killjoy,Omen,Jett","Killjoy,Viper,Omen,Jett,Skye"
Breeze,TBS GC,FURIA GC,13,6,8,4,2,5,"Cypher,Sova,Viper,Jett,KAY/O","Cypher,Sova,Viper,Jett,KAY/O"
Ascent,Power Rangers Jungle Fury,Sky Esports (NA),13,3,2,2,1,11,"Sova,Killjoy,Jett,KAY/O,Clove","Sova,Killjoy,Omen,Jett,KAY/O"
Icebox,REVOADA,sem fazer careta,13,4,9,3,1,4,"Sova,Killjoy,Viper,Jett,KAY/O","Sova,Killjoy,Viper,Jett,Gekko"
Icebox,Area of Effect,Goated,13,3,3,1,2,10,"Sova,Killjoy,Viper,Jett,Gekko","Sova,Killjoy,Viper,Jett,Neon"
Ascent,Six Figures,Nearest Airport,13,11,5,7,4,8,"Sova,Killjoy,Sage,Omen,Jett","Cypher,Sova,Omen,Jett,KAY/O"
Ascent,Winthrop University,Spate Esports,13,4,10,2,2,3,"Cypher,Sova,Omen,Jett,KAY/O","Raze,Sova,Omen,KAY/O,Clove"
Ascent,Sexy Gang,overcook,13,6,6,6,0,7,"Sova,Killjoy,Omen,Jett,KAY/O","Sova,Killjoy,Omen,Jett,KAY/O"
Icebox,Orangutan Gang,DOOMSDAY,13,15,7,7,8,6,"Sova,Killjoy,Viper,Omen,Jett","Sova,Killjoy,Viper,Sage,Chamber"
Haven,Flowstate,1Millisecond,13,6,9,3,3,4,"Breach,Sova,Killjoy,Omen,Jett","Breach,Sova,Killjoy,Omen,Jett"
Sunset,Nightblood Gaming,Forsaken Shadows,13,10,6,5,5,7,"Breach,Raze,Cypher,Omen,Gekko","Breach,Raze,Cypher,Omen,Jett"
Bind,Ions Day Care,Volcano Gang,13,11,5,7,4,8,"Raze,Viper,Brimstone,Jett,Deadlock","Raze,Cypher,Viper,Brimstone,Skye"
Lotus,Lemonade Stand,Dexterity Gaming,13,5,5,1,4,8,"Breach,Raze,Omen,Chamber,Gekko","Breach,Raze,Cypher,Omen,Fade"
Haven,Blue Otter,Predator X Gaming,13,5,4,2,3,9,"Breach,Sova,Killjoy,Omen,Jett","Breach,Sova,Killjoy,Omen,Jett"
Haven,RyZ Knights,Abyss Blueming,13,7,6,2,5,7,"Breach,Sova,Killjoy,Omen,Jett","Breach,Sova,Killjoy,Omen,Jett"
Haven,Be Like Matt,Koala Pound,13,10,3,9,1,10,"Breach,Sova,Killjoy,Omen,Jett","Breach,Cypher,Sova,Omen,Jett"
Haven,Ugly Hamsters,PRO CITY FOUNDERS,7,13,3,9,4,4,"Breach,Cypher,Sova,Omen,Jett","Sova,Killjoy,Reyna,Omen,Jett"
Sunset,LazerrFreeks Mythic,SUPERCLAN,14,12,10,3,9,4,"Breach,Raze,Cypher,Omen,Fade","Raze,Cypher,Sova,KAY/O,Clove"
Haven,Outlaw Merchants,Prospects Amethyst,13,0,1,0,0,12,"Breach,Sova,Killjoy,Omen,Jett","Breach,Sova,Killjoy,Omen,Jett"
Haven,The Final Shape,Prospects,13,7,8,4,3,5,"Breach,Sova,Killjoy,Omen,Jett","Breach,Sova,Killjoy,Omen,Neon"
Lotus,whats a pretzel,Guppies,13,6,4,3,3,9,"Raze,Killjoy,Viper,Omen,Fade","Breach,Raze,Killjoy,Omen,Gekko"
Bind,IOUNL,Lionheart eSports,13,9,5,5,4,8,"Raze,Brimstone,Skye,Yoru,Gekko","Raze,Sova,Viper,Brimstone,Skye"
Sunset,ROSE,BALLZ V3.0,13,9,9,1,8,4,"Raze,Cypher,Omen,KAY/O,Gekko","Raze,Cypher,Omen,KAY/O,Gekko"
Sunset,Shifty505,Miracle Esports,13,5,8,4,1,5,"Breach,Raze,Cypher,Omen,Gekko","Breach,Raze,Cypher,Omen,Gekko"
Split,Special Grade,Beto's Mexican Food,13,5,9,3,2,4,"Breach,Raze,Cypher,Omen,Yoru","Breach,Raze,Cypher,Omen,Skye"
Lotus,MIBR GC,Vila das Flores,13,1,2,0,1,11,"Raze,Killjoy,Viper,Omen,Fade","Raze,Omen,Chamber,Fade,Deadlock"
Ascent,Paranoia Vortex,Paranoia Esports,9,13,7,5,8,2,"Sova,Killjoy,Omen,Jett,KAY/O","Sova,Killjoy,Omen,Jett,KAY/O"
Lotus,Toads,MERC CLAN,13,9,8,4,5,5,"Raze,Killjoy,Viper,Omen,Fade","Killjoy,Omen,Jett,Skye,Gekko"
Icebox,TBS GC,FURIA GC,13,7,6,6,1,7,"Sova,Killjoy,Viper,Jett,Gekko","Sova,Killjoy,Viper,Jett,Gekko"
Sunset,The Final Shape,Prospects,13,2,10,2,0,3,"Breach,Raze,Cypher,Omen,Fade","Breach,Raze,Cypher,Omen,Gekko"
Lotus,Winthrop University,Spate Esports,13,11,6,6,5,7,"Breach,Raze,Cypher,Omen,Fade","Breach,Raze,Cypher,Omen,Gekko"
Split,Area of Effect,Goated,13,7,6,6,1,7,"Raze,Cypher,Viper,Omen,Skye","Raze,Cypher,Jett,Yoru,Clove"
Haven,Ions Day Care,Volcano Gang,13,6,8,4,2,5,"Sova,Killjoy,Omen,Jett,Deadlock","Breach,Sova,Killjoy,Omen,Jett"
Lotus,Outlaw Merchants,Prospects Amethyst,13,1,2,0,1,11,"Raze,Cypher,Omen,Fade,Gekko","Breach,Raze,Cypher,Omen,Gekko"
Ascent,RyZ Knights,Abyss Blueming,13,3,2,2,1,11,"Sova,Killjoy,Omen,Jett,KAY/O","Sova,Killjoy,Omen,Jett,KAY/O"
Sunset,Flowstate,1Millisecond,13,10,7,5,5,6,"Breach,Raze,Cypher,Sova,Clove","Breach,Raze,Cypher,Omen,Fade"
Bind,Nightblood Gaming,Forsaken Shadows,13,6,8,4,2,5,"Raze,Viper,Omen,Skye,Gekko","Raze,Viper,Brimstone,Yoru,Gekko"
Split,REVOADA,sem fazer careta,13,11,7,5,6,6,"Raze,Cypher,Viper,Omen,Skye","Breach,Raze,Viper,Omen,Skye"
Icebox,Lemonade Stand,Dexterity Gaming,13,6,7,5,1,6,"Omen,KAY/O,Harbor,Gekko,Clove","Sova,Killjoy,Viper,Harbor,Gekko"
Haven,IOUNL,Lionheart eSports,13,2,10,2,0,3,"Breach,Cypher,Sova,Omen,Jett","Breach,Sova,Killjoy,Astra,Neon"
Lotus,Blue Otter,Predator X Gaming,13,3,10,2,1,3,"Breach,Raze,Cypher,Omen,Gekko","Raze,Killjoy,Viper,Omen,Fade"
Haven,LazerrFreeks Mythic,SUPERCLAN,5,13,1,5,8,4,"Breach,Sova,Killjoy,Omen,Jett","Breach,Sova,Killjoy,Omen,Jett"
Haven,Power Rangers Jungle Fury,Sky Esports (NA),13,11,8,4,7,5,"Breach,Cypher,Sova,Jett,Clove","Breach,Sova,Killjoy,Omen,Jett"
Icebox,ROSE,BALLZ V3.0,13,3,4,0,3,9,"Sova,Killjoy,Viper,Jett,KAY/O","Sova,Killjoy,Viper,Jett,KAY/O"
Bind,Orangutan Gang,DOOMSDAY,10,13,4,7,6,6,"Raze,Viper,Brimstone,Fade,Gekko","Sage,Harbor,Deadlock,Iso,Clove"
Ascent,Shifty505,Miracle Esports,13,3,2,2,1,11,"Sova,Killjoy,Omen,Jett,KAY/O","Sova,Killjoy,Omen,Jett,KAY/O"
Haven,Sexy Gang,overcook,11,13,4,8,5,7,"Breach,Cypher,Sova,Jett,Clove","Breach,Sova,Killjoy,Omen,Jett"
Sunset,MIBR GC,Vila das Flores,13,1,11,1,0,2,"Raze,Cypher,Omen,Fade,Gekko","Raze,Cypher,Omen,KAY/O,Gekko"
Bind,Six Figures,Nearest Airport,14,12,8,5,7,6,"Raze,Viper,Brimstone,Skye,KAY/O","Raze,Viper,Omen,Fade,Gekko"
Lotus,Paranoia Vortex,Paranoia Esports,13,5,10,2,3,3,"Breach,Raze,Cypher,Omen,Gekko","Killjoy,Viper,Omen,Jett,Gekko"
Haven,Special Grade,Beto's Mexican Food,13,4,4,1,3,9,"Breach,Sova,Killjoy,Omen,Jett","Cypher,Sova,Omen,Jett,Gekko"
Lotus,Be Like Matt,Koala Pound,4,13,4,8,5,0,"Raze,Cypher,Viper,Omen,Skye","Breach,Raze,Cypher,Omen,Gekko"
Sunset,whats a pretzel,Guppies,13,6,9,3,3,4,"Breach,Raze,Cypher,Omen,Gekko","Raze,Cypher,Jett,Gekko,Clove"
Ascent,Ugly Hamsters,PRO CITY FOUNDERS,13,9,6,4,5,7,"Sova,Killjoy,Omen,Jett,KAY/O","Sova,Killjoy,Omen,Jett,KAY/O"
Lotus,Novita Esports,Reveal Multigaming,13,15,8,6,9,5,"Breach,Raze,Killjoy,Omen,Gekko","Breach,Cypher,Sova,Omen,Neon"
Split,UCAN ESPORTS,TeamOrangeGaming,2,13,0,3,10,2,"Raze,Reyna,Omen,Jett,Deadlock","Raze,Cypher,Sage,Omen,Skye"
Ascent,HONEYBADGER123,POTATO ABUSERS,13,4,3,2,2,10,"Cypher,Omen,Jett,KAY/O,Gekko","Sova,Killjoy,Omen,Jett,KAY/O"
Ascent,The Ultimates Odyssey,R8 Blues,9,13,4,6,7,5,"Sova,Killjoy,Omen,Jett,KAY/O","Sova,Killjoy,Astra,KAY/O,Neon"
Lotus,The Ultimates,The Vicious,13,6,4,3,3,9,"Raze,Killjoy,Viper,Omen,Fade","Raze,Killjoy,Omen,Jett,Skye"
Ascent,Lootcifer,6TM ESPORTS,13,10,4,7,3,9,"Cypher,Sova,Omen,Jett,KAY/O","Cypher,Sova,Omen,Jett,KAY/O"
Lotus,LA RUE,AKA HERO,13,11,6,6,5,7,"Raze,Killjoy,Viper,Omen,Fade","Breach,Sova,Killjoy,Omen,Neon"
Bind,INF Esports,GJ Omen,9,13,5,5,8,4,"Raze,Viper,Brimstone,Skye,Gekko","Raze,Viper,Brimstone,Skye,Gekko"
Icebox,FOG Vortex,Team Falcons Vega,4,13,0,5,8,4,"Sova,Killjoy,Viper,Reyna,Jett","Sova,Killjoy,Viper,Jett,Gekko"
Lotus,Dragons Esports GC,Twisted Minds Orchid,8,13,3,6,7,5,"Raze,Killjoy,Viper,Omen,Fade","Breach,Raze,Cypher,Omen,Fade"
Sunset,UCAN ESPORTS,TeamOrangeGaming,13,10,8,3,7,5,"Raze,Cypher,Phoenix,Skye,Clove","Breach,Raze,Cypher,Sova,Omen"
Bind,HONEYBADGER123,POTATO ABUSERS,2,13,2,10,3,0,"Raze,Viper,Brimstone,Skye,Gekko","Raze,Viper,Skye,Gekko,Clove"
Lotus,Reveal Multigaming Saphire,ARROW,11,13,5,7,6,6,"Raze,Killjoy,Viper,Omen,Fade","Raze,Killjoy,Viper,Omen,Fade"
Icebox,MAJOR MONOGWAM,Sissi State Punks,8,13,2,7,6,6,"Sova,Killjoy,Viper,Reyna,Jett","Sova,Killjoy,Viper,Jett,KAY/O"
Ascent,Novita Esports,Reveal Multigaming,13,9,6,4,5,7,"Sova,Killjoy,Phoenix,Omen,Jett","Cypher,Sova,Killjoy,Omen,Jett"
Sunset,TwentyStars,GMBLERS Esports,1,13,1,11,2,0,"Breach,Raze,Cypher,Omen,Gekko","Breach,Raze,Cypher,Omen,Gekko"
Breeze,A One Man Army,Sissi State Punks Academy,13,10,7,4,6,6,"Cypher,Sova,Viper,Jett,KAY/O","Cypher,Sova,Viper,Jett,Yoru"
Sunset,FOG Vortex,Team Falcons Vega,2,13,2,10,3,0,"Breach,Raze,Cypher,Omen,Fade","Breach,Raze,Cypher,Omen,Fade"
Icebox,The Ultimates Odyssey,R8 Blues,7,13,4,8,5,3,"Killjoy,Viper,Omen,KAY/O,Gekko","Sova,Killjoy,Viper,Sage,Neon"
Split,Dragons Esports GC,Twisted Minds Orchid,4,13,2,10,3,2,"Raze,Cypher,Omen,Jett,Skye","Breach,Raze,Cypher,Viper,Omen"
Ascent,INF Esports,GJ Omen,4,13,3,9,4,1,"Breach,Viper,Brimstone,Sage,Neon","Cypher,Sova,Omen,Jett,KAY/O"
Ascent,LA RUE,AKA HERO,13,9,8,4,5,5,"Sova,Killjoy,Omen,Jett,KAY/O","Sova,Killjoy,Omen,Jett,KAY/O"
Lotus,XProjekt Lioness,Team Occupy Feminine Fusion,7,13,3,5,8,4,"Breach,Raze,Killjoy,Omen,Gekko","Raze,Killjoy,Viper,Omen,Fade"
Bind,Lootcifer,6TM ESPORTS,13,11,10,2,9,3,"Raze,Viper,Omen,KAY/O,Gekko","Raze,Viper,Omen,KAY/O,Gekko"
Ascent,MAJOR MONOGWAM,Sissi State Punks,0,13,0,12,1,0,"Sova,Killjoy,Omen,Jett,KAY/O","Sova,Killjoy,Omen,Jett,KAY/O"
Lotus,QUE PASA,Dortmund Esports,9,13,4,8,5,5,"Breach,Raze,Killjoy,Omen,Fade","Raze,Omen,Yoru,Gekko,Deadlock"
Split,FATE Flare,GnG White,0,13,0,1,12,0,"Breach,Raze,Cypher,Omen,Fade","Breach,Raze,Cypher,Omen,Jett"
Ascent,HUNTERS,DSYRE Academy,7,13,4,4,9,3,"Sova,Killjoy,Omen,Jett,KAY/O","Sova,Killjoy,Omen,Jett,KAY/O"
Ascent,The Ultimates,The Vicious,14,12,4,9,3,10,"Sova,Killjoy,Omen,Jett,KAY/O","Sova,Killjoy,Jett,Astra,KAY/O"
Sunset,HONEYBADGER123,POTATO ABUSERS,13,8,9,3,5,4,"Breach,Raze,Sage,Omen,Gekko","Raze,Cypher,Omen,KAY/O,Gekko"
Ascent,Reveal Multigaming Saphire,ARROW,9,13,3,9,4,6,"Sova,Killjoy,Omen,Jett,KAY/O","Sova,Killjoy,Omen,Jett,KAY/O"
Lotus,A One Man Army,Sissi State Punks Academy,13,9,6,6,3,7,"Breach,Raze,Killjoy,Omen,Gekko","Breach,Raze,Sova,Killjoy,Omen"
Icebox,Novita Esports,Reveal Multigaming,8,13,5,4,9,3,"Killjoy,Viper,Reyna,Jett,Gekko","Sova,Killjoy,Viper,Jett,Clove"
Ascent,UCAN ESPORTS,TeamOrangeGaming,12,14,9,4,10,3,"Viper,Reyna,Jett,Yoru,Clove","Sova,Killjoy,Omen,Jett,KAY/O"
Lotus,TwentyStars,GMBLERS Esports,10,13,6,6,7,4,"Breach,Raze,Omen,Skye,Neon","Breach,Raze,Killjoy,Omen,Jett"
Icebox,Andromeda Gaming,Elysian Esports,13,11,9,3,8,4,"Sova,Killjoy,Viper,Jett,Harbor","Sova,Killjoy,Viper,Jett,Yoru"
Ascent,R8 Blues,Gamax Lite,13,4,5,0,4,8,"Sova,Killjoy,Astra,KAY/O,Neon","Sova,Killjoy,Omen,Jett,KAY/O"
Sunset,QUE PASA,Dortmund Esports,7,13,6,6,7,1,"Breach,Raze,Cypher,Omen,Yoru","Breach,Raze,Cypher,Omen,Gekko"
Bind,The Ultimates,The Vicious,13,2,3,0,2,10,"Raze,Viper,Omen,KAY/O,Gekko","Raze,Viper,Brimstone,Skye,Chamber"
Lotus,6TM ESPORTS,Sissi State Punks,8,13,3,6,7,5,"Breach,Raze,Cypher,Sova,Omen","Breach,Raze,Sova,Killjoy,Omen"
Sunset,HUNTERS,DSYRE Academy,13,6,6,1,5,7,"Raze,Cypher,Omen,KAY/O,Gekko","Raze,Cypher,Omen,KAY/O,Gekko"
Icebox,LA RUE,INF Esports,13,7,8,0,7,5,"Killjoy,Viper,Reyna,Jett,Gekko","Sova,Killjoy,Viper,Omen,Jett"
Bind,g,Symbol,8,13,7,5,8,1,"Viper,Brimstone,Jett,Skye,Gekko","Breach,Raze,Cypher,Viper,Brimstone"
Split,Twisted Minds Orchid,FOG Vortex,13,8,6,3,5,7,"Breach,Raze,Cypher,Viper,Omen","Breach,Raze,Cypher,Omen,Jett"
Lotus,RIZON,AKA HERO,7,13,2,6,7,5,"Breach,Cypher,Omen,Neon,Gekko","Breach,Sova,Killjoy,Omen,Neon"
Lotus,The Ultimates Odyssey,Dragons Esports GC,14,12,9,4,8,5,"Breach,Cypher,Sova,Omen,Neon","Raze,Killjoy,Viper,Omen,Fade"
Lotus,Munich Esports,Sissi State Punks Academy,10,13,4,7,6,6,"Raze,Killjoy,Viper,Omen,Fade","Breach,Raze,Sova,Killjoy,Omen"
Icebox,BÖSE BUBEN,POTATO ABUSERS,12,14,7,6,8,5,"Sova,Killjoy,Viper,Jett,Clove","Sova,Killjoy,Viper,Reyna,Jett"
Icebox,A One Man Army,ARROW,13,1,11,1,0,2,"Sova,Killjoy,Viper,Jett,Gekko","Sova,Killjoy,Viper,Reyna,Jett"
Icebox,NO Enemies,90 Seconds,11,13,4,8,5,7,"Sova,Killjoy,Viper,Jett,Gekko","Sova,Killjoy,Viper,Sage,Jett"
Icebox,6TM ESPORTS,Sissi State Punks,3,13,0,4,9,3,"Sova,Killjoy,Viper,Jett,Harbor","Sova,Killjoy,Viper,Jett,KAY/O"
Icebox,The Ultimates,The Vicious,12,14,8,5,9,4,"Sova,Killjoy,Viper,Jett,Gekko","Sova,Killjoy,Viper,Sage,Jett"
Bind,Novita Esports,GJ Omen,6,13,2,5,8,4,"Raze,Viper,Brimstone,Yoru,Gekko","Raze,Viper,Brimstone,Skye,Gekko"
Sunset,LA RUE,INF Esports,13,4,3,2,2,10,"Breach,Raze,Cypher,Omen,Gekko","Breach,Raze,Cypher,Sova,Omen"
Bind,Andromeda Gaming,Elysian Esports,8,13,4,5,8,4,"Raze,Viper,Brimstone,Skye,Gekko","Raze,Cypher,Brimstone,Skye,Yoru"
Sunset,g,Symbol,3,13,2,10,3,1,"Cypher,Sova,Omen,Jett,Gekko","Breach,Raze,Cypher,Sova,Omen"
Ascent,Exceptional Gaming,Reveal Multigaming,10,13,3,8,5,7,"Sova,Killjoy,Omen,Jett,KAY/O","Cypher,Sova,Killjoy,Omen,Jett"
Sunset,MAJOR MONOGWAM,TeamOrangeGaming,5,13,2,4,9,3,"Breach,Raze,Cypher,Omen,Gekko","Breach,Raze,Cypher,Sova,Omen"
Icebox,Munich Esports,Sissi State Punks Academy,3,13,1,3,10,2,"Sova,Killjoy,Viper,Jett,Gekko","Sova,Killjoy,Viper,Sage,Jett"
Icebox,QUE PASA,UCAN ESPORTS,13,6,6,6,0,7,"Sova,Killjoy,Viper,Reyna,Jett","Viper,Reyna,Chamber,Harbor,Gekko"
Ascent,BÖSE BUBEN,POTATO ABUSERS,13,4,3,2,2,10,"Sova,Killjoy,Omen,Jett,KAY/O","Sova,Killjoy,Phoenix,Omen,Jett"
Icebox,R8 Blues,Gamax Lite,13,11,5,7,4,8,"Sova,Killjoy,Viper,Sage,Neon","Sova,Killjoy,Viper,Jett,Gekko"
Lotus,Lootcifer,Dortmund Esports,13,7,4,4,3,9,"Breach,Raze,Cypher,Omen,KAY/O","Raze,Omen,Yoru,Gekko,Deadlock"
Ascent,RIZON,AKA HERO,10,13,3,8,5,7,"Cypher,Sova,Omen,Jett,KAY/O","Sova,Killjoy,Omen,Jett,KAY/O"
Bind,A One Man Army,ARROW,13,5,4,2,3,9,"Raze,Cypher,Viper,Skye,Clove","Raze,Cypher,Viper,Skye,Clove"
Sunset,Twisted Minds Orchid,FOG Vortex,13,9,4,6,3,9,"Breach,Raze,Cypher,Omen,Gekko","Breach,Raze,Cypher,Omen,Fade"
Icebox,The Ultimates Odyssey,Dragons Esports GC,13,5,5,1,4,8,"Killjoy,Viper,Omen,KAY/O,Gekko","Sova,Killjoy,Viper,Sage,Jett"
Sunset,6TM ESPORTS,Sissi State Punks,13,8,8,4,4,5,"Raze,Cypher,Omen,KAY/O,Gekko","Breach,Raze,Cypher,Sova,Omen"
Ascent,Andromeda Gaming,Elysian Esports,13,4,4,1,3,9,"Sova,Killjoy,Omen,Jett,KAY/O","Sova,Killjoy,Omen,Jett,KAY/O"
Ascent,MAJOR MONOGWAM,TeamOrangeGaming,9,13,4,8,5,5,"Sova,Killjoy,Omen,Jett,KAY/O","Sova,Killjoy,Omen,Jett,KAY/O"
Icebox,Novita Esports,GJ Omen,11,13,5,7,6,6,"Killjoy,Viper,Reyna,Jett,Gekko","Sova,Killjoy,Viper,Jett,KAY/O"
Lotus,Exceptional Gaming,Reveal Multigaming,7,13,1,7,6,6,"Raze,Cypher,Viper,Omen,Fade","Breach,Cypher,Sova,Omen,Neon"
Lotus,LA RUE,INF Esports,11,13,8,4,9,3,"Raze,Killjoy,Viper,Omen,Fade","Breach,Raze,Cypher,Omen,Fade"
Ascent,Munich Esports,Sissi State Punks Academy,13,8,8,4,4,5,"Sova,Killjoy,Omen,Jett,KAY/O","Sova,Killjoy,Omen,Jett,KAY/O"
Bind,NO Enemies,90 Seconds,18,16,9,8,8,9,"Sova,Viper,Omen,Skye,Yoru","Raze,Viper,Omen,KAY/O,Gekko"
Sunset,QUE PASA,UCAN ESPORTS,13,10,9,3,7,4,"Breach,Raze,Cypher,Omen,Yoru","Raze,Cypher,Omen,Skye,Gekko"
Bind,Lootcifer,Dortmund Esports,13,9,9,3,6,4,"Raze,Viper,Omen,KAY/O,Gekko","Viper,Omen,Yoru,Gekko,Deadlock"
Bind,BÖSE BUBEN,POTATO ABUSERS,11,13,10,2,11,1,"Raze,Viper,Brimstone,Yoru,Gekko","Raze,Viper,Skye,Gekko,Clove"
Lotus,A One Man Army,ARROW,4,13,3,9,4,1,"Breach,Raze,Killjoy,Omen,Neon","Raze,Killjoy,Viper,Omen,Fade"
Sunset,RIZON,AKA HERO,13,8,5,7,1,8,"Raze,Cypher,Sova,Omen,KAY/O","Breach,Cypher,Sova,Omen,Jett"
Ascent,RIZON,Exceptional Gaming,3,13,1,11,2,2,"Cypher,Sova,Omen,Jett,KAY/O","Sova,Killjoy,Omen,Jett,KAY/O"
Split,Symbol,FlameTeaMix,15,13,10,4,9,5,"Raze,Cypher,Sage,Astra,Clove","Breach,Raze,Cypher,Omen,Skye"
Ascent,Bilgi Elitee,PCIFIC Waves,11,13,7,5,8,4,"Breach,Sova,Killjoy,Omen,Jett","Sova,Killjoy,Omen,Jett,KAY/O"
Sunset,Luminaria,Vixen Esports,14,12,6,7,5,8,"Breach,Cypher,Sova,Omen,Jett","Breach,Cypher,Sova,Neon,Clove"
Breeze,MadWolves Esports,Ketçaplı Ruffles,4,13,3,9,4,1,"Sova,Viper,Jett,Neon,Harbor","Cypher,Sova,Viper,Jett,KAY/O"
Ascent,Ascendium Esport Female,Team Kuara,4,13,4,8,5,0,"Sova,Killjoy,Omen,Jett,KAY/O","Sova,Killjoy,Reyna,Omen,Jett"
Bind,RIZON,Exceptional Gaming,11,13,4,8,5,7,"Raze,Cypher,Brimstone,Skye,Yoru","Raze,Viper,Brimstone,Skye,Fade"
Sunset,Team Falcons,Underground Gaming,13,11,9,3,8,4,"Breach,Raze,Cypher,Omen,Fade","Breach,Raze,Cypher,Omen,Fade"
Lotus,BG chilling,FlameTeaMix,10,13,7,5,8,3,"Breach,Raze,Viper,Omen,Chamber","Breach,Sova,Killjoy,Omen,Jett"
Lotus,Team Falcons,Underground Gaming,13,6,4,3,3,9,"Raze,Viper,Omen,Chamber,Gekko","Raze,Killjoy,Omen,Fade,Gekko"
Sunset,RIZON,Exceptional Gaming,13,8,5,7,1,8,"Raze,Cypher,Sova,Omen,KAY/O","Breach,Raze,Cypher,Omen,Gekko"
Icebox,FlameTeaMix,Team Mono,13,8,5,4,4,8,"Sova,Killjoy,Viper,Jett,Clove","Sova,Killjoy,Viper,Jett,Clove"
Ascent,g,Symbol,13,9,4,8,1,9,"Cypher,Sova,Reyna,Omen,Jett","Sova,Killjoy,Omen,Jett,KAY/O"
Ascent,BG chilling,TactiBears,13,5,4,2,3,9,"Sova,Killjoy,Omen,Jett,KAY/O","Sova,Killjoy,Omen,Jett,KAY/O"
Icebox,Team Falcons,Underground Gaming,13,7,10,2,5,3,"Reyna,Omen,KAY/O,Harbor,Gekko","Killjoy,Viper,Jett,Gekko,Clove"
Lotus,FlameTeaMix,Symbol,10,13,3,8,5,7,"Breach,Killjoy,Omen,Jett,Gekko","Breach,Raze,Killjoy,Omen,Fade"
Sunset,g,BG chilling,13,10,9,3,7,4,"Cypher,Sova,Omen,Jett,Gekko","Breach,Raze,Cypher,Omen,Fade"
Bind,Symbol,TactiBears,13,10,8,3,7,5,"Breach,Raze,Cypher,Viper,Brimstone","Raze,Cypher,Brimstone,Skye,Gekko"
Lotus,FlameTeaMix,Get back shadrach,13,0,1,0,0,12,"Breach,Killjoy,Omen,Jett,Gekko","Raze,Reyna,Skye,Neon,Clove"
Lotus,Team Mono,BG chilling,8,13,2,7,6,6,"Breach,Raze,Cypher,Jett,Clove","Breach,Raze,Viper,Omen,Chamber"
Icebox,Xu Gang,EDGE (OCE),4,13,1,4,9,3,"Sova,Killjoy,Viper,Jett,KAY/O","Sova,Killjoy,Viper,Reyna,Jett"
Bind,Arena Internet Cafe,Rub n' Pug,13,6,5,2,4,8,"Raze,Viper,Brimstone,Skye,Gekko","Raze,Jett,Astra,KAY/O,Gekko"
Bind,JiJieHao Bonkers,iPGN,13,6,6,1,5,7,"Raze,Cypher,Viper,Brimstone,Gekko","Raze,Viper,Brimstone,Fade,Gekko"
Lotus,Justice For Tomorrow,FOCUSGG,3,13,0,4,9,3,"Raze,Killjoy,Omen,Fade,Clove","Raze,Killjoy,Viper,Omen,Fade"
Sunset,VEC DAEJEON,Nongshim RedForce,4,13,0,5,8,4,"Breach,Raze,Cypher,Omen,Skye","Raze,Phoenix,Omen,Fade,Clove"
Bind,BOBO,Peace & Love,14,12,3,10,2,11,"Raze,Viper,Skye,Gekko,Clove","Raze,Brimstone,Reyna,Skye,Neon"
Ascent,Arena Internet Cafe,Rub n' Pug,13,8,6,6,2,7,"Sova,Killjoy,Omen,Jett,KAY/O","Sova,Killjoy,Jett,KAY/O,Clove"
Sunset,Xu Gang,EDGE (OCE),13,11,8,4,7,5,"Breach,Raze,Cypher,Sova,Omen","Cypher,Sova,Omen,Jett,KAY/O"
Sunset,JiJieHao Bonkers,iPGN,13,9,7,5,4,6,"Raze,Cypher,Sova,Omen,KAY/O","Breach,Raze,Cypher,Omen,Gekko"
Icebox,Justice For Tomorrow,FOCUSGG,13,3,4,0,3,9,"Sova,Killjoy,Viper,Reyna,Jett","Sova,Killjoy,Viper,Sage,Omen"
Icebox,Wolf Pack (OCE),Bandits OCE,5,13,2,4,9,3,"Sova,Killjoy,Viper,Jett,Gekko","Sova,Killjoy,Viper,Jett,KAY/O"
Ascent,Tiny Turtle Squad,Corn Dogs (OCE),13,10,3,9,1,10,"Breach,Sova,Killjoy,Omen,Jett","Sova,Killjoy,Omen,Jett,KAY/O"
Bind,VEC DAEJEON,Nongshim RedForce,7,13,6,2,11,1,"Breach,Raze,Cypher,Brimstone,Skye","Omen,Yoru,Fade,Gekko,Clove"
Split,FearX,Superfect Esports Academy,1,13,1,11,2,0,"Raze,Viper,Omen,Jett,Skye","Raze,Cypher,Viper,Omen,Skye"
Bind,Wolf Pack (OCE),Bandits OCE,6,13,2,5,8,4,"Raze,Brimstone,Skye,Gekko,Clove","Raze,Viper,Brimstone,Gekko,Deadlock"
Ascent,JiJieHao Bonkers,iPGN,9,13,3,7,6,6,"Sova,Killjoy,Omen,Jett,KAY/O","Sova,Killjoy,Omen,Jett,KAY/O"
Ascent,BOBO,Peace & Love,14,12,9,4,8,5,"Cypher,Sova,Omen,Jett,KAY/O","Sova,Killjoy,Phoenix,Omen,Neon"
Ascent,Xu Gang,EDGE (OCE),10,13,7,5,8,3,"Sova,Killjoy,Omen,Jett,KAY/O","Cypher,Sova,Omen,Jett,Deadlock"
Lotus,Tiny Turtle Squad,Corn Dogs (OCE),13,8,7,5,3,6,"Raze,Omen,Chamber,Fade,Gekko","Breach,Raze,Cypher,Omen,Gekko"
Bind,Justice For Tomorrow,FOCUSGG,12,14,4,9,5,8,"Raze,Viper,Brimstone,Jett,Skye","Raze,Viper,Brimstone,Fade,Gekko"
Ascent,Sin Prisa Gaming,Dplus Esports,13,3,3,1,2,10,"Cypher,Sova,Omen,Yoru,Iso","Sova,Killjoy,Omen,Jett,KAY/O"
Bind,FearX,Superfect Esports Academy,8,13,2,7,6,6,"Raze,Brimstone,Skye,Harbor,Gekko","Raze,Cypher,Viper,Brimstone,KAY/O"
Bind,Sin Prisa Gaming,Dplus Esports,13,7,7,5,2,6,"Raze,Cypher,Brimstone,Skye,Deadlock","Raze,Viper,Brimstone,KAY/O,Gekko"
Icebox,SLT Seongam,Team IAM,13,8,4,5,3,9,"Sova,Killjoy,Viper,Jett,KAY/O","Raze,Killjoy,Viper,Jett,KAY/O"
Breeze,Sin Prisa Gaming,Dplus Esports,16,18,9,8,10,7,"Cypher,Sova,Viper,Jett,Yoru","Cypher,Sova,Viper,Yoru,KAY/O"
Lotus,SLT Seongam,Team IAM,13,5,3,3,2,10,"Raze,Killjoy,Viper,Omen,Fade","Breach,Raze,Omen,Jett,Skye"
Ascent,FURIA GC,Athena's e-Sports,13,4,2,3,1,11,"Sova,Killjoy,Omen,Jett,KAY/O","Sova,Killjoy,Omen,Jett,KAY/O"
Bind,PS5Patas,sem fazer careta,4,13,2,10,3,2,"Raze,Viper,Brimstone,Skye,Gekko","Raze,Cypher,Brimstone,Skye,Gekko"
Bind,Oxygen Esports,TSM,14,12,9,4,8,5,"Raze,Viper,Brimstone,Skye,Gekko","Raze,Brimstone,Skye,Gekko,Deadlock"
Split,evolutionSTARS,Skout Esports,13,6,2,5,1,11,"Breach,Cypher,Omen,Jett,Skye","Breach,Raze,Cypher,Omen,Gekko"
Ascent,sou proplayer lixo?,coitado,13,7,6,6,1,7,"Sova,Killjoy,Omen,Jett,KAY/O","Sova,Killjoy,Omen,Jett,KAY/O"
Sunset,FURIA GC,Athena's e-Sports,12,14,7,6,8,5,"Breach,Raze,Cypher,Omen,Gekko","Breach,Raze,Cypher,Omen,Gekko"
Sunset,TBS GC,Karasuno Crows,13,3,9,3,0,4,"Breach,Raze,Cypher,Omen,Gekko","Breach,Raze,Cypher,Omen,Gekko"
Lotus,PS5Patas,sem fazer careta,10,13,6,5,8,4,"Raze,Killjoy,Viper,Omen,Fade","Breach,Raze,Killjoy,Omen,Gekko"
Bind,Team Leveling,YOSO GC,13,3,10,2,1,3,"Raze,Viper,Brimstone,Skye,Gekko","Raze,Brimstone,Yoru,Harbor,Gekko"
Ascent,REVOADA,Rebels VAL,13,3,3,1,2,10,"Sova,Killjoy,Omen,Jett,KAY/O","Sova,Killjoy,Omen,Jett,KAY/O"
Sunset,MIBR GC,2K Gaming Lunar,13,5,8,4,1,5,"Raze,Cypher,Omen,Fade,Gekko","Breach,Raze,Cypher,Omen,Gekko"
Icebox,Vila das Flores,xurisco,13,1,11,1,0,2,"Killjoy,Viper,Reyna,KAY/O,Gekko","Sova,Killjoy,Viper,Reyna,Jett"
Lotus,Oxygen Esports,TSM,13,9,9,3,6,4,"Breach,Raze,Cypher,Gekko,Clove","Breach,Raze,Cypher,Omen,Fade"
Bind,FURIA GC,Athena's e-Sports,13,4,9,3,1,4,"Raze,Viper,Brimstone,Skye,Gekko","Raze,Viper,Brimstone,Skye,Gekko"
Sunset,PS5Patas,sem fazer careta,13,6,6,1,5,7,"Breach,Raze,Cypher,Fade,Clove","Cypher,Sova,Phoenix,Gekko,Clove"
Split,REVOADA,Rebels VAL,13,2,12,0,2,1,"Raze,Cypher,Viper,Omen,Skye","Killjoy,Jett,Skye,Gekko,Clove"
Sunset,Vila das Flores,xurisco,13,4,10,2,2,3,"Raze,Cypher,Omen,KAY/O,Gekko","Raze,Cypher,Sova,Omen,Gekko"
Ascent,evolutionSTARS,Skout Esports,11,13,6,6,7,5,"Sova,Killjoy,Omen,Jett,KAY/O","Breach,Sova,Killjoy,Phoenix,Omen"
Lotus,TBS GC,Karasuno Crows,13,8,10,2,6,3,"Raze,Killjoy,Viper,Omen,Fade","Raze,Killjoy,Viper,Omen,Fade"
Lotus,sou proplayer lixo?,coitado,13,6,4,3,3,9,"Raze,Killjoy,Viper,Omen,Skye","Breach,Raze,Killjoy,Omen,Gekko"
Breeze,Team Leveling,YOSO GC,13,2,1,2,0,12,"Cypher,Sova,Viper,Jett,KAY/O","Cypher,Sova,Viper,Jett,Yoru"
Lotus,MIBR GC,2K Gaming Lunar,13,6,7,0,6,6,"Raze,Killjoy,Viper,Omen,Fade","Breach,Raze,Killjoy,Viper,Omen"
Icebox,FiRePOWER GC,9z Team GC,5,13,2,10,3,3,"Killjoy,Viper,Sage,Jett,KAY/O","Killjoy,Viper,Jett,KAY/O,Gekko"
Sunset,SK Gaming,XPERION NXT,13,8,6,3,5,7,"Cypher,Brimstone,Omen,Jett,Gekko","Raze,Sage,Omen,KAY/O,Gekko"
Sunset,evolutionSTARS,Skout Esports,13,10,10,1,9,3,"Breach,Raze,Cypher,Omen,Gekko","Breach,Raze,Cypher,Omen,Gekko"
Ascent,FiRePOWER GC,9z Team GC,8,13,0,9,4,8,"Sova,Killjoy,Omen,Jett,KAY/O","Sova,Killjoy,Omen,Jett,KAY/O"
Bind,CSH White,toxic GC,9,13,4,6,7,5,"Raze,Viper,Brimstone,Skye,Fade","Cypher,Phoenix,Reyna,Omen,Skye"
Lotus,Team Occupy Feminine Fusion,FATE Flare,13,3,9,3,0,4,"Raze,Killjoy,Viper,Omen,Fade","Breach,Raze,Killjoy,Omen,Gekko"
Lotus,Skulls Esports Regina,XProjekt Lioness,8,13,3,6,7,5,"Breach,Raze,Killjoy,Omen,Gekko","Breach,Raze,Killjoy,Omen,Gekko"
Split,FLUFFY AIMERS,SaD Esports,13,9,8,2,7,5,"Breach,Raze,Cypher,Astra,Fade","Raze,Yoru,Astra,Fade,Deadlock"
Icebox,GnG White,Gamax Lite,10,13,5,6,7,5,"Sova,Reyna,Jett,Chamber,Clove","Sova,Killjoy,Viper,Reyna,Gekko"
Bind,SK Gaming,XPERION NXT,16,14,11,4,10,5,"Brimstone,Jett,Fade,Gekko,Clove","Raze,Cypher,Brimstone,Skye,Gekko"
Split,FiRePOWER GC,9z Team GC,9,13,4,6,7,5,"Raze,Viper,Omen,Jett,Skye","Raze,Viper,Omen,Fade,Gekko"
Icebox,FATE Flare,Skulls Esports Regina,13,1,11,1,0,2,"Sova,Killjoy,Viper,Jett,Clove","Sova,Viper,Sage,Jett,Chamber"
Bind,TOG Kitsune,EMUs,13,11,3,9,2,10,"Breach,Raze,Cypher,Brimstone,Gekko","Breach,Raze,Viper,Brimstone,Gekko"
Ascent,DSYRE Academy,NO Enemies,13,9,4,8,1,9,"Sova,Killjoy,Omen,Jett,KAY/O","Sova,Killjoy,Phoenix,Omen,Jett"
Bind,XProjekt Lioness,CSH White,13,9,7,3,6,6,"Raze,Cypher,Omen,Skye,Gekko","Raze,Viper,Brimstone,Skye,Fade"
Ascent,FLUFFY AIMERS,SaD Esports,13,6,7,5,1,6,"Sova,Killjoy,Omen,Jett,KAY/O","Sova,Killjoy,Omen,Jett,KAY/O"
Ascent,The giornalisti,RevenantVAL,12,14,6,7,7,6,"Cypher,Sova,Reyna,Omen,Jett","Cypher,Sova,Omen,Jett,KAY/O"
Sunset,GMBLERS Esports,Fishing Rods,13,10,8,4,6,5,"Breach,Raze,Cypher,Omen,Gekko","Cypher,Sova,Omen,Jett,Yoru"
Lotus,toxic GC,GnG White,3,13,0,4,9,3,"Breach,Raze,Killjoy,Viper,Omen","Breach,Raze,Killjoy,Omen,Fade"
Sunset,90 Seconds,TwentyStars,13,10,4,8,2,9,"Raze,Cypher,Omen,KAY/O,Gekko","Breach,Raze,Cypher,Omen,Gekko"
Sunset,Sissi State Punks Academy,ARROW,11,13,7,5,8,4,"Cypher,Sova,Omen,Jett,KAY/O","Breach,Raze,Cypher,Omen,Gekko"
Sunset,Gamax Lite,Team Occupy Feminine Fusion,13,3,4,0,3,9,"Breach,Raze,Cypher,Gekko,Clove","Breach,Raze,Cypher,Omen,Gekko"
Sunset,Unlucky boys,HUNTERS,13,5,8,4,1,5,"Breach,Raze,Cypher,Omen,Gekko","Raze,Cypher,Omen,KAY/O,Gekko"
Icebox,Fenerbahçe Esports,Istanbul Wildcats,7,13,4,8,5,3,"Sova,Killjoy,Viper,Sage,Jett","Killjoy,Jett,KAY/O,Harbor,Gekko"
Split,SK Gaming,XPERION NXT,12,14,6,7,7,6,"Breach,Cypher,Sova,Jett,Astra","Raze,Cypher,Viper,Omen,Skye"
Lotus,GMBLERS Esports,Fishing Rods,13,2,10,2,0,3,"Breach,Raze,Killjoy,Omen,Jett","Raze,Killjoy,Omen,Fade,Clove"
Lotus,90 Seconds,TwentyStars,7,13,4,8,5,3,"Raze,Killjoy,Viper,Omen,Fade","Breach,Raze,Killjoy,Omen,Gekko"
Icebox,The giornalisti,RevenantVAL,13,8,6,6,2,7,"Sova,Killjoy,Viper,Reyna,Jett","Sova,Killjoy,Viper,Sage,Jett"
Lotus,XProjekt Lioness,FATE Flare,13,5,5,1,4,8,"Breach,Raze,Killjoy,Omen,Gekko","Breach,Raze,Killjoy,Omen,Gekko"
Ascent,Sissi State Punks Academy,ARROW,13,9,5,5,4,8,"Killjoy,Reyna,Omen,Jett,Fade","Sova,Killjoy,Omen,Jett,KAY/O"
Lotus,TOG Kitsune,EMUs,14,12,8,5,7,6,"Breach,Raze,Killjoy,Omen,Gekko","Breach,Raze,Cypher,Gekko,Clove"
Ascent,Unlucky boys,HUNTERS,13,5,8,4,1,5,"Sova,Killjoy,Omen,Jett,KAY/O","Sova,Killjoy,Omen,Jett,KAY/O"
Icebox,Team Occupy Feminine Fusion,toxic GC,13,2,3,0,2,10,"Sova,Killjoy,Viper,Sage,Jett","Sova,Killjoy,Viper,Jett,Gekko"
Lotus,CSH White,GnG White,6,13,4,3,10,2,"Breach,Raze,Omen,Gekko,Deadlock","Breach,Raze,Killjoy,Omen,Fade"
Lotus,FiRePOWER GC,9z Team GC,13,8,7,5,3,6,"Raze,Killjoy,Viper,Omen,Fade","Breach,Killjoy,Omen,Neon,Gekko"
Lotus,NXT,Metizport,9,13,6,4,9,3,"Raze,Cypher,Omen,Fade,Gekko","Raze,Killjoy,Viper,Omen,Fade"
Icebox,Sissi State Punks Academy,ARROW,4,13,3,9,4,1,"Sova,Killjoy,Viper,Sage,Jett","Sova,Killjoy,Viper,Reyna,Jett"
Bind,CGN Esports,DIVIZON,13,4,9,3,1,4,"Raze,Viper,Brimstone,Sage,Gekko","Raze,Cypher,Viper,Omen,Skye"
Ascent,SK Nebula,Permitta Unicorns GC,13,3,2,2,1,11,"Sova,Killjoy,Omen,Jett,KAY/O","Sova,Killjoy,Omen,Jett,KAY/O"
Split,Playbay X VISION SYNC,ALTERNATE aTTaX Ruby,4,13,3,9,4,1,"Breach,Raze,Cypher,Omen,Yoru","Breach,Raze,Cypher,Omen,Skye"
Lotus,LXT Esports GC,aNc Outplayed GC,13,6,5,2,4,8,"Raze,Killjoy,Viper,Omen,Fade","Breach,Raze,Killjoy,Omen,Gekko"
Icebox,HONEYBADGER123,Reveal Multigaming Saphire,13,5,8,4,1,5,"Sova,Killjoy,Viper,Jett,Gekko","Sova,Killjoy,Viper,Jett,Gekko"
Ascent,BÖSE BUBEN,Munich Esports,13,3,2,2,1,11,"Sova,Killjoy,Omen,Jett,KAY/O","Sova,Killjoy,Omen,Jett,KAY/O"
Bind,FOKUS Sakura,RIZON Sugar,13,9,7,5,4,6,"Raze,Viper,Omen,Skye,Chamber","Breach,Raze,Cypher,Brimstone,Skye"
Lotus,HONEYBADGER123,Reveal Multigaming Saphire,13,5,8,4,1,5,"Raze,Killjoy,Omen,KAY/O,Gekko","Raze,Killjoy,Viper,Omen,Fade"
Sunset,Playbay X VISION SYNC,ALTERNATE aTTaX Ruby,6,13,1,6,7,5,"Breach,Raze,Cypher,Astra,Gekko","Breach,Raze,Cypher,Sova,Omen"
Icebox,LXT Esports GC,aNc Outplayed GC,13,5,8,4,1,5,"Killjoy,Viper,Jett,KAY/O,Gekko","Sova,Killjoy,Viper,Yoru,Gekko"
Split,NXT,Metizport,8,13,1,11,2,7,"Raze,Cypher,Omen,Skye,Deadlock","Raze,Viper,Astra,Fade,Gekko"
Icebox,FOKUS Sakura,RIZON Sugar,13,3,9,3,0,4,"Sova,Killjoy,Viper,Jett,Harbor","Sova,Killjoy,Viper,Jett,Gekko"
Lotus,SK Nebula,Permitta Unicorns GC,13,7,10,2,5,3,"Raze,Killjoy,Viper,Omen,Fade","Breach,Raze,Killjoy,Omen,Gekko"
Lotus,BÖSE BUBEN,Munich Esports,13,6,7,5,1,6,"Breach,Raze,Cypher,Sova,Omen","Raze,Killjoy,Viper,Omen,Fade"
Sunset,CGN Esports,DIVIZON,13,15,8,6,9,5,"Raze,Sova,Killjoy,Omen,Clove","Raze,Cypher,Sage,Omen,Skye"
Lotus,Fenerbahçe Esports,Istanbul Wildcats,12,14,6,7,7,6,"Raze,Killjoy,Viper,Omen,Fade","Raze,Sova,Killjoy,Omen,Gekko"
Lotus,Requiem,Apinaorkesteri,13,4,5,0,4,8,"Raze,Killjoy,Viper,Omen,Fade","Raze,Killjoy,Viper,Omen,Fade"
Lotus,CGN Esports,DIVIZON,13,5,10,2,3,3,"Raze,Sova,Killjoy,Omen,Gekko","Raze,Killjoy,Viper,Omen,Fade"
Icebox, ROA,Oblivion Force,10,13,3,8,5,7,"Viper,Sage,Reyna,Gekko,Clove","Killjoy,Viper,Jett,KAY/O,Gekko"
Sunset,PCIFIC Espor,Galatasaray Esports,13,5,8,4,1,5,"Breach,Raze,Cypher,Omen,Gekko","Raze,Cypher,Omen,KAY/O,Gekko"
Sunset,Requiem,Apinaorkesteri,13,5,6,0,5,7,"Raze,Cypher,Omen,KAY/O,Gekko","Breach,Raze,Cypher,Omen,KAY/O"
Bind,MLT Esports,Orangutan,7,13,1,7,6,6,"Raze,Cypher,Viper,Brimstone,Skye","Raze,Viper,Brimstone,Skye,Gekko"
Sunset,XERXIA Esports,Barn nong chok,10,13,3,8,5,7,"Breach,Raze,Cypher,Omen,Fade","Breach,Raze,Cypher,Omen,Gekko"
Breeze,PCIFIC Espor,Galatasaray Esports,13,6,7,5,1,6,"Cypher,Sova,Viper,Jett,KAY/O","Cypher,Sova,Viper,Jett,KAY/O"
Lotus, ROA,Oblivion Force,7,13,4,8,5,3,"Raze,Cypher,Omen,Astra,Gekko","Raze,Viper,Omen,Chamber,Fade"
Breeze,Requiem,Apinaorkesteri,9,13,5,7,6,4,"Cypher,Sova,Viper,Jett,Yoru","Cypher,Sova,Viper,Yoru,Astra"
Ascent,MLT Esports,Orangutan,13,8,7,5,3,6,"Sova,Killjoy,Omen,Jett,KAY/O","Killjoy,Omen,Jett,KAY/O,Gekko"
Lotus,Da Feng Gou,Five Ace e-Sports,13,5,3,3,2,10,"Raze,Killjoy,Viper,Omen,Fade","Raze,Killjoy,Viper,Omen,Fade"
Split,XERXIA Esports,Barn nong chok,11,13,5,7,6,6,"Raze,Cypher,Viper,Omen,Skye","Raze,Cypher,Viper,Omen,Skye"
Breeze,MLT Esports,Orangutan,6,13,0,7,6,6,"Cypher,Sova,Viper,Jett,KAY/O","Cypher,Sova,Viper,Jett,Yoru"
Sunset,Da Feng Gou,Five Ace e-Sports,13,8,6,3,5,7,"Breach,Raze,Cypher,Omen,Fade","Breach,Raze,Cypher,Sova,Omen"
Icebox,Hungkuang Falcon,ONE Team Esports,12,14,7,6,8,5,"Killjoy,Viper,Omen,Jett,Gekko","Killjoy,Viper,Jett,KAY/O,Gekko"
Lotus,Made in Thailand, Santa Gang,9,13,4,8,5,5,"Viper,Omen,Chamber,Neon,Gekko","Raze,Killjoy,Viper,Omen,Fade"
Sunset,Team Kobolds,PAPA ESPORTS,8,13,5,7,6,3,"Breach,Raze,Cypher,Omen,Gekko","Raze,Cypher,Sova,Omen,Gekko"
Bind,Revenant Esports,Alternate Realities,13,4,5,0,4,8,"Raze,Viper,Brimstone,Skye,Gekko","Raze,Viper,Brimstone,Fade,Gekko"
Ascent,Team Kobolds,PAPA ESPORTS,5,13,5,7,6,0,"Sova,Killjoy,Omen,Jett,KAY/O","Sova,Killjoy,Omen,Jett,KAY/O"
Ascent,Da Feng Gou,Five Ace e-Sports,13,15,6,8,7,7,"Sova,Killjoy,Omen,Jett,KAY/O","Sova,Killjoy,Omen,Jett,KAY/O"
Lotus,Hungkuang Falcon,ONE Team Esports,6,13,3,9,4,3,"Raze,Cypher,Omen,Fade,Gekko","Raze,Killjoy,Viper,Omen,Fade"
Bind,Made in Thailand, Santa Gang,10,13,4,7,6,6,"Raze,Cypher,Viper,Brimstone,Skye","Raze,Viper,Brimstone,Skye,Gekko"
Split,Nongshim RedForce,Superfect Esports Academy,13,4,10,2,2,3,"Raze,Omen,Jett,Skye,Astra","Breach,Raze,Cypher,Viper,Omen"
Sunset,iPGN,Bandits OCE,13,11,6,6,5,7,"Breach,Raze,Cypher,Omen,Gekko","Breach,Raze,Cypher,Omen,Gekko"
Lotus,EDGE (OCE),Peace & Love,9,13,6,4,9,3,"Raze,Cypher,Omen,Skye,Gekko","Raze,Killjoy,Omen,Neon,Gekko"
Bind,Nongshim RedForce,Superfect Esports Academy,13,3,3,1,2,10,"Omen,Yoru,Fade,Gekko,Clove","Raze,Cypher,Viper,Brimstone,KAY/O"
Lotus,BOBO,Xu Gang,13,2,10,2,0,3,"Raze,Killjoy,Viper,Omen,Fade","Breach,Raze,Killjoy,Omen,Fade"
Breeze,Arena Internet Cafe,Koopa Troopas,13,3,9,3,0,4,"Cypher,Sova,Viper,Jett,Astra","Sova,Viper,Reyna,Jett,Harbor"
Breeze,iPGN,Bandits OCE,13,11,5,7,4,8,"Cypher,Sova,Viper,Jett,Yoru","Cypher,Sova,Viper,Jett,KAY/O"
Lotus,Revenant Esports,Alternate Realities,13,4,5,0,4,8,"Raze,Viper,Omen,Chamber,Fade","Raze,Killjoy,Viper,Omen,Fade"
Split,JiJieHao Bonkers,Wolf Pack (OCE),15,13,7,7,6,8,"Raze,Viper,Omen,Jett,Skye","Raze,Cypher,Skye,Deadlock,Clove"
Breeze,EDGE (OCE),Peace & Love,5,13,4,2,11,1,"Cypher,Sova,Viper,Jett,KAY/O","Cypher,Sova,Viper,Phoenix,Neon"
Icebox,Justice For Tomorrow,Tiny Turtle Squad,13,6,4,3,3,9,"Sova,Killjoy,Viper,Reyna,Jett","Killjoy,Viper,Sage,Jett,KAY/O"
Bind,EDGE (OCE),Peace & Love,13,2,10,2,0,3,"Raze,Omen,Skye,Gekko,Clove","Raze,Brimstone,Reyna,Skye,Neon"
Lotus,iPGN,Bandits OCE,5,13,4,8,5,1,"Breach,Raze,Killjoy,Omen,Fade","Breach,Raze,Cypher,Omen,Fade"
Split,BOBO,Xu Gang,13,8,3,6,2,10,"Breach,Raze,Cypher,Skye,Astra","Breach,Raze,Cypher,Omen,Deadlock"
Icebox,JiJieHao Bonkers,Wolf Pack (OCE),13,4,3,2,2,10,"Sova,Killjoy,Viper,Jett,Harbor","Sova,Killjoy,Viper,Reyna,Jett"
Lotus,Justice For Tomorrow,Tiny Turtle Squad,13,2,3,0,2,10,"Raze,Killjoy,Omen,Fade,Clove","Raze,Omen,Chamber,Fade,Gekko"
Ascent,Arena Internet Cafe,Koopa Troopas,13,10,4,8,2,9,"Sova,Killjoy,Omen,Jett,KAY/O","Sova,Killjoy,Phoenix,Omen,Jett"
Lotus,Team IAM,Dplus Esports,5,13,0,6,7,5,"Breach,Raze,Omen,Jett,Skye","Killjoy,Omen,Jett,KAY/O,Gekko"
Ascent,Team IAM,Dplus Esports,14,16,5,10,6,9,"Sova,Killjoy,Omen,Jett,KAY/O","Sova,Killjoy,Omen,Jett,KAY/O"
Sunset,FUSION,Illicit Gaming,4,13,2,10,3,2,"Breach,Raze,Cypher,Sova,Brimstone","Breach,Raze,Cypher,Omen,Gekko"
Sunset,Purpose Gaming,2 Arbres 3 quebs,10,13,4,7,6,6,"Cypher,Sova,Omen,KAY/O,Neon","Raze,Cypher,Sova,Omen,Gekko"
Breeze,Purpose Gaming,Spate Esports,13,11,7,5,6,6,"Sova,Viper,Jett,Yoru,Astra","Sova,Viper,Yoru,Astra,Neon"
Breeze,FUSION,Illicit Gaming,14,16,8,7,9,6,"Cypher,Sova,Viper,Jett,Yoru","Cypher,Sova,Viper,Jett,KAY/O"
Sunset,DeTox,Purpose Gaming,5,13,4,8,5,1,"Breach,Cypher,Sova,Omen,Neon","Cypher,Sova,Omen,KAY/O,Neon"
Ascent,Spate Esports,Crack Babies,13,8,5,4,4,8,"Raze,Sova,Omen,KAY/O,Clove","Cypher,Sova,Omen,Jett,KAY/O"
Lotus,RETA Esports,Six Karma,13,0,12,0,0,1,"Raze,Killjoy,Viper,Omen,Fade","Cypher,Omen,Jett,Gekko,Deadlock"
Lotus,Sky Esports (NA),Jack n Frens ,13,15,7,7,8,6,"Raze,Killjoy,Omen,Jett,Gekko","Breach,Raze,Killjoy,Omen,Gekko"
Bind,YOSO GC,curralzinho,13,8,6,3,5,7,"Raze,Brimstone,Yoru,Harbor,Gekko","Breach,Raze,Cypher,Gekko,Clove"
Ascent,Monsters Uni,2 Arbres 3 quebs,10,13,4,7,6,6,"Breach,Raze,Cypher,Sova,Omen","Sova,Killjoy,Omen,Jett,KAY/O"
Lotus,Rebels VAL,Extermine GC,13,2,3,0,2,10,"Raze,Killjoy,Omen,Fade,Gekko","Breach,Raze,Omen,Harbor,Deadlock"
Breeze,Hyperion Gold,Spate Esports,8,13,3,6,7,5,"Cypher,Sova,Viper,Reyna,Chamber","Sova,Viper,Yoru,Astra,Neon"
Breeze,Goated,Purpose Gaming,10,13,5,7,6,5,"Cypher,Sova,Viper,Jett,KAY/O","Sova,Viper,Jett,Yoru,Astra"
Ascent,Crack Babies,Labyrinth Red,13,7,8,4,3,5,"Cypher,Sova,Omen,Jett,KAY/O","Sova,Killjoy,Omen,Jett,KAY/O"
Lotus,Noob,Jack n Frens ,8,13,6,6,7,2,"Breach,Raze,Omen,Jett,Skye","Breach,Raze,Killjoy,Omen,Gekko"
Bind,RETA Esports,Six Karma,10,13,4,7,6,6,"Raze,Viper,Brimstone,Skye,Gekko","Raze,Viper,Brimstone,Fade,Gekko"
Sunset,OPPY,DeTox,11,13,5,7,6,6,"Raze,Cypher,Sova,Omen,KAY/O","Breach,Cypher,Sova,Omen,Neon"
Lotus,92' Dream Team,Monsters Uni,7,13,4,8,5,3,"Breach,Raze,Killjoy,Omen,Gekko","Breach,Raze,Killjoy,Omen,Gekko"
Icebox,Blinn Esports,M80,13,11,6,6,5,7,"Sova,Killjoy,Viper,Jett,Harbor","Killjoy,Viper,Omen,KAY/O,Gekko"
Sunset,Borpa,2 Arbres 3 quebs,5,13,3,3,10,2,"Raze,Cypher,KAY/O,Fade,Harbor","Raze,Cypher,Sova,Omen,Gekko"
Sunset,Miracle NA,Sky Esports (NA),9,13,2,8,5,7,"Breach,Raze,Cypher,Omen,Gekko","Raze,Cypher,Sova,Gekko,Clove"
Ascent,Hero Base,Galorys,13,10,7,5,5,6,"Breach,Viper,Omen,Jett,KAY/O","Sova,Killjoy,Omen,Jett,KAY/O"
Bind,FURIA GC,Insanity Purple,13,4,4,1,3,9,"Raze,Viper,Brimstone,Skye,Gekko","Raze,Cypher,Brimstone,Skye,Gekko"
Breeze,YOSO GC,curralzinho,12,14,10,3,11,2,"Cypher,Sova,Viper,Jett,Yoru","Cypher,Sova,Viper,Jett,KAY/O"
Bind,Tartarugas Pinga,Karasuno Crows,12,14,7,6,8,5,"Cypher,Brimstone,Reyna,Jett,Gekko","Raze,Brimstone,Skye,Harbor,Gekko"
Bind,Rebels VAL,Extermine GC,14,12,7,6,6,7,"Raze,Viper,Brimstone,Skye,Gekko","Raze,Viper,Brimstone,Gekko,Deadlock"
Sunset,Vila das Flores,fake da luy,13,4,9,3,1,4,"Raze,Cypher,Omen,KAY/O,Gekko","Breach,Raze,Cypher,Phoenix,Omen"
Ascent,xurisco,Vexis FEM,13,1,2,0,1,11,"Raze,Sage,Reyna,Astra,Chamber","Sova,Killjoy,Omen,Jett,Neon"
Lotus,Team Leveling,BLOODMAXIMUM STARS,13,8,7,5,3,6,"Breach,Raze,Killjoy,Omen,Gekko","Raze,Killjoy,Omen,Astra,Gekko"
Icebox,REVOADA,Menace Girls,13,2,11,1,1,2,"Sova,Killjoy,Viper,Jett,KAY/O","Raze,Sova,Killjoy,Viper,Gekko"
Sunset,sem fazer careta,não pensamos num nome,13,11,8,4,7,5,"Cypher,Sova,Phoenix,Gekko,Clove","Raze,Cypher,Omen,Fade,Gekko"
Icebox,sou proplayer lixo?,Variants GC,13,4,4,1,3,9,"Sova,Killjoy,Viper,Jett,Gekko","Sova,Killjoy,Viper,Jett,Gekko"
Lotus,Jack n Frens ,nf,13,2,10,2,0,3,"Breach,Raze,Killjoy,Omen,Gekko","Breach,Raze,Killjoy,Omen,Gekko"
Lotus,Athena's e-Sports,Higashi nine,13,8,8,1,7,5,"Breach,Raze,Killjoy,Omen,Gekko","Raze,Killjoy,Viper,Omen,Fade"
Bind,VLA Gaming GC,coitado,0,13,0,12,1,0,"Raze,Cypher,Viper,Brimstone,Skye","Raze,Cypher,Viper,Brimstone,Skye"
Sunset,MIBR GC,Seizo e-Sports,13,1,11,1,0,2,"Raze,Cypher,Omen,Fade,Gekko","Breach,Raze,Cypher,Sova,Clove"
Icebox,TBS GC,Moranguinhas,13,2,11,1,1,2,"Sova,Viper,Reyna,Chamber,Gekko","Sova,Killjoy,Jett,Astra,Harbor"
Bind,Spate Esports,U4RIA Radiata,13,11,8,4,7,5,"Viper,Jett,Yoru,Gekko,Clove","Raze,Sova,Brimstone,Gekko,Deadlock"
Lotus,Kaizen GC BR,2K Gaming Lunar,1,13,1,11,2,0,"Raze,Killjoy,Viper,Omen,Fade","Breach,Raze,Killjoy,Viper,Omen"
Ascent,imonthatgoodkushandalcohol,2 Arbres 3 quebs,8,13,5,7,6,3,"Sova,Killjoy,Omen,Jett,KAY/O","Sova,Killjoy,Omen,Jett,KAY/O"
Bind,Goated,Recon Ducklings,13,11,5,7,4,8,"Raze,Brimstone,Reyna,Skye,Gekko","Raze,Cypher,Viper,Brimstone,Skye"
Ascent,Backpack Bros,Purpose Gaming,9,13,6,4,9,3,"Sova,Killjoy,Omen,Jett,KAY/O","Sova,Killjoy,Omen,Jett,KAY/O"
Sunset,Neglected,DeTox,9,13,4,6,7,5,"Breach,Raze,Cypher,Sova,Omen","Breach,Cypher,Sova,Omen,Neon"
Ascent,Sushi Bois,Sky Esports (NA),1,13,0,2,11,1,"Sova,Killjoy,Omen,Jett,KAY/O","Sova,Killjoy,Omen,Jett,KAY/O"
Ascent,Borpa,WasTaken,13,5,7,5,0,6,"Sova,Killjoy,Omen,Jett,KAY/O","Killjoy,Omen,Jett,KAY/O,Deadlock"
Icebox,RETA Esports,Six Karma,13,5,9,3,2,4,"Sova,Killjoy,Viper,Jett,Harbor","Sova,Killjoy,Viper,Jett,Harbor"
Sunset,Labyrinth Red,Meat Munchers,14,12,9,4,8,5,"Cypher,Sova,Omen,KAY/O,Neon","Raze,Cypher,Omen,KAY/O,Gekko"
Lotus,Crack Babies,GroundX,13,9,8,4,5,5,"Raze,Killjoy,Viper,Omen,Fade","Breach,Raze,Cypher,Omen,Gekko"
Ascent,Monsters Uni,MimicGG,13,7,4,4,3,9,"Breach,Raze,Sova,Killjoy,Omen","Sova,Killjoy,Omen,Jett,KAY/O"
Sunset,xurisco,Vexis FEM,13,2,10,2,0,3,"Raze,Cypher,Sova,Omen,Gekko","Cypher,Omen,Neon,Fade,Gekko"
Lotus,FURIA GC,Insanity Purple,13,6,10,2,4,3,"Breach,Raze,Killjoy,Omen,Gekko","Breach,Raze,Cypher,Omen,Gekko"
Breeze,Blinn Esports,M80,13,11,3,9,2,10,"Cypher,Sova,Viper,Jett,Yoru","Cypher,Sova,Viper,Jett,KAY/O"
Breeze,Hero Base,Galorys,13,7,8,4,3,5,"Cypher,Sova,Viper,Jett,KAY/O","Cypher,Sova,Viper,Jett,KAY/O"
Bind,Vila das Flores,fake da luy,13,3,10,2,1,3,"Raze,Viper,Brimstone,Skye,Gekko","Breach,Raze,Brimstone,Skye,Chamber"
Split,REVOADA,Menace Girls,13,2,3,0,2,10,"Raze,Cypher,Viper,Omen,Skye","Cypher,Killjoy,Omen,Jett,Skye"
Sunset,Tartarugas Pinga,Karasuno Crows,8,13,3,6,7,5,"Raze,Cypher,Neon,Gekko,Clove","Breach,Raze,Cypher,Omen,Gekko"
Split,YOSO GC,curralzinho,13,11,4,8,3,9,"Breach,Raze,Cypher,Omen,Deadlock","Breach,Raze,Cypher,Omen,Skye"
Lotus,TBS GC,Moranguinhas,13,1,2,0,1,11,"Raze,Killjoy,Viper,Omen,Fade","Raze,Killjoy,Omen,Jett,Skye"
Lotus,MIBR GC,Seizo e-Sports,13,1,11,1,0,2,"Raze,Killjoy,Viper,Omen,Fade","Killjoy,Omen,Jett,Fade,Gekko"
Ascent,Rebels VAL,Extermine GC,11,13,3,9,4,8,"Sova,Killjoy,Omen,Jett,KAY/O","Sova,Killjoy,Omen,Jett,KAY/O"
Ascent,VLA Gaming GC,coitado,2,13,0,3,10,2,"Sova,Killjoy,Omen,Jett,KAY/O","Sova,Killjoy,Omen,Jett,KAY/O"
Sunset,Athena's e-Sports,Higashi nine,13,4,5,0,4,8,"Breach,Raze,Cypher,Omen,Gekko","Breach,Cypher,Phoenix,Omen,Gekko"
Ascent,Team Leveling,BLOODMAXIMUM STARS,13,7,7,5,2,6,"Sova,Killjoy,Omen,Jett,KAY/O","Sova,Killjoy,Omen,Jett,KAY/O"
Lotus,sou proplayer lixo?,Variants GC,13,8,8,4,4,5,"Raze,Killjoy,Viper,Omen,Fade","Breach,Raze,Killjoy,Omen,Gekko"
Bind,sem fazer careta,não pensamos num nome,13,9,6,4,5,7,"Raze,Cypher,Brimstone,Skye,Gekko","Raze,Cypher,Brimstone,Skye,Gekko"
Icebox,Kaizen GC BR,2K Gaming Lunar,3,13,0,4,9,3,"Killjoy,Viper,Jett,KAY/O,Gekko","Sova,Killjoy,Viper,Jett,Gekko"
Bind,FATE Flare,CSH White,10,13,8,3,10,2,"Breach,Raze,Cypher,Brimstone,Gekko","Raze,Viper,Brimstone,Skye,Fade"
Sunset,Gamax Lite,XProjekt Lioness,13,5,4,2,3,9,"Breach,Raze,Cypher,Gekko,Clove","Breach,Raze,Cypher,Omen,Gekko"
Ascent,toxic GC,Skulls Esports Regina,11,13,6,6,7,5,"Breach,Sova,Killjoy,Omen,Jett","Cypher,Sova,Reyna,Omen,Jett"
Lotus,GnG White,Team Occupy Feminine Fusion,13,3,9,3,0,4,"Breach,Raze,Killjoy,Omen,Fade","Raze,Killjoy,Viper,Omen,Fade"
Ascent,YFP Gaming,Winthrop University,13,6,10,2,4,3,"Cypher,Sova,Omen,Jett,Deadlock","Sova,Killjoy,Omen,Jett,KAY/O"
Bind,The7,SAGAZ,13,6,9,3,3,4,"Raze,Viper,Brimstone,Skye,Chamber","Breach,Raze,Viper,Brimstone,Gekko"
Bind,Reven eClub,E-Xolos LAZER,16,18,8,9,9,8,"Raze,Cypher,Viper,Omen,Skye","Raze,Brimstone,Skye,Harbor,Gekko"
Lotus,CSH White,Team Occupy Feminine Fusion,3,13,2,2,11,1,"Breach,Raze,Omen,Gekko,Deadlock","Raze,Killjoy,Viper,Omen,Fade"
Lotus,The7,SAGAZ,13,2,10,2,0,3,"Breach,Raze,Omen,Jett,Skye","Raze,Killjoy,Viper,Omen,Fade"
Icebox,Skulls Esports Regina,GnG White,2,13,0,3,10,2,"Sova,Killjoy,Viper,Jett,Gekko","Sova,Killjoy,Viper,Reyna,Jett"
Sunset,YFP Gaming,Winthrop University,13,5,11,1,4,2,"Breach,Raze,Cypher,Omen,Gekko","Breach,Raze,Cypher,Omen,Fade"
Bind,XProjekt Lioness,toxic GC,13,10,8,3,7,5,"Raze,Cypher,Omen,Skye,Gekko","Raze,Cypher,Viper,Brimstone,Skye"
Sunset,FATE Flare,Gamax Lite,0,13,0,1,12,0,"Breach,Raze,Cypher,Omen,Gekko","Raze,Cypher,Reyna,Gekko,Clove"
Breeze,Lootcifer,MAJOR MONOGWAM,13,9,6,4,5,7,"Cypher,Sova,Viper,Reyna,Jett","Cypher,Sova,Viper,Yoru,Harbor"
Sunset,Reven eClub,E-Xolos LAZER,10,13,6,5,8,4,"Breach,Raze,Cypher,Sova,Omen","Breach,Raze,Cypher,Omen,Gekko"
Bind,Ovation eSports,Eintracht Frankfurt,2,13,2,10,3,0,"Raze,Viper,Brimstone,Skye,KAY/O","Raze,Viper,Yoru,Gekko,Clove"
Sunset,Team Occupy Feminine Fusion,Skulls Esports Regina,13,8,7,5,3,6,"Breach,Raze,Cypher,Omen,Gekko","Breach,Raze,Cypher,Omen,Gekko"
Sunset,Eternal Fire,Galakticos,9,13,4,6,7,5,"Breach,Raze,Astra,KAY/O,Deadlock","Raze,Cypher,Sova,Omen,Neon"
Ascent,Solary,Joblife,8,13,4,5,8,4,"Sova,Killjoy,Omen,Jett,KAY/O","Sova,Killjoy,Omen,Jett,KAY/O"
Lotus,GnG White,XProjekt Lioness,13,7,10,2,5,3,"Breach,Raze,Killjoy,Omen,Fade","Breach,Raze,Killjoy,Omen,Gekko"
Bind,toxic GC,FATE Flare,13,7,6,2,5,7,"Raze,Cypher,Viper,Brimstone,Skye","Breach,Raze,Cypher,Brimstone,Gekko"
Split,Reven eClub,E-Xolos LAZER,13,7,6,6,1,7,"Breach,Raze,Cypher,Omen,Gekko","Breach,Raze,Cypher,Skye,Astra"
Ascent,Lootcifer,MAJOR MONOGWAM,9,13,2,8,5,7,"Cypher,Sova,Omen,Jett,KAY/O","Sova,Killjoy,Omen,Jett,KAY/O"
Split,Ovation eSports,Eintracht Frankfurt,4,13,4,8,5,0,"Breach,Viper,Omen,Jett,Fade","Raze,Cypher,Omen,Skye,Deadlock"
Split,TheSecretClub,Andromeda Gaming,11,13,5,7,6,6,"Breach,Raze,Cypher,Omen,Skye","Breach,Raze,Viper,Omen,Skye"
Ascent,Gamax Lite,CSH White,13,3,4,0,3,9,"Sova,Killjoy,Omen,Jett,KAY/O","Breach,Raze,Sova,Killjoy,Omen"
Breeze,ARROW,HONEYBADGER123,8,13,6,6,7,2,"Cypher,Sova,Viper,Jett,Yoru","Cypher,Sova,Viper,Jett,Yoru"
Breeze,Roehampton University,Royal Holloway University of London,6,13,1,6,7,5,"Cypher,Sova,Viper,Jett,Yoru","Cypher,Sova,Viper,Reyna,Jett"
Icebox,Eternal Fire,Galakticos,8,13,2,7,6,6,"Killjoy,KAY/O,Harbor,Gekko,Clove","Sova,Omen,Jett,KAY/O,Clove"
Icebox,The Ultimates Odyssey,FOG Vortex,13,6,7,5,1,6,"Killjoy,Viper,Omen,KAY/O,Gekko","Sova,Killjoy,Viper,Reyna,Jett"
Lotus,ARROW,HONEYBADGER123,4,13,1,4,9,3,"Raze,Killjoy,Viper,Omen,Fade","Raze,Killjoy,Omen,KAY/O,Gekko"
Ascent,Twisted Minds Orchid,Dark Nebula,13,2,3,0,2,10,"Sova,Killjoy,Omen,Jett,KAY/O","Cypher,Sova,Reyna,Jett,Clove"
Bind,Lootcifer,MAJOR MONOGWAM,13,8,6,3,5,7,"Raze,Viper,Omen,KAY/O,Gekko","Raze,Cypher,Brimstone,Skye,Gekko"
Sunset,Solary,Joblife,11,13,6,6,7,5,"Breach,Raze,Cypher,Omen,Fade","Raze,Cypher,Omen,KAY/O,Gekko"
Bind,TheSecretClub,Andromeda Gaming,8,13,4,8,5,4,"Raze,Viper,Brimstone,Fade,Gekko","Raze,Viper,Brimstone,Skye,Gekko"
Ascent,FOKUS,ALTERNATE aTTaX,6,13,4,8,5,2,"Cypher,Sova,Omen,Jett,KAY/O","Sova,Killjoy,Omen,Jett,KAY/O"
Icebox,Formulation Gaming,Apeks,11,13,5,7,6,6,"Killjoy,Viper,Omen,KAY/O,Gekko","Killjoy,Viper,Jett,KAY/O,Gekko"
Bind,Roehampton University,Royal Holloway University of London,10,13,6,6,7,4,"Raze,Cypher,Viper,Brimstone,Skye","Raze,Cypher,Jett,Skye,Clove"
Lotus,Chipi Chapa's,Diamant Esports,5,13,3,9,4,2,"Raze,Cypher,Viper,Omen,Skye","Raze,Killjoy,Viper,Omen,Skye"
Bind,FOG Vortex,Twisted Minds Orchid,0,13,0,1,12,0,"Breach,Raze,Cypher,Brimstone,Skye","Raze,Viper,Brimstone,KAY/O,Gekko"
Icebox,R8 Blues,The Ultimates Odyssey,12,14,9,4,10,3,"Sova,Killjoy,Viper,Sage,Neon","Killjoy,Viper,Omen,KAY/O,Gekko"
Lotus,TheSecretClub,Andromeda Gaming,13,9,8,4,5,5,"Raze,Killjoy,Viper,Omen,Fade","Breach,Raze,Killjoy,Omen,Fade"
Sunset,FOKUS,ALTERNATE aTTaX,4,13,3,9,4,1,"Cypher,Sage,Omen,KAY/O,Gekko","Raze,Cypher,Omen,KAY/O,Gekko"
Icebox,Chipi Chapa's,Diamant Esports,3,13,3,9,4,0,"Killjoy,Viper,Reyna,KAY/O,Gekko","Breach,Raze,Killjoy,Viper,Gekko"
Sunset,Akroma,Mandatory,9,13,3,7,6,6,"Breach,Raze,Cypher,Omen,Gekko","Breach,Raze,Cypher,Omen,Gekko"
Sunset,Formulation Gaming,Apeks,7,13,5,7,6,2,"Cypher,Sova,Omen,KAY/O,Neon","Viper,Sage,Omen,KAY/O,Gekko"
Split,PAPA ESPORTS,ONE Team Esports,10,13,3,9,4,7,"Raze,Cypher,Viper,Omen,Skye","Raze,Cypher,Viper,Omen,Skye"
Lotus,HOWL Esports,Papara SuperMassive,14,12,9,4,8,5,"Raze,Cypher,Viper,Omen,Fade","Cypher,Omen,KAY/O,Neon,Gekko"
Bind,B8 Esports,trashcan,9,13,3,9,4,6,"Raze,Cypher,Viper,Brimstone,Skye","Raze,Viper,Brimstone,Skye,Gekko"
Lotus,Requiem,OnlyFins,13,8,8,4,4,5,"Raze,Killjoy,Viper,Omen,Fade","Breach,Raze,Killjoy,Omen,Gekko"
Icebox,Akroma,Mandatory,9,13,5,7,6,4,"Killjoy,Viper,Jett,KAY/O,Gekko","Sova,Viper,Sage,Jett,KAY/O"
Breeze,Formulation Gaming,Apeks,13,4,9,3,1,4,"Cypher,Sova,Viper,Yoru,KAY/O","Cypher,Sova,Viper,Yoru,KAY/O"
Lotus,FOKUS,ALTERNATE aTTaX,13,8,6,6,2,7,"Raze,Killjoy,Viper,Omen,Fade","Breach,Raze,Sova,Killjoy,Omen"
Ascent,VEC DAEJEON,Sin Prisa Gaming,10,13,5,6,7,5,"Breach,Sova,Killjoy,Omen,Jett","Cypher,Sova,Omen,Yoru,Iso"
Icebox,HOWL Esports,Papara SuperMassive,13,7,8,4,3,5,"Killjoy,Viper,Jett,Skye,Harbor","Killjoy,Viper,Omen,KAY/O,Gekko"
Sunset,PAPA ESPORTS,ONE Team Esports,11,13,6,6,7,5,"Raze,Cypher,Sova,Omen,Gekko","Raze,Cypher,Omen,KAY/O,Gekko"
Ascent,Royal Holloway University of London,College Of Esports,13,7,6,2,5,7,"Sova,Killjoy,Omen,Jett,KAY/O","Sova,Killjoy,Omen,Jett,KAY/O"
Sunset,Requiem,OnlyFins,6,13,1,6,7,5,"Raze,Cypher,Omen,KAY/O,Gekko","Breach,Raze,Cypher,Omen,Gekko"
Sunset,B8 Esports,trashcan,12,14,7,6,8,5,"Breach,Raze,Cypher,Sova,Omen","Raze,Cypher,Viper,Omen,Skye"
Icebox,True Rippers,Orangutan,13,1,2,0,1,11,"Sova,Killjoy,Viper,Jett,Gekko","Sova,Killjoy,Viper,Jett,Harbor"
Sunset,HOWL Esports,Papara SuperMassive,9,13,3,7,6,6,"Raze,Cypher,Omen,KAY/O,Gekko","Raze,Cypher,Omen,KAY/O,Gekko"
Sunset,VEC DAEJEON,Sin Prisa Gaming,13,11,8,4,7,5,"Breach,Raze,Cypher,Omen,Skye","Breach,Cypher,Sova,Omen,Jett"
Ascent,PAPA ESPORTS,ONE Team Esports,13,8,5,4,4,8,"Sova,Killjoy,Omen,Jett,KAY/O","Sova,Killjoy,Omen,Jett,KAY/O"
Ascent,True Rippers,Orangutan,13,5,8,4,1,5,"Sova,Killjoy,Omen,Jett,KAY/O","Killjoy,Omen,Jett,KAY/O,Gekko"
Split,FULL SENSE,Sharper Esports,13,4,9,3,1,4,"Raze,Cypher,Sage,Omen,Skye","Cypher,Viper,Omen,Skye,Clove"
Lotus,Royal Holloway University of London,Roehampton University,8,13,4,8,5,4,"Breach,Raze,Cypher,Omen,Fade","Raze,Cypher,Viper,Omen,Skye"
Split,VEC DAEJEON,Sin Prisa Gaming,9,13,3,7,6,6,"Breach,Raze,Cypher,Omen,Skye","Raze,Cypher,Omen,Fade,Deadlock"
Breeze,True Rippers,Orangutan,4,13,2,3,10,2,"Cypher,Sova,Viper,Jett,KAY/O","Cypher,Sova,Viper,Jett,Yoru"
Lotus,Team Kobolds,Da Feng Gou,13,11,7,5,6,6,"Breach,Raze,Killjoy,Omen,Skye","Raze,Killjoy,Viper,Omen,Fade"
Sunset,FULL SENSE,Sharper Esports,13,6,4,3,3,9,"Breach,Raze,Cypher,Omen,Gekko","Breach,Raze,Sage,Omen,Gekko"
Ascent,College Of Esports,City University,14,12,6,7,5,8,"Sova,Killjoy,Omen,Jett,KAY/O","Sova,Killjoy,Jett,KAY/O,Clove"
Breeze, ROA,Five Ace e-Sports,14,12,9,4,8,5,"Sova,Viper,Reyna,Jett,Yoru","Cypher,Sova,Viper,Jett,KAY/O"
Bind,Team Kobolds,Da Feng Gou,14,12,6,7,5,8,"Raze,Viper,Brimstone,Skye,Gekko","Raze,Viper,Brimstone,Skye,Gekko"
Split,Hungkuang Falcon,Oblivion Force,6,13,1,6,7,5,"Raze,Cypher,Omen,Jett,Skye","Raze,Cypher,Omen,Jett,Skye"
Lotus, ROA,Five Ace e-Sports,13,10,6,6,4,7,"Raze,Cypher,Omen,Astra,Gekko","Raze,Killjoy,Viper,Omen,Fade"
Bind,XOXO-01,Team NKT,7,13,4,4,9,3,"Raze,Viper,Brimstone,Skye,Gekko","Raze,Viper,Brimstone,Skye,Gekko"
Icebox,Velocity Gaming,Revenant Esports,12,14,6,7,7,6,"Sova,Killjoy,Viper,Sage,Jett","Sova,Killjoy,Viper,Jett,Harbor"
Icebox,SLT Seongam,FearX,13,11,5,7,4,8,"Sova,Killjoy,Viper,Jett,KAY/O","Killjoy,Viper,Jett,KAY/O,Harbor"
Ascent,City University,Roehampton University,4,13,2,10,3,2,"Sova,Killjoy,Omen,Jett,Skye","Cypher,Sova,Omen,Jett,KAY/O"
Lotus,Royal Holloway University of London,College Of Esports,13,4,5,0,4,8,"Breach,Raze,Cypher,Omen,Fade","Raze,Cypher,Viper,Omen,Fade"
Icebox,Hungkuang Falcon,Oblivion Force,10,13,5,6,7,5,"Killjoy,Viper,Omen,Jett,Gekko","Killjoy,Viper,Jett,KAY/O,Gekko"
Ascent, ROA,Five Ace e-Sports,6,13,4,8,5,2,"Sova,Killjoy,Omen,Jett,KAY/O","Sova,Killjoy,Omen,Jett,KAY/O"
Ascent,Team Kobolds,Da Feng Gou,10,13,5,7,6,5,"Sova,Killjoy,Omen,Jett,KAY/O","Sova,Killjoy,Omen,Jett,KAY/O"
Icebox,XOXO-01,Team NKT,3,13,2,10,3,1,"Killjoy,Omen,KAY/O,Harbor,Gekko","Sova,Killjoy,Viper,Jett,Gekko"
Breeze,Velocity Gaming,Revenant Esports,12,14,6,7,7,6,"Cypher,Sova,Viper,Jett,KAY/O","Sova,Viper,Jett,Yoru,Astra"
Split,Velocity Gaming,Revenant Esports,14,12,8,5,7,6,"Breach,Raze,Cypher,Omen,Fade","Raze,Cypher,Omen,Jett,Skye"
Bind,SLT Seongam,FearX,9,13,3,7,6,6,"Viper,Brimstone,Jett,Skye,Gekko","Raze,Brimstone,Skye,Harbor,Gekko"
Lotus,SLT Seongam,FearX,14,12,8,5,7,6,"Raze,Killjoy,Viper,Omen,Fade","Breach,Raze,Omen,Jett,Skye"
Sunset,Moist x Shopify,DarkZero Esports,10,13,2,9,4,8,"Raze,Cypher,Omen,KAY/O,Gekko","Breach,Raze,Cypher,Omen,Gekko"
Bind,Moist x Shopify,DarkZero Esports,11,13,9,3,10,2,"Raze,Viper,Brimstone,Skye,Gekko","Raze,Brimstone,Sage,Fade,Gekko"
Split,2Game Esports,TBK Esports,13,7,8,4,3,5,"Raze,Viper,Astra,Fade,Gekko","Raze,Viper,Omen,Jett,Skye"
Lotus,All Knights,XSOUL,13,5,9,3,2,4,"Raze,Killjoy,Viper,Omen,Fade","Raze,Killjoy,Viper,Omen,Fade"
Icebox,2Game Esports,TBK Esports,13,6,8,4,2,5,"Sova,Killjoy,Viper,Omen,Gekko","Sova,Killjoy,Viper,Sage,Jett"
Split,All Knights,XSOUL,13,10,4,7,3,9,"Raze,Killjoy,Viper,Skye,Astra","Raze,Cypher,Viper,Skye,Astra"
Ascent,FTW LEÇA FC,Impulse GW,11,13,2,10,3,9,"Sova,Killjoy,Omen,Jett,KAY/O","Sova,Killjoy,Omen,Jett,KAY/O"
Lotus,Team Occupy Feminine Fusion,XProjekt Lioness,13,6,8,4,2,5,"Raze,Killjoy,Viper,Omen,Fade","Breach,Raze,Killjoy,Omen,Gekko"
Lotus,GnG White,FATE Flare,13,0,12,0,0,1,"Breach,Raze,Killjoy,Omen,Fade","Breach,Raze,Killjoy,Omen,Gekko"
Ascent,CSH White,Skulls Esports Regina,9,13,2,8,5,7,"Breach,Raze,Sova,Killjoy,Omen","Sova,Killjoy,Reyna,Omen,Jett"
Lotus,QoR,Dough Bros,2,13,2,10,3,0,"Breach,Raze,Cypher,Gekko,Clove","Raze,Omen,Fade,Deadlock,Clove"
Split,toxic GC,Gamax Lite,2,13,0,3,10,2,"Breach,Raze,Cypher,Omen,Skye","Cypher,Reyna,Omen,Jett,Skye"
Icebox,XLD Gaming,RED Canids,1,13,1,11,2,0,"Sova,Killjoy,Viper,Sage,Jett","Sova,Killjoy,Viper,Sage,Jett"
Sunset,Legacy,Stellae Gaming,7,13,5,7,6,2,"Breach,Raze,Cypher,Omen,Gekko","Breach,Raze,Cypher,Omen,Gekko"
Lotus,R8 Esports,GAMAX eSports,13,4,9,3,1,4,"Raze,Killjoy,Omen,Skye,Astra","Breach,Raze,Cypher,Sova,Omen"
Bind,Permitta Unicorns,MOUZ,3,13,3,9,4,0,"Raze,Reyna,Skye,Chamber,Clove","Breach,Raze,Viper,Brimstone,Gekko"
Ascent,top gz,Team Occupy,7,13,3,5,8,4,"Cypher,Sova,Phoenix,Omen,Jett","Sova,Killjoy,Omen,Jett,KAY/O"
Lotus,EX0TIK GAMING,FUZOS,13,10,8,3,7,5,"Breach,Raze,Killjoy,Omen,Fade","Breach,Raze,Killjoy,Omen,Fade"
Ascent,toxic GC,CSH White,13,3,3,1,2,10,"Breach,Sova,Killjoy,Omen,Jett","Breach,Raze,Sova,Killjoy,Omen"
Lotus,XProjekt Lioness,Skulls Esports Regina,13,8,4,5,3,9,"Breach,Raze,Killjoy,Omen,Gekko","Breach,Raze,Killjoy,Omen,Gekko"
Lotus,FATE Flare,Team Occupy Feminine Fusion,8,13,3,6,7,5,"Breach,Raze,Killjoy,Omen,Gekko","Raze,Killjoy,Viper,Omen,Fade"
Split,R8 Esports,GAMAX eSports,13,1,2,0,1,11,"Raze,Cypher,Viper,Omen,Skye","Breach,Raze,Cypher,Omen,Fade"
Ascent,XLD Gaming,RED Canids,11,13,7,5,8,4,"Sova,Killjoy,Omen,Jett,KAY/O","Sova,Killjoy,Omen,Jett,KAY/O"
Sunset,QoR,Dough Bros,10,13,7,4,9,3,"Breach,Raze,Cypher,Omen,Gekko","Breach,Raze,Cypher,Omen,Gekko"
Icebox,Legacy,Stellae Gaming,11,13,2,10,3,9,"Sova,Killjoy,Viper,Jett,Gekko","Sova,Killjoy,Viper,Jett,KAY/O"
Lotus,Gamax Lite,GnG White,13,10,7,4,6,6,"Breach,Raze,Cypher,Gekko,Clove","Breach,Raze,Killjoy,Omen,Fade"
Split,top gz,Team Occupy,13,3,3,1,2,10,"Breach,Raze,Cypher,Deadlock,Clove","Breach,Raze,Viper,Omen,Skye"
Ascent,Onyx Ravens,Skulls Esports,13,3,2,2,1,11,"Sova,Killjoy,Omen,Jett,KAY/O","Cypher,Sova,Omen,Jett,KAY/O"
Split,9z Team,Zen Esports,13,10,6,6,4,7,"Breach,Raze,Viper,Omen,Skye","Breach,Raze,Killjoy,Skye,Astra"
Icebox,A One Man Army,HONEYBADGER123,14,12,9,4,8,5,"Sova,Killjoy,Viper,Jett,Clove","Sova,Killjoy,Viper,Jett,Gekko"
Split,Cicadas Gaming,Zerance,7,13,2,6,7,5,"Breach,Raze,Cypher,Sage,Omen","Raze,Viper,Omen,Jett,Skye"
Bind,ESC Gaming,Zero Tenacity,13,8,3,6,2,10,"Raze,Cypher,Viper,Brimstone,Skye","Raze,Cypher,Viper,Brimstone,Skye"
Lotus,Fire Flux Esports,Galatasaray Esports,13,10,5,6,4,8,"Breach,Raze,Cypher,Omen,Gekko","Raze,Killjoy,Yoru,Astra,Fade"
Lotus,PPP,GTZ Esports,13,6,7,0,6,6,"Breach,Raze,Cypher,Sova,Omen","Breach,Raze,Cypher,Omen,Fade"
Icebox,BÖSE BUBEN,Reveal Multigaming Saphire,17,15,8,8,7,9,"Sova,Killjoy,Viper,Jett,Clove","Sova,Killjoy,Viper,Jett,Gekko"
Lotus,Permitta Unicorns,MOUZ,15,17,4,12,5,11,"Breach,Raze,Killjoy,Omen,Skye","Breach,Cypher,Omen,Yoru,Fade"
Split,Barça eSports,KPI Gaming,6,13,2,5,8,4,"Raze,Viper,Sage,Skye,Astra","Breach,Raze,Cypher,Omen,Skye"
Bind,9z Team,Zen Esports,13,3,9,3,0,4,"Raze,Sova,Viper,Brimstone,KAY/O","Raze,Viper,Brimstone,Skye,Chamber"
Icebox,Onyx Ravens,Skulls Esports,13,5,9,3,2,4,"Killjoy,Viper,Sage,Jett,Gekko","Sova,Killjoy,Viper,Jett,KAY/O"
Lotus,Skulls Esports Regina,FATE Flare,13,9,7,3,6,6,"Breach,Raze,Killjoy,Omen,Gekko","Breach,Raze,Killjoy,Omen,Gekko"
Ascent,Team Occupy Feminine Fusion,Gamax Lite,8,13,7,2,11,1,"Sova,Killjoy,Omen,Jett,KAY/O","Sova,Killjoy,Omen,Jett,KAY/O"
Lotus,Team Falcons Vega,GIANTX GC,13,9,6,4,5,7,"Raze,Viper,Omen,Chamber,Gekko","Breach,Raze,Sova,Omen,Chamber"
Bind,R8 Esports,GAMAX eSports,11,13,9,3,10,2,"Raze,Cypher,Viper,Brimstone,Skye","Raze,Viper,Brimstone,Skye,Fade"
Lotus,top gz,Team Occupy,8,13,4,5,8,4,"Breach,Raze,Killjoy,Omen,Fade","Breach,Raze,Sova,Killjoy,Omen"
Icebox,GnG White,toxic GC,13,0,1,0,0,12,"Sova,Killjoy,Viper,Reyna,Jett","Sova,Killjoy,Viper,Jett,Gekko"
Lotus,CSH White,XProjekt Lioness,12,14,7,6,8,5,"Breach,Raze,Omen,Gekko,Deadlock","Breach,Raze,Killjoy,Omen,Gekko"
Ascent,Novita Esports,LA RUE,7,13,2,6,7,5,"Sova,Killjoy,Omen,Jett,KAY/O","Sova,Killjoy,Omen,Jett,KAY/O"
Breeze,Cicadas Gaming,Zerance,4,13,2,3,10,2,"Cypher,Sova,Viper,Jett,Skye","Cypher,Sova,Viper,Jett,Yoru"
Lotus,ESC Gaming,Zero Tenacity,5,13,3,3,10,2,"Breach,Raze,Killjoy,Omen,Fade","Raze,Killjoy,Viper,Omen,Fade"
Lotus,Team Prolific,Babos Gaming,7,13,5,7,6,2,"Breach,Cypher,Omen,Neon,Gekko","Breach,Killjoy,Omen,Neon,Gekko"
Icebox,NASR Esports,Team RA'AD,9,13,5,7,6,4,"Killjoy,Viper,Omen,KAY/O,Gekko","Killjoy,Viper,Sage,Gekko,Clove"
Icebox,Twisted Saints Esports,Surely Tragic,8,13,3,6,7,5,"Sova,Killjoy,Viper,Jett,KAY/O","Sova,Killjoy,Viper,Harbor,Gekko"
Ascent,Team Falcons Vega,GIANTX GC,13,4,5,0,4,8,"Sova,Jett,Astra,KAY/O,Fade","Sova,Killjoy,Omen,Jett,KAY/O"
Ascent,BÖSE BUBEN,Reveal Multigaming Saphire,9,13,5,5,8,4,"Sova,Killjoy,Omen,Jett,KAY/O","Sova,Killjoy,Omen,Jett,KAY/O"
Split,Sissi State Punks,TeamOrangeGaming,13,9,3,7,2,10,"Breach,Raze,Cypher,Omen,Skye","Raze,Cypher,Sage,Omen,Skye"
Split,OXEN,Furious Gaming,13,3,4,0,3,9,"Raze,Cypher,Skye,Astra,Deadlock","Breach,Raze,Astra,KAY/O,Chamber"
Sunset,POTATO ABUSERS,Munich Esports,13,8,6,3,5,7,"Raze,Cypher,Omen,KAY/O,Gekko","Breach,Raze,Cypher,Omen,Gekko"
Split,Thin Fecking Ice,Coalesce,7,13,2,6,7,5,"Raze,Cypher,Viper,Omen,Skye","Raze,Viper,Omen,Jett,Skye"
Icebox,SweetNsour,OnlyFins,11,13,3,9,4,8,"Killjoy,Viper,Jett,KAY/O,Gekko","Killjoy,Viper,Jett,KAY/O,Gekko"
Bind,Fire Flux Esports,Galatasaray Esports,16,14,10,5,9,6,"Raze,Viper,Omen,KAY/O,Gekko","Raze,Viper,Brimstone,Skye,Yoru"
Ascent,HOF Esports,SAW,9,13,3,7,6,6,"Sova,Killjoy,Omen,Jett,KAY/O","Sova,Killjoy,Omen,Jett,KAY/O"
Sunset,A One Man Army,HONEYBADGER123,21,19,10,10,9,11,"Breach,Raze,Cypher,Sova,Omen","Breach,Raze,Sage,Omen,Gekko"
Icebox,Five Media Clan,Imperium Gaming,13,7,6,6,1,7,"Killjoy,Viper,Jett,KAY/O,Gekko","Killjoy,Viper,Jett,KAY/O,Gekko"
Lotus,Twisted Minds Orchid,R8 Blues,12,14,5,8,6,7,"Breach,Raze,Cypher,Omen,Fade","Killjoy,Viper,Omen,Skye,Neon"
Split,Dark Nebula,FOG Vortex,2,13,2,10,3,0,"Raze,Cypher,Reyna,Skye,Clove","Breach,Raze,Cypher,Omen,Jett"
Lotus,MAJOR MONOGWAM,QUE PASA,13,4,4,1,3,9,"Breach,Raze,Killjoy,Omen,Gekko","Raze,Killjoy,Omen,Yoru,Fade"
Ascent,RIZON,INF Esports,2,13,0,3,10,2,"Cypher,Sova,Omen,Jett,KAY/O","Breach,Viper,Brimstone,Sage,Neon"
Split,Project 1,DSQ Esports,13,11,8,4,7,5,"Raze,Cypher,Viper,Omen,Skye","Raze,Cypher,Viper,Omen,Skye"
Sunset,Novita Esports,LA RUE,10,13,7,4,9,3,"Breach,Raze,Cypher,Sova,Omen","Breach,Raze,Cypher,Omen,Gekko"
Sunset,Dortmund Esports,6TM ESPORTS,13,5,7,5,0,6,"Breach,Raze,Cypher,Omen,Gekko","Raze,Cypher,Omen,KAY/O,Gekko"
Icebox,Team Prolific,Babos Gaming,14,12,7,6,6,7,"Sova,Killjoy,Sage,Reyna,Harbor","Killjoy,Viper,KAY/O,Neon,Gekko"
Icebox,Lootcifer,UCAN ESPORTS,13,5,4,2,3,9,"Sova,Killjoy,Jett,Harbor,Clove","Viper,Reyna,Chamber,Harbor,Gekko"
Lotus,AKA HERO,Exceptional Gaming,12,14,6,7,7,6,"Breach,Killjoy,Omen,Jett,Gekko","Raze,Killjoy,Viper,Omen,Fade"
Breeze,ESC Gaming,Zero Tenacity,13,11,9,3,8,4,"Cypher,Sova,Viper,Jett,KAY/O","Sova,Viper,Jett,Yoru,Astra"
Icebox,Eintracht Frankfurt,ALTERNATE aTTaX,14,12,6,7,5,8,"Sova,Killjoy,Viper,Omen,Yoru","Killjoy,Viper,Jett,KAY/O,Gekko"
Sunset,R3VOLT,RYL | Royal Legion,13,5,10,2,3,3,"Breach,Raze,Cypher,Sova,Omen","Sage,Jett,Harbor,Deadlock,Clove"
Sunset,Cicadas Gaming,Zerance,16,14,7,8,6,9,"Breach,Raze,Cypher,Omen,Yoru","Breach,Raze,Cypher,Sova,Omen"
Sunset,NASR Esports,Team RA'AD,8,13,6,3,10,2,"Breach,Raze,Cypher,Omen,Fade","Breach,Raze,Cypher,Omen,Gekko"
Lotus,Sissi State Punks,TeamOrangeGaming,13,8,9,3,5,4,"Breach,Raze,Cypher,Sova,Omen","Breach,Raze,Cypher,Omen,Gekko"
Bind,Thin Fecking Ice,Coalesce,8,13,4,8,5,4,"Breach,Raze,Cypher,Brimstone,Yoru","Raze,Cypher,Brimstone,Skye,Gekko"
Breeze,Novita Esports,LA RUE,13,4,10,2,2,3,"Cypher,Sova,Viper,Jett,Yoru","Cypher,Sova,Viper,Jett,Yoru"
Sunset,Project 1,DSQ Esports,13,4,10,2,2,3,"Breach,Raze,Cypher,Sova,Omen","Breach,Raze,Cypher,Omen,Gekko"
Bind,MAJOR MONOGWAM,QUE PASA,13,9,6,4,5,7,"Raze,Cypher,Brimstone,Skye,Gekko","Raze,Cypher,Omen,Skye,Yoru"
Sunset,UCAM Esports Club,Falke Esports,13,3,4,0,3,9,"Breach,Raze,Cypher,Sova,Omen","Breach,Cypher,Viper,Omen,Yoru"
Ascent,POTATO ABUSERS,Munich Esports,13,9,7,5,4,6,"Sova,Killjoy,Phoenix,Omen,Jett","Sova,Killjoy,Omen,Jett,KAY/O"
Lotus,SweetNsour,OnlyFins,6,13,5,7,6,1,"Raze,Killjoy,Viper,Omen,Fade","Breach,Raze,Killjoy,Omen,Gekko"
Split,Twisted Saints Esports,Surely Tragic,9,13,4,6,7,5,"Raze,Cypher,Viper,Omen,Skye","Breach,Raze,Omen,Gekko,Deadlock"
Ascent,R3VOLT,RYL | Royal Legion,13,6,6,1,5,7,"Sova,Killjoy,Omen,Jett,KAY/O","Breach,Raze,Jett,Deadlock,Clove"
Sunset,Team Prolific,Babos Gaming,5,13,3,3,10,2,"Breach,Cypher,Omen,Neon,Gekko","Breach,Cypher,Omen,Neon,Gekko"
Lotus,RIZON,INF Esports,6,13,2,5,8,4,"Breach,Cypher,Omen,Neon,Gekko","Breach,Raze,Cypher,Omen,Fade"
Bind,BÖSE BUBEN,Reveal Multigaming Saphire,14,12,8,5,7,6,"Raze,Viper,Brimstone,Yoru,Gekko","Breach,Viper,Brimstone,Skye,Yoru"
Lotus,Lootcifer,UCAN ESPORTS,13,3,9,3,0,4,"Breach,Raze,Cypher,Phoenix,Omen","Breach,Raze,Cypher,Omen,Gekko"
Bind,Dortmund Esports,6TM ESPORTS,13,8,5,7,1,8,"Viper,Omen,Yoru,Gekko,Deadlock","Raze,Omen,KAY/O,Harbor,Gekko"
Ascent,Vision Esports,Twisted Minds Esports,13,10,8,3,7,5,"Sova,Killjoy,Omen,Jett,KAY/O","Cypher,Sova,Phoenix,Omen,Jett"
Lotus,A One Man Army,HONEYBADGER123,8,13,3,6,7,5,"Breach,Raze,Killjoy,Omen,Fade","Raze,Killjoy,Omen,KAY/O,Gekko"
Bind,OXEN,Furious Gaming,13,8,7,2,6,6,"Raze,Viper,Omen,Skye,KAY/O","Raze,Viper,Yoru,Harbor,Gekko"
Sunset,AKA HERO,Exceptional Gaming,6,13,3,9,4,3,"Breach,Raze,Omen,Gekko,Deadlock","Breach,Raze,Cypher,Omen,Fade"
Bind,The Ultimates Odyssey,Twisted Minds Orchid,13,5,5,1,4,8,"Breach,Raze,Viper,Brimstone,Gekko","Raze,Viper,Brimstone,KAY/O,Gekko"
Lotus,R8 Blues,Dark Nebula,13,5,3,3,2,10,"Killjoy,Viper,Omen,Skye,Neon","Breach,Raze,Cypher,Gekko,Clove"
Ascent,HEROIC Valkyries,Odd 1 OUT,9,13,7,5,8,2,"Sova,Killjoy,Omen,Jett,KAY/O","Sova,Killjoy,Omen,Jett,KAY/O"
Ascent,Eintracht Frankfurt,ALTERNATE aTTaX,13,6,5,2,4,8,"Cypher,Sova,Sage,Omen,Jett","Sova,Killjoy,Omen,Jett,KAY/O"
Bind,Team Falcons,Fraggerz,13,1,2,0,1,11,"Raze,Viper,Sage,Skye,Clove","Raze,Cypher,Omen,Jett,Skye"
Lotus,Valiant,DVM Esport,13,4,9,3,1,4,"Breach,Raze,Killjoy,Omen,Fade","Raze,Cypher,Sova,Omen,Deadlock"
Icebox,Fenerbahçe Esports,S2G Esports,13,10,4,7,3,9,"Sova,Killjoy,Viper,Sage,Jett","Sova,Killjoy,Viper,Jett,Gekko"
Ascent,Acend,GoNext Esports,16,14,9,6,8,7,"Viper,Phoenix,Sage,Jett,Astra","Sova,Killjoy,Omen,Jett,KAY/O"
Icebox,Vision Esports,Twisted Minds Esports,13,8,8,1,7,5,"Sova,Killjoy,Viper,Sage,Jett","Killjoy,Viper,Jett,KAY/O,Gekko"
Lotus,HEROIC Valkyries,Odd 1 OUT,4,13,4,8,5,0,"Raze,Viper,Sage,Omen,Skye","Breach,Raze,Cypher,Sova,Astra"
Lotus,Team Falcons,Fraggerz,13,2,10,2,0,3,"Raze,Viper,Omen,Chamber,Gekko","Raze,Killjoy,Omen,Skye,Gekko"
Split,ZETA Gaming,Ramboot Club,10,13,4,8,5,6,"Breach,Raze,Cypher,Omen,Skye","Raze,Viper,Omen,Jett,Skye"
Sunset,SweetNsour,OnlyFins,13,11,10,2,9,3,"Raze,Cypher,Omen,KAY/O,Gekko","Breach,Raze,Cypher,Omen,Gekko"
Icebox,Valiant,DVM Esport,13,3,2,2,1,11,"Killjoy,Viper,Jett,KAY/O,Gekko","Sova,Killjoy,Viper,Jett,Gekko"
Sunset,Eintracht Frankfurt,ALTERNATE aTTaX,11,13,4,8,5,7,"Cypher,Sage,Omen,Yoru,Gekko","Raze,Cypher,Omen,KAY/O,Gekko"
Sunset,Acend,GoNext Esports,13,6,7,0,6,6,"Raze,Cypher,Omen,KAY/O,Gekko","Breach,Cypher,Omen,Yoru,Neon"
Sunset,Fenerbahçe Esports,S2G Esports,11,13,5,7,6,6,"Raze,Cypher,Omen,KAY/O,Gekko","Breach,Raze,Cypher,Omen,Gekko"
Bind,HEROIC Valkyries,Odd 1 OUT,13,11,6,6,5,7,"Raze,Viper,Skye,Astra,Gekko","Breach,Cypher,Sova,Omen,Neon"
Lotus,Acend,GoNext Esports,4,13,2,10,3,2,"Raze,Cypher,Omen,Jett,Skye","Breach,Cypher,Sova,Omen,Jett"
Split,Fenerbahçe Esports,S2G Esports,13,11,6,6,5,7,"Raze,Cypher,Sage,Reyna,Omen","Raze,Viper,Sage,Skye,Astra"
Split,Reckoning Esports,MLT Esports,15,13,5,9,4,10,"Breach,Raze,Cypher,Omen,Skye","Cypher,Viper,Omen,Jett,Skye"
Lotus,Reckoning Esports,MLT Esports,13,4,8,4,0,5,"Breach,Raze,Sova,Killjoy,Omen","Raze,Killjoy,Viper,Omen,Fade"
Bind,Alternate Realities,Medal Esports,2,13,0,3,10,2,"Raze,Viper,Brimstone,Fade,Gekko","Raze,Viper,Brimstone,Jett,Skye"
Sunset,Alternate Realities,Medal Esports,10,13,3,8,5,7,"Raze,Cypher,Omen,KAY/O,Gekko","Breach,Raze,Cypher,Omen,Gekko"
Bind,FUSION X,KS Esports GC,15,13,7,7,6,8,"Raze,Cypher,Brimstone,Skye,Gekko","Raze,Viper,Brimstone,Skye,Yoru"
Icebox,FUZOS,FTW LEÇA FC,9,13,3,9,4,6,"Killjoy,Viper,Jett,KAY/O,Gekko","Killjoy,Viper,Jett,KAY/O,Gekko"
Sunset,FOKUS Sakura,Permitta Unicorns GC,13,9,5,7,2,8,"Raze,Cypher,Omen,Yoru,Gekko","Breach,Raze,Cypher,Omen,Gekko"
Lotus,GAMAX eSports,top gz,13,7,5,7,0,8,"Breach,Raze,Cypher,Sova,Omen","Breach,Raze,Killjoy,Omen,Fade"
Lotus,FATE Flare,XProjekt Lioness,4,13,0,5,8,4,"Breach,Raze,Killjoy,Omen,Gekko","Breach,Raze,Killjoy,Omen,Gekko"
Lotus,GnG White,CSH White,13,4,10,2,2,3,"Breach,Raze,Killjoy,Omen,Fade","Breach,Raze,Killjoy,Omen,Gekko"
Lotus,toxic GC,Team Occupy Feminine Fusion,2,13,0,3,10,2,"Breach,Raze,Killjoy,Viper,Clove","Raze,Killjoy,Viper,Omen,Fade"
Bind,SAW,PPP,8,13,3,6,7,5,"Raze,Viper,Brimstone,Fade,Gekko","Raze,Viper,Brimstone,Fade,Gekko"
Breeze,Team RA'AD,R8 Esports,5,13,1,5,8,4,"Sova,Viper,Jett,Yoru,Astra","Cypher,Sova,Viper,Omen,Yoru"
Icebox,FOKUS Sakura,Permitta Unicorns GC,13,8,9,3,5,4,"Raze,Sova,Killjoy,Viper,Reyna","Sova,Killjoy,Viper,Jett,Gekko"
Sunset,Gamax Lite,Skulls Esports Regina,13,0,1,0,0,12,"Breach,Raze,Cypher,Omen,Gekko","Breach,Raze,Cypher,Astra,Fade"
Icebox,GAMAX eSports,top gz,14,12,8,5,7,6,"Sova,Killjoy,Viper,Jett,KAY/O","Sova,Killjoy,Viper,Sage,Jett"
Bind,Skulls Esports,Team Occupy,7,13,5,7,6,2,"Raze,Cypher,Sova,Astra,Gekko","Raze,Cypher,Brimstone,Reyna,Skye"
Icebox,Impulse GW,HOF Esports,13,4,5,0,4,8,"Killjoy,Viper,Jett,KAY/O,Gekko","Sova,Killjoy,Viper,Jett,Harbor"
Lotus,FOKUS Sakura,Permitta Unicorns GC,10,13,7,5,8,3,"Raze,Killjoy,Omen,Skye,Gekko","Breach,Raze,Killjoy,Omen,Gekko"
Split,Gladius,Andromeda Gaming,7,13,2,6,7,5,"Raze,Omen,Yoru,Astra,Fade","Breach,Raze,Viper,Omen,Skye"
Sunset,Team Occupy Feminine Fusion,GnG White,13,9,9,3,6,4,"Breach,Raze,Cypher,Omen,Gekko","Breach,Raze,Cypher,Omen,Fade"
Lotus,CSH White,FATE Flare,13,7,5,3,4,8,"Breach,Raze,Killjoy,Omen,Gekko","Breach,Raze,Killjoy,Omen,Gekko"
Sunset,GAMAX eSports,top gz,9,13,8,4,9,1,"Breach,Raze,Cypher,Omen,Fade","Breach,Raze,Cypher,Omen,Gekko"
Ascent,Skulls Esports Regina,toxic GC,13,9,5,5,4,8,"Breach,Raze,Killjoy,Omen,Fade","Killjoy,Phoenix,Omen,Jett,Skye"
Icebox,Team RA'AD,R8 Esports,12,14,10,3,11,2,"Killjoy,Viper,Sage,Gekko,Clove","Killjoy,Viper,Sage,Reyna,Gekko"
Sunset,FUSION X,KS Esports GC,13,8,8,1,7,5,"Raze,Cypher,Omen,KAY/O,Gekko","Raze,Cypher,Omen,KAY/O,Gekko"
Sunset,XProjekt Lioness,Gamax Lite,1,13,0,2,11,1,"Breach,Raze,Cypher,Omen,Gekko","Breach,Raze,Cypher,Omen,Gekko"
Lotus,Barça eSports,ZETA Gaming,13,8,9,3,5,4,"Killjoy,Omen,KAY/O,Neon,Gekko","Raze,Killjoy,Viper,Omen,Fade"
Ascent,Skulls Esports,Team Occupy,5,13,4,8,5,1,"Cypher,Sova,Omen,Jett,KAY/O","Sova,Killjoy,Omen,Jett,KAY/O"
Ascent,Onyx Ravens,NASR Esports,8,13,3,6,7,5,"Sova,Killjoy,Omen,Jett,KAY/O","Cypher,Sova,Phoenix,Omen,Jett"
Bind,EXO Clan,CTRL x YARI Esports,14,12,5,8,4,9,"Raze,Viper,Omen,Skye,KAY/O","Raze,Viper,Omen,Skye,Gekko"
Icebox,FOG Vortex,R8 Blues,7,13,5,7,6,2,"Sova,Killjoy,Viper,Reyna,Jett","Sova,Killjoy,Viper,Sage,Neon"
Ascent,Incognito,Chipi Chapa's,5,13,2,4,9,3,"Sova,Killjoy,Omen,Jett,KAY/O","Cypher,Sova,Phoenix,Omen,Jett"
Bind,SK Nebula,Playbay X VISION SYNC,13,4,3,2,2,10,"Breach,Cypher,Yoru,Astra,Gekko","Raze,Cypher,Brimstone,Skye,Gekko"
Bind,Gladius,Andromeda Gaming,7,13,3,9,4,4,"Raze,Cypher,Brimstone,Skye,Harbor","Raze,Viper,Brimstone,Skye,Gekko"
Lotus,Underground Gaming,Unity Esports,9,13,3,7,6,6,"Breach,Raze,Killjoy,Omen,Gekko","Breach,Cypher,Sova,Omen,Jett"
Bind,Reveal Multigaming,GJ Omen,13,10,8,4,6,5,"Raze,Cypher,Brimstone,Skye,Gekko","Raze,Viper,Brimstone,Skye,Gekko"
Split,TOG Kitsune,ALTERNATE aTTaX Ruby,4,13,4,8,5,0,"Breach,Cypher,Sage,Omen,Yoru","Breach,Raze,Cypher,Omen,Skye"
Bind,Dark Nebula,The Ultimates Odyssey,5,13,2,10,3,3,"Raze,Cypher,Reyna,Skye,Clove","Breach,Raze,Viper,Brimstone,Gekko"
Lotus,GTZ Esports,EX0TIK GAMING,9,13,5,5,8,4,"Breach,Raze,Cypher,Omen,Fade","Breach,Raze,Killjoy,Omen,Fade"
Lotus,RIZON Sugar,EMUs,3,13,2,10,3,1,"Breach,Raze,Killjoy,Omen,Fade","Breach,Raze,Cypher,Gekko,Clove"
Ascent,NASR Ignite,Karmine Corp GC,9,13,8,4,9,1,"Cypher,Sova,Phoenix,Omen,Jett","Sova,Killjoy,Omen,Jett,KAY/O"
Sunset,Onyx Ravens,NASR Esports,5,13,1,5,8,4,"Breach,Raze,Cypher,Sova,Omen","Breach,Raze,Cypher,Omen,Fade"
Lotus,EXO Clan,CTRL x YARI Esports,13,8,8,1,7,5,"Raze,Killjoy,Viper,Omen,Fade","Breach,Killjoy,Omen,Neon,Fade"
Ascent,Elysian Esports,Vanir,4,13,3,9,4,1,"Sova,Killjoy,Omen,Jett,KAY/O","Cypher,Sova,Omen,Jett,Deadlock"
Icebox,KPI Gaming,Five Media Clan,10,13,5,6,7,5,"Killjoy,Viper,Jett,KAY/O,Gekko","Killjoy,Viper,Jett,KAY/O,Gekko"
Bind,Underground Gaming,Unity Esports,13,7,6,2,5,7,"Raze,Viper,Omen,Skye,Yoru","Breach,Raze,Viper,Brimstone,Gekko"
Lotus,Gladius,Andromeda Gaming,13,10,5,6,4,8,"Raze,Killjoy,Omen,KAY/O,Gekko","Breach,Raze,Killjoy,Omen,Fade"
Sunset,Incognito,Chipi Chapa's,9,13,2,8,5,7,"Breach,Raze,Cypher,Sova,Omen","Breach,Raze,Cypher,Omen,Yoru"
Lotus,SK Nebula,Playbay X VISION SYNC,13,8,7,5,3,6,"Raze,Killjoy,Viper,Omen,Fade","Breach,Raze,Cypher,Omen,Fade"
Breeze,NASR Ignite,Karmine Corp GC,5,13,3,9,4,2,"Cypher,Sova,Viper,Jett,Gekko","Cypher,Sova,Viper,Jett,KAY/O"
Breeze,RIZON Sugar,EMUs,10,13,6,6,7,4,"Cypher,Sova,Viper,Jett,Yoru","Sova,Viper,Jett,Yoru,Astra"
Bind,Imperium Gaming,UCAM Esports Club,1,13,0,2,11,1,"Raze,Viper,Omen,Skye,Fade","Breach,Raze,Brimstone,Yoru,Fade"
Sunset,TOG Kitsune,ALTERNATE aTTaX Ruby,11,13,4,8,5,7,"Breach,Raze,Cypher,Omen,Gekko","Breach,Raze,Cypher,Sova,Omen"
Icebox,Reveal Multigaming,GJ Omen,13,10,7,5,5,6,"Sova,Killjoy,Viper,Jett,Clove","Sova,Killjoy,Viper,Reyna,Jett"
Split,The Ultimates,Team Falcons,2,13,0,3,10,2,"Raze,Viper,Omen,Skye,KAY/O","Breach,Raze,Cypher,Omen,Skye"
Icebox,Elysian Esports,Vanir,5,13,2,4,9,3,"Sova,Killjoy,Viper,Jett,Chamber","Sova,Killjoy,Viper,Sage,Jett"
Icebox,FOG Vortex,The Ultimates Odyssey,2,13,2,10,3,0,"Sova,Killjoy,Viper,Reyna,Jett","Killjoy,Viper,Omen,KAY/O,Gekko"
Sunset,Dark Nebula,Twisted Minds Orchid,8,13,6,6,7,2,"Raze,Cypher,Reyna,Gekko,Clove","Breach,Raze,Cypher,Omen,Gekko"
Icebox,EXO Clan,CTRL x YARI Esports,9,13,2,8,5,7,"Sova,Killjoy,Viper,Yoru,Deadlock","Sova,Killjoy,Viper,Jett,Gekko"
Icebox,Fraggerz,Vision Esports,13,9,5,5,4,8,"Sova,Killjoy,Viper,Sage,Jett","Sova,Killjoy,Viper,Sage,Jett"
Icebox,NOM Esports,Diamant Esports,8,13,4,5,8,4,"Sova,Killjoy,Viper,Sage,Jett","Breach,Raze,Killjoy,Viper,Gekko"
Lotus,Fraggerz,Vision Esports,13,7,6,6,1,7,"Raze,Killjoy,Omen,Skye,Gekko","Breach,Raze,Cypher,Omen,Fade"
Lotus,The Ultimates,Team Falcons,10,13,8,4,9,2,"Raze,Killjoy,Viper,Omen,Fade","Raze,Viper,Omen,Chamber,Gekko"
Ascent,Underground Gaming,Unity Esports,11,13,7,5,8,4,"Sova,Killjoy,Omen,Jett,KAY/O","Breach,Cypher,Sova,Omen,Jett"
Icebox,Falke Esports,Ramboot Club,9,13,8,4,9,1,"Sova,Killjoy,Viper,Omen,Jett","Sova,Killjoy,Viper,Jett,Gekko"
Bind,G2 Gozen,HEROIC Valkyries,13,5,10,2,3,3,"Raze,Viper,Omen,Skye,Gekko","Raze,Viper,Skye,Astra,Gekko"
Lotus,G2 Gozen,HEROIC Valkyries,13,2,3,0,2,10,"Raze,Killjoy,Viper,Omen,Fade","Raze,Viper,Sage,Omen,Skye"
Lotus,NOM Esports,Diamant Esports,9,13,6,6,7,3,"Raze,Killjoy,Viper,Omen,Fade","Raze,Killjoy,Viper,Omen,Skye"
Lotus,RyZ Knights,Saturday then FF,13,11,5,7,4,8,"Raze,Sova,Killjoy,Viper,Omen","Raze,Killjoy,Reyna,Omen,Fade"
Bind,RyZ Knights,Saturday then FF,13,9,6,4,5,7,"Raze,Cypher,Viper,Brimstone,Skye","Raze,Brimstone,Skye,Yoru,Gekko"
Sunset,RyZ Knights,whats a pretzel,13,5,9,3,2,4,"Breach,Raze,Cypher,Sova,Omen","Raze,Cypher,Omen,KAY/O,Gekko"
Haven,Blue Otter,Saturday then FF,8,13,6,6,7,2,"Breach,Sova,Killjoy,Omen,Jett","Sova,Killjoy,Reyna,Omen,Jett"
Lotus,RyZ Knights,whats a pretzel,13,5,6,0,5,7,"Raze,Sova,Killjoy,Viper,Omen","Raze,Viper,Omen,Skye,Deadlock"
Lotus,Blue Otter,Saturday then FF,8,13,4,8,5,4,"Breach,Raze,Killjoy,Gekko,Clove","Raze,Killjoy,Reyna,Omen,Fade"
Split,whats a pretzel,Thinking MarksMen,13,11,4,8,3,9,"Raze,Cypher,Viper,Omen,Skye","Raze,Cypher,Viper,Omen,Skye"
Ascent,Team 7 Esports,Division 7,3,13,3,9,4,0,"Sova,Killjoy,Omen,Jett,KAY/O","Sova,Killjoy,Omen,Jett,KAY/O"
Haven,Asians and Maxim,Blue Otter,7,13,3,5,8,4,"Breach,Sova,Killjoy,Omen,Jett","Breach,Sova,Killjoy,Omen,Jett"
Haven,whats a pretzel,Thinking MarksMen,13,7,6,2,5,7,"Breach,Cypher,Sova,Omen,Jett","Breach,Sova,Killjoy,Omen,Jett"
Ascent,9z Team GC,University War GC,13,10,6,5,5,7,"Sova,Killjoy,Omen,Jett,KAY/O","Sova,Killjoy,Omen,Jett,KAY/O"
Split,Ions Day Care,Saturday then FF,10,13,5,6,7,5,"Raze,Cypher,Reyna,Astra,Fade","Raze,Cypher,Omen,Skye,Yoru"
Bind,Team Occupy,GAMAX eSports,11,13,5,7,6,6,"Raze,Cypher,Brimstone,Reyna,Skye","Raze,Viper,Brimstone,Skye,Fade"
Icebox,RyZ Knights,ROSE,13,11,8,4,7,5,"Sova,Killjoy,Viper,Reyna,Gekko","Sova,Killjoy,Viper,Jett,KAY/O"
Sunset,RyZ Knights,ROSE,13,3,9,3,0,4,"Breach,Raze,Cypher,Sova,Omen","Raze,Cypher,Omen,KAY/O,Gekko"
Haven,Ions Day Care,Saturday then FF,7,13,4,8,5,3,"Sova,Killjoy,Omen,Jett,Gekko","Sova,Killjoy,Reyna,Omen,Jett"
Ascent,Asians and Maxim,Blue Otter,11,13,6,6,7,5,"Sova,Killjoy,Omen,Jett,KAY/O","Sova,Killjoy,Omen,Jett,KAY/O"
Icebox,Team 7 Esports,Division 7,15,17,6,10,7,9,"Sova,Killjoy,Viper,Jett,Gekko","Sova,Killjoy,Viper,Jett,Gekko"
Sunset,9z Team GC,University War GC,13,5,5,1,4,8,"Breach,Raze,Viper,Omen,Gekko","Breach,Raze,Cypher,Omen,Fade"
Sunset,top gz,Team RA'AD,6,13,3,4,9,3,"Breach,Raze,Cypher,Omen,Gekko","Breach,Raze,Cypher,Sova,Omen"
Ascent,whats a pretzel,Thinking MarksMen,12,14,6,7,7,6,"Sova,Killjoy,Omen,Jett,KAY/O","Sova,Killjoy,Omen,Jett,KAY/O"
Icebox,R8 Esports,Onyx Ravens,13,6,5,2,4,8,"Killjoy,Viper,Sage,Reyna,Gekko","Killjoy,Viper,Sage,Jett,Gekko"
Lotus,Team Occupy,GAMAX eSports,14,12,4,9,3,10,"Breach,Raze,Sova,Killjoy,Omen","Breach,Raze,Cypher,Sova,Omen"
Bind,NASR Esports,Skulls Esports,13,0,1,0,0,12,"Viper,Omen,Yoru,Fade,Gekko","Raze,Cypher,Brimstone,Skye,Fade"
Split,REY eSports,R3VOLT,8,13,2,10,3,6,"Breach,Raze,Cypher,Omen,Jett","Raze,Cypher,Viper,Omen,Skye"
Icebox,top gz,Team RA'AD,7,13,1,7,6,6,"Sova,Killjoy,Viper,Sage,Jett","Killjoy,Viper,Sage,Gekko,Clove"
Lotus,R8 Esports,Onyx Ravens,13,7,7,1,6,6,"Raze,Killjoy,Omen,Skye,Astra","Breach,Raze,Killjoy,Omen,Gekko"
Lotus,Gladius,TheSecretClub,8,13,2,7,6,6,"Raze,Killjoy,Omen,KAY/O,Gekko","Raze,Killjoy,Viper,Omen,Fade"
Ascent,Surely Tragic,Babos Gaming,11,13,7,5,8,4,"Sova,Killjoy,Omen,Jett,KAY/O","Sova,Killjoy,Omen,KAY/O,Neon"
Lotus,9z Team GC,University War GC,13,10,10,2,8,3,"Breach,Killjoy,Omen,Neon,Gekko","Breach,Raze,Omen,Gekko,Deadlock"
Lotus,NASR Esports,Skulls Esports,13,3,4,0,3,9,"Raze,Killjoy,Viper,Omen,Skye","Breach,Cypher,Sova,Omen,Jett"
Split,Team Occupy,GAMAX eSports,3,13,1,11,2,2,"Breach,Raze,Viper,Omen,Skye","Breach,Raze,Cypher,Omen,Fade"
Ascent,Axolotl,HGE Esports,11,13,2,10,3,9,"Breach,Killjoy,Viper,Omen,Yoru","Sova,Killjoy,Omen,Jett,KAY/O"
Split,Project 1,Thin Fecking Ice,13,3,9,3,0,4,"Raze,Cypher,Viper,Omen,Skye","Breach,Raze,Cypher,Omen,Skye"
Sunset,REY eSports,R3VOLT,13,15,4,10,5,9,"Breach,Cypher,Omen,Jett,Gekko","Breach,Raze,Cypher,Sova,Omen"
Bind,Project 1,Thin Fecking Ice,13,3,9,3,0,4,"Raze,Viper,Brimstone,Skye,Gekko","Breach,Raze,Cypher,Viper,Brimstone"
Sunset,Gladius,TheSecretClub,9,13,3,7,6,6,"Raze,Cypher,Omen,KAY/O,Gekko","Breach,Raze,Cypher,Omen,Gekko"
Lotus,Surely Tragic,Babos Gaming,6,13,2,5,8,4,"Raze,Cypher,Viper,Omen,Fade","Breach,Killjoy,Omen,Neon,Gekko"
Ascent,Unity Esports,Dragons Esports,13,11,5,7,4,8,"Breach,Cypher,Sova,Omen,Jett","Cypher,Sova,Omen,Jett,KAY/O"
Sunset,LONETEAM,VX300 Gaming,9,13,4,8,5,5,"Breach,Raze,Cypher,Sova,Omen","Raze,Killjoy,Sage,Omen,Gekko"
Bind,Munich Esports,ARROW,3,13,0,4,9,3,"Raze,Viper,Brimstone,Skye,Gekko","Raze,Cypher,Viper,Skye,Clove"
Icebox,G2 Gozen,Valiant GC,13,9,7,5,4,6,"Sova,Killjoy,Viper,Jett,Clove","Sova,Killjoy,Viper,Sage,Jett"
Sunset,Tani eSports,Lotus Knights,11,13,1,11,2,10,"Breach,Raze,Cypher,Omen,Gekko","Breach,Raze,Cypher,Omen,Gekko"
Lotus,GTZ Esports,FUZOS,16,18,9,8,10,7,"Breach,Raze,Cypher,Omen,Fade","Breach,Raze,Killjoy,Omen,Fade"
Icebox,Twisted Minds Esports,Fraggerz,14,16,6,9,7,8,"Sova,Killjoy,Viper,Jett,KAY/O","Sova,Killjoy,Viper,Sage,Jett"
Bind,Gladius,TheSecretClub,13,11,9,3,8,4,"Raze,Cypher,Brimstone,Skye,Harbor","Raze,Viper,Brimstone,Fade,Gekko"
Lotus,Munich Esports,ARROW,2,13,2,10,3,0,"Breach,Raze,Omen,Jett,Skye","Raze,Killjoy,Viper,Omen,Fade"
Sunset,Unity Esports,Dragons Esports,8,13,4,5,8,4,"Breach,Cypher,Omen,Jett,Fade","Raze,Cypher,Viper,Omen,Fade"
Icebox,NOVO Esports,RTZN,13,2,10,2,0,3,"Sova,Killjoy,Viper,Sage,Jett","Sova,Killjoy,Viper,Jett,KAY/O"
Split,G2 Gozen,Valiant GC,13,2,3,0,2,10,"Breach,Raze,Cypher,Omen,Fade","Raze,Viper,Omen,Jett,KAY/O"
Lotus,Vision Esports,The Ultimates,6,13,4,3,10,2,"Breach,Raze,Cypher,Omen,Jett","Raze,Killjoy,Viper,Omen,Fade"
Lotus,Team Falcons,Underground Gaming,13,4,2,3,1,11,"Raze,Viper,Omen,Chamber,Gekko","Raze,Killjoy,Viper,Omen,Gekko"
Icebox,Vision Esports,The Ultimates,4,13,2,3,10,2,"Sova,Killjoy,Viper,Sage,Jett","Sova,Killjoy,Viper,Jett,Gekko"
Lotus,Tani eSports,Lotus Knights,9,13,5,7,6,4,"Breach,Raze,Cypher,Omen,Gekko","Raze,Killjoy,Viper,Omen,Fade"
Bind,Twisted Minds Esports,Fraggerz,10,13,5,7,6,5,"Raze,Brimstone,Reyna,Skye,Harbor","Raze,Cypher,Omen,Jett,Skye"
Split,Team Falcons,Underground Gaming,13,1,11,1,0,2,"Breach,Raze,Cypher,Omen,Skye","Raze,Cypher,Viper,Omen,Skye"
Lotus,Unity Esports,Dragons Esports,13,6,5,2,4,8,"Breach,Cypher,Sova,Omen,Jett","Raze,Killjoy,Viper,Omen,Fade"
Icebox,PPP,Impulse GW,13,10,8,4,6,5,"Sova,Killjoy,Viper,Sage,Jett","Killjoy,Viper,Jett,KAY/O,Gekko"
Ascent,Outplayed,DSYRE,7,13,3,9,4,4,"Sova,Killjoy,Omen,Jett,KAY/O","Sova,Killjoy,Omen,Jett,KAY/O"
Icebox,Team Falcons Vega,FOKUS Sakura,13,9,5,5,4,8,"Reyna,Omen,Jett,Harbor,Gekko","Raze,Sova,Killjoy,Viper,Reyna"
Lotus,REY ACADEMY,Coalesce,4,13,4,8,5,0,"Raze,Viper,Omen,Chamber,Gekko","Raze,Cypher,Omen,Jett,Skye"
Sunset,EX0TIK GAMING,SAW,2,13,2,10,3,0,"Breach,Raze,Cypher,Omen,Gekko","Breach,Raze,Cypher,Omen,Gekko"
Lotus,Cuban Raft Raiders,MouzKings eSports,8,13,3,6,7,5,"Raze,Killjoy,Viper,Omen,Fade","Breach,Killjoy,Omen,Neon,Fade"
Sunset,Team Falcons Vega,FOKUS Sakura,13,3,4,0,3,9,"Breach,Raze,Cypher,Omen,Gekko","Raze,Cypher,Omen,Yoru,Gekko"
Split,Elysian Esports,Twisted Saints Esports,13,9,7,3,6,6,"Breach,Raze,Cypher,Omen,Jett","Raze,Viper,Omen,Jett,Skye"
Bind,Cuban Raft Raiders,MouzKings eSports,1,13,1,11,2,0,"Raze,Killjoy,Viper,Brimstone,Gekko","Raze,Cypher,Brimstone,Reyna,Skye"
Icebox,HOF Esports,FTW LEÇA FC,13,5,5,1,4,8,"Sova,Killjoy,Viper,Jett,Harbor","Killjoy,Viper,Jett,KAY/O,Gekko"
Ascent,Elysian Esports,Twisted Saints Esports,13,4,3,2,2,10,"Sova,Killjoy,Omen,Jett,KAY/O","Raze,Viper,Reyna,Skye,Harbor"
Split,Ions Day Care,IOUNL,17,15,11,5,10,6,"Raze,Cypher,Reyna,Astra,Fade","Raze,Cypher,Omen,Jett,Skye"
Haven,Saturday then FF,Aspyre x Swarm,13,11,8,4,7,5,"Breach,Sova,Killjoy,Omen,Jett","Breach,Sova,Killjoy,Omen,Jett"
Lotus,Thinking MarksMen,Area of Effect,13,7,8,4,3,5,"Breach,Raze,Killjoy,Omen,Gekko","Raze,Cypher,Viper,Omen,Fade"
Ascent,Saturday then FF,Aspyre x Swarm,13,4,4,1,3,9,"Sova,Killjoy,Omen,Jett,KAY/O","Sova,Killjoy,Omen,Jett,KAY/O"
Sunset,RyZ Knights,chqse and kittens,13,3,4,0,3,9,"Breach,Raze,Cypher,Sova,Omen","Breach,Raze,Cypher,Sova,Omen"
Icebox,Ions Day Care,IOUNL,11,13,5,7,6,6,"Raze,Killjoy,Viper,Reyna,Gekko","Sova,Killjoy,Viper,Reyna,Jett"
Ascent,Thinking MarksMen,Area of Effect,13,1,2,0,1,11,"Sova,Killjoy,Omen,Jett,KAY/O","Cypher,Sova,Omen,Jett,Deadlock"
Haven,Asians and Maxim,Valkyrie,13,2,3,0,2,10,"Sova,Killjoy,Reyna,Omen,Jett","Breach,Sova,Killjoy,Omen,Jett"
Bind,SaD Purple,Sky Esports (NA),13,8,6,6,2,7,"Raze,Brimstone,Reyna,Harbor,Gekko","Raze,Cypher,Brimstone,Skye,Gekko"
Haven,whats a pretzel,Power Rangers Jungle Fury,14,12,6,7,5,8,"Breach,Cypher,Sova,Omen,Jett","Breach,Cypher,Sova,Omen,Jett"
Haven,Ions Day Care,IOUNL,13,9,8,4,5,5,"Raze,Cypher,Reyna,Neon,Clove","Breach,Cypher,Sova,Omen,Jett"
Icebox,Sexy Gang,ROSE,6,13,2,5,8,4,"Sova,Killjoy,Viper,Jett,KAY/O","Sova,Killjoy,Viper,Jett,KAY/O"
Icebox,RyZ Knights,chqse and kittens,13,10,6,6,4,7,"Sova,Killjoy,Viper,Reyna,Gekko","Sova,Killjoy,Viper,Jett,Gekko"
Ascent,Asians and Maxim,Valkyrie,13,10,5,6,4,8,"Sova,Killjoy,Omen,Jett,KAY/O","Sova,Killjoy,Omen,Jett,KAY/O"
Haven,Blue Otter,Nightblood Gaming,13,3,4,0,3,9,"Breach,Sova,Killjoy,Omen,Jett","Breach,Sova,Killjoy,Omen,Jett"
Lotus,SaD Purple,Sky Esports (NA),13,7,6,2,5,7,"Raze,Killjoy,Viper,Omen,Fade","Raze,Cypher,Omen,Jett,Gekko"
Lotus,Orangutan Gang,University of Oklahoma,13,6,7,5,1,6,"Raze,Killjoy,Viper,Omen,Fade","Raze,Viper,Omen,Chamber,Fade"
Sunset,Aspyre x Swarm,Dan's Minions,15,13,9,5,8,6,"Breach,Raze,Cypher,Sova,Omen","Raze,Cypher,Sage,Omen,Gekko"
Ascent,whats a pretzel,Power Rangers Jungle Fury,13,7,7,1,6,6,"Sova,Killjoy,Omen,Jett,KAY/O","Sova,Killjoy,Omen,Jett,KAY/O"
Split,The GRID,Area of Effect,9,13,7,5,8,2,"Raze,Omen,Skye,Astra,Gekko","Raze,Cypher,Viper,Omen,Skye"
Sunset,Sexy Gang,ROSE,2,13,2,1,12,0,"Raze,Cypher,KAY/O,Gekko,Clove","Raze,Cypher,Omen,KAY/O,Gekko"
Bind,Blue Otter,Nightblood Gaming,13,5,4,2,3,9,"Raze,Viper,Brimstone,Skye,Yoru","Raze,Viper,Omen,Skye,Gekko"
Haven,RyZ Knights,Neo,13,3,3,1,2,10,"Breach,Sova,Killjoy,Omen,Jett","Killjoy,Viper,Jett,Skye,Harbor"
Haven,Valkyrie,1Millisecond,13,1,2,0,1,11,"Breach,Sova,Killjoy,Omen,Jett","Breach,Sova,Killjoy,Omen,Jett"
Ascent,IOUNL,Nearest Airport,14,12,6,7,5,8,"Cypher,Sova,Omen,Jett,Deadlock","Viper,Omen,Jett,KAY/O,Fade"
Ascent,Sky Esports (NA),University of Oklahoma,14,12,3,10,2,11,"Cypher,Sova,Omen,Jett,Yoru","Sova,Killjoy,Omen,Jett,KAY/O"
Haven,Aspyre x Swarm,Dan's Minions,13,9,8,2,7,5,"Breach,Sova,Killjoy,Omen,Jett","Raze,Cypher,Omen,Fade,Deadlock"
Sunset,The GRID,Area of Effect,6,13,6,6,7,0,"Raze,Cypher,Omen,KAY/O,Gekko","Breach,Raze,Cypher,Sova,Omen"
Split,TAMU Maroon,Blinn Esports,13,6,3,4,2,10,"Raze,Cypher,Viper,Omen,Skye","Raze,Cypher,Viper,Omen,Skye"
Ascent,chqse and kittens,YDZ Esports,13,7,6,2,5,7,"Sova,Killjoy,Omen,Jett,KAY/O","Sova,Killjoy,Omen,Jett,KAY/O"
Lotus,Power Rangers Jungle Fury,yves saint laurent,13,8,9,3,5,4,"Raze,Killjoy,Omen,Fade,Gekko","Raze,Killjoy,Viper,Omen,Skye"
Haven,Sexy Gang,CSP Val Blue,13,10,6,6,4,7,"Breach,Killjoy,Jett,Gekko,Clove","Cypher,Sova,Omen,Jett,Chamber"
Ascent,SaD Purple,Orangutan Gang,13,4,2,3,1,11,"Sova,Killjoy,Omen,Jett,KAY/O","Sova,Killjoy,Omen,Jett,KAY/O"
Icebox,Thinking MarksMen,Six Figures,13,10,5,7,3,8,"Sova,Killjoy,Viper,Reyna,Clove","Sova,Killjoy,Viper,KAY/O,Chamber"
Sunset,Ions Day Care,Destro,13,3,3,1,2,10,"Raze,Sova,Reyna,Omen,Neon","Breach,Raze,Cypher,Fade,Clove"
Haven,Asians and Maxim,Abyss Blueming,13,3,4,0,3,9,"Sova,Killjoy,Omen,Jett,Yoru","Sova,Killjoy,Reyna,Omen,Jett"
Lotus,ROSE,BOOSTIOS PIGS,13,1,11,1,0,2,"Raze,Cypher,Viper,Omen,Fade","Raze,Cypher,Omen,KAY/O,Gekko"
Lotus,RyZ Knights,Neo,13,5,9,3,2,4,"Raze,Sova,Killjoy,Viper,Omen","Breach,Raze,Killjoy,Omen,Gekko"
Sunset,Valkyrie,1Millisecond,11,13,6,6,7,5,"Breach,Raze,Cypher,Omen,Gekko","Breach,Raze,Cypher,Omen,Fade"
Haven,Saturday then FF,Deathrow,13,2,3,0,2,10,"Breach,Sova,Killjoy,Omen,Jett","Cypher,Sova,Omen,Jett,Deadlock"
Sunset,Blue Otter,Refugee Camp,13,9,7,5,4,6,"Breach,Raze,Cypher,Omen,Gekko","Raze,Cypher,Reyna,Omen,Gekko"
Lotus,IOUNL,Nearest Airport,11,13,4,8,5,7,"Raze,Cypher,Omen,Jett,Gekko","Breach,Raze,Cypher,Gekko,Clove"
Lotus,The GRID,Area of Effect,13,7,7,1,6,6,"Raze,Killjoy,Reyna,Omen,Gekko","Raze,Cypher,Viper,Omen,Fade"
Icebox,Asians and Maxim,Abyss Blueming,13,4,4,1,3,9,"Sova,Viper,Jett,Gekko,Deadlock","Sova,Killjoy,Reyna,Jett,Harbor"
Haven,whats a pretzel,Ugly Hamsters,13,10,3,8,2,10,"Breach,Cypher,Sova,Omen,Jett","Breach,Sova,Killjoy,Omen,Jett"
Haven,Ions Day Care,Destro,13,4,4,1,3,9,"Sova,Killjoy,Omen,Jett,Gekko","Breach,Killjoy,Omen,Jett,Fade"
Haven,Nightblood Gaming,Awaken,13,11,7,5,6,6,"Breach,Sova,Killjoy,Omen,Jett","Breach,Cypher,Sova,Omen,Jett"
Bind,Sexy Gang,CSP Val Blue,13,8,6,3,5,7,"Raze,Cypher,Brimstone,Fade,Gekko","Breach,Raze,Brimstone,Jett,Skye"
Split,SaD Purple,Lotus 8 Esports,13,0,1,0,0,12,"Raze,Cypher,Omen,Skye,Deadlock","Raze,Cypher,Viper,Omen,Skye"
Split,Akave Esports Black,MYVRA,13,3,9,3,0,4,"Raze,Jett,Skye,Gekko,Clove","Breach,Raze,Cypher,Skye,Astra"
Sunset,TAMU Maroon,Blinn Esports,14,12,6,7,5,8,"Breach,Raze,Cypher,Omen,Gekko","Breach,Raze,Cypher,Omen,Gekko"
Haven,Power Rangers Jungle Fury,yves saint laurent,13,11,7,5,6,6,"Breach,Cypher,Sova,Omen,Jett","Breach,Sova,Killjoy,Omen,Jett"
Icebox,ROSE,BOOSTIOS PIGS,13,4,5,0,4,8,"Sova,Killjoy,Viper,Jett,KAY/O","Sova,Viper,Jett,Chamber,Gekko"
Icebox,chqse and kittens,YDZ Esports,14,12,8,5,7,6,"Sova,Killjoy,Viper,Jett,Gekko","Sova,Killjoy,Viper,Reyna,Jett"
Bind,Sky Esports (NA),Forsaken Shadows,13,11,5,7,4,8,"Raze,Cypher,Omen,Jett,Gekko","Raze,Brimstone,Skye,Harbor,Gekko"
Haven,Blue Otter,Refugee Camp,13,3,9,3,0,4,"Breach,Sova,Killjoy,Omen,Jett","Breach,Sova,Killjoy,Omen,Jett"
Icebox,Neo,GoodFellas,13,4,4,1,3,9,"Sova,Killjoy,Viper,Harbor,Gekko","Sova,Killjoy,Viper,Jett,Gekko"
Ascent,Valkyrie,1Millisecond,13,4,2,3,1,11,"Sova,Killjoy,Omen,Jett,KAY/O","Sova,Killjoy,Omen,Jett,KAY/O"
Split,Thinking MarksMen,Six Figures,13,8,8,1,7,5,"Raze,Cypher,Viper,Omen,Skye","Raze,Cypher,Omen,Jett,Deadlock"
Lotus,Wired Esports,University of Oklahoma,3,13,2,2,11,1,"Raze,Cypher,Viper,Omen,Gekko","Raze,Killjoy,Viper,Omen,Fade"
Ascent,Saturday then FF,Deathrow,13,4,3,2,2,10,"Sova,Killjoy,Omen,Jett,KAY/O","Sova,Killjoy,Omen,Jett,KAY/O"
Split,LF8 Mythic,Dan's Minions,14,16,6,9,7,8,"Breach,Raze,Cypher,Omen,Gekko","Raze,Viper,Omen,Jett,Skye"
Lotus,whats a pretzel,Ugly Hamsters,13,5,8,4,1,5,"Raze,Viper,Omen,Skye,Deadlock","Breach,Raze,Omen,Gekko,Deadlock"
Haven,IOUNL,Nearest Airport,13,8,5,4,4,8,"Cypher,Sova,Omen,Jett,Chamber","Breach,Cypher,Sova,Omen,Jett"
Ascent,Area of Effect,Kitten Shelter,13,4,3,2,2,10,"Cypher,Sova,Omen,Jett,Deadlock","Cypher,Sova,Omen,Jett,Deadlock"
Sunset,Nightblood Gaming,Awaken,13,11,9,3,8,4,"Breach,Raze,Cypher,Omen,Gekko","Breach,Raze,Sage,Omen,Gekko"
Ascent,Onyx Ravens,top gz,13,2,3,0,2,10,"Sova,Killjoy,Omen,Jett,KAY/O","Sova,Killjoy,Omen,Jett,KAY/O"
Bind,Akave Esports Black,MYVRA,13,6,7,5,1,6,"Raze,Cypher,Viper,Brimstone,Skye","Breach,Raze,Cypher,Brimstone,Gekko"
Sunset,Orangutan Gang,Tall guys,17,15,7,9,6,10,"Raze,Cypher,Omen,KAY/O,Gekko","Raze,Cypher,Omen,Yoru,Gekko"
Lotus,Neo,GoodFellas,13,9,5,5,4,8,"Breach,Raze,Killjoy,Omen,Gekko","Raze,Killjoy,Viper,Omen,Gekko"
Sunset,YDZ Esports,MERC CLAN,13,6,10,2,4,3,"Breach,Raze,Cypher,Sova,Clove","Raze,Cypher,Omen,KAY/O,Gekko"
Haven,yves saint laurent,Raven Esports,13,9,4,6,3,9,"Breach,Sova,Killjoy,Omen,Jett","Killjoy,Viper,Omen,Jett,Skye"
Bind,Six Figures,reddot's retirement home,13,5,9,3,2,4,"Raze,Viper,Brimstone,Skye,KAY/O","Raze,Viper,Chamber,Gekko,Clove"
Ascent,TAMU Maroon,Blinn Esports,13,15,9,5,10,4,"Cypher,Sova,Omen,Jett,Deadlock","Sova,Killjoy,Omen,Jett,KAY/O"
Haven,Abyss Blueming,BALLZ V3.0,14,12,8,5,7,6,"Sova,Killjoy,Reyna,Omen,Jett","Breach,Cypher,Sova,Omen,Jett"
Haven,CSP Val Blue,royal buddies,15,13,6,8,5,9,"Cypher,Sova,Phoenix,Omen,Jett","Breach,Cypher,Sova,Omen,Jett"
Ascent,Refugee Camp,ABG luvrs,13,10,8,3,7,5,"Sova,Killjoy,Omen,Jett,KAY/O","Sova,Killjoy,Omen,Jett,KAY/O"
Sunset,Deathrow,SiXSENSE,13,2,10,2,0,3,"Breach,Raze,Cypher,Omen,Gekko","Breach,Raze,Cypher,Omen,Gekko"
Ascent,Destro,Goated,13,4,5,0,4,8,"Breach,Omen,Jett,KAY/O,Fade","Sova,Phoenix,Omen,Jett,KAY/O"
Split,Forsaken Shadows,Kaizen Esports Red,13,4,8,4,0,5,"Raze,Cypher,Viper,Omen,Skye","Breach,Raze,Cypher,Omen,Skye"
Haven,Ugly Hamsters,Paranoia Esports,13,9,7,3,6,6,"Killjoy,Viper,Jett,Skye,Clove","Breach,Sova,Killjoy,Omen,Jett"
Ascent,BHOP Esports,BOOSTIOS PIGS,12,14,7,6,8,5,"Sova,Killjoy,Omen,Jett,KAY/O","Viper,Omen,Jett,KAY/O,Gekko"
Haven,LF8 Mythic,Dan's Minions,8,13,5,7,6,3,"Breach,Sova,Killjoy,Omen,Jett","Raze,Cypher,Omen,Fade,Deadlock"
Haven,Nearest Airport,Hybrid Authority,13,4,8,4,0,5,"Breach,Cypher,Sova,Omen,Jett","Killjoy,Omen,Jett,Fade,Harbor"
Sunset,1Millisecond,CHURCH OF CHAEWON KIM,13,5,8,4,1,5,"Breach,Raze,Cypher,Omen,Fade","Breach,Raze,Cypher,Omen,Gekko"
Lotus,Awaken,minions united GC,13,2,3,0,2,10,"Raze,Cypher,Omen,KAY/O,Gekko","Breach,Raze,Killjoy,Omen,Fade"
Haven,Area of Effect,Kitten Shelter,9,13,2,10,3,7,"Breach,Cypher,Sova,Omen,Jett","Breach,Cypher,Sova,Omen,Jett"
Sunset,NASR Esports,R8 Esports,13,6,8,4,2,5,"Breach,Raze,Cypher,Omen,Fade","Breach,Cypher,Sova,Omen,Yoru"
Lotus,Onyx Ravens,top gz,13,5,9,3,2,4,"Breach,Raze,Killjoy,Omen,Gekko","Breach,Raze,Killjoy,Omen,Fade"
Lotus,Orangutan Gang,Guangzhou Gooners,13,2,10,2,0,3,"Raze,Killjoy,Viper,Omen,Fade","Raze,Killjoy,Viper,Omen,Fade"
Ascent,ST x WTP,University of Oklahoma,8,13,5,7,6,3,"Sova,Killjoy,Reyna,Omen,Jett","Sova,Killjoy,Omen,Jett,KAY/O"
Lotus,Tall guys,Tactital Tater Tossers,13,4,9,3,1,4,"Raze,Killjoy,Viper,Omen,Fade","Breach,Raze,Killjoy,Omen,Gekko"
Haven,Neo,GoodFellas,11,13,5,7,6,6,"Breach,Cypher,Sova,Omen,Jett","Breach,Sova,Killjoy,Omen,Jett"
Lotus,SaD Purple,Harmony,13,5,6,0,5,7,"Breach,Raze,Cypher,Omen,Fade","Breach,Raze,Killjoy,Omen,Fade"
Sunset,LF8 Mythic,Dan's Minions,13,0,1,0,0,12,"Breach,Raze,Cypher,Omen,Fade","Breach,Raze,Cypher,Omen,Gekko"
Lotus,1Millisecond,CHURCH OF CHAEWON KIM,13,1,11,1,0,2,"Raze,Cypher,Viper,Omen,Fade","Raze,Killjoy,Viper,Omen,Fade"
Lotus,Ugly Hamsters,Paranoia Esports,13,5,7,5,0,6,"Breach,Raze,Omen,Gekko,Deadlock","Raze,Killjoy,Viper,Omen,Gekko"
Lotus,Nearest Airport,Hybrid Authority,13,2,3,0,2,10,"Breach,Raze,Cypher,Gekko,Clove","Breach,Raze,Killjoy,Omen,Fade"
Lotus,BHOP Esports,BOOSTIOS PIGS,7,13,3,5,8,4,"Breach,Raze,Omen,Chamber,Gekko","Raze,Cypher,Omen,KAY/O,Gekko"
Haven,YDZ Esports,MERC CLAN,13,8,8,4,4,5,"Breach,Sova,Killjoy,Omen,Jett","Killjoy,Viper,Omen,Jett,Skye"
Bind,yves saint laurent,Raven Esports,13,11,5,7,4,8,"Raze,Viper,Skye,Gekko,Clove","Raze,Viper,Brimstone,Jett,Skye"
Sunset,Destro,Goated,13,2,12,0,2,1,"Breach,Raze,Cypher,Fade,Clove","Raze,Cypher,Omen,Gekko,Iso"
Bind,TAMU Maroon,Blinn Esports,13,9,6,4,5,7,"Raze,Viper,Brimstone,Skye,Deadlock","Raze,Viper,Brimstone,KAY/O,Gekko"
Haven,Refugee Camp,ABG luvrs,13,7,10,2,5,3,"Breach,Sova,Killjoy,Omen,Jett","Breach,Sova,Killjoy,Omen,Jett"
Lotus,Deathrow,SiXSENSE,13,6,6,1,5,7,"Raze,Killjoy,Omen,Fade,Gekko","Raze,Killjoy,Viper,Omen,Fade"
Split,Six Figures,reddot's retirement home,13,9,9,1,8,4,"Raze,Cypher,Omen,Jett,Deadlock","Raze,Cypher,Omen,Jett,Skye"
Lotus,Akave Esports Black,MYVRA,12,14,6,7,7,6,"Breach,Raze,Cypher,Omen,Gekko","Breach,Raze,Cypher,Omen,Gekko"
Ascent,Sky Esports (NA),F5 Esports,13,1,2,0,1,11,"Cypher,Sova,Omen,Jett,Yoru","Sova,Killjoy,Omen,Jett,KAY/O"
Sunset,Area of Effect,Kitten Shelter,13,2,10,2,0,3,"Breach,Raze,Cypher,Sova,Omen","Breach,Raze,Cypher,Omen,Fade"
Ascent,Awaken,minions united GC,13,3,4,0,3,9,"Cypher,Sova,Omen,Jett,Deadlock","Sova,Killjoy,Omen,Jett,KAY/O"
Sunset,Abyss Blueming,BALLZ V3.0,13,11,10,2,9,3,"Raze,Cypher,Reyna,Omen,Gekko","Raze,Cypher,Omen,KAY/O,Gekko"
Bind,CSP Val Blue,royal buddies,13,11,5,7,4,8,"Breach,Raze,Brimstone,Jett,Skye","Breach,Raze,Cypher,Brimstone,Gekko"
Split,Skulls Esports,GAMAX eSports,7,13,2,6,7,5,"Raze,Cypher,Viper,Sage,Astra","Breach,Raze,Cypher,Omen,Fade"
Sunset,AQUA Nation,Harmony,5,13,2,4,9,3,"Sova,Phoenix,Sage,Omen,Clove","Breach,Raze,Cypher,Omen,Gekko"
Lotus,Neglected,:3,13,9,7,3,6,6,"Raze,Killjoy,Viper,Omen,Fade","Raze,Killjoy,Omen,Jett,Gekko"
Icebox,SaD Purple,Jack n Frens ,13,5,6,0,5,7,"Sova,Killjoy,Viper,Reyna,Jett","Sova,Viper,Reyna,Jett,Clove"
Ascent,ST x WTP,4 Girls and StringBeanAdam,13,7,6,6,1,7,"Sova,Killjoy,Reyna,Omen,Jett","Sova,Killjoy,Omen,Jett,KAY/O"
Lotus,Sky Esports (NA),Outcast Gaming,13,2,10,2,0,3,"Raze,Cypher,Omen,Jett,Gekko","Raze,Phoenix,Omen,Chamber,Fade"
Sunset,Orangutan Gang,EXOTICK,13,2,11,1,1,2,"Raze,Cypher,Omen,KAY/O,Gekko","Breach,Raze,Cypher,Omen,Fade"
Icebox,Luminescent Sapphire,BALLZ V3.0,3,13,2,10,3,1,"Killjoy,Viper,Jett,Harbor,Gekko","Sova,Killjoy,Viper,Reyna,Gekko"
Bind,AURA Valorant,Forsaken Shadows,6,13,3,4,9,3,"Raze,Cypher,Viper,Brimstone,Skye","Raze,Brimstone,Skye,Harbor,Gekko"
Bind,Guangzhou Gooners,TMNT,13,8,9,3,5,4,"Raze,Viper,Brimstone,Skye,Gekko","Raze,Cypher,Sova,Brimstone,Skye"
Lotus,M for Mini,F5 Esports,2,13,2,10,3,0,"Raze,Killjoy,Viper,Omen,Fade","Raze,Killjoy,Omen,Fade,Gekko"
Lotus,Kaizen Esports Red,ECG EEPY Shadows,13,1,12,0,1,1,"Breach,Raze,Killjoy,Omen,Fade","Raze,Killjoy,Viper,Fade,Gekko"
Ascent,F1 Esports,Lotus 8 Esports,7,13,5,7,6,2,"Sova,Killjoy,Omen,Jett,KAY/O","Cypher,Sova,Omen,Jett,KAY/O"
Sunset,Tall guys,Outlast Gaming,13,2,3,0,2,10,"Raze,Cypher,Omen,Yoru,Gekko","Breach,Raze,Cypher,Omen,Gekko"
Lotus,Hyjinx Violet,Wired Esports,10,13,7,5,8,3,"Raze,Killjoy,Viper,Omen,Fade","Raze,Cypher,Viper,Omen,Gekko"
Lotus,NASR Esports,R8 Esports,14,12,7,6,6,7,"Raze,Killjoy,Viper,Omen,Skye","Raze,Killjoy,Omen,Skye,Astra"
Ascent,GroundX,Tactital Tater Tossers,11,13,7,5,8,4,"Sova,Killjoy,Omen,Jett,KAY/O","Sova,Killjoy,Jett,KAY/O,Clove"
Icebox,Onyx Ravens,top gz,13,15,7,7,8,6,"Killjoy,Viper,Sage,Jett,Gekko","Sova,Killjoy,Viper,Sage,Jett"
Ascent,University of Oklahoma,Team NGA,13,1,2,0,1,11,"Cypher,Sova,Omen,Jett,KAY/O","Reyna,Jett,Skye,Deadlock,Clove"
Sunset,Akave Esports Black,MYVRA,13,7,6,6,1,7,"Breach,Raze,Cypher,Omen,Gekko","Breach,Raze,Cypher,Omen,Gekko"
Split,DSQ Esports,Free Orbs,4,13,3,9,4,1,"Raze,Cypher,Viper,Omen,Skye","Breach,Raze,Cypher,Omen,Skye"
Ascent,Skulls Esports,GAMAX eSports,1,13,1,11,2,0,"Cypher,Sova,Omen,Jett,KAY/O","Sova,Killjoy,Omen,Jett,KAY/O"
Ascent,Team Prolific,Surely Tragic,6,13,3,4,9,3,"Breach,Viper,Phoenix,Omen,KAY/O","Sova,Killjoy,Omen,Jett,KAY/O"
Bind,EXO Clan,RYL | Royal Legion,13,3,9,3,0,4,"Raze,Viper,Omen,Skye,KAY/O","Raze,Viper,Brimstone,Skye,Gekko"
Bind,DSYRE,RTZN,13,8,6,3,5,7,"Raze,Viper,Brimstone,Skye,Gekko","Raze,Viper,Brimstone,Fade,Gekko"
Ascent,Dragons Esports,Fraggerz,13,9,6,4,5,7,"Cypher,Sova,Omen,Jett,KAY/O","Breach,Sova,Killjoy,Omen,Jett"
Split,Team RA'AD,Team Occupy,13,8,6,3,5,7,"Raze,Cypher,Viper,Omen,Skye","Breach,Raze,Viper,Omen,Skye"
Bind,Unity Esports,Team Falcons,9,13,4,6,7,5,"Breach,Raze,Viper,Brimstone,Gekko","Raze,Viper,Sage,Skye,Clove"
Ascent,The Ultimates,Twisted Minds Esports,1,13,1,11,2,0,"Sova,Killjoy,Omen,Jett,KAY/O","Sova,Killjoy,Omen,Jett,KAY/O"
Bind,Twisted Minds Orchid,FOG Vortex,13,3,3,1,2,10,"Raze,Viper,Brimstone,KAY/O,Gekko","Breach,Raze,Cypher,Brimstone,Skye"
Icebox,NXT,Apeks,8,13,4,8,5,4,"Sova,Killjoy,Viper,Reyna,Jett","Killjoy,Viper,Jett,KAY/O,Gekko"
Bind,The Ultimates Odyssey,R8 Blues,9,13,2,8,5,7,"Breach,Raze,Viper,Brimstone,Gekko","Viper,Phoenix,Sage,Skye,Clove"
Sunset,DSQ Esports,Free Orbs,7,13,2,6,7,5,"Breach,Raze,Cypher,Omen,Gekko","Breach,Cypher,Sova,Omen,Neon"
Lotus,EXO Clan,RYL | Royal Legion,13,4,5,0,4,8,"Raze,Killjoy,Viper,Omen,Fade","Raze,Viper,Omen,Chamber,Fade"
Split,Team Prolific,Surely Tragic,9,13,5,5,8,4,"Breach,Raze,Cypher,Omen,Chamber","Breach,Raze,Omen,Gekko,Deadlock"
Icebox,Team RA'AD,Team Occupy,13,2,10,2,0,3,"Killjoy,Viper,Sage,Gekko,Clove","Sova,Killjoy,Viper,Sage,Jett"
Icebox,Axolotl,NOVO Esports,13,6,10,2,4,3,"Sova,Killjoy,Viper,Sage,Jett","Breach,Killjoy,Viper,Omen,Yoru"
Breeze,NASR Ignite,FOKUS Sakura,13,7,7,5,2,6,"Cypher,Sova,Viper,Jett,Gekko","Cypher,Sova,Viper,Jett,Yoru"
Icebox,Dragons Esports,Fraggerz,10,13,5,6,7,5,"Sova,Killjoy,Viper,Reyna,Harbor","Sova,Killjoy,Viper,Sage,Jett"
Icebox,Unity Esports,Team Falcons,5,13,2,4,9,3,"Killjoy,Viper,Jett,KAY/O,Gekko","Reyna,Omen,KAY/O,Harbor,Gekko"
Icebox,The Ultimates,Twisted Minds Esports,3,13,1,3,10,2,"Killjoy,Viper,Jett,KAY/O,Gekko","Sova,Killjoy,Viper,Jett,KAY/O"
Lotus,Dragons Esports,Fraggerz,13,8,7,5,3,6,"Raze,Killjoy,Viper,Omen,Fade","Raze,Killjoy,Omen,Skye,Gekko"
Ascent,NXT,Apeks,8,13,6,6,7,2,"Cypher,Sova,Omen,Jett,KAY/O","Sova,Killjoy,Omen,Jett,KAY/O"
Bind,NASR Ignite,FOKUS Sakura,13,7,5,3,4,8,"Raze,Viper,Omen,Skye,Gekko","Raze,Viper,Omen,Skye,Chamber"
Ascent,HGE Esports,LONETEAM,13,4,8,4,0,5,"Sova,Killjoy,Omen,Jett,KAY/O","Sova,Killjoy,Omen,Jett,KAY/O"
Bind,R8 Blues,Twisted Minds Orchid,13,8,7,2,6,6,"Viper,Phoenix,Sage,Skye,Clove","Raze,Viper,Brimstone,KAY/O,Gekko"
Split,FOG Vortex,Dark Nebula,6,13,2,5,8,4,"Breach,Raze,Cypher,Omen,Jett","Raze,Cypher,Reyna,Skye,Clove"
Sunset,Unity Esports,Team Falcons,14,12,8,5,7,6,"Breach,Raze,Cypher,Omen,Fade","Breach,Raze,Cypher,Omen,Fade"
Bind,The Ultimates,Twisted Minds Esports,15,13,9,5,8,6,"Raze,Viper,Omen,KAY/O,Gekko","Raze,Brimstone,Reyna,Skye,Harbor"
Split,VX300 Gaming,Outplayed,10,13,5,7,6,5,"Breach,Raze,Cypher,Omen,Fade","Raze,Cypher,Viper,Omen,Skye"
Sunset,Valiant GC,BBL Queens,8,13,2,10,3,6,"Breach,Raze,Cypher,Omen,Jett","Breach,Raze,Sage,Omen,Gekko"
Breeze,Apinaorkesteri,Metizport,14,12,9,4,8,5,"Cypher,Sova,Viper,Yoru,Astra","Cypher,Sova,Viper,Jett,Yoru"
Lotus,Valiant GC,BBL Queens,2,13,2,10,3,0,"Breach,Raze,Cypher,Sova,Omen","Raze,Viper,Omen,Chamber,Fade"
Lotus,aNc Outplayed GC,EKO Esports GC,13,5,5,1,4,8,"Breach,Raze,Killjoy,Omen,Gekko","Breach,Raze,Killjoy,Omen,Fade"
Sunset,Apinaorkesteri,Metizport,13,11,8,4,7,5,"Raze,Cypher,Sova,Omen,KAY/O","Breach,Raze,Cypher,Omen,Gekko"
Icebox,aNc Outplayed GC,EKO Esports GC,13,7,8,4,3,5,"Sova,Killjoy,Viper,Yoru,Gekko","Sova,Killjoy,Viper,Sage,Jett"
Icebox,QoR,DarkZero Esports,12,14,5,8,6,7,"Sova,Killjoy,Viper,Jett,Harbor","Killjoy,Viper,Jett,KAY/O,Gekko"
Bind,QoR,DarkZero Esports,3,13,2,2,11,1,"Raze,Viper,Brimstone,Skye,Deadlock","Raze,Brimstone,Sage,Fade,Gekko"
Icebox,TBK Esports,SAGAZ,13,4,8,4,0,5,"Sova,Killjoy,Viper,Sage,Jett","Sova,Killjoy,Viper,Sage,Jett"
Breeze,TBK Esports,SAGAZ,13,1,11,1,0,2,"Cypher,Sova,Viper,Jett,Yoru","Cypher,Sova,Viper,Jett,KAY/O"
Sunset,QoR,DarkZero Esports,13,2,10,2,0,3,"Breach,Raze,Cypher,Omen,Gekko","Breach,Raze,Cypher,Omen,Gekko"
Sunset,TBK Esports,SAGAZ,8,13,6,6,7,2,"Breach,Raze,Cypher,Omen,Gekko","Breach,Raze,Cypher,Omen,Gekko"
Split,Blinn Esports,TSM,10,13,2,9,4,8,"Raze,Cypher,Viper,Omen,Skye","Raze,Cypher,Viper,Omen,Skye"
Breeze,Blinn Esports,TSM,13,5,11,1,4,2,"Cypher,Sova,Viper,Jett,Yoru","Sova,Viper,Jett,Yoru,Astra"
Icebox,The Ultimates,Twisted Minds Esports,8,13,6,6,7,2,"Killjoy,Viper,Jett,KAY/O,Gekko","Sova,Killjoy,Viper,Jett,KAY/O"
Bind,Exceptional Gaming,GJ Omen,13,11,7,5,6,6,"Raze,Viper,Brimstone,Skye,Fade","Raze,Cypher,Brimstone,Reyna,Gekko"
Sunset,AKA HERO,INF Esports,6,13,5,2,11,1,"Breach,Omen,Jett,Chamber,Gekko","Breach,Raze,Cypher,Sova,Omen"
Breeze,Reveal Multigaming,LA RUE,7,13,6,6,7,1,"Cypher,Sova,Viper,Jett,Clove","Cypher,Sova,Viper,Jett,Yoru"
Ascent,RED Canids,Stellae Gaming,17,15,8,8,7,9,"Sova,Killjoy,Omen,Jett,KAY/O","Sova,Killjoy,Omen,Jett,KAY/O"
Ascent,Exceptional Gaming,GJ Omen,10,13,4,7,6,6,"Sova,Killjoy,Omen,Jett,KAY/O","Sova,Killjoy,Omen,Jett,KAY/O"
Ascent,KRÜ BLAZE,FiRePOWER GC,13,5,9,3,2,4,"Sova,Killjoy,Omen,Jett,KAY/O","Cypher,Sova,Omen,Jett,KAY/O"
Ascent,The Ultimates,Twisted Minds Esports,13,8,9,3,5,4,"Sova,Killjoy,Omen,Jett,KAY/O","Sova,Killjoy,Omen,Jett,KAY/O"
Sunset,Dortmund Esports,UCAN ESPORTS,14,12,6,7,5,8,"Breach,Raze,Cypher,Omen,Gekko","Raze,Cypher,Omen,Skye,Gekko"
Bind,BÖSE BUBEN,A One Man Army,13,9,5,5,4,8,"Raze,Viper,Brimstone,Yoru,Gekko","Breach,Yoru,Astra,Neon,Fade"
Sunset,Sissi State Punks,QUE PASA,13,7,2,6,1,11,"Breach,Raze,Cypher,Sova,Omen","Breach,Cypher,Omen,Jett,Yoru"
Lotus,toxic GC,XProjekt Lioness,6,13,2,5,8,4,"Breach,Raze,Killjoy,Omen,Fade","Breach,Raze,Killjoy,Gekko,Clove"
Ascent,AKA HERO,INF Esports,10,13,5,6,7,5,"Cypher,Sova,Killjoy,Omen,Jett","Breach,Viper,Brimstone,Sage,Neon"
Bind,Reveal Multigaming,LA RUE,12,14,5,8,6,7,"Raze,Cypher,Brimstone,Skye,Gekko","Raze,Viper,Brimstone,Skye,Yoru"
Ascent,Team Occupy Feminine Fusion,CSH White,13,7,7,5,2,6,"Sova,Killjoy,Reyna,Omen,Jett","Breach,Raze,Sova,Killjoy,Omen"
Split,Gamax Lite,FATE Flare,13,0,1,0,0,12,"Breach,Raze,Cypher,Omen,Skye","Breach,Raze,Cypher,Omen,Skye"
Lotus,POTATO ABUSERS,Reveal Multigaming Saphire,13,7,7,1,6,6,"Raze,Killjoy,Viper,Omen,Fade","Raze,Viper,Omen,Chamber,Gekko"
Lotus,Exceptional Gaming,GJ Omen,13,4,8,4,0,5,"Raze,Killjoy,Viper,Omen,Fade","Raze,Killjoy,Viper,Omen,Fade"
Bind,Blinn Esports,TSM,9,13,2,8,5,7,"Raze,Viper,Brimstone,KAY/O,Gekko","Raze,Viper,Brimstone,Skye,Gekko"
Icebox,KRÜ BLAZE,FiRePOWER GC,13,4,12,0,4,1,"Sova,Killjoy,Viper,Jett,Harbor","Killjoy,Viper,Sage,Jett,KAY/O"
Bind,RED Canids,Stellae Gaming,13,3,4,0,3,9,"Raze,Cypher,Viper,Brimstone,Skye","Raze,Viper,Brimstone,Skye,KAY/O"
Bind,Entry Frogs Iris,NOVO GC,8,13,2,10,3,6,"Raze,Cypher,Viper,Brimstone,Skye","Raze,Viper,Brimstone,Skye,Gekko"
Icebox,RIZON,Novita Esports,4,13,3,2,11,1,"Sova,Killjoy,Viper,Reyna,Jett","Killjoy,Viper,Reyna,Jett,Gekko"
Bind,TwentyStars,DSYRE Academy,6,13,1,6,7,5,"Breach,Raze,Omen,Skye,Chamber","Raze,Brimstone,Skye,Yoru,Gekko"
Ascent,The giornalisti,GMBLERS Esports,13,6,5,2,4,8,"Cypher,Sova,Omen,Jett,KAY/O","Sova,Killjoy,Omen,Jett,KAY/O"
Icebox,Sissi State Punks,QUE PASA,13,4,5,0,4,8,"Sova,Killjoy,Viper,Reyna,Jett","Sova,Killjoy,Viper,Reyna,Jett"
Lotus,BÖSE BUBEN,A One Man Army,13,1,11,1,0,2,"Breach,Raze,Cypher,Omen,Gekko","Raze,Killjoy,Brimstone,Omen,KAY/O"
Lotus,Dortmund Esports,UCAN ESPORTS,13,6,8,4,2,5,"Raze,Omen,Yoru,Gekko,Deadlock","Breach,Raze,Cypher,Omen,Gekko"
Split,6TM ESPORTS,TeamOrangeGaming,3,13,0,4,9,3,"Breach,Raze,Cypher,Sova,Omen","Raze,Cypher,Sage,Skye,Clove"
Lotus,The Vicious,Vision Esports,13,10,8,3,7,5,"Raze,Killjoy,Omen,Jett,Skye","Breach,Killjoy,Omen,Jett,Fade"
Bind,POTATO ABUSERS,Reveal Multigaming Saphire,13,4,9,3,1,4,"Raze,Viper,Brimstone,Skye,Gekko","Raze,Viper,Brimstone,Chamber,Gekko"
Sunset,Underground Gaming,Onyx Ravens,13,9,6,4,5,7,"Breach,Raze,Cypher,Omen,Fade","Breach,Raze,Cypher,Omen,Fade"
Icebox,AKA HERO,INF Esports,13,9,5,5,4,8,"Sova,Killjoy,Viper,Jett,Gekko","Sova,Killjoy,Viper,Reyna,Omen"
Split,FATE Flare,toxic GC,4,13,2,3,10,2,"Breach,Raze,Cypher,Omen,Skye","Breach,Raze,Cypher,Omen,Skye"
Bind,RIZON,Novita Esports,5,13,2,10,3,3,"Raze,Cypher,Brimstone,Skye,Gekko","Raze,Viper,Brimstone,Yoru,Gekko"
Breeze,XProjekt Lioness,GnG White,6,13,3,4,9,3,"Cypher,Sova,Jett,Harbor,Gekko","Cypher,Sova,Viper,Jett,Yoru"
Lotus,Entry Frogs Iris,NOVO GC,3,13,3,9,4,0,"Breach,Raze,Killjoy,Omen,Fade","Breach,Sova,Killjoy,Omen,Neon"
Bind,GJ Omen,LA RUE,13,9,7,3,6,6,"Raze,Cypher,Brimstone,Reyna,Gekko","Raze,Cypher,Viper,Brimstone,Skye"
Ascent,6TM ESPORTS,TeamOrangeGaming,1,13,1,11,2,0,"Cypher,Sova,Omen,Jett,KAY/O","Sova,Killjoy,Jett,KAY/O,Clove"
Ascent,CSH White,Gamax Lite,5,13,2,4,9,3,"Breach,Raze,Sova,Killjoy,Omen","Sova,Killjoy,Omen,Jett,KAY/O"
Split,KRÜ BLAZE,FiRePOWER GC,13,7,4,4,3,9,"Raze,Viper,Omen,Skye,Astra","Raze,Viper,Omen,Jett,Skye"
Lotus,Formulation Gaming,SweetNsour,7,13,2,6,7,5,"Breach,Raze,Cypher,Omen,Fade","Raze,Killjoy,Viper,Omen,Fade"
Ascent,Sissi State Punks Academy,BÖSE BUBEN,7,13,2,6,7,5,"Sova,Killjoy,Omen,Jett,KAY/O","Sova,Killjoy,Omen,Jett,KAY/O"
Sunset,The giornalisti,GMBLERS Esports,11,13,6,6,7,5,"Breach,Raze,Cypher,Sova,Omen","Breach,Raze,Cypher,Omen,Gekko"
Sunset,TwentyStars,DSYRE Academy,13,11,5,7,4,8,"Breach,Raze,Cypher,Omen,Gekko","Raze,Cypher,Omen,KAY/O,Gekko"
Ascent,Underground Gaming,Onyx Ravens,10,13,4,7,6,6,"Sova,Killjoy,Omen,Jett,KAY/O","Sova,Killjoy,Phoenix,Jett,Clove"
Icebox,The Vicious,Vision Esports,13,8,10,2,6,3,"Sova,Killjoy,Viper,Sage,Jett","Sova,Killjoy,Viper,Sage,Jett"
Ascent,EXO Clan,REY eSports,13,10,8,3,7,5,"Breach,Phoenix,Omen,KAY/O,Deadlock","Sova,Killjoy,Omen,Jett,KAY/O"
Lotus,Twisted Minds Orchid,The Ultimates Odyssey,7,13,4,4,9,3,"Breach,Raze,Cypher,Omen,Fade","Breach,Cypher,Sova,Omen,Neon"
Bind,INF Esports,Exceptional Gaming,13,7,5,3,4,8,"Breach,Raze,Cypher,Brimstone,Gekko","Raze,Viper,Brimstone,Skye,Gekko"
Lotus,Jabba Enjoyers,CTRL x YARI Esports,13,8,5,4,4,8,"Breach,Raze,Killjoy,Omen,Fade","Breach,Raze,Killjoy,Omen,Fade"
Breeze,Dark Nebula,R8 Blues,5,13,3,9,4,2,"Cypher,Sova,Viper,Reyna,Jett","Sova,Viper,Phoenix,KAY/O,Chamber"
Ascent,GJ Omen,LA RUE,13,5,3,3,2,10,"Sova,Killjoy,Omen,Jett,KAY/O","Sova,Killjoy,Omen,Jett,KAY/O"
Split,DSQ Esports,Thin Fecking Ice,13,10,3,9,1,10,"Raze,Cypher,Viper,Omen,Skye","Breach,Raze,Cypher,Omen,Skye"
Lotus,Sissi State Punks,Lootcifer,12,14,8,5,9,4,"Breach,Raze,Sova,Killjoy,Omen","Breach,Raze,Cypher,Phoenix,Omen"
Lotus,Reveal Multigaming,RIZON,13,4,9,3,1,4,"Breach,Cypher,Sova,Omen,Neon","Breach,Raze,Killjoy,Omen,Gekko"
Sunset,NO Enemies,Unlucky boys,13,9,6,6,3,7,"Breach,Raze,Cypher,Omen,Gekko","Breach,Raze,Cypher,Omen,Gekko"
Lotus,Team Prolific,Elysian Esports,5,13,3,3,10,2,"Breach,Raze,Killjoy,Omen,Fade","Raze,Killjoy,Viper,Omen,Fade"
Lotus,Sissi State Punks Academy,BÖSE BUBEN,13,10,7,5,5,6,"Breach,Killjoy,Omen,Neon,Gekko","Breach,Raze,Cypher,Omen,Gekko"
Ascent,Formulation Gaming,SweetNsour,7,13,3,9,4,4,"Cypher,Sova,Omen,Jett,KAY/O","Sova,Killjoy,Omen,Jett,KAY/O"
Bind,Dortmund Esports,MAJOR MONOGWAM,13,8,7,2,6,6,"Viper,Omen,Yoru,Gekko,Deadlock","Raze,Cypher,Brimstone,Skye,Gekko"
Lotus,POTATO ABUSERS,A One Man Army,6,13,2,10,3,4,"Breach,Omen,Jett,Chamber,Neon","Raze,Killjoy,Brimstone,Omen,KAY/O"
Sunset,Fishing Rods,90 Seconds,13,11,5,7,4,8,"Raze,Cypher,Omen,Gekko,Clove","Raze,Cypher,Omen,KAY/O,Gekko"
Lotus,TeamOrangeGaming,QUE PASA,13,3,3,1,2,10,"Breach,Raze,Cypher,Omen,Gekko","Raze,Killjoy,Viper,Omen,Fade"
Ascent,LXT Esports GC,TwentyStars GC,13,6,8,4,2,5,"Sova,Killjoy,Omen,Jett,KAY/O","Sova,Killjoy,Phoenix,Omen,Jett"
Ascent,UCAN ESPORTS,6TM ESPORTS,10,13,5,6,7,5,"Cypher,Sova,Jett,Astra,KAY/O","Cypher,Sova,Omen,Jett,KAY/O"
Sunset,RevenantVAL,HUNTERS,13,6,6,1,5,7,"Breach,Raze,Cypher,Omen,Gekko","Breach,Raze,Cypher,Omen,KAY/O"
Icebox,AKA HERO,Novita Esports,8,13,5,4,9,3,"Sova,Killjoy,Viper,Jett,Gekko","Killjoy,Viper,Reyna,Jett,Gekko"
Bind,REY ACADEMY,Project 1,1,13,1,11,2,0,"Raze,Cypher,Brimstone,Skye,Yoru","Raze,Viper,Brimstone,Skye,Gekko"
Lotus,BBL Queens,Odd 1 OUT,13,7,8,4,3,5,"Raze,Viper,Omen,Chamber,Fade","Breach,Raze,Cypher,Sova,Astra"
Lotus,Underground Gaming,Onyx Ravens,13,9,6,6,3,7,"Breach,Raze,Killjoy,Omen,Gekko","Breach,Raze,Cypher,Viper,Clove"
Ascent,Reveal Multigaming Saphire,Munich Esports,13,5,4,2,3,9,"Sova,Killjoy,Omen,Jett,KAY/O","Sova,Killjoy,Omen,Jett,KAY/O"
Lotus,EXO Clan,REY eSports,13,8,5,4,4,8,"Raze,Killjoy,Viper,Omen,Fade","Breach,Raze,Sova,Killjoy,Omen"
Ascent,The Vicious,Vision Esports,10,13,5,6,7,5,"Sova,Killjoy,Jett,Astra,KAY/O","Sova,Killjoy,Omen,Jett,KAY/O"
Sunset,TeamOrangeGaming,QUE PASA,13,6,5,2,4,8,"Breach,Raze,Cypher,Sova,Omen","Breach,Cypher,Omen,Jett,Yoru"
Ascent,Jabba Enjoyers,CTRL x YARI Esports,14,12,6,7,5,8,"Sova,Killjoy,Omen,Jett,KAY/O","Sova,Killjoy,Omen,Jett,KAY/O"
Lotus,Dortmund Esports,MAJOR MONOGWAM,13,6,6,1,5,7,"Raze,Omen,Yoru,Gekko,Deadlock","Breach,Raze,Killjoy,Omen,Gekko"
Sunset,Sissi State Punks,Lootcifer,6,13,5,7,6,1,"Breach,Cypher,Sova,Omen,Jett","Cypher,Omen,Chamber,Fade,Clove"
Sunset,INF Esports,Exceptional Gaming,13,10,5,7,3,8,"Breach,Raze,Cypher,Sova,Omen","Breach,Raze,Cypher,Omen,Fade"
Ascent,Reveal Multigaming,RIZON,13,10,5,7,3,8,"Cypher,Sova,Killjoy,Omen,Jett","Sova,Killjoy,Phoenix,Omen,Jett"
Lotus,GJ Omen,LA RUE,11,13,4,8,5,7,"Raze,Killjoy,Viper,Omen,Fade","Raze,Killjoy,Viper,Omen,Fade"
Lotus,UCAN ESPORTS,6TM ESPORTS,5,13,3,3,10,2,"Breach,Raze,Cypher,Omen,Gekko","Breach,Raze,Cypher,Sova,Omen"
Bind,Reveal Multigaming Saphire,Munich Esports,13,3,4,0,3,9,"Raze,Viper,Brimstone,Chamber,Gekko","Raze,Viper,Brimstone,Skye,Gekko"
Lotus,RevenantVAL,HUNTERS,13,3,4,0,3,9,"Breach,Raze,Killjoy,Omen,Fade","Breach,Raze,Cypher,Omen,Fade"
Lotus,LXT Esports GC,TwentyStars GC,13,4,11,1,3,2,"Raze,Killjoy,Viper,Omen,Fade","Breach,Raze,Killjoy,Omen,Jett"
Lotus,REY ACADEMY,Project 1,6,13,3,9,4,3,"Raze,Viper,Omen,Chamber,Gekko","Raze,Killjoy,Viper,Omen,Fade"
Split,R8 Blues,FOG Vortex,13,7,5,3,4,8,"Raze,Killjoy,Viper,Omen,Skye","Breach,Raze,Cypher,Omen,Jett"
Ascent,NO Enemies,Unlucky boys,11,13,6,6,7,5,"Sova,Killjoy,Phoenix,Omen,Jett","Sova,Killjoy,Omen,Jett,KAY/O"
Bind,DSQ Esports,Thin Fecking Ice,15,13,9,5,8,6,"Raze,Viper,Brimstone,Skye,Gekko","Breach,Raze,Viper,Brimstone,Yoru"
Bind,POTATO ABUSERS,A One Man Army,7,13,2,6,7,5,"Raze,Viper,Brimstone,Skye,Gekko","Breach,Yoru,Astra,Neon,Fade"
Ascent,Team Prolific,Elysian Esports,8,13,3,6,7,5,"Breach,Viper,Phoenix,Omen,KAY/O","Sova,Killjoy,Omen,Jett,KAY/O"
Icebox,Fishing Rods,90 Seconds,10,13,7,4,9,3,"Sova,Killjoy,Viper,Reyna,Jett","Sova,Killjoy,Viper,Sage,Jett"
Ascent,AKA HERO,Novita Esports,3,13,3,9,4,0,"Cypher,Sova,Omen,Jett,KAY/O","Sova,Killjoy,Omen,Jett,KAY/O"
Lotus,The Ultimates Odyssey,Dark Nebula,13,5,8,4,1,5,"Breach,Cypher,Sova,Omen,Neon","Breach,Raze,Omen,Chamber,Gekko"
Icebox,Sissi State Punks Academy,BÖSE BUBEN,11,13,7,5,8,4,"Sova,Killjoy,Viper,Sage,Jett","Sova,Killjoy,Viper,Jett,Clove"
Breeze,BBL Queens,Odd 1 OUT,13,8,4,5,3,9,"Cypher,Sova,Viper,Jett,Skye","Cypher,Sova,Jett,KAY/O,Harbor"
Ascent,GIANTX GC,Karmine Corp GC,13,8,7,5,3,6,"Sova,Killjoy,Omen,Jett,KAY/O","Sova,Killjoy,Omen,Jett,KAY/O"
Icebox,Requiem,OnlyFins,13,6,7,0,6,6,"Killjoy,Viper,Jett,KAY/O,Gekko","Killjoy,Viper,Jett,KAY/O,Gekko"
Sunset,GIANTX GC,Karmine Corp GC,13,5,9,3,2,4,"Breach,Raze,Cypher,Omen,Gekko","Breach,Raze,Cypher,Omen,Gekko"
Ascent,Moist x Shopify,Dough Bros,13,11,7,5,6,6,"Cypher,Sova,Omen,Jett,Deadlock","Sova,Killjoy,Omen,Jett,KAY/O"
Icebox,Galorys,2Game Esports,13,11,8,4,7,5,"Sova,Killjoy,Viper,Sage,Jett","Sova,Killjoy,Viper,Omen,Gekko"
Breeze,Moist x Shopify,Dough Bros,13,2,12,0,2,1,"Cypher,Sova,Viper,Jett,KAY/O","Sova,Viper,Jett,Yoru,Astra"
Lotus,Moist x Shopify,Dough Bros,4,13,3,9,4,1,"Breach,Raze,Cypher,Brimstone,Gekko","Raze,Omen,Fade,Deadlock,Clove"
Ascent,Hero Base,Legacy,13,11,6,6,5,7,"Breach,Viper,Omen,Jett,KAY/O","Sova,Killjoy,Omen,Jett,KAY/O"
Breeze,Galorys,2Game Esports,13,10,8,4,6,5,"Cypher,Sova,Viper,Jett,KAY/O","Sova,Viper,Jett,Yoru,Astra"
Split,Onyx Ravens,Vision Esports,13,3,4,0,3,9,"Breach,Raze,Cypher,Sage,Omen","Breach,Raze,Cypher,Omen,Jett"
Sunset,Hero Base,Legacy,11,13,4,8,5,7,"Breach,Raze,Viper,Omen,KAY/O","Breach,Raze,Cypher,Omen,Gekko"
Ascent,YFP Gaming,SaD Esports,13,6,7,5,1,6,"Cypher,Sova,Omen,Jett,Deadlock","Sova,Killjoy,Omen,Jett,KAY/O"
Breeze,New Origins Esports,Division 7,6,13,0,7,6,6,"Cypher,Sova,Viper,Jett,KAY/O","Cypher,Sova,Viper,Jett,Yoru"
Split,XLD Gaming,The7,9,13,5,7,6,4,"Raze,Viper,Omen,Jett,Skye","Raze,Viper,Omen,Jett,Skye"
Icebox,Onyx Ravens,Vision Esports,7,13,5,3,10,2,"Sova,Killjoy,Viper,Sage,Jett","Sova,Killjoy,Viper,Sage,Jett"
Lotus,GMBLERS Esports,RevenantVAL,8,13,2,7,6,6,"Breach,Raze,Killjoy,Omen,Gekko","Breach,Raze,Killjoy,Omen,Fade"
Sunset,Unlucky boys,TwentyStars,9,13,4,8,5,5,"Breach,Raze,Cypher,Omen,Gekko","Breach,Raze,Cypher,Omen,Gekko"
Lotus,90 Seconds,The giornalisti,12,14,7,6,8,5,"Raze,Killjoy,Viper,Omen,Fade","Breach,Raze,Killjoy,Omen,Gekko"
Breeze,Permitta Unicorns GC,EMUs,3,13,1,3,10,2,"Cypher,Sova,Viper,Reyna,Jett","Sova,Viper,Jett,Yoru,Astra"
Icebox,XLD Gaming,The7,7,13,3,5,8,4,"Sova,Killjoy,Viper,Sage,Jett","Killjoy,Viper,Jett,KAY/O,Gekko"
Sunset,YFP Gaming,SaD Esports,14,12,8,5,7,6,"Breach,Raze,Cypher,Omen,Gekko","Breach,Raze,Cypher,Sova,Omen"
Lotus,Hero Base,Legacy,14,12,10,3,9,4,"Killjoy,Viper,Omen,Neon,Gekko","Raze,Killjoy,Omen,Astra,Fade"
Ascent,HUNTERS,NO Enemies,9,13,2,8,5,7,"Sova,Killjoy,Omen,Jett,KAY/O","Sova,Killjoy,Phoenix,Omen,Jett"
Breeze,DSYRE Academy,Fishing Rods,13,9,6,6,3,7,"Cypher,Sova,Viper,Jett,Yoru","Cypher,Sova,Viper,Reyna,Jett"
Sunset,Onyx Ravens,Vision Esports,15,13,11,3,10,4,"Breach,Raze,Cypher,Omen,Fade","Breach,Raze,Cypher,Omen,Fade"
Split,DSYRE Academy,Fishing Rods,13,5,9,3,2,4,"Raze,Cypher,Sage,Omen,Jett","Raze,Viper,Reyna,Omen,Skye"
Lotus,HUNTERS,NO Enemies,4,13,1,4,9,3,"Breach,Raze,Cypher,Omen,Fade","Breach,Raze,Cypher,Omen,Fade"
Ascent,Unlucky boys,TwentyStars,12,14,7,6,8,5,"Sova,Killjoy,Omen,Jett,KAY/O","Sova,Killjoy,Omen,Jett,KAY/O"
Ascent,GMBLERS Esports,RevenantVAL,19,17,9,9,8,10,"Sova,Killjoy,Omen,Jett,KAY/O","Sova,Killjoy,Omen,Jett,KAY/O"
Sunset,90 Seconds,The giornalisti,6,13,5,7,6,1,"Raze,Cypher,Omen,KAY/O,Gekko","Breach,Raze,Cypher,Sova,Omen"
Split,Coalesce,Free Orbs,7,13,6,6,7,1,"Raze,Viper,Omen,Jett,Skye","Breach,Raze,Cypher,Omen,Skye"
Lotus,Permitta Unicorns GC,EMUs,12,14,8,5,9,4,"Breach,Raze,Killjoy,Omen,Gekko","Raze,Killjoy,Omen,Fade,Gekko"
Icebox,G3 Esports,The Vicious,10,13,8,3,10,2,"Sova,Killjoy,Viper,Sage,Jett","Sova,Killjoy,Viper,Sage,Jett"
Lotus,Twisted Minds Esports,Underground Gaming,10,13,5,7,6,5,"Raze,Killjoy,Viper,Omen,Gekko","Breach,Raze,Killjoy,Gekko,Clove"
Split,KR Esports,The Ultimates,7,13,4,4,9,3,"Raze,Sage,Omen,Jett,Skye","Raze,Viper,Omen,Jett,Skye"
Ascent,G3 Esports,The Vicious,13,11,5,7,4,8,"Cypher,Sova,Jett,KAY/O,Clove","Sova,Killjoy,Jett,Astra,KAY/O"
Ascent,Coalesce,Free Orbs,13,10,9,3,7,4,"Cypher,Sova,Phoenix,Omen,Jett","Viper,Omen,Jett,Skye,KAY/O"
Lotus,RIZON Sugar,ALTERNATE aTTaX Ruby,3,13,1,3,10,2,"Breach,Raze,Killjoy,Omen,Deadlock","Breach,Raze,Cypher,Omen,Fade"
Bind,FOKUS Sakura,SK Nebula,13,4,11,1,3,2,"Raze,Viper,Omen,Skye,Chamber","Breach,Cypher,Yoru,Astra,Gekko"
Bind,Playbay X VISION SYNC,TOG Kitsune,3,13,2,10,3,1,"Raze,Cypher,Brimstone,Skye,Gekko","Breach,Raze,Cypher,Brimstone,Gekko"
Split,RYL | Royal Legion,CTRL x YARI Esports,10,13,4,7,6,6,"Raze,Viper,Omen,Skye,Chamber","Breach,Raze,Cypher,Omen,Skye"
Lotus,Vanir,Twisted Saints Esports,13,9,6,4,5,7,"Breach,Raze,Cypher,Harbor,Deadlock","Breach,Sova,Omen,Yoru,Neon"
Ascent,KR Esports,The Ultimates,3,13,1,11,2,2,"Sova,Killjoy,Reyna,Omen,Jett","Sova,Killjoy,Omen,Jett,KAY/O"
Ascent,Twisted Minds Esports,Underground Gaming,4,13,1,11,2,3,"Cypher,Sova,Phoenix,Omen,Jett","Sova,Killjoy,Omen,Jett,KAY/O"
Lotus,G3 Esports,The Vicious,8,13,5,7,6,3,"Raze,Jett,Gekko,Deadlock,Clove","Raze,Killjoy,Omen,Jett,Skye"
Lotus,Coalesce,Free Orbs,6,13,3,4,9,3,"Raze,Cypher,Omen,Jett,Skye","Breach,Killjoy,Omen,Neon,Fade"
Sunset,RIZON Sugar,ALTERNATE aTTaX Ruby,4,13,2,3,10,2,"Breach,Raze,Cypher,Sova,Omen","Breach,Raze,Cypher,Sova,Omen"
Split,Playbay X VISION SYNC,TOG Kitsune,1,13,0,2,11,1,"Breach,Raze,Cypher,Viper,Omen","Breach,Cypher,Sage,Omen,Yoru"
Sunset,FOKUS Sakura,SK Nebula,13,6,10,2,4,3,"Raze,Cypher,Omen,Yoru,Gekko","Breach,Raze,Cypher,Omen,Fade"
Ascent,Vanir,Twisted Saints Esports,13,5,4,2,3,9,"Cypher,Sova,Omen,Jett,Deadlock","Raze,Viper,Reyna,Skye,Harbor"
Lotus,RYL | Royal Legion,CTRL x YARI Esports,3,13,0,4,9,3,"Raze,Viper,Omen,Chamber,Fade","Breach,Raze,Killjoy,Omen,Fade"
Lotus,Rejects (NA),ST x WTP,13,10,7,4,6,6,"Raze,Killjoy,Omen,Chamber,Gekko","Raze,Killjoy,Omen,Fade,Gekko"
Ascent,RUN IT BACK,Luminescent Sapphire,4,13,2,10,3,2,"Sova,Killjoy,Omen,Jett,Clove","Cypher,Sova,Omen,Jett,KAY/O"
Ascent,ST x WTP,Koala Pound,13,10,5,6,4,8,"Sova,Killjoy,Omen,Jett,KAY/O","Cypher,Sova,Omen,KAY/O,Neon"
Icebox,Reven eClub,FUSION,13,11,6,6,5,7,"Killjoy,Viper,Jett,KAY/O,Gekko","Sova,Killjoy,Viper,Jett,Harbor"
Bind,Rejects (NA),Utica Blue,13,11,6,6,5,7,"Raze,Skye,Gekko,Deadlock,Clove","Raze,Cypher,Viper,Brimstone,Skye"
Ascent,FLUFFY AIMERS,Winthrop University,12,14,5,8,6,7,"Sova,Killjoy,Omen,Jett,KAY/O","Sova,Killjoy,Omen,Jett,KAY/O"
Icebox,RUN IT BACK,Volcano Gang,13,6,5,2,4,8,"Sova,Killjoy,Jett,Harbor,Gekko","Sova,Killjoy,Viper,Jett,Harbor"
Lotus,Luminescent Sapphire,OPPY,13,8,9,3,5,4,"Raze,Cypher,Viper,Omen,Fade","Raze,Killjoy,Viper,Omen,Gekko"
Lotus,Koala Pound,Sky Esports (NA),13,10,8,4,6,5,"Breach,Raze,Cypher,Omen,Gekko","Raze,Cypher,Omen,Jett,Gekko"
Icebox,VZN E-SPORTS,ST x WTP,9,13,4,6,7,5,"Sova,Killjoy,Viper,Jett,Gekko","Sova,Viper,Sage,Reyna,Jett"
Icebox,RED Canids,The7,13,3,2,2,1,11,"Sova,Killjoy,Viper,Sage,Jett","Killjoy,Viper,Jett,KAY/O,Gekko"
Lotus,Utica Blue,Wired Esports,13,7,8,0,7,5,"Raze,Cypher,Viper,Omen,Gekko","Raze,Cypher,Viper,Omen,Gekko"
Lotus,Reven eClub,FUSION,13,5,6,0,5,7,"Breach,Raze,Cypher,Omen,Gekko","Breach,Cypher,Sova,Omen,Jett"
Icebox,Something Funny,RUN IT BACK,6,13,4,8,5,2,"Sova,Killjoy,Viper,Sage,Jett","Sova,Killjoy,Jett,Harbor,Gekko"
Sunset,FLUFFY AIMERS,Winthrop University,10,13,5,6,7,5,"Breach,Raze,Cypher,Omen,Skye","Breach,Raze,Cypher,Omen,Fade"
Ascent,FART GAMING,OPPY,7,13,5,3,10,2,"Raze,Sova,Jett,Astra,Deadlock","Sova,Killjoy,Omen,Jett,KAY/O"
Bind,Volcano Gang,Omnipotence,13,2,3,0,2,10,"Raze,Cypher,Viper,Brimstone,Skye","Raze,Cypher,Brimstone,Skye,Gekko"
Bind,Jeepney Juggernauts,Luminescent Sapphire,6,13,4,3,10,2,"Raze,Brimstone,Reyna,Skye,Harbor","Raze,Viper,Brimstone,Skye,Gekko"
Lotus,ASTANE GC,Koala Pound,2,13,2,10,3,0,"Raze,Cypher,Omen,Gekko,Deadlock","Breach,Raze,Cypher,Omen,Gekko"
Bind,Ice Fishers,Sky Esports (NA),7,13,3,9,4,4,"Raze,Viper,Brimstone,Skye,Gekko","Raze,Cypher,Brimstone,Jett,Skye"
Lotus,RED Canids,The7,13,4,5,0,4,8,"Raze,Killjoy,Viper,Omen,Skye","Breach,Raze,Omen,Jett,Skye"
Ascent,VZN E-SPORTS,Backpack Bros,13,11,9,3,8,4,"Sova,Killjoy,Omen,Jett,KAY/O","Sova,Killjoy,Omen,Jett,KAY/O"
Lotus,Utica Blue,Shirtless Gamers,13,11,10,2,9,3,"Raze,Cypher,Viper,Omen,Gekko","Raze,Killjoy,Viper,Omen,Gekko"
Lotus,Something Funny,nf,13,8,10,2,6,3,"Breach,Raze,Cypher,Omen,Fade","Breach,Raze,Killjoy,Omen,Gekko"
Icebox,ST x WTP,U4RIA Radiata,13,5,7,5,0,6,"Sova,Viper,Reyna,Jett,Deadlock","Sova,Killjoy,Viper,Sage,Jett"
Sunset,Six Karma,Illicit Gaming,2,13,0,3,10,2,"Breach,Raze,Cypher,Omen,Fade","Breach,Raze,Cypher,Omen,Gekko"
Sunset,Rejects (NA),BALLZ V3.0,14,12,8,5,7,6,"Breach,Raze,Cypher,Gekko,Clove","Raze,Cypher,Sova,Omen,Gekko"
Ascent,FART GAMING,Eclipse Gaming,13,7,4,4,3,9,"Sova,Killjoy,Phoenix,Jett,Astra","Sova,Killjoy,Omen,Jett,KAY/O"
Ascent,RUN IT BACK,Hyperion Gold,13,11,4,8,3,9,"Sova,Killjoy,Omen,Jett,Clove","Sova,Killjoy,Omen,Jett,KAY/O"
Bind,Venatus,Omnipotence,3,13,2,10,3,1,"Raze,Viper,Brimstone,Skye,Gekko","Raze,Cypher,Brimstone,Skye,Gekko"
Lotus,Luminescent Sapphire,FUNG,13,1,12,0,1,1,"Raze,Cypher,Viper,Omen,Fade","Raze,Killjoy,Viper,Omen,Fade"
Lotus,Fallen Angels Dynasty,Wired Esports,9,13,8,4,9,1,"Breach,Raze,Killjoy,Omen,Gekko","Raze,Cypher,Viper,Omen,Gekko"
Lotus,FLUFFY AIMERS,Winthrop University,13,11,4,8,3,9,"Breach,Raze,Cypher,Omen,Fade","Breach,Raze,Cypher,Omen,Fade"
Icebox,Holy Smokes,Volcano Gang,2,13,2,10,3,0,"Sage,Omen,Yoru,Harbor,Gekko","Sova,Killjoy,Viper,Jett,Harbor"
Lotus,Backpack Bros,Luminous Shadow,13,4,4,1,3,9,"Raze,Viper,Omen,Chamber,Fade","Raze,Killjoy,Omen,Fade,Gekko"
Lotus,Sky Esports (NA),adam's pizzeria,13,8,5,4,4,8,"Raze,Cypher,Omen,Jett,Gekko","Raze,Killjoy,Fade,Gekko,Clove"
Lotus,Koala Pound,Rush Hour,13,7,7,1,6,6,"Breach,Raze,Cypher,Omen,Gekko","Raze,Killjoy,Viper,Omen,Fade"
Bind,Wired Esports,We Gamers,13,0,12,0,0,1,"Raze,Cypher,Brimstone,Gekko,Clove","Sage,Omen,Yoru,Chamber,Iso"
Bind,U4RIA Radiata,Devious Esports,13,2,10,2,0,3,"Raze,Sova,Brimstone,Gekko,Deadlock","Raze,Skye,Yoru,Astra,Harbor"
Lotus,Baby Goats,Rejects (NA),0,13,0,12,1,0,"Breach,Raze,Killjoy,Omen,Gekko","Cypher,Chamber,Gekko,Deadlock,Clove"
Split,Shirtless Gamers,GroundX,13,9,6,6,3,7,"Raze,Cypher,Omen,Jett,Skye","Raze,Cypher,Sage,Omen,Gekko"
Bind,Six Karma,Illicit Gaming,8,13,6,6,7,2,"Raze,Viper,Brimstone,Fade,Gekko","Raze,Viper,Brimstone,Skye,Gekko"
Lotus,2Game Esports,XLD Gaming,14,12,4,9,3,10,"Breach,Killjoy,Omen,Neon,Fade","Raze,Killjoy,Viper,Omen,Fade"
Lotus,Oxygen Esports,M80,13,11,10,2,9,3,"Breach,Raze,Cypher,Gekko,Clove","Breach,Raze,Cypher,Omen,Gekko"
Lotus,Skout Esports,Division 7,13,7,6,6,1,7,"Breach,Raze,Killjoy,Omen,Skye","Breach,Raze,Killjoy,Reyna,Omen"
Breeze,2Game Esports,XLD Gaming,13,5,10,2,3,3,"Sova,Viper,Jett,Yoru,Astra","Cypher,Sova,Viper,Jett,Yoru"
Split,The Vicious,KR Esports,13,5,4,2,3,9,"Breach,Raze,Cypher,Omen,Jett","Raze,Cypher,Viper,Omen,Skye"
Ascent,Skout Esports,Division 7,13,7,3,5,2,10,"Breach,Sova,Killjoy,Phoenix,Omen","Sova,Killjoy,Phoenix,Omen,Jett"
Ascent,2Game Esports,XLD Gaming,5,13,4,8,5,1,"Sova,Killjoy,Omen,Jett,KAY/O","Sova,Killjoy,Omen,Jett,KAY/O"
Bind,Valiant,Zerance,13,9,7,3,6,6,"Raze,Viper,Brimstone,Skye,Gekko","Raze,Viper,Brimstone,Skye,Gekko"
Sunset,Oxygen Esports,M80,14,12,9,4,8,5,"Breach,Raze,Cypher,Omen,KAY/O","Breach,Raze,Cypher,Omen,Gekko"
Lotus,TwentyStars GC,Entry Frogs Iris,13,2,3,0,2,10,"Breach,Raze,Killjoy,Omen,Jett","Breach,Raze,Killjoy,Omen,Fade"
Ascent,The Vicious,KR Esports,13,6,4,3,3,9,"Sova,Killjoy,Jett,Astra,KAY/O","Sova,Killjoy,Omen,Jett,KAY/O"
Split,Skout Esports,Division 7,11,13,4,8,5,7,"Breach,Raze,Cypher,Omen,Gekko","Breach,Raze,Cypher,Omen,Jett"
Sunset,TwentyStars GC,Entry Frogs Iris,13,2,3,0,2,10,"Raze,Cypher,Sova,Reyna,Omen","Breach,Raze,Cypher,Sova,Clove"
Ascent,Onyx Ravens,G3 Esports,13,1,2,0,1,11,"Sova,Killjoy,Omen,Jett,KAY/O","Sova,Killjoy,Reyna,Omen,Jett"
Icebox,Valiant,Zerance,13,10,6,5,5,7,"Killjoy,Viper,Jett,KAY/O,Gekko","Killjoy,Viper,Jett,Skye,Harbor"
Lotus,The Ultimates,Underground Gaming,8,13,2,10,3,6,"Breach,Raze,Cypher,Sova,Omen","Breach,Raze,Killjoy,Omen,Gekko"
Breeze,Vision Esports,Twisted Minds Esports,13,8,6,6,2,7,"Cypher,Sova,Viper,Jett,Yoru","Cypher,Sova,Viper,Jett,Yoru"
Bind,DSQ Esports,REY ACADEMY,13,4,10,2,2,3,"Raze,Viper,Brimstone,Skye,Gekko","Raze,Cypher,Brimstone,Skye,Yoru"
Ascent,Fire Flux Esports,Istanbul Wildcats,13,6,6,1,5,7,"Sova,Killjoy,Omen,Jett,KAY/O","Cypher,Sova,Omen,Jett,KAY/O"
Icebox,aNc Outplayed GC,LXT Esports GC,3,13,2,2,11,1,"Sova,Killjoy,Viper,Jett,Gekko","Killjoy,Viper,Jett,KAY/O,Gekko"
Ascent,The Ultimates,Underground Gaming,7,13,3,5,8,4,"Sova,Killjoy,Omen,Jett,KAY/O","Sova,Killjoy,Omen,Jett,KAY/O"
Sunset,Valiant,Zerance,9,13,5,7,6,4,"Breach,Raze,Cypher,Omen,Gekko","Breach,Raze,Cypher,Sova,Omen"
Lotus,Onyx Ravens,G3 Esports,17,15,11,5,10,6,"Breach,Raze,Cypher,Viper,Omen","Raze,Jett,Gekko,Deadlock,Clove"
Icebox,Vision Esports,Twisted Minds Esports,13,11,9,3,8,4,"Sova,Killjoy,Viper,Sage,Jett","Killjoy,Viper,Jett,KAY/O,Gekko"
Split,The Ultimates,Underground Gaming,13,4,9,3,1,4,"Raze,Viper,Omen,Jett,Skye","Raze,Cypher,Sage,Omen,Skye"
Split,Fire Flux Esports,Istanbul Wildcats,13,3,9,3,0,4,"Breach,Raze,Cypher,Omen,Yoru","Breach,Cypher,Omen,Jett,Skye"
Sunset,DSQ Esports,REY ACADEMY,13,5,4,2,3,9,"Breach,Raze,Cypher,Omen,Gekko","Breach,Raze,Cypher,Omen,Gekko"
Lotus,aNc Outplayed GC,LXT Esports GC,4,13,3,2,11,1,"Breach,Raze,Killjoy,Omen,Gekko","Raze,Killjoy,Viper,Omen,Fade"
Breeze,Akroma,Cicadas Gaming,3,13,2,10,3,1,"Cypher,Sova,Viper,Jett,Yoru","Cypher,Sova,Viper,Jett,Skye"
Breeze,PCIFIC Espor,Fenerbahçe Esports,13,1,11,1,0,2,"Cypher,Sova,Viper,Jett,KAY/O","Cypher,Sova,Viper,Jett,Yoru"
Icebox,Akroma,Cicadas Gaming,8,13,5,7,6,3,"Killjoy,Viper,Jett,KAY/O,Gekko","Sova,Killjoy,Viper,Jett,Harbor"
Icebox,PCIFIC Espor,Fenerbahçe Esports,11,13,8,4,9,3,"Sova,Killjoy,Viper,Jett,Gekko","Killjoy,Viper,Jett,Gekko,Clove"
Bind,PCIFIC Espor,Fenerbahçe Esports,13,9,4,6,3,9,"Raze,Viper,Omen,Skye,Gekko","Raze,Viper,Brimstone,Skye,Gekko"
Bind,NORTHEPTION,VARREL,8,13,3,9,4,5,"Raze,Viper,Omen,Skye,Yoru","Raze,Viper,Omen,Skye,Deadlock"
Split,NORTHEPTION,VARREL,16,14,7,8,6,9,"Raze,Viper,Omen,Jett,Skye","Raze,Cypher,Viper,Omen,Skye"
Icebox,NORTHEPTION,VARREL,8,13,4,8,5,4,"Sova,Killjoy,Viper,Jett,KAY/O","Sova,Killjoy,Viper,Reyna,Gekko"
Split,SCARZ,REJECT,13,9,7,3,6,6,"Raze,Viper,Omen,Fade,Gekko","Raze,Cypher,Viper,Omen,Skye"
Breeze,SCARZ,REJECT,4,13,1,4,9,3,"Cypher,Sova,Viper,Yoru,Astra","Sova,Viper,Jett,Yoru,Astra"
Lotus,SCARZ,REJECT,13,10,8,3,7,5,"Breach,Raze,Sova,Killjoy,Omen","Raze,Killjoy,Viper,Omen,Fade"
Split,Sengoku Gaming,RIDDLE ORDER,15,17,11,5,12,4,"Breach,Raze,Viper,Omen,Fade","Raze,Viper,Omen,Jett,Skye"
Sunset,Rejects (NA),Asura,11,13,10,2,11,1,"Breach,Raze,Cypher,Sova,Omen","Raze,Cypher,Omen,KAY/O,Gekko"
Bind,Rejects (NA),Asura,4,13,3,9,4,1,"Raze,Cypher,Skye,Gekko,Clove","Raze,Cypher,Viper,Brimstone,Skye"
Ascent,Hero Base,SAGAZ,13,5,7,5,0,6,"Breach,Viper,Omen,Jett,KAY/O","Cypher,Sova,Omen,Jett,KAY/O"
Lotus,Asura,MimicGG,13,4,5,0,4,8,"Breach,Raze,Killjoy,Omen,Gekko","Breach,Cypher,Omen,Neon,Gekko"
Split,Rejects (NA),BALLZ V3.0,13,0,12,0,0,1,"Raze,Cypher,Jett,Skye,Clove","Breach,Raze,Cypher,Omen,Skye"
Lotus,BALLZ V3.0,Spate Esports,13,5,8,4,1,5,"Raze,Killjoy,Viper,Omen,Fade","Breach,Raze,Cypher,Omen,Gekko"
Icebox,Asura,Baby Goats,13,2,3,0,2,10,"Sova,Killjoy,Viper,Jett,Harbor","Sova,Killjoy,Viper,Harbor,Deadlock"
Ascent,Rejects (NA),Solo Swing Nation,13,3,9,3,0,4,"Sova,Omen,Jett,KAY/O,Deadlock","Sova,Sage,Omen,Yoru,Chamber"
Sunset,Hero Base,SAGAZ,5,13,3,3,10,2,"Breach,Raze,Viper,Omen,KAY/O","Breach,Raze,Cypher,Omen,Gekko"
Bind,Spate Esports,Outlaw Academy,13,1,11,1,0,2,"Viper,Jett,Yoru,Gekko,Clove","Breach,Raze,Omen,Skye,Gekko"
Bind,MimicGG,Luminescent Sapphire,13,2,3,0,2,10,"Raze,Cypher,Gekko,Deadlock,Clove","Raze,Viper,Brimstone,Skye,Gekko"
Sunset,Solo Swing Nation,92' Dream Team,13,6,6,6,0,7,"Raze,Cypher,Sova,Omen,Iso","Raze,Cypher,Sova,Omen,Gekko"
Ascent,BALLZ V3.0,Team Octave,13,6,4,3,3,9,"Sova,Killjoy,Omen,Jett,KAY/O","Raze,Cypher,Phoenix,Gekko,Clove"
Lotus,Hero Base,SAGAZ,13,5,9,3,2,4,"Killjoy,Viper,Omen,Neon,Gekko","Raze,Killjoy,Viper,Omen,Fade"
Sunset,Baby Goats,Dreadnoughts,13,10,9,2,8,4,"Breach,Raze,Cypher,Omen,Gekko","Breach,Raze,Cypher,Sova,Omen"
Ascent,9z Team,Furious Gaming,13,7,6,2,5,7,"Killjoy,Viper,Omen,Jett,Skye","Sova,Killjoy,Omen,Jett,KAY/O"
Split,9z Team,Furious Gaming,13,1,11,1,0,2,"Breach,Raze,Viper,Omen,Skye","Breach,Raze,Astra,KAY/O,Chamber"
Sunset,Galorys,Stellae Gaming,6,13,5,7,6,1,"Raze,Cypher,Viper,Omen,Gekko","Breach,Raze,Cypher,Omen,Gekko"
Bind,SAW,GTZ Esports,13,11,7,5,6,6,"Raze,Viper,Brimstone,Fade,Gekko","Breach,Raze,Cypher,Viper,Brimstone"
Lotus,Legacy,TBK Esports,13,10,6,5,5,7,"Raze,Killjoy,Omen,Astra,Fade","Raze,Killjoy,Viper,Omen,Fade"
Split,Galorys,Stellae Gaming,13,7,4,4,3,9,"Raze,Viper,Omen,Jett,Skye","Raze,Cypher,Viper,Omen,Skye"
Ascent,XSOUL,OXEN,6,13,1,6,7,5,"Sova,Killjoy,Omen,Jett,KAY/O","Cypher,Sova,Omen,Jett,KAY/O"
Lotus,Joblife,Mandatory,9,13,4,8,5,5,"Raze,Sova,Killjoy,Omen,Gekko","Raze,Killjoy,Viper,Omen,Fade"
Bind,FUZOS,HOF Esports,9,13,4,6,7,5,"Raze,Viper,Brimstone,Skye,Gekko","Breach,Raze,Viper,Brimstone,Gekko"
Sunset,XSOUL,OXEN,3,13,0,4,9,3,"Raze,Cypher,Omen,Gekko,Clove","Viper,Sage,Omen,KAY/O,Gekko"
Sunset,Zero Tenacity,NOM Esports,11,13,8,4,9,3,"Breach,Cypher,Sova,Omen,Yoru","Breach,Raze,Cypher,Omen,Fade"
Ascent,Legacy,TBK Esports,13,4,5,0,4,8,"Sova,Killjoy,Omen,Jett,KAY/O","Sova,Killjoy,Omen,Jett,KAY/O"
Lotus,Galorys,Stellae Gaming,11,13,7,5,8,4,"Raze,Killjoy,Viper,Omen,Fade","Raze,Killjoy,Viper,Omen,Fade"
Icebox,Team Occupy,Onyx Ravens,9,13,4,6,7,5,"Sova,Killjoy,Viper,Reyna,Jett","Killjoy,Viper,Sage,Jett,Gekko"
Sunset,Joblife,Mandatory,8,13,2,7,6,6,"Raze,Cypher,Omen,KAY/O,Gekko","Breach,Raze,Cypher,Omen,Gekko"
Ascent,top gz,NASR Esports,2,13,1,2,11,1,"Sova,Killjoy,Omen,Jett,KAY/O","Cypher,Sova,Phoenix,Omen,Jett"
Bind,R8 Esports,Skulls Esports,13,4,4,1,3,9,"Raze,Cypher,Viper,Brimstone,Skye","Cypher,Jett,Skye,Astra,KAY/O"
Split,GAMAX eSports,Team RA'AD,13,15,4,10,5,9,"Breach,Raze,Cypher,Omen,Fade","Raze,Cypher,Viper,Omen,Skye"
Lotus,NOVO GC,LuckyGirls,13,10,4,8,2,9,"Breach,Sova,Killjoy,Omen,Neon","Raze,Killjoy,Viper,Omen,Fade"
Breeze,Munich Esports,HONEYBADGER123,4,13,2,3,10,2,"Cypher,Sova,Viper,Jett,Yoru","Cypher,Sova,Viper,Jett,Yoru"
Lotus,GIANTX GC,NASR Ignite,13,7,7,5,2,6,"Breach,Raze,Sova,Omen,Chamber","Raze,Killjoy,Viper,Omen,Fade"
Lotus,UCAM Esports Club,KPI Gaming,13,4,5,0,4,8,"Breach,Sova,Killjoy,Omen,Jett","Killjoy,Omen,Skye,Astra,Neon"
Sunset,TeamOrangeGaming,Lootcifer,13,2,3,0,2,10,"Breach,Raze,Cypher,Sova,Omen","Breach,Raze,Cypher,Sage,Omen"
Bind,XSOUL,OXEN,13,6,7,5,1,6,"Raze,Cypher,Viper,Brimstone,Skye","Raze,Viper,Brimstone,Skye,Gekko"
Split,Team Occupy,Onyx Ravens,4,13,4,8,5,0,"Breach,Raze,Viper,Omen,Skye","Raze,Viper,Omen,Skye,Chamber"
Icebox,Zero Tenacity,NOM Esports,14,12,6,7,5,8,"Raze,Killjoy,Viper,Brimstone,Fade","Sova,Killjoy,Viper,Sage,Jett"
Lotus,FTW LEÇA FC,PPP,12,14,7,6,8,5,"Raze,Killjoy,Viper,Omen,Fade","Breach,Cypher,Sova,Omen,Neon"
Sunset,Eternal Fire,S2G Esports,4,13,0,5,8,4,"Breach,Raze,Cypher,Omen,KAY/O","Breach,Raze,Cypher,Omen,Gekko"
Lotus,top gz,NASR Esports,3,13,0,4,9,3,"Breach,Raze,Killjoy,Omen,Fade","Raze,Killjoy,Viper,Omen,Skye"
Sunset,6TM ESPORTS,QUE PASA,13,3,4,0,3,9,"Raze,Cypher,Omen,KAY/O,Gekko","Raze,Cypher,Viper,Omen,Fade"
Sunset,R8 Esports,Skulls Esports,13,3,11,1,2,2,"Breach,Cypher,Sova,Omen,Yoru","Raze,Cypher,Sova,Omen,KAY/O"
Ascent,Joblife,Mandatory,13,4,9,3,1,4,"Sova,Killjoy,Omen,Jett,KAY/O","Sova,Killjoy,Omen,Jett,KAY/O"
Bind,DIVIZON,Ovation eSports,13,4,9,3,1,4,"Raze,Cypher,Viper,Omen,Skye","Raze,Viper,Brimstone,KAY/O,Chamber"
Icebox,Vanir,Team Prolific,13,4,3,2,2,10,"Sova,Killjoy,Viper,Sage,Jett","Sova,Killjoy,Viper,Jett,Harbor"
Icebox,GAMAX eSports,Team RA'AD,11,13,8,4,9,3,"Sova,Killjoy,Viper,Jett,KAY/O","Killjoy,Viper,Sage,Gekko,Clove"
Ascent,GIANTX GC,NASR Ignite,13,9,4,8,1,9,"Sova,Killjoy,Omen,Jett,KAY/O","Cypher,Sova,Phoenix,Omen,Jett"
Lotus,EKO Esports GC,HGE Esports GC,5,13,5,7,6,0,"Breach,Raze,Killjoy,Omen,Fade","Breach,Raze,Killjoy,Omen,Gekko"
Breeze,Eternal Fire,S2G Esports,5,13,1,5,8,4,"Cypher,Sova,Viper,Jett,KAY/O","Cypher,Sova,Viper,Jett,Yoru"
Lotus,Munich Esports,HONEYBADGER123,12,14,8,5,9,4,"Breach,Raze,Omen,Jett,Skye","Raze,Killjoy,Omen,KAY/O,Gekko"
Bind,GJ Omen,RIZON,13,7,6,2,5,7,"Raze,Cypher,Brimstone,Reyna,Gekko","Raze,Cypher,Brimstone,Skye,Gekko"
Icebox,Jabba Enjoyers,EXO Clan,13,11,7,5,6,6,"Sova,Killjoy,Viper,Jett,Deadlock","Sova,Killjoy,Viper,Yoru,Deadlock"
Breeze,INF Esports,Novita Esports,10,13,7,5,8,3,"Cypher,Sova,Viper,Jett,Yoru","Cypher,Sova,Viper,Jett,Yoru"
Bind,TeamOrangeGaming,Lootcifer,10,13,4,7,6,6,"Raze,Cypher,Brimstone,Skye,Gekko","Raze,Viper,Omen,KAY/O,Gekko"
Icebox,Dortmund Esports,Sissi State Punks,5,13,0,6,7,5,"Breach,Viper,Omen,Yoru,Neon","Sova,Killjoy,Viper,Reyna,Neon"
Breeze,Zero Tenacity,NOM Esports,8,13,6,6,7,2,"Sova,Viper,Jett,Yoru,Astra","Cypher,Sova,Viper,Jett,Yoru"
Lotus,Impulse GW,EX0TIK GAMING,13,4,5,0,4,8,"Raze,Killjoy,Viper,Omen,Fade","Breach,Raze,Killjoy,Omen,Fade"
Ascent,ZETA Gaming,Falke Esports,14,12,6,7,5,8,"Cypher,Sova,Phoenix,Omen,Jett","Sova,Killjoy,Omen,Jett,KAY/O"
Sunset,Exceptional Gaming,LA RUE,11,13,6,6,7,5,"Breach,Raze,Cypher,Omen,Fade","Breach,Raze,Cypher,Omen,Gekko"
Lotus,6TM ESPORTS,QUE PASA,13,9,7,5,4,6,"Breach,Raze,Cypher,Sova,Omen","Raze,Killjoy,Viper,Omen,Fade"
Lotus,Vanir,Team Prolific,13,2,10,2,0,3,"Breach,Raze,Cypher,Harbor,Deadlock","Breach,Killjoy,Omen,Neon,Gekko"
Lotus,Coalesce,Project 1,13,5,5,1,4,8,"Raze,Cypher,Omen,Jett,Skye","Raze,Killjoy,Viper,Omen,Fade"
Sunset,Solary,DVM Esport,13,8,5,4,4,8,"Breach,Raze,Cypher,Omen,Fade","Breach,Raze,Cypher,Omen,Gekko"
Lotus,DIVIZON,Ovation eSports,13,9,4,6,3,9,"Raze,Killjoy,Viper,Omen,Fade","Raze,Killjoy,Viper,Omen,Fade"
Breeze,POTATO ABUSERS,Sissi State Punks Academy,13,9,6,4,5,7,"Cypher,Sova,Viper,Jett,KAY/O","Cypher,Sova,Viper,Jett,KAY/O"
Lotus,Reveal Multigaming Saphire,A One Man Army,5,13,4,8,5,1,"Raze,Killjoy,Viper,Omen,Fade","Raze,Killjoy,Brimstone,Omen,KAY/O"
Ascent,UCAN ESPORTS,MAJOR MONOGWAM,1,13,0,2,11,1,"Cypher,Sova,Astra,Neon,Fade","Sova,Killjoy,Omen,Jett,KAY/O"
Ascent,ARROW,BÖSE BUBEN,12,14,4,9,5,8,"Cypher,Sova,Phoenix,Omen,Jett","Sova,Killjoy,Omen,Jett,KAY/O"
Ascent,AKA HERO,Reveal Multigaming,6,13,1,6,7,5,"Sova,Killjoy,Omen,Jett,KAY/O","Cypher,Sova,Killjoy,Omen,Jett"
Sunset,GAMAX eSports,Team RA'AD,13,5,4,2,3,9,"Breach,Raze,Cypher,Omen,Fade","Breach,Raze,Cypher,Omen,Gekko"
Breeze,GIANTX GC,NASR Ignite,4,13,2,3,10,2,"Sova,Viper,Jett,Yoru,Astra","Cypher,Sova,Viper,Jett,Gekko"
Ascent,Jabba Enjoyers,EXO Clan,13,6,7,0,6,6,"Sova,Killjoy,Omen,Jett,KAY/O","Breach,Phoenix,Omen,KAY/O,Deadlock"
Bind,INF Esports,Novita Esports,7,13,5,7,6,2,"Raze,Viper,Sage,Skye,Harbor","Raze,Viper,Skye,Gekko,Clove"
Lotus,GJ Omen,RIZON,13,8,9,3,5,4,"Raze,Killjoy,Viper,Omen,Fade","Breach,Cypher,Omen,Neon,Gekko"
Split,TeamOrangeGaming,Lootcifer,13,10,3,9,1,10,"Raze,Cypher,Sage,Omen,Skye","Raze,Cypher,Sage,Omen,Skye"
Lotus,Dortmund Esports,Sissi State Punks,9,13,7,5,8,2,"Raze,Omen,Yoru,Gekko,Deadlock","Breach,Sova,Killjoy,Omen,Jett"
Lotus,Exceptional Gaming,LA RUE,6,13,4,8,5,2,"Breach,Raze,Cypher,Omen,Gekko","Raze,Killjoy,Viper,Omen,Fade"
Icebox,EKO Esports GC,HGE Esports GC,13,9,7,5,4,6,"Sova,Killjoy,Viper,Sage,Jett","Killjoy,Viper,Jett,KAY/O,Gekko"
Icebox,6TM ESPORTS,QUE PASA,8,13,1,8,5,7,"Sova,Killjoy,Viper,Jett,Harbor","Sova,Killjoy,Viper,Reyna,Jett"
Sunset,Coalesce,Project 1,13,7,5,3,4,8,"Raze,Cypher,Sova,Omen,Gekko","Raze,Cypher,Sova,Omen,Gekko"
Ascent,Reveal Multigaming Saphire,A One Man Army,4,13,4,8,5,0,"Breach,Viper,Phoenix,Omen,KAY/O","Sova,Killjoy,Omen,Jett,KAY/O"
Ascent,Munich Esports,HONEYBADGER123,14,12,6,7,5,8,"Sova,Killjoy,Omen,Jett,KAY/O","Cypher,Omen,Jett,KAY/O,Gekko"
Icebox,AKA HERO,Reveal Multigaming,2,13,0,3,10,2,"Sova,Killjoy,Viper,Jett,KAY/O","Sova,Killjoy,Viper,Jett,Clove"
Bind,POTATO ABUSERS,Sissi State Punks Academy,13,6,8,4,2,5,"Raze,Viper,Brimstone,Skye,Gekko","Cypher,Brimstone,Yoru,Harbor,Gekko"
Sunset,Vanir,Team Prolific,10,13,4,8,5,6,"Breach,Raze,Cypher,Omen,Gekko","Breach,Cypher,Omen,Neon,Gekko"
Lotus,UCAN ESPORTS,MAJOR MONOGWAM,6,13,4,8,5,2,"Breach,Raze,Cypher,Omen,Gekko","Breach,Raze,Killjoy,Omen,Gekko"
Ascent,Solary,DVM Esport,6,13,1,6,7,5,"Sova,Killjoy,Omen,Jett,KAY/O","Cypher,Sova,Omen,Jett,Deadlock"
Split,Five Media Clan,Barça eSports,2,13,2,10,3,0,"Breach,Raze,Cypher,Omen,Skye","Raze,Viper,Sage,Skye,Astra"
Lotus,Vision Esports,Unity Esports,8,13,2,7,6,6,"Breach,Raze,Cypher,Omen,Fade","Breach,Cypher,Sova,Omen,Jett"
Bind,ARROW,BÖSE BUBEN,8,13,6,6,7,2,"Raze,Cypher,Skye,Yoru,Clove","Raze,Viper,Brimstone,Yoru,Gekko"
Sunset,Team Falcons,Dragons Esports,13,4,9,3,1,4,"Breach,Raze,Cypher,Omen,Fade","Raze,Cypher,Viper,Omen,Fade"
Lotus,Fraggerz,The Ultimates,1,13,0,2,11,1,"Breach,Raze,Killjoy,Omen,Jett","Breach,Raze,Cypher,Sova,Omen"
Bind,Eternal Fire,S2G Esports,16,14,8,7,7,8,"Sova,Jett,Astra,KAY/O,Deadlock","Raze,Viper,Omen,Skye,Fade"
Breeze,Incognito,ESC Gaming,16,14,5,10,4,11,"Cypher,Sova,Viper,Jett,Yoru","Cypher,Sova,Viper,Jett,KAY/O"
Split,Permitta Unicorns,FOKUS,3,13,1,3,10,2,"Raze,Cypher,Viper,Omen,Skye","Raze,Omen,Yoru,Astra,Fade"
Sunset,Vision Esports,Unity Esports,4,13,3,9,4,1,"Breach,Cypher,Sova,Reyna,Clove","Breach,Cypher,Omen,Jett,Fade"
Icebox,Team Falcons,Dragons Esports,13,7,8,0,7,5,"Reyna,Omen,KAY/O,Harbor,Gekko","Sova,Killjoy,Viper,Jett,Harbor"
Bind,Fraggerz,The Ultimates,7,13,2,6,7,5,"Raze,Cypher,Omen,Jett,Skye","Raze,Viper,Omen,KAY/O,Gekko"
Icebox,Valiant GC,HEROIC Valkyries,11,13,7,5,8,4,"Sova,Killjoy,Viper,Sage,Jett","Killjoy,Viper,Jett,KAY/O,Gekko"
Lotus,Incognito,ESC Gaming,13,4,8,4,0,5,"Raze,Killjoy,Viper,Omen,Fade","Breach,Raze,Killjoy,Omen,Fade"
Icebox,Solary,DVM Esport,13,8,9,3,5,4,"Sova,Killjoy,Viper,Sage,Jett","Killjoy,Viper,KAY/O,Gekko,Deadlock"
Icebox,Ramboot Club,Imperium Gaming,13,9,6,6,3,7,"Sova,Killjoy,Viper,Jett,Gekko","Killjoy,Viper,Reyna,KAY/O,Gekko"
Sunset,Permitta Unicorns,FOKUS,6,13,4,8,5,2,"Breach,Raze,Cypher,Sova,Omen","Cypher,Sage,Omen,KAY/O,Gekko"
Ascent,Galakticos,Galatasaray Esports,13,11,7,5,6,6,"Sova,Phoenix,Omen,Jett,Astra","Sova,Killjoy,Omen,Jett,KAY/O"
Ascent,Incognito,ESC Gaming,11,13,5,7,6,6,"Sova,Killjoy,Omen,Jett,KAY/O","Sova,Killjoy,Omen,Jett,KAY/O"
Lotus,Valiant GC,HEROIC Valkyries,6,13,1,6,7,5,"Breach,Raze,Cypher,Sova,Omen","Raze,Viper,Sage,Omen,Skye"
Bind,Galakticos,Galatasaray Esports,15,13,9,5,8,6,"Raze,Omen,Skye,Yoru,Astra","Raze,Viper,Brimstone,Skye,Yoru"
Breeze,Carnival Gaming,Alternate Realities,9,13,4,8,5,5,"Sova,Viper,Omen,Jett,Yoru","Cypher,Sova,Viper,Jett,KAY/O"
Lotus,Carnival Gaming,Alternate Realities,7,13,3,5,8,4,"Breach,Raze,Killjoy,Omen,Fade","Raze,Killjoy,Viper,Omen,Fade"
Split,Murash Gaming,FENNEL,13,9,5,5,4,8,"Raze,Cypher,Sage,Omen,Skye","Breach,Raze,Cypher,Sage,Omen"
Icebox,Orangutan,The Zoo  (IN),13,9,11,1,8,2,"Sova,Killjoy,Viper,Jett,Harbor","Sova,Killjoy,Viper,Jett,Gekko"
Ascent,Orangutan,The Zoo  (IN),13,6,5,2,4,8,"Killjoy,Omen,Jett,KAY/O,Gekko","Sova,Reyna,Omen,Jett,KAY/O"
Sunset,Murash Gaming,FENNEL,13,9,6,4,5,7,"Sova,Phoenix,Sage,Omen,Clove","Cypher,Sova,Omen,KAY/O,Neon"
Sunset,Sengoku Gaming,RIDDLE ORDER,5,13,3,9,2,0,"Raze,Sage,Omen,Gekko,Clove","Breach,Raze,Cypher,Omen,Gekko"
Icebox,PPP,HOF Esports,13,8,7,2,6,6,"Sova,Killjoy,Viper,Sage,Jett","Sova,Killjoy,Viper,Jett,Harbor"
Lotus,MOUZ,SK Gaming,9,13,4,6,7,5,"Breach,Cypher,Omen,Yoru,Fade","Breach,Cypher,Sova,Omen,Jett"
Split,TheSecretClub,Clown9 Valorant,14,12,7,6,6,7,"Breach,Raze,Cypher,Viper,Omen","Raze,Viper,Omen,Skye,Chamber"
Sunset,Skulls Esports,Team RA'AD,7,13,4,4,9,3,"Raze,Cypher,Omen,KAY/O,Gekko","Breach,Raze,Cypher,Omen,Gekko"
Lotus,EX0TIK GAMING,FTW LEÇA FC,13,10,5,6,4,8,"Breach,Raze,Killjoy,Omen,Fade","Raze,Killjoy,Viper,Omen,Fade"
Sunset,GAMAX eSports,Onyx Ravens,8,13,6,6,7,2,"Breach,Raze,Cypher,Omen,Fade","Breach,Raze,Cypher,Sova,Omen"
Sunset,top gz,R8 Esports,6,13,3,4,9,3,"Breach,Raze,Cypher,Omen,Gekko","Breach,Cypher,Sova,Omen,Yoru"
Sunset,NOVO Esports,DSYRE,6,13,4,8,5,2,"Breach,Raze,Cypher,Omen,Deadlock","Cypher,Sova,Omen,KAY/O,Neon"
Sunset,MOUZ,SK Gaming,13,11,4,8,3,9,"Raze,Cypher,Viper,Omen,Gekko","Cypher,Viper,Omen,Jett,Gekko"
Bind,UCAM Esports Club,Barça eSports,3,13,0,4,9,3,"Breach,Raze,Brimstone,Yoru,Fade","Cypher,Viper,Yoru,Gekko,Clove"
Ascent,GoNext Esports,trashcan,13,1,2,0,1,11,"Sova,Killjoy,Omen,Jett,KAY/O","Sova,Killjoy,Omen,Jett,KAY/O"
Bind,TheSecretClub,Clown9 Valorant,13,9,9,1,8,4,"Raze,Viper,Brimstone,Fade,Gekko","Raze,Viper,Omen,Skye,Gekko"
Breeze,RYL | Royal Legion,REY eSports,13,11,8,4,7,5,"Cypher,Sova,Viper,Jett,KAY/O","Cypher,Sova,Viper,Skye,Yoru"
Ascent,Skulls Esports,Team RA'AD,11,13,6,6,7,5,"Cypher,Sova,Omen,Jett,KAY/O","Breach,Raze,Cypher,Sova,Omen"
Lotus,Team Occupy,NASR Esports,5,13,1,5,8,4,"Breach,Raze,Sova,Killjoy,Omen","Raze,Killjoy,Viper,Omen,Skye"
Ascent,SAW,FUZOS,13,2,2,1,1,11,"Sova,Killjoy,Omen,Jett,KAY/O","Sova,Killjoy,Omen,Jett,KAY/O"
Split,GAMAX eSports,Onyx Ravens,9,13,3,9,4,6,"Breach,Raze,Cypher,Omen,Fade","Raze,Viper,Omen,Skye,Chamber"
Icebox,top gz,R8 Esports,2,13,2,10,3,0,"Sova,Killjoy,Viper,Sage,Jett","Sova,Killjoy,Viper,Sage,Jett"
Icebox,GoNext Esports,trashcan,13,2,3,0,2,10,"Sova,Killjoy,Viper,Sage,Jett","Sova,Killjoy,Viper,KAY/O,Clove"
Split,Outplayed,HGE Esports,9,13,3,9,4,6,"Raze,Cypher,Viper,Omen,Skye","Raze,Cypher,Omen,Skye,Clove"
Split,MOUZ,SK Gaming,9,13,1,9,4,8,"Breach,Raze,Cypher,Omen,Skye","Breach,Raze,Cypher,Sova,Astra"
Sunset,Ursus Gaming,Lotus Knights,9,13,5,5,8,4,"Raze,Cypher,Omen,KAY/O,Gekko","Breach,Raze,Cypher,Omen,Gekko"
Sunset,RYL | Royal Legion,REY eSports,13,7,6,2,5,7,"Breach,Raze,Cypher,Omen,Gekko","Cypher,Omen,Jett,KAY/O,Deadlock"
Icebox,Ramboot Club,KPI Gaming,9,13,4,8,5,5,"Sova,Killjoy,Viper,Jett,Gekko","Killjoy,Viper,Jett,KAY/O,Gekko"
Breeze,GTZ Esports,Impulse GW,7,13,2,6,7,5,"Cypher,Sova,Viper,Jett,Yoru","Cypher,Sova,Viper,Jett,KAY/O"
Lotus,TheSecretClub,Clown9 Valorant,13,15,6,8,7,7,"Raze,Killjoy,Viper,Omen,Fade","Raze,Killjoy,Viper,Omen,Fade"
Bind,Team Occupy,NASR Esports,11,13,3,9,4,8,"Raze,Cypher,Brimstone,Reyna,Skye","Viper,Omen,Yoru,Fade,Gekko"
Lotus,Twisted Minds Esports,Unity Esports,8,13,3,6,7,5,"Breach,Raze,Killjoy,Omen,Gekko","Breach,Cypher,Sova,Omen,Jett"
Lotus,GoNext Esports,trashcan,7,13,3,5,8,4,"Breach,Cypher,Sova,Omen,Jett","Raze,Killjoy,Viper,Omen,Fade"
Lotus,Thin Fecking Ice,Free Orbs,9,13,7,5,8,2,"Raze,Killjoy,Viper,Omen,Fade","Breach,Killjoy,Omen,Neon,Fade"
Sunset,R3VOLT,CTRL x YARI Esports,5,13,3,3,10,2,"Breach,Raze,Cypher,Sova,Omen","Breach,Raze,Cypher,Omen,Gekko"
Ascent,Dragons Esports,The Ultimates,9,13,1,9,4,8,"Cypher,Sova,Omen,Jett,KAY/O","Sova,Killjoy,Omen,Jett,KAY/O"
Split,Twisted Saints Esports,Babos Gaming,10,13,7,5,8,3,"Raze,Viper,Omen,Jett,Skye","Cypher,Viper,Omen,Skye,Neon"
Split,HEROIC Valkyries,BBL Queens,2,13,2,10,3,0,"Raze,Omen,Yoru,Astra,Fade","Breach,Raze,Cypher,Omen,Skye"
Sunset,RTZN,VX300 Gaming,13,10,7,5,5,6,"Breach,Raze,Cypher,Omen,Gekko","Raze,Killjoy,Sage,Omen,Gekko"
Bind,Thin Fecking Ice,Free Orbs,5,13,4,8,5,1,"Breach,Raze,Viper,Brimstone,Yoru","Raze,Viper,Omen,Skye,Deadlock"
Icebox,Acend,ESC Gaming,13,7,7,1,6,6,"Killjoy,Viper,Jett,KAY/O,Gekko","Killjoy,Viper,Yoru,Harbor,Gekko"
Split,Dragons Esports,The Ultimates,13,6,6,1,5,7,"Raze,Cypher,Viper,Omen,Skye","Raze,Viper,Omen,Jett,Skye"
Icebox,Falke Esports,Imperium Gaming,13,11,4,8,3,9,"Sova,Killjoy,Viper,Jett,KAY/O","Killjoy,Viper,Reyna,KAY/O,Gekko"
Lotus,RYL | Royal Legion,REY eSports,12,14,6,7,7,6,"Raze,Viper,Omen,Chamber,Fade","Breach,Raze,Sova,Killjoy,Omen"
Split,R3VOLT,CTRL x YARI Esports,7,13,2,6,7,5,"Cypher,Viper,Omen,Jett,Skye","Breach,Raze,Cypher,Omen,Skye"
Ascent,Fraggerz,Underground Gaming,5,13,4,8,5,1,"Cypher,Sova,Omen,Jett,Skye","Sova,Killjoy,Omen,Jett,KAY/O"
Lotus,HEROIC Valkyries,BBL Queens,5,13,3,9,4,2,"Raze,Viper,Sage,Omen,Skye","Raze,Viper,Omen,Chamber,Fade"
Sunset,Twisted Minds Esports,Unity Esports,13,9,5,5,4,8,"Raze,Cypher,Omen,KAY/O,Gekko","Breach,Cypher,Omen,Jett,Fade"
Ascent,XPERION NXT,CGN Esports,3,13,3,9,4,0,"Sova,Killjoy,Omen,Jett,KAY/O","Sova,Killjoy,Phoenix,Jett,Astra"
Lotus,Vision Esports,Team Falcons,11,13,6,6,7,5,"Breach,Raze,Cypher,Omen,Fade","Raze,Viper,Omen,Chamber,Gekko"
Ascent,Vision Esports,Team Falcons,2,13,2,10,3,0,"Cypher,Sova,Omen,Jett,KAY/O","Sova,Jett,Astra,KAY/O,Fade"
Ascent,Twisted Minds Esports,Unity Esports,6,13,4,8,5,2,"Cypher,Sova,Phoenix,Omen,Jett","Breach,Cypher,Sova,Omen,Jett"
Lotus,Fraggerz,Underground Gaming,10,13,5,7,6,5,"Breach,Raze,Killjoy,Omen,Skye","Raze,Killjoy,Viper,Omen,Gekko"
Lotus,Dragons Esports,The Ultimates,13,15,7,7,8,6,"Raze,Killjoy,Viper,Omen,Fade","Breach,Raze,Cypher,Sova,Omen"
Icebox,LONETEAM,Axolotl,15,13,6,8,5,9,"Sova,Killjoy,Viper,Jett,Gekko","Sova,Killjoy,Viper,Reyna,Chamber"
Breeze,Acend,ESC Gaming,14,12,4,9,3,10,"Cypher,Sova,Viper,Jett,KAY/O","Cypher,Sova,Viper,Jett,KAY/O"
Ascent,GIANTX GC,FOKUS Sakura,13,8,7,5,3,6,"Sova,Killjoy,Omen,Jett,KAY/O","Sova,Killjoy,Phoenix,Omen,Jett"
Ascent,ZETA Gaming,Five Media Clan,13,10,6,6,4,7,"Cypher,Sova,Phoenix,Omen,Jett","Sova,Killjoy,Omen,Jett,KAY/O"
Sunset,XPERION NXT,CGN Esports,9,13,5,7,6,4,"Raze,Sage,Omen,KAY/O,Gekko","Raze,Sova,Killjoy,Omen,Clove"
Ascent,Acend,ESC Gaming,11,13,7,5,8,4,"Sova,Killjoy,Omen,Jett,KAY/O","Sova,Killjoy,Omen,Jett,KAY/O"
Sunset,GIANTX GC,FOKUS Sakura,13,11,5,7,4,8,"Breach,Raze,Cypher,Omen,Gekko","Raze,Cypher,Omen,Yoru,Gekko"
Icebox,RyZ Knights,alvinboy fanclub,10,13,3,8,5,7,"Sova,Killjoy,Viper,Reyna,Jett","Sova,Killjoy,Viper,Jett,Gekko"
Ascent,RyZ Knights,alvinboy fanclub,8,13,5,7,6,3,"Sova,Killjoy,Omen,Jett,KAY/O","Sova,Killjoy,Omen,Jett,KAY/O"
Lotus,RyZ Knights,alvinboy fanclub,13,7,7,1,6,6,"Raze,Sova,Killjoy,Viper,Omen","Raze,Cypher,Viper,Skye,Clove"
Split,Rejects (NA),Asians and Friend,13,11,7,5,6,6,"Raze,Cypher,Jett,Skye,Clove","Raze,Cypher,Viper,Omen,Skye"
Bind,Rejects (NA),Asians and Friend,13,4,5,0,4,8,"Raze,Cypher,Skye,Gekko,Clove","Raze,Viper,Brimstone,Skye,Gekko"
Sunset,RyZ Knights,Zero MarksMen Black,13,11,7,5,6,6,"Breach,Raze,Cypher,Sova,Clove","Breach,Raze,Cypher,Omen,Gekko"
Sunset,WASTED TALENT,Asians and Friend,11,13,4,8,5,7,"Breach,Raze,Cypher,Omen,Gekko","Breach,Raze,Cypher,Omen,Gekko"
Lotus,RyZ Knights,Zero MarksMen Black,16,14,10,5,9,6,"Raze,Sova,Killjoy,Viper,Omen","Raze,Killjoy,Viper,Omen,Fade"
Bind,AURA Valorant,Rejects (NA),3,13,1,11,2,2,"Raze,Cypher,Brimstone,Skye,Gekko","Raze,Cypher,Skye,Gekko,Clove"
Icebox,Tahm Kenchers,WASTED TALENT,11,13,2,10,3,9,"Sova,Viper,Jett,Chamber,Deadlock","Sova,Killjoy,Viper,Jett,Astra"
Icebox,Ions Day Care,alvinboy fanclub,13,15,7,7,8,6,"Sova,Killjoy,Viper,Reyna,Jett","Sova,Killjoy,Viper,Jett,Gekko"
Bind,Fisher Falcons,Blinn Esports,6,13,2,5,8,4,"Raze,Viper,Brimstone,Skye,Gekko","Raze,Viper,Brimstone,KAY/O,Gekko"
Bind,Baby Goats,Asians and Friend,1,13,1,11,2,0,"Raze,Viper,Brimstone,Yoru,Gekko","Raze,Viper,Brimstone,Skye,Gekko"
Bind,AURA Valorant,MERC CLAN,13,9,7,3,6,6,"Raze,Cypher,Brimstone,Skye,Gekko","Raze,Viper,Skye,Chamber,Clove"
Ascent,Rollbit Warriors,Rejects (NA),13,15,6,8,7,7,"Raze,Sova,Killjoy,Reyna,Omen","Sova,Killjoy,Omen,Jett,KAY/O"
Bind,TEAM T2G,WASTED TALENT,11,13,7,5,8,4,"Raze,Viper,Brimstone,Skye,Gekko","Raze,Cypher,Viper,Brimstone,Skye"
Lotus,Asians and Friend,Omnipotence,13,10,7,5,5,6,"Breach,Raze,Cypher,Omen,Fade","Raze,Killjoy,Omen,Fade,Gekko"
Lotus,BCIT Yellow,AURA Valorant,9,13,6,6,7,3,"Breach,Raze,Cypher,Omen,Fade","Breach,Raze,Killjoy,Omen,Gekko"
Icebox,Fisher Falcons,Blinn Esports,13,15,7,7,8,6,"Sova,Killjoy,Viper,Reyna,Jett","Sova,Killjoy,Viper,Jett,Harbor"
Lotus,Rollbit Warriors,Take Back Control,13,5,9,3,2,4,"Raze,Killjoy,Reyna,Omen,Gekko","Breach,Raze,Cypher,Omen,Gekko"
Bind,Ions Day Care,alvinboy fanclub,16,14,6,9,5,10,"Raze,Viper,Brimstone,Fade,Deadlock","Raze,Cypher,Brimstone,Skye,Clove"
Ascent,MERC CLAN,Smart Front Load Washer,13,7,11,1,6,2,"Sova,Killjoy,Omen,Jett,KAY/O","Cypher,Sova,Phoenix,Reyna,Omen"
Icebox,Baby Goats,d1v1ne,13,8,9,0,8,4,"Sova,Killjoy,Viper,Harbor,Deadlock","Killjoy,Viper,KAY/O,Harbor,Gekko"
Bind,Onyx Ravens,Team RA'AD,13,8,6,6,2,7,"Raze,Viper,Brimstone,Skye,Gekko","Raze,Viper,Brimstone,Skye,Gekko"
Split,Hyjinx Violet,Rejects (NA),2,13,0,3,10,2,"Breach,Raze,Cypher,Viper,Clove","Raze,Cypher,Jett,Skye,Clove"
Ascent,Twisted Saints Esports,Team Prolific,13,7,10,2,5,3,"Raze,Viper,Reyna,Skye,Harbor","Sova,Viper,Phoenix,Omen,Jett"
Bind,NoPrac,Asians and Friend,6,13,6,6,7,0,"Raze,Viper,Brimstone,Skye,Gekko","Raze,Viper,Brimstone,Skye,Gekko"
Lotus,Jack n Frens ,Tahm Kenchers,6,13,5,2,11,1,"Breach,Raze,Viper,Omen,Gekko","Raze,Cypher,Sage,Astra,Clove"
Ascent,TEAM T2G,Sky Esports (NA),13,11,5,7,4,8,"Sova,Killjoy,Omen,Jett,KAY/O","Cypher,Sova,Omen,Jett,KAY/O"
Ascent,Rejects (NA),WasTaken,13,5,4,2,3,9,"Raze,Sova,Killjoy,Jett,Clove","Killjoy,Omen,Jett,KAY/O,Deadlock"
Ascent,GroundX,Take Back Control,12,14,4,9,5,8,"Sova,Killjoy,Reyna,Omen,Jett","Sova,Killjoy,Omen,Jett,KAY/O"
Lotus,Ions Day Care,alvinboy fanclub,9,13,6,4,9,3,"Raze,Killjoy,Reyna,Omen,Fade","Raze,Cypher,Viper,Skye,Clove"
Bind,AURORAA,MERC CLAN,8,13,4,5,8,4,"Raze,Viper,Jett,Fade,Harbor","Raze,Viper,Skye,Yoru,Clove"
Lotus,Smart Front Load Washer,korrupt shootas,13,8,5,4,4,8,"Breach,Raze,Killjoy,Omen,Gekko","Raze,Killjoy,Viper,Omen,Fade"
Ascent,WASTED TALENT,Rush Hour,13,9,6,4,5,7,"Sova,Killjoy,Omen,Jett,KAY/O","Sova,Killjoy,Omen,Jett,KAY/O"
Breeze,d1v1ne,M for Mini,13,9,10,2,7,3,"Cypher,Sova,Viper,Reyna,Yoru","Cypher,Sova,Viper,Jett,KAY/O"
Split,Fisher Falcons,Blinn Esports,13,9,8,2,7,5,"Raze,Cypher,Viper,Omen,Skye","Raze,Cypher,Viper,Omen,Skye"
Bind,R8 Esports,Team Occupy,13,7,4,4,3,9,"Raze,Cypher,Viper,Brimstone,Skye","Raze,Cypher,Brimstone,Reyna,Skye"
Lotus,NASR Esports,GAMAX eSports,13,2,10,2,0,3,"Raze,Killjoy,Viper,Omen,Skye","Breach,Raze,Cypher,Sova,Omen"
Ascent,RYL | Royal Legion,Jabba Enjoyers,10,13,5,6,7,5,"Cypher,Sova,Omen,Jett,KAY/O","Sova,Killjoy,Omen,Jett,KAY/O"
Icebox,Onyx Ravens,Team RA'AD,15,13,10,4,9,5,"Killjoy,Viper,Sage,Jett,Gekko","Killjoy,Viper,Sage,Gekko,Clove"
Split,Team Falcons Vega,NASR Ignite,10,13,5,7,6,5,"Breach,Raze,Cypher,Omen,Skye","Raze,Cypher,Viper,Omen,Skye"
Ascent,top gz,Skulls Esports,13,11,5,7,4,8,"Sova,Killjoy,Omen,Jett,KAY/O","Cypher,Sova,Omen,Jett,KAY/O"
Breeze,R3VOLT,EXO Clan,9,13,4,8,5,5,"Cypher,Sova,Viper,Omen,Yoru","Cypher,Sova,Viper,Jett,KAY/O"
Lotus,Team Galaga Kitsune,LUA Gaming,5,13,4,8,5,1,"Breach,Raze,Killjoy,Omen,Gekko","Breach,Raze,Killjoy,Omen,Gekko"
Ascent,HGE Esports,VX300 Gaming,11,13,9,3,10,2,"Sova,Killjoy,Omen,Jett,KAY/O","Sova,Killjoy,Omen,Jett,KAY/O"
Split,Twisted Saints Esports,Team Prolific,16,14,8,7,7,8,"Raze,Viper,Omen,Jett,Skye","Breach,Raze,Cypher,Omen,Chamber"
Icebox,RYL | Royal Legion,Jabba Enjoyers,4,13,0,5,8,4,"Killjoy,Viper,Jett,KAY/O,Gekko","Sova,Killjoy,Viper,Jett,Deadlock"
Sunset,R8 Esports,Team Occupy,13,9,3,7,2,10,"Breach,Cypher,Sova,Omen,Yoru","Breach,Raze,Cypher,Sova,Omen"
Icebox,top gz,Skulls Esports,13,3,9,3,0,4,"Sova,Killjoy,Viper,Sage,Jett","Killjoy,Viper,Reyna,Jett,Gekko"
Sunset,NASR Esports,GAMAX eSports,13,9,11,1,8,2,"Breach,Raze,Cypher,Omen,Fade","Breach,Raze,Cypher,Omen,Fade"
Split,Surely Tragic,Elysian Esports,9,13,6,6,7,3,"Breach,Raze,Omen,Gekko,Deadlock","Breach,Raze,Cypher,Omen,Fade"
Ascent,Coalesce,DSQ Esports,13,4,8,4,0,5,"Cypher,Sova,Omen,Jett,KAY/O","Sova,Killjoy,Omen,Jett,KAY/O"
Ascent,R3VOLT,EXO Clan,6,13,0,7,6,6,"Sova,Killjoy,Omen,Jett,KAY/O","Breach,Phoenix,Omen,KAY/O,Deadlock"
Sunset,Onyx Ravens,Team RA'AD,9,13,4,6,7,5,"Breach,Raze,Cypher,Sova,Omen","Breach,Raze,Cypher,Omen,Gekko"
Icebox,Team Galaga Kitsune,LUA Gaming,13,6,10,2,4,3,"Sova,Killjoy,Viper,Sage,Jett","Sova,Killjoy,Viper,Sage,Jett"
Icebox,Team Falcons Vega,NASR Ignite,12,14,4,9,5,8,"Reyna,Omen,KAY/O,Harbor,Gekko","Sova,Killjoy,Viper,Jett,Gekko"
Lotus,Twisted Saints Esports,Team Prolific,9,13,6,6,7,3,"Breach,Raze,Omen,Jett,Skye","Breach,Killjoy,Omen,Neon,Gekko"
Lotus,Coalesce,DSQ Esports,13,4,4,1,3,9,"Raze,Cypher,Omen,Jett,Skye","Raze,Killjoy,Viper,Omen,Fade"
Lotus,RYL | Royal Legion,Jabba Enjoyers,13,5,2,4,1,11,"Raze,Viper,Omen,Chamber,Fade","Breach,Raze,Killjoy,Omen,Fade"
Ascent,Axolotl,DSYRE,10,13,5,6,7,5,"Breach,Killjoy,Viper,Omen,Yoru","Sova,Killjoy,Omen,Jett,KAY/O"
Ascent,Solar Flare,Tani eSports,3,13,0,4,9,3,"Cypher,Sova,Omen,Jett,KAY/O","Cypher,Sova,Omen,Jett,KAY/O"
Ascent,Surely Tragic,Elysian Esports,8,13,5,4,9,3,"Sova,Killjoy,Omen,Jett,KAY/O","Sova,Killjoy,Omen,Jett,KAY/O"
Sunset,R3VOLT,EXO Clan,13,7,8,4,3,5,"Breach,Raze,Cypher,Sova,Omen","Raze,Cypher,Reyna,Omen,Gekko"
Split,Underground Gaming,The Ultimates,4,13,1,4,9,3,"Raze,Cypher,Viper,Omen,Skye","Raze,Viper,Jett,Skye,Astra"
Bind,Lumina Gaming,Andromeda Gaming,2,13,1,11,2,1,"Raze,Viper,Brimstone,Skye,Yoru","Raze,Viper,Brimstone,Skye,Gekko"
Lotus,Vision Esports,Dragons Esports,5,13,2,10,3,3,"Breach,Raze,Cypher,Omen,Fade","Raze,Killjoy,Viper,Omen,Fade"
Ascent,Impulse GW,SAW,6,13,3,4,9,3,"Sova,Killjoy,Omen,Jett,KAY/O","Sova,Killjoy,Omen,Jett,KAY/O"
Split,Team Galaga Kitsune,LUA Gaming,16,18,8,9,9,8,"Breach,Raze,Cypher,Omen,Jett","Breach,Raze,Cypher,Omen,Skye"
Sunset,Valiant GC,Odd 1 OUT,9,13,7,5,8,2,"Raze,Cypher,Omen,KAY/O,Gekko","Cypher,Sova,KAY/O,Neon,Clove"
Icebox,Outplayed,NOVO Esports,13,7,6,2,5,7,"Killjoy,Viper,Jett,KAY/O,Gekko","Sova,Killjoy,Viper,Sage,Jett"
Ascent,Team Falcons,Twisted Minds Esports,13,8,8,1,7,5,"Sova,Jett,Astra,KAY/O,Fade","Cypher,Sova,Phoenix,Omen,Jett"
Ascent,Unity Esports,Fraggerz,13,11,7,5,6,6,"Breach,Cypher,Sova,Omen,Jett","Raze,Cypher,Sova,Omen,Jett"
Lotus,Underground Gaming,The Ultimates,13,6,5,2,4,8,"Raze,Killjoy,Viper,Omen,Gekko","Breach,Raze,Cypher,Sova,Omen"
Ascent,POK,New Origins Esports,2,13,2,10,3,0,"Sova,Killjoy,Omen,Jett,KAY/O","Breach,Sova,Killjoy,Omen,Jett"
Lotus,Lumina Gaming,Andromeda Gaming,9,13,7,5,8,2,"Breach,Raze,Killjoy,Omen,Gekko","Breach,Raze,Killjoy,Omen,Fade"
Sunset,Vision Esports,Dragons Esports,15,13,8,6,7,7,"Breach,Raze,Cypher,Omen,Fade","Raze,Cypher,Viper,Omen,Fade"
Breeze,FTW LEÇA FC,GTZ Esports,9,13,7,5,8,2,"Cypher,Sova,Viper,Jett,Astra","Cypher,Sova,Viper,Jett,Yoru"
Split,Team Falcons,Twisted Minds Esports,13,9,9,3,6,4,"Breach,Raze,Cypher,Omen,Skye","Raze,Viper,Omen,Jett,Skye"
Ascent,Dimonis,Ursus Gaming,13,6,8,4,2,5,"Sova,Killjoy,Omen,Jett,KAY/O","Sova,Killjoy,Omen,Jett,KAY/O"
Lotus,Thin Fecking Ice,REY ACADEMY,7,13,2,6,7,5,"Raze,Killjoy,Viper,Omen,Fade","Raze,Viper,Omen,Chamber,Gekko"
Lotus,Unity Esports,Fraggerz,13,9,8,2,7,5,"Breach,Cypher,Sova,Omen,Jett","Breach,Raze,Killjoy,Omen,Skye"
Ascent,Vision Esports,Dragons Esports,1,13,1,11,2,0,"Breach,Sova,Killjoy,Omen,Jett","Cypher,Sova,Omen,Jett,KAY/O"
Ascent,Underground Gaming,The Ultimates,12,14,4,9,5,8,"Sova,Killjoy,Omen,Jett,KAY/O","Sova,Killjoy,Omen,Jett,KAY/O"
Sunset,LONETEAM,RTZN,13,9,9,3,6,4,"Breach,Raze,Cypher,Sova,Omen","Breach,Raze,Cypher,Omen,Gekko"
Icebox,Valiant GC,Odd 1 OUT,13,11,7,5,6,6,"Sova,Killjoy,Viper,Sage,Jett","Sova,Killjoy,Viper,Jett,KAY/O"
Bind,Nottingham Trent,Staffordshire University,7,13,6,6,7,1,"Raze,Cypher,Brimstone,Skye,Gekko","Raze,Cypher,Brimstone,Jett,Gekko"
Sunset,cunnyfuntsss,Orkadia,7,13,1,7,6,6,"Raze,Cypher,Omen,KAY/O,Gekko","Raze,Cypher,Omen,KAY/O,Gekko"
Icebox,Surely Tragic,Vanir,5,13,2,4,9,3,"Sova,Killjoy,Viper,Harbor,Gekko","Sova,Killjoy,Viper,Sage,Jett"
Sunset,HOF Esports,EX0TIK GAMING,13,7,5,3,4,8,"Breach,Raze,Cypher,Sova,Omen","Breach,Raze,Cypher,Omen,Gekko"
Bind,Thin Fecking Ice,REY ACADEMY,13,9,5,5,4,8,"Breach,Raze,Viper,Brimstone,Yoru","Raze,Cypher,Brimstone,Skye,Yoru"
Lotus,Dimonis,Ursus Gaming,14,12,10,3,9,4,"Raze,Killjoy,Viper,Omen,Gekko","Breach,Raze,Killjoy,Omen,Gekko"
Icebox,cunnyfuntsss,Orkadia,10,13,6,6,7,4,"Reyna,Jett,Chamber,Gekko,Clove","Sova,Viper,Sage,Reyna,Chamber"
Ascent,Valiant GC,Odd 1 OUT,11,13,3,9,4,8,"Cypher,Sova,Omen,Jett,KAY/O","Sova,Killjoy,Omen,Jett,KAY/O"
Ascent,Nottingham Trent,Staffordshire University,8,13,7,5,8,1,"Cypher,Sova,Omen,Jett,KAY/O","Cypher,Sova,Omen,Jett,KAY/O"
Ascent,Surely Tragic,Vanir,12,14,5,8,6,7,"Sova,Killjoy,Omen,Jett,KAY/O","Cypher,Sova,Omen,Jett,Deadlock"
Lotus,cunnyfuntsss,Orkadia,13,7,9,3,4,4,"Raze,Cypher,Skye,Gekko,Clove","Raze,Killjoy,Viper,Omen,Fade"
Lotus,FUZOS,PPP,6,13,5,7,6,1,"Raze,Cypher,Viper,Omen,Fade","Breach,Cypher,Sova,Omen,Neon"
Icebox,Thin Fecking Ice,REY ACADEMY,10,13,3,8,5,7,"Sova,Killjoy,Viper,Reyna,KAY/O","Raze,Killjoy,Viper,Yoru,KAY/O"
Split,Nottingham Trent,Staffordshire University,13,11,6,6,5,7,"Breach,Raze,Cypher,Omen,Skye","Raze,Cypher,Omen,Jett,Skye"
Bind,Riddim,Orkadia,1,13,1,11,2,0,"Raze,Cypher,Viper,Brimstone,Skye","Raze,Viper,Brimstone,Skye,Gekko"
Ascent,Staffordshire University,University of Göttingen,16,14,9,6,8,7,"Cypher,Sova,Omen,Jett,KAY/O","Sova,Killjoy,Phoenix,Omen,KAY/O"
Ascent,Riddim,Orkadia,5,13,1,11,2,4,"Sova,Killjoy,Omen,Jett,KAY/O","Sova,Killjoy,Omen,Jett,KAY/O"
Lotus,Staffordshire University,University of Göttingen,13,8,6,6,2,7,"Raze,Omen,Jett,Skye,Gekko","Breach,Raze,Killjoy,Omen,Skye"
Breeze,cunnyfuntsss,Section 5.1,13,2,10,2,0,3,"Killjoy,Viper,Jett,Yoru,KAY/O","Raze,Cypher,Sova,Viper,Reyna"
Split,cunnyfuntsss,Section 5.1,13,7,6,6,1,7,"Raze,Cypher,Skye,Deadlock,Clove","Breach,Raze,Cypher,Brimstone,Reyna"
Lotus,Zero MarksMen Black,Ranked Nightmares,16,14,13,2,12,3,"Raze,Killjoy,Viper,Omen,Fade","Breach,Raze,Cypher,Omen,Fade"
Ascent,Zero MarksMen Black,Ranked Nightmares,2,13,2,10,3,0,"Sova,Killjoy,Omen,Jett,KAY/O","Sova,Killjoy,Omen,Jett,KAY/O"
Ascent,raindrops,YIPPEE,13,8,10,2,6,3,"Cypher,Sova,Omen,Jett,KAY/O","Sova,Killjoy,Omen,Jett,KAY/O"
Sunset,RyZ Knights,Time Machine,13,8,4,5,3,9,"Breach,Raze,Cypher,Sova,Clove","Breach,Raze,Cypher,Omen,Gekko"
Sunset,raindrops,YIPPEE,13,4,8,4,0,5,"Breach,Raze,Cypher,Omen,Gekko","Raze,Cypher,Omen,KAY/O,Gekko"
Lotus,Ions Day Care,whats a pretzel,13,4,9,3,1,4,"Raze,Killjoy,Omen,Jett,Fade","Raze,Killjoy,Viper,Omen,Skye"
Bind,Let Us Think,alvinboy fanclub,11,13,4,8,5,7,"Raze,Brimstone,Skye,Gekko,Clove","Raze,Cypher,Brimstone,Skye,Clove"
Bind,Zero MarksMen Black,Ranked Nightmares,16,14,9,6,8,7,"Raze,Viper,Brimstone,Skye,Gekko","Raze,Viper,Brimstone,Fade,Gekko"
Icebox,RyZ Knights,Time Machine,13,4,3,2,2,10,"Sova,Killjoy,Viper,Reyna,Jett","Sova,Killjoy,Viper,Jett,Gekko"
Sunset,Ions Day Care,whats a pretzel,13,4,4,1,3,9,"Raze,Cypher,Omen,Fade,Deadlock","Breach,Raze,Cypher,Omen,Gekko"
Lotus,Let Us Think,alvinboy fanclub,9,13,5,7,6,4,"Raze,Viper,Omen,Fade,Deadlock","Raze,Cypher,Viper,Skye,Clove"
Lotus,raindrops,YIPPEE,13,9,8,4,5,5,"Cypher,Phoenix,Omen,Jett,Gekko","Raze,Killjoy,Viper,Omen,Fade"
Split,FlyQuest RED,Reformed GC,5,13,5,7,6,0,"Raze,Cypher,Viper,Omen,Skye","Raze,Cypher,Viper,Omen,Skye"
Icebox,Let Us Think,alvinboy fanclub,13,5,6,0,5,7,"Sova,Killjoy,Harbor,Gekko,Clove","Sova,Killjoy,Viper,Jett,Gekko"
Sunset,Zero MarksMen Black,DOOMSDAY,14,12,6,7,5,8,"Breach,Raze,Cypher,Omen,Gekko","Breach,Raze,Cypher,Omen,Gekko"
Icebox,SaD Purple,Tall guys,13,8,8,4,4,5,"Sova,Killjoy,Viper,Reyna,Jett","Raze,Sova,Killjoy,Viper,Reyna"
Lotus,whats a pretzel,Sexy Gang,13,8,7,2,6,6,"Raze,Viper,Omen,Fade,Deadlock","Breach,Raze,Cypher,Omen,Fade"
Ascent,YDZ Esports,Dog Barkers,13,3,4,0,3,9,"Sova,Killjoy,Jett,KAY/O,Clove","Sova,Killjoy,Omen,Jett,KAY/O"
Sunset,Undecisive,Time Machine,10,13,7,5,8,3,"Breach,Raze,Cypher,Sova,Omen","Raze,Cypher,Omen,KAY/O,Gekko"
Bind,Ions Day Care,Culturized,13,8,7,2,6,6,"Raze,Viper,Brimstone,Jett,Clove","Raze,Cypher,Viper,Brimstone,Skye"
Lotus,Let Us Think,LazerrFreeks Mythic,13,3,11,1,2,2,"Raze,Viper,Omen,Fade,Deadlock","Breach,Raze,Cypher,Omen,Gekko"
Breeze,SaD Purple,Tall guys,13,7,9,3,4,4,"Cypher,Sova,Viper,Jett,Yoru","Cypher,Sova,Viper,Jett,Yoru"
Ascent,Zero MarksMen Black,DOOMSDAY,13,6,4,3,3,9,"Sova,Killjoy,Omen,Jett,KAY/O","Sova,Killjoy,Omen,Jett,KAY/O"
Ascent,RyZ Knights,PDF Files,15,13,5,9,4,10,"Sova,Killjoy,Omen,Jett,KAY/O","Sova,Killjoy,Omen,Jett,KAY/O"
Lotus,YDZ Esports,Dog Barkers,13,5,9,3,2,4,"Raze,Cypher,Gekko,Deadlock,Clove","Raze,Killjoy,Omen,Skye,Gekko"
Bind,FlyQuest RED,Reformed GC,13,15,7,7,8,6,"Raze,Viper,Skye,Astra,Gekko","Raze,Viper,Brimstone,Skye,Deadlock"
Split,Ions Day Care,Culturized,13,5,5,1,4,8,"Raze,Cypher,Jett,Astra,Fade","Breach,Raze,Cypher,Omen,Gekko"
Sunset,UST Esports,TAMU Maroon,13,10,6,6,4,7,"Breach,Raze,Cypher,Omen,Gekko","Breach,Raze,Cypher,Omen,Fade"
Bind,whats a pretzel,Sexy Gang,13,10,5,7,3,8,"Raze,Viper,Brimstone,Skye,Gekko","Raze,Cypher,Brimstone,Skye,Chamber"
Sunset,Special Grade,Ranked Nightmares,8,13,2,7,6,6,"Raze,Cypher,Omen,KAY/O,Gekko","Breach,Raze,Cypher,Omen,Gekko"
Ascent,Undecisive,Time Machine,13,10,5,7,3,8,"Sova,Killjoy,Omen,Jett,KAY/O","Sova,Killjoy,Omen,Jett,KAY/O"
Icebox,UST Esports,TAMU Maroon,13,4,4,1,3,9,"Sova,Killjoy,Viper,Reyna,Jett","Sova,Killjoy,Viper,Jett,Gekko"
Bind,RyZ Knights,PDF Files,13,8,6,3,5,7,"Raze,Cypher,Viper,Brimstone,Skye","Raze,Brimstone,Jett,Skye,Chamber"
Icebox,YDZ Esports,SaD Purple,7,13,4,8,5,3,"Sova,Killjoy,Viper,Jett,KAY/O","Sova,Killjoy,Viper,Reyna,Jett"
Split,IOUNL,DOOMSDAY,8,13,2,7,6,6,"Raze,Cypher,Sage,Omen,Skye","Raze,Cypher,Viper,Omen,Skye"
Sunset,Dog Barkers,Tall guys,3,13,1,11,2,2,"Cypher,Omen,Yoru,Fade,Harbor","Raze,Cypher,Omen,Yoru,Gekko"
Icebox,Let Us Think,LazerrFreeks Mythic,15,13,7,7,6,8,"Sova,Killjoy,Harbor,Gekko,Clove","Killjoy,Viper,Jett,KAY/O,Gekko"
Bind,Undecisive,Time Machine,3,13,2,10,3,1,"Raze,Viper,Brimstone,Skye,Yoru","Raze,Cypher,Viper,Brimstone,Skye"
Bind,Special Grade,Ranked Nightmares,7,13,3,5,8,4,"Raze,Viper,Brimstone,Skye,Chamber","Raze,Viper,Brimstone,Fade,Gekko"
Ascent,FlyQuest RED,Solstice GC,13,10,4,8,2,9,"Sova,Killjoy,Omen,Jett,KAY/O","Sova,Killjoy,Omen,Jett,KAY/O"
Ascent,Culturized,Aspyre x Swarm,13,10,4,8,2,9,"Sova,Killjoy,Omen,Jett,KAY/O","Sova,Killjoy,Omen,Jett,KAY/O"
Split,Reformed GC,mesos millionaires,13,2,3,0,2,10,"Raze,Cypher,Viper,Omen,Skye","Raze,Cypher,Omen,Jett,Skye"
Breeze,UST Esports,TAMU Maroon,13,8,11,1,7,2,"Cypher,Sova,Viper,Jett,KAY/O","Cypher,Sova,Viper,Yoru,Astra"
Sunset,Lionheart eSports,PDF Files,9,13,2,10,3,7,"Breach,Cypher,Sova,Omen,Neon","Raze,Cypher,Reyna,Omen,Skye"
Lotus,FFE,LazerrFreeks Mythic,3,13,0,4,9,3,"Raze,Killjoy,Viper,Omen,Fade","Breach,Raze,Cypher,Omen,Gekko"
Lotus,Luminescent Sapphire,YDZ Esports,6,13,3,4,9,3,"Raze,Killjoy,Viper,Omen,Fade","Raze,Cypher,Gekko,Deadlock,Clove"
Bind,Dog Barkers,Lotus 8 Esports,13,8,7,2,6,6,"Raze,Cypher,Viper,Brimstone,Skye","Raze,Brimstone,Reyna,Skye,Harbor"
Lotus,Culturized,Aspyre x Swarm,13,6,6,1,5,7,"Breach,Raze,Cypher,Omen,Gekko","Raze,Killjoy,Viper,Omen,Fade"
Ascent,Orangutan Gang,SaD Purple,13,15,2,12,3,11,"Sova,Killjoy,Omen,Jett,KAY/O","Sova,Killjoy,Omen,Jett,KAY/O"
Bind,FlyQuest RED,Solstice GC,13,10,4,8,2,9,"Raze,Viper,Skye,Astra,Gekko","Raze,Viper,Brimstone,Skye,Yoru"
Icebox,Reformed GC,mesos millionaires,13,6,9,3,3,4,"Killjoy,Viper,Sage,Jett,Gekko","Sova,Killjoy,Viper,Sage,Jett"
Breeze,Team Occupy,top gz,13,10,4,8,2,9,"Cypher,Sova,Viper,Reyna,Yoru","Cypher,Sova,Viper,Jett,KAY/O"
Lotus,IOUNL,DOOMSDAY,14,16,6,9,7,8,"Raze,Cypher,Sova,Omen,Skye","Raze,Killjoy,Viper,Omen,Fade"
Breeze,BALLZ V3.0,Tall guys,2,13,2,10,3,0,"Cypher,Sova,Viper,Jett,Yoru","Cypher,Sova,Viper,Jett,Yoru"
Split,Time Machine,overcook,13,3,3,1,2,10,"Raze,Cypher,Jett,Skye,Astra","Raze,Cypher,Jett,Skye,Astra"
Split,SJSU Blue,Blinn Esports,6,13,1,6,7,5,"Raze,Cypher,Jett,Skye,Astra","Raze,Cypher,Viper,Omen,Skye"
Lotus,Ranked Nightmares,1Millisecond,13,11,7,5,6,6,"Breach,Raze,Killjoy,Omen,Fade","Breach,Raze,Cypher,Omen,Fade"
Icebox,The GRID,CHURCH OF CHAEWON KIM,13,4,8,4,0,5,"Sova,Killjoy,Reyna,Jett,Harbor","Sova,Killjoy,Viper,Jett,Gekko"
Ascent,Lionheart eSports,PDF Files,9,13,4,8,5,5,"Sova,Killjoy,Omen,Jett,KAY/O","Sova,Killjoy,Reyna,Omen,Jett"
Icebox,IOUNL,DOOMSDAY,13,4,4,1,3,9,"Sova,Killjoy,Viper,Reyna,Jett","Breach,Killjoy,Viper,Jett,Neon"
Bind,Culturized,Aspyre x Swarm,11,13,6,6,7,5,"Raze,Cypher,Viper,Brimstone,Skye","Raze,Cypher,Viper,Brimstone,Skye"
Sunset,FFE,LazerrFreeks Mythic,11,13,5,7,6,6,"Cypher,Sova,Omen,KAY/O,Neon","Breach,Raze,Cypher,Omen,Fade"
Icebox,Time Machine,overcook,13,6,5,2,4,8,"Sova,Killjoy,Viper,Reyna,Jett","Sova,Killjoy,Viper,Jett,Clove"
Split,BALLZ V3.0,Jack n Frens ,13,4,4,1,3,9,"Breach,Raze,Cypher,Skye,Astra","Breach,Raze,Cypher,Omen,Skye"
Ascent,Ranked Nightmares,1Millisecond,13,3,4,0,3,9,"Sova,Killjoy,Omen,Jett,KAY/O","Sova,Killjoy,Omen,Jett,KAY/O"
Bind,SJSU Blue,Blinn Esports,3,13,0,4,9,3,"Raze,Cypher,Brimstone,Reyna,Skye","Raze,Viper,Brimstone,KAY/O,Gekko"
Lotus,The GRID,CHURCH OF CHAEWON KIM,13,2,10,2,0,3,"Breach,Cypher,Omen,Neon,Gekko","Raze,Killjoy,Viper,Omen,Fade"
Ascent,SaD Purple,F1 Esports,13,5,5,1,4,8,"Sova,Killjoy,Omen,Jett,KAY/O","Cypher,Sova,Omen,Jett,KAY/O"
Ascent,Orangutan Gang,Goated,13,10,6,6,4,7,"Sova,Killjoy,Omen,Jett,KAY/O","Sova,Killjoy,Omen,Jett,KAY/O"
Lotus,Luminescent Sapphire,Hyjinx Violet,13,10,5,6,4,8,"Raze,Killjoy,Viper,Omen,Fade","Raze,Killjoy,Viper,Omen,Fade"
Lotus,YDZ Esports,Sky Esports (NA),13,9,8,2,7,5,"Raze,Cypher,Gekko,Deadlock,Clove","Raze,Killjoy,Omen,Fade,Gekko"
Lotus,Lotus 8 Esports,Omnipotence,13,7,6,6,1,7,"Breach,Raze,Omen,Jett,Skye","Raze,Killjoy,Omen,Fade,Gekko"
Lotus,FAWZ Purple,Tall guys,10,13,9,2,11,1,"Raze,Killjoy,Viper,Omen,Fade","Raze,Killjoy,Omen,Jett,Gekko"
Icebox,Dog Barkers,Spate Esports,13,6,8,4,2,5,"Sova,Killjoy,Viper,Jett,Gekko","Viper,Jett,KAY/O,Gekko,Clove"
Bind,GAMAX eSports,R8 Esports,8,13,4,5,8,4,"Raze,Cypher,Brimstone,Reyna,Skye","Raze,Cypher,Viper,Brimstone,Skye"
Icebox,Outplayed,LONETEAM,9,13,3,9,4,6,"Killjoy,Viper,Jett,KAY/O,Gekko","Sova,Killjoy,Viper,Jett,Gekko"
Icebox,CKnights,BALLZ V3.0,1,13,1,11,2,0,"Killjoy,Viper,Jett,KAY/O,Gekko","Sova,Killjoy,Viper,Jett,Gekko"
Lotus,Harmony,Jack n Frens ,10,13,5,6,7,5,"Breach,Raze,Killjoy,Omen,Fade","Breach,Raze,Viper,Omen,Gekko"
Bind,:3,Sky Esports (NA),5,13,1,5,8,4,"Raze,Cypher,Viper,Brimstone,Skye","Raze,Viper,Brimstone,Skye,Gekko"
Lotus,Lotus 8 Esports,Guangzhou Gooners,13,7,9,3,4,4,"Breach,Raze,Omen,Jett,Skye","Raze,Killjoy,Viper,Omen,Fade"
Ascent,Orangutan Gang,TEAM T2G,13,6,6,6,0,7,"Sova,Killjoy,Omen,Jett,KAY/O","Sova,Killjoy,Omen,Jett,KAY/O"
Ascent,Elysian Esports,Babos Gaming,13,7,6,6,1,7,"Sova,Killjoy,Omen,Jett,KAY/O","Sova,Killjoy,Omen,KAY/O,Neon"
Ascent,YDZ Esports,Reactor 9,13,2,10,2,0,3,"Sova,Killjoy,Jett,KAY/O,Clove","Sova,Killjoy,Omen,Jett,KAY/O"
Split,Meow Meow (NA),Omnipotence,4,13,2,10,3,2,"Raze,Sage,Omen,Skye,Gekko","Breach,Raze,Cypher,Omen,Skye"
Ascent,F1 Esports,blade,13,6,8,4,2,5,"Cypher,Sova,Omen,Jett,KAY/O","Sova,Killjoy,Omen,Jett,KAY/O"
Lotus,Spate Esports,Harmony White,13,4,10,2,2,3,"Breach,Raze,Cypher,Omen,Gekko","Breach,Raze,Killjoy,Omen,Fade"
Lotus,Tall guys,ST x WTP,13,10,5,7,3,8,"Raze,Killjoy,Omen,Jett,Gekko","Raze,Killjoy,Omen,Fade,Gekko"
Bind,Booty Lover Esports,Dog Barkers,3,13,0,4,9,3,"Raze,Cypher,Brimstone,Jett,Gekko","Breach,Reyna,Yoru,Deadlock,Clove"
Ascent,Goated,CocoNUTS,13,9,8,2,7,5,"Sova,Killjoy,Omen,Jett,KAY/O","Cypher,Brimstone,Reyna,Jett,Clove"
Ascent,FAWZ Purple,Shirtless Gamers,13,6,9,3,3,4,"Sova,Killjoy,Omen,Jett,KAY/O","Sova,Killjoy,Omen,Jett,KAY/O"
Lotus,Kaizen Esports Red,Luminescent Sapphire,8,13,4,8,5,4,"Breach,Raze,Killjoy,Omen,Fade","Raze,Killjoy,Viper,Omen,Fade"
Bind,Team Occupy,top gz,13,7,7,5,2,6,"Raze,Cypher,Brimstone,Reyna,Skye","Raze,Cypher,Viper,Brimstone,Skye"
Lotus,GAMAX eSports,R8 Esports,7,13,4,4,9,3,"Breach,Raze,Cypher,Sova,Omen","Raze,Killjoy,Omen,Skye,Astra"
Split,Team RA'AD,NASR Esports,14,12,5,8,4,9,"Raze,Cypher,Viper,Omen,Skye","Breach,Raze,Cypher,Sova,Omen"
Sunset,Formulation Gaming,OnlyFins,13,11,10,2,9,3,"Cypher,Sova,Omen,KAY/O,Neon","Breach,Raze,Cypher,Omen,Gekko"
Icebox,NOVO Esports,VX300 Gaming,13,5,11,1,4,2,"Sova,Killjoy,Viper,Sage,Jett","Sova,Killjoy,Viper,Omen,Yoru"
Sunset,Elysian Esports,Babos Gaming,13,11,8,4,7,5,"Cypher,Sova,Omen,KAY/O,Neon","Breach,Cypher,Omen,Neon,Gekko"
Breeze,G2 Gozen,BBL Queens,13,4,9,3,1,4,"Cypher,Sova,Viper,Jett,KAY/O","Cypher,Sova,Viper,Jett,Skye"
Icebox,Team RA'AD,NASR Esports,13,9,8,2,7,5,"Killjoy,Sage,Omen,Gekko,Clove","Killjoy,Viper,Omen,KAY/O,Gekko"
Sunset,INF Esports,Gladius,2,13,2,10,3,0,"Breach,Cypher,Omen,Jett,KAY/O","Raze,Cypher,Omen,KAY/O,Gekko"
Sunset,Supernova GC (EU),LUA Gaming,2,13,0,3,10,2,"Breach,Raze,Cypher,Omen,Gekko","Breach,Raze,Cypher,Sova,Omen"
Ascent,DSYRE,HGE Esports,13,5,9,3,2,4,"Sova,Killjoy,Omen,Jett,KAY/O","Sova,Killjoy,Omen,Jett,KAY/O"
Ascent,Formulation Gaming,OnlyFins,14,12,4,9,3,10,"Cypher,Sova,Omen,Jett,KAY/O","Sova,Killjoy,Omen,Jett,KAY/O"
Bind,G2 Gozen,BBL Queens,13,3,2,2,1,11,"Raze,Viper,Omen,Skye,Gekko","Raze,Viper,Brimstone,Sage,Skye"
Lotus,Dragons Esports,Underground Gaming,13,8,9,3,5,4,"Raze,Killjoy,Viper,Omen,Fade","Raze,Killjoy,Viper,Omen,Gekko"
Sunset,Twisted Minds Esports,Vision Esports,13,9,8,2,7,5,"Raze,Cypher,Omen,KAY/O,Gekko","Breach,Raze,Cypher,Omen,Fade"
Sunset,The Ultimates,Unity Esports,7,13,6,6,7,1,"Breach,Raze,Sage,Omen,Gekko","Breach,Cypher,Omen,Jett,Fade"
Lotus,INF Esports,Gladius,5,13,4,8,5,1,"Breach,Killjoy,Omen,Neon,Gekko","Raze,Killjoy,Omen,KAY/O,Gekko"
Sunset,Team Galaga Kitsune,MAD Lions KOI,2,13,0,3,10,2,"Breach,Raze,Cypher,Omen,Gekko","Breach,Raze,Cypher,Omen,Deadlock"
Split,Fraggerz,Team Falcons,7,13,2,6,7,5,"Breach,Raze,Cypher,Omen,Gekko","Breach,Raze,Cypher,Omen,Skye"
Lotus,Melilla Titans Aura,Supernova GC (EU),10,13,7,5,8,3,"Breach,Raze,Killjoy,Omen,Skye","Breach,Raze,Killjoy,Omen,Gekko"
Sunset,LUA Gaming,Imperium Livia,13,4,10,2,2,3,"Breach,Raze,Cypher,Sova,Omen","Breach,Raze,Cypher,Omen,Deadlock"
Lotus,FOKUS Sakura,Karmine Corp GC,6,13,1,6,7,5,"Breach,Raze,Killjoy,Omen,Skye","Breach,Raze,Killjoy,Omen,Fade"
Icebox,NXT,SweetNsour,3,13,0,4,9,3,"Killjoy,Viper,Jett,KAY/O,Gekko","Killjoy,Viper,Jett,KAY/O,Gekko"
Sunset,Dragons Esports,Underground Gaming,13,5,3,3,2,10,"Raze,Cypher,Viper,Omen,Fade","Cypher,Sova,Omen,Neon,Gekko"
Ascent,Twisted Minds Esports,Vision Esports,13,6,5,2,4,8,"Cypher,Sova,Phoenix,Omen,Jett","Breach,Sova,Killjoy,Omen,Jett"
Icebox,University of Göttingen,TUD Apes,13,10,3,8,2,10,"Sova,Killjoy,Viper,Sage,Jett","Sova,Killjoy,Viper,Reyna,Jett"
Bind,The Ultimates,Unity Esports,11,13,7,5,8,4,"Raze,Viper,Omen,KAY/O,Gekko","Breach,Raze,Viper,Brimstone,Gekko"
Sunset,RTZN,Axolotl,17,15,6,10,5,11,"Breach,Raze,Cypher,Omen,Gekko","Raze,Cypher,Phoenix,Omen,Gekko"
Bind,Team Galaga Kitsune,MAD Lions KOI,13,11,6,6,5,7,"Breach,Raze,Cypher,Brimstone,Gekko","Breach,Raze,Cypher,Brimstone,Gekko"
Split,Project 1,Free Orbs,7,13,2,10,3,5,"Raze,Cypher,Viper,Omen,Skye","Breach,Raze,Cypher,Omen,Skye"
Ascent,Nottingham Trent,NUPESU,10,13,4,8,5,6,"Sova,Killjoy,Omen,Jett,KAY/O","Sova,Killjoy,Sage,Jett,Clove"
Lotus,Staffordshire University,Owls UPC,13,9,10,2,7,3,"Raze,Omen,Jett,Skye,Gekko","Breach,Raze,Killjoy,Omen,Gekko"
Breeze,FOKUS Sakura,Karmine Corp GC,5,13,1,5,8,4,"Cypher,Sova,Viper,Jett,KAY/O","Cypher,Sova,Viper,Jett,KAY/O"
Ascent,University of Göttingen,TUD Apes,10,13,7,5,8,3,"Cypher,Sova,Phoenix,Omen,KAY/O","Sova,Killjoy,Phoenix,Omen,Jett"
Lotus,Vay Esports GC,Imperium Livia,5,13,5,7,6,0,"Breach,Raze,Killjoy,Omen,Gekko","Breach,Raze,Killjoy,Omen,Gekko"
Lotus,Anselmo,Supernova GC (EU),11,13,6,6,7,5,"Breach,Killjoy,Omen,Neon,Gekko","Breach,Raze,Killjoy,Omen,Gekko"
Lotus,NXT,SweetNsour,11,13,3,9,4,8,"Raze,Cypher,Omen,Fade,Gekko","Raze,Killjoy,Viper,Omen,Fade"
Lotus,Project 1,Free Orbs,3,13,2,10,3,1,"Raze,Killjoy,Viper,Omen,Fade","Breach,Killjoy,Omen,Neon,Fade"
Lotus,Team Galaga Kitsune,MAD Lions KOI,6,13,5,7,6,1,"Breach,Raze,Killjoy,Omen,Gekko","Breach,Sova,Omen,Chamber,Neon"
Lotus,REY eSports,CTRL x YARI Esports,1,13,0,2,11,1,"Breach,Raze,Killjoy,Omen,Gekko","Breach,Raze,Killjoy,Omen,Fade"
Bind,Nottingham Trent,NUPESU,8,13,2,7,6,6,"Raze,Cypher,Viper,Brimstone,Skye","Raze,Cypher,Viper,Sage,Clove"
Ascent,Staffordshire University,Owls UPC,13,10,7,5,5,6,"Cypher,Sova,Omen,Jett,KAY/O","Sova,Killjoy,Phoenix,Omen,Jett"
Lotus,University of Göttingen,TUD Apes,13,11,8,4,7,5,"Breach,Raze,Killjoy,Omen,Skye","Raze,Viper,Omen,Chamber,Gekko"
Bind,REY eSports,CTRL x YARI Esports,7,13,6,2,11,1,"Raze,Viper,Skye,Gekko,Clove","Raze,Viper,Omen,Skye,Gekko"
Split,NXT,SweetNsour,13,10,9,3,7,4,"Raze,Cypher,Omen,Skye,Deadlock","Raze,Cypher,Viper,Omen,Skye"
Split,NUPESU,Staffordshire University,13,8,4,5,3,9,"Raze,Cypher,Viper,Sage,Clove","Raze,Cypher,Omen,Jett,Skye"
Sunset,Faculty of OI,TUD Apes,8,13,4,8,5,4,"Breach,Raze,Cypher,Omen,Gekko","Breach,Raze,Cypher,Omen,Gekko"
Bind,Sorbonne University,Owls UPC,10,13,5,6,7,5,"Breach,Raze,Cypher,Omen,Skye","Breach,Raze,Viper,Omen,Skye"
Icebox,Faculty of OI,TUD Apes,9,13,2,8,5,7,"Reyna,Chamber,Harbor,Gekko,Clove","Sova,Killjoy,Viper,Reyna,Jett"
Bind,NUPESU,Staffordshire University,13,9,7,3,6,6,"Raze,Cypher,Viper,Sage,Clove","Raze,Cypher,Brimstone,Jett,Gekko"
Lotus,Sorbonne University,Owls UPC,4,13,1,4,9,3,"Breach,Raze,Omen,Chamber,Gekko","Breach,Raze,Killjoy,Omen,Gekko"
Ascent,Nottingham Trent,University of Göttingen,13,9,8,4,5,5,"Sova,Killjoy,Omen,Jett,KAY/O","Sova,Killjoy,Phoenix,Omen,KAY/O"
Ascent,NUPESU,Staffordshire University,9,13,5,7,6,4,"Sova,Killjoy,Sage,Jett,Clove","Cypher,Sova,Omen,Jett,KAY/O"
Lotus,Faculty of OI,TUD Apes,13,11,8,4,7,5,"Breach,Killjoy,Omen,Neon,Gekko","Raze,Viper,Omen,Chamber,Gekko"
Sunset,Nottingham Trent,University of Göttingen,13,4,3,2,2,10,"Raze,Cypher,Omen,KAY/O,Gekko","Breach,Raze,Cypher,Omen,Gekko"
Sunset,Sorbonne University,Owls UPC,13,11,6,6,5,7,"Breach,Raze,Cypher,Omen,Gekko","Breach,Raze,Cypher,Omen,Gekko"
Ascent,Nottingham Trent,Sorbonne University,13,0,1,0,0,12,"Sova,Killjoy,Omen,Jett,KAY/O","Cypher,Sova,Reyna,Omen,Jett"
Split,NUPESU,Faculty of OI,13,5,4,2,3,9,"Raze,Cypher,Viper,Sage,Clove","Raze,Cypher,Astra,Gekko,Deadlock"
Split,TUD Apes,Staffordshire University,6,13,0,7,6,6,"Breach,Raze,Cypher,Omen,Jett","Raze,Cypher,Omen,Jett,Skye"
Icebox,University of Göttingen,Owls UPC,13,7,6,2,5,7,"Sova,Killjoy,Viper,Sage,Jett","Sova,Killjoy,Viper,Reyna,Jett"
Icebox,Area of Effect,overcook,9,13,2,8,5,7,"Sova,Killjoy,Viper,Jett,Gekko","Sova,Killjoy,Viper,Jett,Clove"
Ascent,IOUNL,CaptainDemi's Magic Band,13,7,8,4,3,5,"Cypher,Sova,Omen,Jett,Deadlock","Sova,Killjoy,Omen,Jett,KAY/O"
Bind,Culturized,Prospects,13,6,10,2,4,3,"Raze,Cypher,Viper,Brimstone,Skye","Raze,Viper,Brimstone,Yoru,Gekko"
Bind,Lionheart eSports,Slept On,13,6,8,4,2,5,"Raze,Sova,Viper,Brimstone,Skye","Raze,Viper,Brimstone,Jett,Skye"
Split,Area of Effect,overcook,13,9,7,3,6,6,"Raze,Cypher,Viper,Omen,Skye","Raze,Cypher,Jett,Skye,Astra"
Icebox,IOUNL,CaptainDemi's Magic Band,13,7,5,3,4,8,"Sova,Killjoy,Viper,Reyna,Jett","Killjoy,Viper,Jett,KAY/O,Gekko"
Lotus,Balut Warriors,YIPPEE,9,13,4,8,5,5,"Raze,Killjoy,Omen,Jett,Fade","Raze,Killjoy,Viper,Omen,Fade"
Sunset,1Millisecond,Kraken,13,11,7,5,6,6,"Breach,Raze,Cypher,Fade,Clove","Breach,Raze,Cypher,Omen,Gekko"
Lotus,Culturized,Prospects,7,13,3,5,8,4,"Breach,Raze,Cypher,Omen,Gekko","Raze,Killjoy,Viper,Omen,Fade"
Ascent,DOOMSDAY,MERC CLAN,13,4,10,2,2,3,"Sova,Killjoy,Omen,Jett,KAY/O","Sova,Killjoy,Omen,Jett,KAY/O"
Sunset,Lionheart eSports,Slept On,13,9,7,5,4,6,"Breach,Cypher,Sova,Omen,Neon","Breach,Raze,Cypher,Omen,Fade"
Lotus,Valkyrie,Six Figures,13,11,5,7,4,8,"Breach,Raze,Omen,Jett,Skye","Raze,Killjoy,Viper,Fade,Clove"
Icebox,1Millisecond,Kraken,13,7,6,2,5,7,"Killjoy,Viper,Jett,KAY/O,Gekko","Sova,Killjoy,Viper,Jett,Gekko"
Icebox,Special Grade,CHURCH OF CHAEWON KIM,13,7,6,2,5,7,"Killjoy,Viper,Jett,KAY/O,Gekko","Sova,Killjoy,Viper,Jett,Gekko"
Icebox,Balut Warriors,YIPPEE,13,10,4,8,2,9,"Raze,Reyna,Jett,Harbor,Clove","Killjoy,Viper,Jett,KAY/O,Gekko"
Sunset,LazerrFreeks Mythic,Sussy Players,13,4,11,1,3,2,"Breach,Raze,Cypher,Omen,Fade","Raze,Cypher,Omen,KAY/O,Gekko"
Lotus,IOUNL,CaptainDemi's Magic Band,13,15,7,7,8,6,"Raze,Killjoy,Viper,Omen,Fade","Raze,Killjoy,Viper,Omen,Fade"
Bind,Aspyre x Swarm,BALLZ V3.0,13,8,7,5,3,6,"Raze,Viper,Brimstone,Skye,Chamber","Raze,Brimstone,Jett,Skye,Gekko"
Bind,DOOMSDAY,MERC CLAN,13,1,11,1,0,2,"Raze,Brimstone,Skye,Yoru,Harbor","Raze,Cypher,Viper,Brimstone,Skye"
Sunset,Area of Effect,overcook,11,13,5,7,6,6,"Breach,Raze,Cypher,Sova,Omen","Raze,Cypher,Omen,Jett,Gekko"
Sunset,Culturized,Prospects,13,8,9,3,5,4,"Raze,Cypher,Omen,KAY/O,Gekko","Raze,Cypher,Omen,KAY/O,Gekko"
Lotus,Passion Project,CHURCH OF CHAEWON KIM,13,2,10,2,0,3,"Breach,Raze,Killjoy,Omen,Gekko","Raze,Killjoy,Viper,Omen,Fade"
Bind,Toads,Scarlet Knights Black,13,7,3,5,2,10,"Raze,Viper,Brimstone,Skye,Deadlock","Raze,Viper,Brimstone,Skye,Chamber"
Lotus,Lionheart eSports,Slept On,11,13,7,5,8,4,"Breach,Cypher,Omen,Neon,Fade","Raze,Cypher,Omen,KAY/O,Gekko"
Ascent,Aspyre x Swarm,BALLZ V3.0,13,1,2,0,1,11,"Sova,Killjoy,Omen,Jett,KAY/O","Sova,Killjoy,Omen,Jett,KAY/O"
Split,Valkyrie,Six Figures,10,13,3,9,4,7,"Raze,Viper,Omen,Jett,Skye","Raze,Cypher,Omen,Jett,Deadlock"
Split,Balut Warriors,YIPPEE,5,13,3,9,4,2,"Raze,Cypher,Omen,Skye,Deadlock","Raze,Cypher,Viper,Skye,Astra"
Lotus,LazerrFreeks Mythic,Sussy Players,13,9,5,7,2,8,"Breach,Raze,Cypher,Omen,Gekko","Raze,Cypher,Omen,Fade,Gekko"
Sunset,Passion Project,CHURCH OF CHAEWON KIM,13,2,10,2,0,3,"Breach,Raze,Cypher,Omen,Gekko","Breach,Raze,Cypher,Omen,Gekko"
Bind,IOUNL,Sexy Gang,7,13,2,6,7,5,"Breach,Raze,Sova,Reyna,Clove","Raze,Cypher,Brimstone,Skye,Chamber"
Sunset,Toads,Scarlet Knights Black,13,3,3,1,2,10,"Cypher,Sova,Omen,KAY/O,Neon","Raze,Cypher,Omen,Jett,Gekko"
Split,Culturized,Ranked Nightmares,7,13,5,7,6,2,"Breach,Raze,Cypher,Omen,Gekko","Raze,Cypher,Omen,Skye,Deadlock"
Sunset,Valkyrie,Six Figures,13,4,10,2,2,3,"Raze,Cypher,Omen,KAY/O,Gekko","Raze,Cypher,Omen,KAY/O,Gekko"
Ascent,BALLZ V3.0,Paranoia Esports,13,5,2,4,1,11,"Sova,Killjoy,Omen,Jett,KAY/O","Sova,Killjoy,Omen,Jett,KAY/O"
Lotus,alvinboy fanclub,1Millisecond,13,10,6,5,5,7,"Raze,Killjoy,Omen,Skye,Clove","Breach,Raze,Cypher,Omen,Fade"
Sunset,Volcano Gang,overcook,9,13,4,6,7,5,"Raze,Cypher,Omen,KAY/O,Gekko","Raze,Cypher,Omen,Jett,Gekko"
Breeze,floppers,Reformed GC,7,13,5,3,10,2,"Cypher,Sova,Viper,Yoru,Astra","Cypher,Sova,Viper,Omen,KAY/O"
Ascent,MERC CLAN,Imperial Titans,14,12,7,6,6,7,"Sova,Killjoy,Omen,Jett,KAY/O","Sova,Killjoy,Omen,Jett,KAY/O"
Bind,Kraken,Thug Shakers,13,11,4,8,3,9,"Raze,Viper,Brimstone,Fade,Gekko","Raze,Cypher,Viper,Brimstone,Skye"
Split,whats a pretzel,Lionheart eSports,13,9,5,7,2,8,"Raze,Cypher,Viper,Omen,Skye","Raze,Cypher,Omen,Skye,Neon"
Bind,Sussy Players,Hybrid Authority,13,6,9,3,3,4,"Raze,Viper,Brimstone,Skye,Yoru","Raze,Viper,Brimstone,Skye,Gekko"
Icebox,IOUNL,Sexy Gang,4,13,1,11,2,3,"Sova,Killjoy,Viper,Jett,Gekko","Sova,Killjoy,Viper,Jett,KAY/O"
Icebox,Time Machine,Aspyre x Swarm,13,8,7,5,3,6,"Sova,Killjoy,Viper,Reyna,Jett","Sova,Killjoy,Viper,Reyna,Jett"
Split,Ions Day Care,Area of Effect,13,7,9,3,4,4,"Raze,Cypher,Jett,Astra,Fade","Raze,Cypher,Viper,Omen,Skye"
Ascent,YIPPEE,DXA Esports,13,6,5,2,4,8,"Sova,Killjoy,Omen,Jett,KAY/O","Sova,Killjoy,Omen,Jett,KAY/O"
Split,FlyQuest RED,Cafe Coke,13,1,11,1,0,2,"Raze,Cypher,Viper,Omen,Skye","Breach,Raze,Cypher,Omen,Skye"
Bind,Thinking Men,DOOMSDAY,13,7,5,3,4,8,"Raze,Brimstone,Skye,Gekko,Clove","Raze,Brimstone,Skye,Yoru,Harbor"
Split,The GRID,PDF Files,13,6,7,5,1,6,"Raze,Omen,Skye,Astra,Gekko","Raze,Cypher,Reyna,Omen,Skye"
Ascent,Special Grade,Passion Project,13,8,6,6,2,7,"Sova,Killjoy,Omen,Jett,KAY/O","Sova,Killjoy,Omen,Jett,KAY/O"
Sunset,raindrops,Balut Warriors,13,2,10,2,0,3,"Breach,Raze,Cypher,Omen,Gekko","Breach,Raze,Cypher,Omen,Gekko"
Breeze,Lyrical's Daycare,CaptainDemi's Magic Band,9,13,3,7,6,6,"Cypher,Sova,Viper,Jett,Yoru","Sova,Viper,Jett,Yoru,Astra"
Ascent,Culturized,Ranked Nightmares,11,13,8,4,9,3,"Sova,Killjoy,Omen,Jett,KAY/O","Sova,Killjoy,Omen,Jett,KAY/O"
Lotus,NTE,Dexterity Gaming,9,13,4,6,7,5,"Breach,Raze,Cypher,Omen,Gekko","Jett,KAY/O,Deadlock,Iso,Clove"
Sunset,RyZ Knights,Valkyrie,13,7,11,1,6,2,"Breach,Raze,Cypher,Sova,Clove","Raze,Cypher,Omen,KAY/O,Gekko"
Ascent,Slept On,The Hideout,13,6,8,4,2,5,"Sova,Killjoy,Omen,Jett,KAY/O","Sova,Killjoy,Omen,Jett,KAY/O"
Split,Volcano Gang,overcook,10,13,3,8,5,7,"Raze,Cypher,Omen,Skye,Iso","Raze,Cypher,Omen,Jett,Skye"
Lotus,BALLZ V3.0,Paranoia Esports,11,13,6,6,7,5,"Breach,Cypher,Omen,Jett,Fade","Raze,Killjoy,Viper,Omen,Gekko"
Sunset,Undecisive,Toads,16,14,9,6,8,7,"Breach,Raze,Cypher,Sova,Omen","Cypher,Sova,Omen,KAY/O,Neon"
Breeze,Sussy Players,Hybrid Authority,13,5,5,1,4,8,"Cypher,Sova,Viper,Jett,KAY/O","Cypher,Sova,Viper,Reyna,Jett"
Split,MERC CLAN,Imperial Titans,13,11,7,5,6,6,"Raze,Cypher,Viper,Omen,Skye","Raze,Cypher,Viper,Omen,Skye"
Ascent,alvinboy fanclub,1Millisecond,14,12,7,6,6,7,"Sova,Killjoy,Omen,Jett,KAY/O","Sova,Killjoy,Omen,Jett,KAY/O"
Icebox,Thinking Men,DOOMSDAY,13,4,5,0,4,8,"Sova,Killjoy,Harbor,Gekko,Clove","Breach,Killjoy,Viper,Jett,Neon"
Ascent,Teddy Tactics,mesos millionaires,11,13,4,8,5,7,"Sova,Killjoy,Omen,Jett,KAY/O","Sova,Killjoy,Jett,Astra,KAY/O"
Ascent,Ions Day Care,Area of Effect,5,13,4,8,5,1,"Sova,Killjoy,Jett,Astra,Clove","Cypher,Sova,Omen,Jett,Deadlock"
Icebox,Kraken,Thug Shakers,13,10,7,5,5,6,"Sova,Killjoy,Viper,Jett,Gekko","Sova,Killjoy,Viper,Jett,Gekko"
Lotus,whats a pretzel,Lionheart eSports,10,13,8,4,9,2,"Raze,Killjoy,Viper,Omen,Fade","Raze,Killjoy,Skye,Yoru,Astra"
Lotus,floppers,Reformed GC,11,13,6,6,7,5,"Raze,Cypher,Omen,KAY/O,Gekko","Raze,Killjoy,Viper,Omen,Gekko"
Bind,FlyQuest RED,Cafe Coke,13,3,10,2,1,3,"Raze,Viper,Skye,Astra,Gekko","Raze,Viper,Skye,Gekko,Clove"
Bind,Prospects,Mynamejeff,13,6,5,2,4,8,"Raze,Viper,Brimstone,Yoru,Gekko","Raze,Viper,Brimstone,Skye,Gekko"
Sunset,YIPPEE,DXA Esports,13,9,10,2,7,3,"Raze,Cypher,Omen,KAY/O,Gekko","Breach,Raze,Cypher,Omen,Gekko"
Icebox,Zero MarksMen Black,LazerrFreeks Mythic,13,2,3,0,2,10,"Sova,Killjoy,Viper,Reyna,Jett","Sova,Killjoy,Viper,Jett,Gekko"
Ascent,NTE,Dexterity Gaming,2,13,0,12,1,2,"Sova,Killjoy,Omen,Jett,KAY/O","Cypher,Sova,Omen,Jett,KAY/O"
Ascent,RyZ Knights,Valkyrie,4,13,3,9,4,1,"Sova,Killjoy,Omen,Jett,KAY/O","Sova,Killjoy,Omen,Jett,KAY/O"
Ascent,IOUNL,Sexy Gang,13,11,5,7,4,8,"Cypher,Sova,Omen,Jett,Deadlock","Sova,Killjoy,Omen,Jett,KAY/O"
Bind,The GRID,PDF Files,13,11,6,6,5,7,"Raze,Reyna,Harbor,Gekko,Clove","Raze,Cypher,Brimstone,Reyna,Skye"
Lotus,raindrops,Balut Warriors,13,8,9,3,5,4,"Cypher,Phoenix,Omen,Jett,Gekko","Raze,Cypher,Omen,Fade,Deadlock"
Breeze,Special Grade,Passion Project,9,13,7,5,8,2,"Cypher,Sova,Viper,Jett,Yoru","Cypher,Sova,Viper,Jett,Yoru"
Bind,Time Machine,Aspyre x Swarm,15,13,6,8,5,9,"Raze,Viper,Brimstone,Reyna,Skye","Raze,Cypher,Viper,Brimstone,Skye"
Lotus,Solstice GC,Supernova x Pals,13,6,9,3,3,4,"Raze,Killjoy,Viper,Gekko,Clove","Raze,Killjoy,Viper,Omen,Fade"
Lotus,Lyrical's Daycare,CaptainDemi's Magic Band,9,13,4,8,5,5,"Breach,Raze,Killjoy,Omen,Gekko","Raze,Killjoy,Viper,Omen,Fade"
Icebox,BALLZ V3.0,Paranoia Esports,13,6,5,2,4,8,"Sova,Killjoy,Viper,Jett,Gekko","Killjoy,Viper,Jett,Gekko,Clove"
Bind,Medics,Six Figures,1,13,0,2,11,1,"Raze,Cypher,Brimstone,Skye,Gekko","Raze,Viper,Brimstone,Skye,Fade"
Bind,Culturized,Ranked Nightmares,13,10,7,5,5,6,"Raze,Cypher,Viper,Brimstone,Skye","Raze,Brimstone,Fade,Gekko,Deadlock"
Icebox,Volcano Gang,overcook,13,9,4,6,3,9,"Sova,Killjoy,Omen,Jett,Harbor","Sova,Viper,Reyna,Jett,Clove"
Lotus,Ions Day Care,Area of Effect,13,5,7,5,0,6,"Killjoy,Reyna,Omen,Fade,Gekko","Raze,Killjoy,Viper,Omen,Skye"
Split,CHURCH OF CHAEWON KIM,Ugly Hamsters,13,7,7,1,6,6,"Raze,Cypher,Viper,Omen,Skye","Raze,Cypher,Omen,Jett,Skye"
Lotus,Prospects,Mynamejeff,13,2,10,2,0,3,"Raze,Killjoy,Viper,Omen,Fade","Raze,Killjoy,Reyna,Omen,Gekko"
Breeze,Undecisive,Toads,13,9,7,3,6,6,"Cypher,Sova,Viper,Jett,Yoru","Cypher,Sova,Viper,Yoru,Astra"
Lotus,Slept On,The Hideout,13,11,8,4,7,5,"Raze,Cypher,Omen,KAY/O,Gekko","Raze,Killjoy,Viper,Fade,Clove"
Icebox,DOOMSDAY,Imperial Titans,13,5,8,4,1,5,"Breach,Killjoy,Viper,Jett,Neon","Sova,Killjoy,Viper,Jett,KAY/O"
Bind,whats a pretzel,Lionheart eSports,13,8,8,4,4,5,"Raze,Viper,Brimstone,Skye,Chamber","Raze,Viper,Brimstone,Skye,Gekko"
Lotus,1Millisecond,Thug Shakers,13,6,7,5,1,6,"Breach,Raze,Cypher,Omen,Fade","Raze,Killjoy,Viper,Omen,Skye"
Sunset,Zero MarksMen Black,LazerrFreeks Mythic,13,4,4,1,3,9,"Breach,Raze,Cypher,Omen,Gekko","Breach,Raze,Cypher,Omen,Fade"
Lotus,Sussy Players,Hybrid Authority,10,13,7,5,8,3,"Raze,Cypher,Omen,Fade,Gekko","Raze,Killjoy,Viper,Omen,Fade"
Lotus,RyZ Knights,Valkyrie,13,4,4,1,3,9,"Raze,Sova,Killjoy,Viper,Omen","Breach,Raze,Omen,Jett,Skye"
Sunset,Teddy Tactics,mesos millionaires,10,13,6,6,7,4,"Raze,Cypher,Omen,KAY/O,Gekko","Raze,Cypher,KAY/O,Gekko,Clove"
Ascent,Medics,Six Figures,0,13,0,12,1,0,"Sova,Killjoy,Omen,Jett,KAY/O","Sova,Killjoy,Sage,Omen,Jett"
Bind,floppers,Reformed GC,13,8,8,4,4,5,"Breach,Raze,Brimstone,Yoru,Fade","Raze,Viper,Brimstone,Skye,Deadlock"
Bind,Special Grade,Passion Project,13,7,5,3,4,8,"Raze,Viper,Brimstone,Skye,Chamber","Raze,Cypher,Viper,Brimstone,Skye"
Breeze,PDF Files,Dexterity Gaming,13,8,6,6,2,7,"Cypher,Sova,Viper,Jett,Yoru","Sova,Viper,Jett,Yoru,Astra"
Breeze,PDF Files,Dexterity Gaming,13,8,6,6,2,7,"Cypher,Sova,Viper,Jett,Yoru","Sova,Viper,Jett,Yoru,Astra"
Bind,Aspyre x Swarm,Paranoia Esports,13,5,3,3,2,10,"Raze,Cypher,Viper,Brimstone,Skye","Raze,Viper,Brimstone,Skye,Gekko"
Ascent,Solstice GC,Supernova x Pals,13,11,9,3,8,4,"Sova,Killjoy,Omen,Jett,KAY/O","Sova,Killjoy,Omen,Jett,KAY/O"
Ascent,Sexy Gang,CaptainDemi's Magic Band,13,6,8,4,2,5,"Sova,Killjoy,Omen,Jett,KAY/O","Cypher,Sova,Omen,Jett,KAY/O"
Lotus,CHURCH OF CHAEWON KIM,Ugly Hamsters,13,8,5,4,4,8,"Raze,Killjoy,Viper,Omen,Fade","Breach,Raze,Cypher,Omen,Gekko"
Sunset,1Millisecond,Thug Shakers,13,3,4,0,3,9,"Breach,Raze,Cypher,Omen,Fade","Raze,Cypher,Omen,KAY/O,Gekko"
Sunset,Special Grade,CHURCH OF CHAEWON KIM,13,3,4,0,3,9,"Breach,Raze,Cypher,Omen,Fade","Raze,Cypher,Omen,KAY/O,Gekko"
Sunset,Cafe Coke,house flippers,13,11,7,5,6,6,"Breach,Raze,Cypher,Omen,Gekko","Raze,Cypher,Omen,KAY/O,Gekko"
Sunset,DOOMSDAY,Imperial Titans,7,13,5,7,6,2,"Breach,Raze,Cypher,Omen,Gekko","Breach,Raze,Cypher,Omen,Gekko"
Sunset,LazerrFreeks Mythic,Hybrid Authority,13,0,1,0,0,12,"Breach,Raze,Cypher,Omen,Fade","Breach,Raze,Cypher,Omen,Fade"
Lotus,The Hideout,Lionheart eSports,8,13,2,7,6,6,"Breach,Raze,Killjoy,Omen,Gekko","Breach,Killjoy,Omen,Neon,Gekko"
Ascent,Culturized,Prospects,16,14,9,6,8,7,"Sova,Killjoy,Omen,Jett,KAY/O","Cypher,Sova,Phoenix,Omen,Yoru"
Lotus,Ions Day Care,Volcano Gang,13,10,7,5,5,6,"Raze,Killjoy,Omen,Jett,Chamber","Breach,Raze,Killjoy,Omen,Gekko"
Icebox,Toads,Scarlet Knights Black,13,5,9,3,2,4,"Sova,Killjoy,Viper,Reyna,Jett","Sova,Killjoy,Viper,Jett,KAY/O"
Icebox,Eternal Sunrise,Scarlet Knights Black,13,5,9,3,2,4,"Sova,Killjoy,Viper,Reyna,Jett","Sova,Killjoy,Viper,Jett,KAY/O"
Split,PDF Files,Dexterity Gaming,13,5,8,4,1,5,"Raze,Cypher,Reyna,Omen,Skye","Raze,Cypher,Viper,Omen,Skye"
Split,PDF Files,Dexterity Gaming,13,5,8,4,1,5,"Raze,Cypher,Reyna,Omen,Skye","Raze,Cypher,Viper,Omen,Skye"
Bind,Valkyrie,Six Figures,14,12,9,4,8,5,"Raze,Viper,Skye,Gekko,Clove","Raze,Viper,Brimstone,Skye,Fade"
Ascent,whats a pretzel,Slept On,13,6,10,2,4,3,"Sova,Killjoy,Omen,Jett,KAY/O","Sova,Killjoy,Omen,Jett,KAY/O"
Ascent,IOUNL,Lyrical's Daycare,13,6,3,4,2,10,"Cypher,Sova,Omen,Jett,Deadlock","Sova,Killjoy,Omen,Jett,KAY/O"
Ascent,Undecisive,Eternal Sunrise,13,3,4,0,3,9,"Sova,Killjoy,Omen,Jett,KAY/O","Sova,Killjoy,Omen,Jett,KAY/O"
Lotus,Reformed GC,Kinetic GC,13,6,5,2,4,8,"Raze,Killjoy,Viper,Omen,Gekko","Breach,Raze,Cypher,Omen,Gekko"
Icebox,Zero MarksMen Black,Sussy Players,13,4,4,1,3,9,"Sova,Killjoy,Viper,Reyna,Jett","Sova,Killjoy,Viper,Jett,Gekko"
Ascent,Ranked Nightmares,Mynamejeff,13,4,5,0,4,8,"Sova,Killjoy,Omen,Jett,KAY/O","Sova,Phoenix,Sage,KAY/O,Clove"
Ascent,Area of Effect,overcook,13,8,6,3,5,7,"Cypher,Sova,Omen,Jett,Deadlock","Sova,Killjoy,Omen,Jett,KAY/O"
Icebox,alvinboy fanclub,Kraken,13,6,8,4,2,5,"Sova,Killjoy,Viper,Jett,Gekko","Sova,Killjoy,Viper,Jett,Gekko"
Icebox,Time Machine,BALLZ V3.0,13,10,5,7,3,8,"Sova,Killjoy,Viper,Sage,Jett","Sova,Killjoy,Viper,Jett,Gekko"
Split,mesos millionaires,minions united GC,13,6,8,4,2,5,"Raze,Cypher,Omen,Jett,Skye","Breach,Raze,Cypher,Omen,Skye"
Bind,Thinking Men,MERC CLAN,13,8,3,6,2,10,"Raze,Viper,Brimstone,Skye,Gekko","Cypher,Viper,Jett,Skye,Clove"
Lotus,The GRID,NTE,13,2,10,2,0,3,"Breach,Cypher,Omen,Neon,Gekko","Breach,Raze,Cypher,Omen,Gekko"
Ascent,Passion Project,Ugly Hamsters,13,1,2,0,1,11,"Sova,Killjoy,Omen,Jett,KAY/O","Sova,Killjoy,Omen,Jett,KAY/O"
Lotus,Sexy Gang,CaptainDemi's Magic Band,9,13,6,6,7,3,"Breach,Raze,Cypher,Omen,Fade","Raze,Killjoy,Viper,Omen,Fade"
Bind,Cafe Coke,house flippers,10,13,4,7,6,6,"Raze,Viper,Skye,Gekko,Clove","Raze,Viper,Brimstone,Skye,Gekko"
Bind,Ions Day Care,Volcano Gang,13,10,6,5,5,7,"Raze,Viper,Brimstone,Yoru,Deadlock","Raze,Cypher,Viper,Brimstone,Skye"
Ascent,RyZ Knights,Medics,13,0,1,0,0,12,"Sova,Killjoy,Omen,Jett,KAY/O","Sova,Killjoy,Omen,Jett,KAY/O"
Sunset,The Hideout,Lionheart eSports,9,13,3,7,6,6,"Breach,Raze,Cypher,Omen,Gekko","Breach,Cypher,Sova,Omen,Neon"
Lotus,Solstice GC,Minimum,13,1,11,1,0,2,"Raze,Killjoy,Viper,Gekko,Clove","Raze,Killjoy,Omen,Skye,Gekko"
Ascent,Aspyre x Swarm,Paranoia Esports,13,7,5,3,4,8,"Sova,Killjoy,Omen,Jett,KAY/O","Sova,Killjoy,Omen,Jett,KAY/O"
Ascent,1Millisecond,Thug Shakers,11,13,6,6,7,5,"Sova,Killjoy,Omen,Jett,KAY/O","Sova,Killjoy,Omen,Jett,KAY/O"
Breeze,Supernova x Pals,ASTANE GC,13,9,5,7,2,8,"Sova,Viper,Jett,Yoru,Astra","Sova,Viper,Jett,KAY/O,Chamber"
Icebox,Thinking Men,MERC CLAN,13,0,12,0,0,1,"Sova,Killjoy,Harbor,Gekko,Clove","Sova,Killjoy,Viper,Sage,Jett"
Lotus,LazerrFreeks Mythic,Hybrid Authority,13,9,5,7,2,8,"Breach,Raze,Cypher,Omen,Gekko","Raze,Killjoy,Viper,Omen,Fade"
Icebox,IOUNL,Lyrical's Daycare,13,5,4,2,3,9,"Sova,Killjoy,Viper,Jett,Gekko","Killjoy,Viper,Jett,KAY/O,Gekko"
Ascent,DOOMSDAY,Imperial Titans,15,13,7,7,6,8,"Sova,Killjoy,Omen,Jett,KAY/O","Sova,Killjoy,Omen,Jett,KAY/O"
Lotus,Undecisive,Eternal Sunrise,13,4,10,2,2,3,"Raze,Killjoy,Viper,Omen,Fade","Raze,Killjoy,Omen,Fade,Gekko"
Bind,Passion Project,Ugly Hamsters,13,2,3,0,2,10,"Raze,Cypher,Viper,Brimstone,Skye","Raze,Sova,Brimstone,Skye,Chamber"
Lotus,Area of Effect,overcook,13,2,10,2,0,3,"Raze,Killjoy,Viper,Omen,Skye","Breach,Raze,Killjoy,Omen,Fade"
Icebox,Reformed GC,Kinetic GC,13,3,4,0,3,9,"Killjoy,Viper,Sage,Jett,Gekko","Sova,Killjoy,Viper,Jett,Gekko"
Lotus,Culturized,Prospects,13,11,9,3,8,4,"Breach,Raze,Cypher,Omen,Gekko","Raze,Killjoy,Viper,Omen,Fade"
Bind,The GRID,NTE,13,2,3,0,2,10,"Raze,Reyna,Harbor,Gekko,Clove","Raze,Viper,Brimstone,Skye,Deadlock"
Icebox,PDF Files,Dexterity Gaming,11,13,8,4,9,3,"Sova,Killjoy,Viper,Reyna,Jett","Sova,Killjoy,Viper,Harbor,Gekko"
Icebox,PDF Files,Dexterity Gaming,11,13,8,4,9,3,"Sova,Killjoy,Viper,Reyna,Jett","Sova,Killjoy,Viper,Harbor,Gekko"
Lotus,Time Machine,BALLZ V3.0,13,3,9,3,0,4,"Raze,Killjoy,Omen,Skye,Gekko","Raze,Cypher,Omen,Fade,Gekko"
Sunset,Eternal Sunrise,Scarlet Knights Black,13,11,7,5,6,6,"Cypher,Sova,Omen,KAY/O,Neon","Raze,Cypher,Omen,Jett,Gekko"
Sunset,Toads,Scarlet Knights Black,13,11,7,5,6,6,"Cypher,Sova,Omen,KAY/O,Neon","Raze,Cypher,Omen,Jett,Gekko"
Bind,Ranked Nightmares,Mynamejeff,13,8,3,6,2,10,"Raze,Fade,Gekko,Deadlock,Clove","Raze,Viper,Brimstone,Skye,Gekko"
Ascent,floppers,Harmony Opal,13,4,4,1,3,9,"Jett,Astra,KAY/O,Fade,Deadlock","Sova,Killjoy,Omen,Jett,KAY/O"
Ascent,FlyQuest RED,Tenax GC,13,6,6,6,0,7,"Sova,Killjoy,Omen,Jett,KAY/O","Sova,Killjoy,Omen,Jett,KAY/O"
Lotus,alvinboy fanclub,Kraken,13,5,9,3,2,4,"Raze,Killjoy,Viper,Omen,Skye","Raze,Killjoy,Viper,Omen,Fade"
Lotus,Zero MarksMen Black,Sussy Players,13,5,6,0,5,7,"Raze,Killjoy,Viper,Omen,Fade","Raze,Cypher,Omen,Fade,Gekko"
Sunset,Valkyrie,Six Figures,13,11,7,5,6,6,"Raze,Cypher,Omen,KAY/O,Gekko","Raze,Cypher,Omen,KAY/O,Gekko"
Lotus,whats a pretzel,Slept On,13,9,7,3,6,6,"Raze,Viper,Omen,Fade,Deadlock","Raze,Cypher,Omen,KAY/O,Gekko"
Icebox,Sexy Gang,CaptainDemi's Magic Band,13,5,8,4,1,5,"Sova,Killjoy,Viper,Jett,KAY/O","Sova,Killjoy,Viper,Sage,KAY/O"
Icebox,Teddy Tactics,Vulcan Rising GC,13,8,6,6,2,7,"Sova,Killjoy,Viper,Sage,Jett","Sova,Killjoy,Viper,Jett,Gekko"
Bind,mesos millionaires,minions united GC,10,13,2,9,4,8,"Raze,Viper,Skye,Gekko,Clove","Raze,Viper,Brimstone,Skye,Gekko"
Lotus,Supernova x Pals,ASTANE GC,13,10,5,6,4,8,"Raze,Killjoy,Viper,Omen,Fade","Raze,Cypher,Omen,Gekko,Deadlock"
Breeze,Cafe Coke,house flippers,15,13,8,6,7,7,"Cypher,Sova,Jett,Harbor,Clove","Cypher,Sova,Jett,Yoru,Harbor"
Ascent,Solstice GC,Minimum,14,12,6,7,5,8,"Sova,Killjoy,Omen,Jett,KAY/O","Sova,Killjoy,Omen,Jett,KAY/O"
Sunset,floppers,Harmony Opal,13,7,6,6,1,7,"Omen,KAY/O,Gekko,Deadlock,Clove","Breach,Raze,Cypher,Omen,Fade"
Sunset,FlyQuest RED,Tenax GC,13,7,6,6,1,7,"Breach,Raze,Cypher,Sova,Omen","Raze,Cypher,Omen,KAY/O,Gekko"
Sunset,Reformed GC,Kinetic GC,6,13,2,5,8,4,"Raze,Cypher,Omen,KAY/O,Gekko","Raze,Cypher,Omen,KAY/O,Gekko"
Lotus,Teddy Tactics,Vulcan Rising GC,13,1,11,1,0,2,"Raze,Killjoy,Viper,Omen,Fade","Breach,Raze,Killjoy,Omen,Skye"
Sunset,mesos millionaires,minions united GC,13,5,5,1,4,8,"Raze,Cypher,KAY/O,Gekko,Clove","Breach,Raze,Cypher,Omen,Gekko"
Icebox,Twisted Minds Esports,G3 Esports,13,8,6,3,5,7,"Sova,Killjoy,Viper,Reyna,Jett","Sova,Killjoy,Viper,Sage,Jett"
Sunset,Team Falcons Vega,Karmine Corp GC,5,13,3,3,10,2,"Breach,Raze,Cypher,Omen,Fade","Breach,Raze,Cypher,Omen,Gekko"
Ascent,EKO Esports GC,NOVO GC,13,15,8,6,9,5,"Cypher,Sova,Phoenix,Omen,Jett","Sova,Killjoy,Omen,Jett,KAY/O"
Breeze,Twisted Minds Esports,G3 Esports,13,8,5,4,4,8,"Cypher,Sova,Viper,Jett,Yoru","Sova,Viper,Jett,Yoru,Chamber"
Lotus,EKO Esports GC,NOVO GC,3,13,3,9,4,0,"Breach,Raze,Killjoy,Omen,Fade","Breach,Sova,Killjoy,Omen,Neon"
Split,Team Falcons Vega,Karmine Corp GC,13,10,8,4,6,5,"Breach,Raze,Cypher,Omen,Skye","Raze,Viper,Omen,Jett,Skye"
Ascent,Underground Gaming,Vision Esports,13,11,10,2,9,3,"Sova,Killjoy,Omen,Jett,KAY/O","Breach,Sova,Killjoy,Omen,Jett"
Sunset,Powerpuff GC,Imperium Livia,5,13,3,9,4,2,"Cypher,Sova,Omen,KAY/O,Neon","Breach,Raze,Cypher,Omen,Deadlock"
Lotus,KR Esports,Onyx Ravens,5,13,3,9,4,2,"Breach,Raze,Killjoy,Omen,Gekko","Breach,Raze,Cypher,Viper,Omen"
Icebox,Sisire Femer,Supernova GC (EU),3,13,1,11,2,2,"Raze,Killjoy,Viper,Harbor,Gekko","Sova,Killjoy,Viper,Jett,Gekko"
Bind,The Vicious,The Ultimates,7,13,3,5,8,4,"Raze,Viper,Brimstone,Skye,Chamber","Raze,Viper,Omen,KAY/O,Gekko"
Lotus,Team Galaga Kitsune,Melilla Titans Aura,13,10,10,1,9,3,"Breach,Raze,Killjoy,Omen,Gekko","Breach,Raze,Killjoy,Omen,Skye"
Lotus,LUA Gaming,MAD Lions KOI,2,13,0,3,10,2,"Breach,Raze,Killjoy,Omen,Gekko","Breach,Sova,Omen,Chamber,Neon"
Icebox,KR Esports,Onyx Ravens,2,13,1,11,2,1,"Sova,Killjoy,Viper,Jett,KAY/O","Sova,Killjoy,Viper,Sage,Jett"
Lotus,Underground Gaming,Vision Esports,13,8,8,4,4,5,"Breach,Raze,Killjoy,Omen,Gekko","Breach,Raze,Killjoy,Omen,Fade"
Icebox,Team Falcons Vega,Karmine Corp GC,16,18,5,12,6,11,"Reyna,Omen,KAY/O,Harbor,Gekko","Sova,Killjoy,Viper,Sage,Jett"
Ascent,The Vicious,The Ultimates,6,13,2,5,8,4,"Sova,Killjoy,Jett,Astra,KAY/O","Sova,Killjoy,Omen,Jett,KAY/O"
Bind,Requiem,Metizport,15,13,5,9,4,10,"Raze,Viper,Brimstone,Skye,Gekko","Raze,Cypher,Viper,Brimstone,Skye"
Lotus,Team Galaga Kitsune,Vay Esports GC,13,0,1,0,0,12,"Breach,Raze,Killjoy,Omen,Gekko","Breach,Raze,Killjoy,Omen,Gekko"
Sunset,Melilla Titans Aura,Imperium Livia,13,10,7,4,6,6,"Breach,Raze,Cypher,Omen,Skye","Breach,Raze,Cypher,Omen,Deadlock"
Bind,MAD Lions KOI,Supernova GC (EU),13,8,5,7,1,8,"Breach,Raze,Cypher,Brimstone,Gekko","Raze,Brimstone,Skye,Gekko,Clove"
Sunset,LUA Gaming,Anselmo,13,2,3,0,2,10,"Breach,Raze,Cypher,Sova,Omen","Breach,Raze,Cypher,Omen,Fade"
Breeze,G2 Gozen,Odd 1 OUT,9,13,4,6,7,5,"Cypher,Sova,Viper,Jett,KAY/O","Cypher,Sova,Jett,KAY/O,Harbor"
Lotus,Vay Esports GC,Sisire Femer,13,11,7,5,6,6,"Breach,Raze,Killjoy,Omen,Gekko","Breach,Raze,Killjoy,Omen,Gekko"
Sunset,Anselmo,Powerpuff GC,13,6,8,4,2,5,"Breach,Raze,Cypher,Omen,Fade","Cypher,Sova,Omen,KAY/O,Neon"
Breeze,Requiem,Metizport,13,11,6,6,5,7,"Cypher,Sova,Viper,Jett,Yoru","Cypher,Sova,Viper,Jett,Yoru"
Bind,G2 Gozen,Odd 1 OUT,12,14,4,9,5,8,"Raze,Viper,Skye,Gekko,Clove","Breach,Cypher,Sova,Omen,Neon"
Split,FLYLESS BALTIC,LANPACAN,4,13,2,3,10,2,"Raze,Cypher,Omen,Jett,Skye","Breach,Raze,Cypher,Omen,Skye"
Ascent,FLYLESS BALTIC,LANPACAN,13,10,6,6,4,7,"Sova,Killjoy,Omen,Jett,KAY/O","Sova,Killjoy,Omen,Jett,KAY/O"
Lotus,FLYLESS BALTIC,LANPACAN,3,13,3,9,4,0,"Breach,Killjoy,Omen,Jett,Yoru","Breach,Raze,Killjoy,Omen,Gekko"
Lotus,Fisher Falcons,University of Virginia,13,7,6,2,5,7,"Raze,Killjoy,Viper,Omen,Fade","Raze,Killjoy,Viper,Omen,Fade"
Icebox,Fisher Falcons,University of Virginia,13,6,3,4,2,10,"Sova,Killjoy,Viper,Reyna,Jett","Sova,Killjoy,Viper,Sage,Jett"
Icebox,Onyx Ravens,The Vicious,13,2,3,0,2,10,"Sova,Killjoy,Viper,Sage,Jett","Sova,Killjoy,Viper,Sage,Jett"
Sunset,LXT Esports GC,Entry Frogs Iris,13,7,6,2,5,7,"Raze,Cypher,Omen,KAY/O,Gekko","Breach,Raze,Cypher,Sova,Clove"
Sunset,Onyx Ravens,The Vicious,13,6,9,3,3,4,"Breach,Raze,Cypher,Omen,Fade","Raze,Cypher,Sova,Omen,Gekko"
Lotus,LXT Esports GC,Entry Frogs Iris,13,1,11,1,0,2,"Raze,Killjoy,Viper,Omen,Fade","Breach,Raze,Killjoy,Omen,Fade"
Lotus,Diamant Esports,Incognito,13,7,4,4,3,9,"Raze,Killjoy,Viper,Omen,Skye","Raze,Killjoy,Viper,Omen,Fade"
Icebox,The Ultimates,Vision Esports,13,4,8,4,0,5,"Killjoy,Viper,Jett,KAY/O,Gekko","Sova,Killjoy,Viper,Jett,Gekko"
Icebox,G3 Esports,Underground Gaming,7,13,4,8,5,3,"Sova,Killjoy,Viper,Sage,Jett","Sova,Killjoy,Viper,Jett,Gekko"
Ascent,Twisted Minds Esports,KR Esports,13,1,2,0,1,11,"Cypher,Sova,Phoenix,Omen,Jett","Breach,Cypher,Sova,Omen,Jett"
Lotus,LuckyGirls,aNc Outplayed GC,1,13,0,2,11,1,"Raze,Killjoy,Viper,Omen,Fade","Breach,Raze,Killjoy,Omen,Gekko"
Ascent,Diamant Esports,Incognito,13,9,5,5,4,8,"Cypher,Sova,Omen,Jett,KAY/O","Sova,Killjoy,Omen,Jett,KAY/O"
Breeze,G3 Esports,Underground Gaming,12,14,5,8,6,7,"Sova,Viper,Jett,Yoru,Chamber","Cypher,Sova,Viper,Jett,Yoru"
Breeze,Twisted Minds Esports,KR Esports,13,11,6,6,5,7,"Cypher,Sova,Viper,Jett,Yoru","Cypher,Sova,Viper,Jett,Yoru"
Ascent,The Ultimates,Vision Esports,13,9,8,4,5,5,"Sova,Killjoy,Omen,Jett,KAY/O","Breach,Sova,Killjoy,Omen,Jett"
Icebox,LuckyGirls,aNc Outplayed GC,5,13,4,8,5,1,"Sova,Killjoy,Viper,Reyna,Jett","Sova,Killjoy,Viper,Yoru,Gekko"
Sunset,Apinaorkesteri,Apeks,2,13,0,3,10,2,"Cypher,Omen,Yoru,Gekko,Deadlock","Viper,Sage,Omen,KAY/O,Gekko"
Bind,trashcan,Zero Tenacity,7,13,3,5,8,4,"Raze,Viper,Brimstone,Skye,Gekko","Raze,Cypher,Viper,Brimstone,Skye"
Lotus,Apinaorkesteri,Apeks,12,14,6,7,7,6,"Raze,Killjoy,Omen,Fade,Deadlock","Raze,Killjoy,Viper,Omen,Fade"
Icebox,trashcan,Zero Tenacity,13,6,9,3,3,4,"Sova,Killjoy,Viper,KAY/O,Clove","Raze,Killjoy,Viper,Brimstone,Fade"
Sunset,trashcan,Zero Tenacity,11,13,8,4,9,3,"Raze,Cypher,Viper,Omen,Skye","Breach,Cypher,Sova,Omen,Yoru"
Icebox,FUSION,RETA Esports,3,13,0,4,9,3,"Sova,Killjoy,Viper,Sage,Jett","Sova,Killjoy,Viper,Jett,Harbor"
Ascent,ASTANE GC,Kirbee Squad,13,6,9,3,3,4,"Cypher,Sova,Omen,Jett,KAY/O","Sova,Killjoy,Reyna,Omen,Jett"
Ascent,Luxoria GC,Tenax GC,6,13,4,8,5,2,"Sova,Killjoy,Omen,Jett,KAY/O","Sova,Killjoy,Omen,Jett,KAY/O"
Lotus,friends GC,house flippers,10,13,6,6,7,4,"Raze,Cypher,Omen,KAY/O,Gekko","Breach,Raze,Cypher,Omen,Gekko"
Bind,FUSION,RETA Esports,9,13,5,5,8,4,"Viper,Brimstone,Skye,Yoru,Gekko","Raze,Viper,Brimstone,Skye,Gekko"
Sunset,Kinetic GC,C4C Flare,13,4,3,2,2,10,"Raze,Cypher,Omen,KAY/O,Gekko","Breach,Raze,Cypher,Omen,Gekko"
Sunset,Luxoria GC,Tenax GC,3,13,1,11,2,2,"Raze,Cypher,Omen,KAY/O,Gekko","Raze,Cypher,Omen,KAY/O,Gekko"
Bind,Stellae Gaming,TBK Esports,8,13,5,4,9,3,"Raze,Cypher,Brimstone,Harbor,Gekko","Raze,Viper,Brimstone,Sage,Skye"
Lotus,ASTANE GC,Kirbee Squad,11,13,2,10,3,9,"Raze,Cypher,Omen,Skye,Deadlock","Raze,Killjoy,Fade,Gekko,Clove"
Breeze,Harmony Opal,Ukiyo,13,9,5,5,4,8,"Cypher,Sova,Viper,Jett,KAY/O","Cypher,Sova,Viper,Jett,KAY/O"
Lotus,Detox GC,Vulcan Rising GC,9,13,3,9,4,6,"Breach,Raze,Killjoy,Omen,Fade","Breach,Raze,Killjoy,Omen,Skye"
Sunset,friends GC,house flippers,13,5,5,1,4,8,"Raze,Cypher,Omen,KAY/O,Gekko","Raze,Cypher,Omen,KAY/O,Gekko"
Ascent,minions united GC,SaD FROST,13,4,8,4,0,5,"Sova,Killjoy,Omen,Jett,KAY/O","Sova,Killjoy,Omen,Jett,KAY/O"
Ascent,Take Back Control,Minimum,6,13,4,8,5,2,"Sova,Killjoy,Omen,Jett,KAY/O","Sova,Killjoy,Omen,Jett,KAY/O"
Breeze,FUSION,RETA Esports,14,12,6,7,5,8,"Cypher,Sova,Viper,Jett,Yoru","Cypher,Sova,Viper,Jett,KAY/O"
Icebox,Kinetic GC,C4C Flare,13,11,2,10,1,11,"Sova,Killjoy,Viper,Jett,Gekko","Sova,Killjoy,Viper,Reyna,Harbor"
Ascent,Stellae Gaming,TBK Esports,9,13,6,4,9,3,"Sova,Killjoy,Omen,Jett,KAY/O","Sova,Killjoy,Omen,Jett,KAY/O"
Icebox,ASTANE GC,Kirbee Squad,15,13,11,3,10,4,"Sova,Viper,Reyna,KAY/O,Chamber","Sova,Killjoy,Viper,Reyna,Jett"
Lotus,Luxoria GC,Tenax GC,13,11,8,4,7,5,"Raze,Killjoy,Viper,Omen,Fade","Raze,Killjoy,Omen,KAY/O,Gekko"
Bind,Harmony Opal,Ukiyo,13,9,6,4,5,7,"Raze,Cypher,Viper,Skye,Clove","Raze,Cypher,Brimstone,Skye,Gekko"
Breeze,friends GC,house flippers,8,13,5,4,9,3,"Cypher,Sova,Viper,Jett,KAY/O","Cypher,Sova,Jett,Yoru,Harbor"
Lotus,Take Back Control,Minimum,8,13,4,5,8,4,"Breach,Raze,Cypher,Omen,Gekko","Raze,Killjoy,Omen,Skye,Gekko"
Sunset,minions united GC,SaD FROST,13,9,7,5,4,6,"Breach,Raze,Cypher,Omen,Gekko","Breach,Viper,Sage,Omen,Gekko"
Icebox,Detox GC,Vulcan Rising GC,9,13,3,9,4,6,"Sova,Killjoy,Viper,Sage,Jett","Sova,Killjoy,Viper,Yoru,Harbor"
Sunset,Reven eClub,Illicit Gaming,1,13,1,11,2,0,"Breach,Raze,Cypher,Sova,Omen","Breach,Raze,Cypher,Omen,Gekko"
Ascent,ASTANE GC,Mystics GC,13,7,6,6,1,7,"Cypher,Sova,Omen,Jett,KAY/O","Sova,Killjoy,Omen,Jett,KAY/O"
Lotus,Take Back Control,Teddy Tactics,4,13,2,3,10,2,"Breach,Raze,Cypher,Omen,Gekko","Raze,Killjoy,Viper,Omen,Fade"
Bind,Reven eClub,Illicit Gaming,12,14,8,5,9,4,"Raze,Cypher,Viper,Omen,Skye","Raze,Viper,Brimstone,Skye,Gekko"
Lotus,Kirbee Squad,Kinetic GC,5,13,2,10,3,3,"Killjoy,Reyna,Omen,Jett,Gekko","Breach,Raze,Cypher,Omen,Gekko"
Lotus,house flippers,Endear Moon,13,7,6,2,5,7,"Breach,Raze,Cypher,Omen,Gekko","Raze,Cypher,Viper,Omen,Skye"
Split,Catnappers,Detox GC,7,13,7,5,8,0,"Raze,Cypher,Omen,Skye,Yoru","Raze,Cypher,Jett,Skye,Astra"
Split,ASTANE GC,Mystics GC,13,8,6,6,2,7,"Breach,Raze,Cypher,Omen,Skye","Raze,Cypher,Viper,Skye,Astra"
Sunset,Tenax GC,Kryptic GC,13,7,5,3,4,8,"Raze,Cypher,Omen,KAY/O,Gekko","Breach,Raze,Cypher,Omen,Gekko"
Lotus,Galorys,XLD Gaming,3,13,0,4,9,3,"Raze,Killjoy,Viper,Omen,Fade","Raze,Killjoy,Viper,Omen,Fade"
Ascent,Harmony Opal,FlyQuest RED,1,13,0,2,11,1,"Sova,Killjoy,Omen,Jett,KAY/O","Sova,Killjoy,Omen,Jett,KAY/O"
Icebox,LazerrFreeks Ivy,mesos millionaires,4,13,4,8,5,0,"Sova,Killjoy,Omen,Jett,Harbor","Sova,Killjoy,Viper,Sage,Jett"
Sunset,minions united GC,Psycho Cats,13,5,5,1,4,8,"Breach,Raze,Cypher,Omen,Gekko","Breach,Raze,Omen,Chamber,Gekko"
Bind,fish with no eye,Reformed GC,2,13,1,2,11,1,"Raze,Cypher,Viper,Brimstone,Skye","Raze,Viper,Brimstone,Skye,Deadlock"
Icebox,Thrive Vixens,Minimum,5,13,2,4,9,3,"Sova,Killjoy,Viper,Yoru,Gekko","Sova,Killjoy,Viper,Yoru,Harbor"
Ascent,Take Back Control,Teddy Tactics,13,11,5,7,4,8,"Sova,Killjoy,Omen,Jett,KAY/O","Sova,Killjoy,Omen,Jett,KAY/O"
Split,floppers,Skyline Dreamers GC,13,4,10,2,2,3,"Breach,Raze,Cypher,Omen,Fade","Breach,Raze,Cypher,Omen,Skye"
Ascent,Underground Gaming,KR Esports,13,9,6,4,5,7,"Sova,Killjoy,Omen,Jett,KAY/O","Breach,Sova,Killjoy,Omen,Jett"
Ascent,house flippers,Endear Moon,13,9,9,1,8,4,"Sova,Killjoy,Omen,Jett,KAY/O","Sova,Killjoy,Reyna,Omen,Jett"
Bind,Kirbee Squad,Kinetic GC,9,13,7,5,8,2,"Raze,Cypher,Viper,Skye,Clove","Raze,Viper,Brimstone,Skye,Chamber"
Icebox,Tenax GC,Kryptic GC,13,7,8,0,7,5,"Sova,Killjoy,Viper,Jett,Gekko","Sova,Killjoy,Viper,Jett,Harbor"
Icebox,Catnappers,Detox GC,5,13,2,4,9,3,"Sova,Killjoy,Viper,Reyna,Jett","Sova,Killjoy,Viper,Sage,Jett"
Split,minions united GC,Psycho Cats,13,3,4,0,3,9,"Breach,Raze,Cypher,Omen,Skye","Breach,Raze,Cypher,Omen,Skye"
Icebox,fish with no eye,Reformed GC,2,13,2,1,12,0,"Sova,Killjoy,Viper,Jett,Gekko","Killjoy,Viper,Sage,Jett,Gekko"
Sunset,LazerrFreeks Ivy,mesos millionaires,1,13,0,2,11,1,"Raze,Cypher,Fade,Gekko,Clove","Raze,Cypher,KAY/O,Gekko,Clove"
Lotus,Thrive Vixens,Minimum,3,13,0,4,9,3,"Raze,Killjoy,Viper,Omen,Fade","Raze,Killjoy,Omen,Skye,Gekko"
Icebox,ASTANE GC,Mystics GC,10,13,5,6,7,5,"Sova,Viper,Reyna,KAY/O,Chamber","Sova,Killjoy,Viper,Sage,Jett"
Sunset,Harmony Opal,FlyQuest RED,6,13,2,5,8,4,"Breach,Raze,Cypher,Omen,Fade","Breach,Raze,Cypher,Sova,Omen"
Split,GAMAX eSports,Skulls Esports,13,2,3,0,2,10,"Breach,Raze,Cypher,Omen,Fade","Breach,Raze,Cypher,Omen,Jett"
Lotus,floppers,Skyline Dreamers GC,13,0,12,0,0,1,"Raze,Cypher,Omen,KAY/O,Gekko","Breach,Raze,Killjoy,Omen,Gekko"
Icebox,Neverlanders eSports Baby's,Tropadobagaço,13,9,6,4,5,7,"Sova,Reyna,Jett,Chamber,Harbor","Sova,Killjoy,Viper,Reyna,Jett"
Split,Take Back Control,Teddy Tactics,4,13,4,8,5,0,"Breach,Raze,Cypher,Omen,Gekko","Raze,Viper,Omen,Skye,Deadlock"
Lotus,Underground Gaming,KR Esports,13,2,10,2,0,3,"Breach,Raze,Omen,Chamber,Gekko","Raze,Omen,Chamber,Gekko,Deadlock"
Bind,Galorys,XLD Gaming,14,16,6,9,7,8,"Raze,Viper,Brimstone,Skye,Chamber","Raze,Viper,Brimstone,Skye,Gekko"
Lotus,Neverlanders eSports Baby's,Tropadobagaço,13,9,8,2,7,5,"Breach,Raze,Killjoy,Omen,Gekko","Breach,Raze,Killjoy,Omen,Fade"
Bind,GAMAX eSports,Skulls Esports,12,14,8,5,9,4,"Breach,Raze,Viper,Brimstone,Fade","Raze,Cypher,Reyna,Astra,Gekko"
Breeze,Underground Gaming,KR Esports,10,13,4,7,6,6,"Cypher,Sova,Viper,Jett,Yoru","Cypher,Sova,Viper,Jett,Yoru"
Ascent,Onyx Ravens,The Ultimates,13,10,5,6,4,8,"Sova,Killjoy,Omen,Jett,KAY/O","Sova,Killjoy,Omen,Jett,KAY/O"
Sunset,GAMAX eSports,Skulls Esports,13,5,8,4,1,5,"Breach,Raze,Cypher,Omen,Fade","Breach,Raze,Cypher,Omen,Gekko"
Breeze,The Vicious,Twisted Minds Esports,13,9,8,4,5,5,"Cypher,Sova,Viper,Reyna,Neon","Cypher,Sova,Viper,Jett,Yoru"
Breeze,Chipi Chapa's,B8 Esports,13,4,8,4,0,5,"Cypher,Sova,Viper,Jett,Yoru","Cypher,Sova,Viper,Jett,Yoru"
Lotus,Onyx Ravens,The Ultimates,13,7,5,3,4,8,"Breach,Raze,Cypher,Viper,Omen","Breach,Cypher,Sova,Omen,Neon"
Ascent,Vision Esports,G3 Esports,13,10,7,4,6,6,"Breach,Sova,Killjoy,Omen,Jett","Breach,Sova,Jett,Astra,KAY/O"
Sunset,Chipi Chapa's,B8 Esports,13,7,9,3,4,4,"Breach,Raze,Cypher,Omen,Yoru","Breach,Raze,Cypher,Omen,Deadlock"
Split,Onyx Ravens,The Ultimates,6,13,2,5,8,4,"Breach,Raze,Cypher,Sage,Omen","Raze,Viper,Omen,Jett,Skye"
Icebox,The Vicious,Twisted Minds Esports,14,12,11,2,10,3,"Sova,Killjoy,Viper,Sage,Jett","Killjoy,Viper,Jett,KAY/O,Gekko"
Icebox,Vision Esports,G3 Esports,13,7,7,5,2,6,"Sova,Killjoy,Viper,Jett,Gekko","Sova,Killjoy,Viper,Sage,Jett"
Sunset,HOWL Esports,Galatasaray Esports,11,13,6,6,7,5,"Raze,Cypher,Omen,KAY/O,Gekko","Raze,Cypher,Omen,KAY/O,Gekko"
Sunset,NOM Esports,Acend,5,13,3,3,10,2,"Breach,Raze,Cypher,Omen,Fade","Raze,Cypher,Omen,KAY/O,Gekko"
Ascent,HOWL Esports,Galatasaray Esports,7,13,2,6,7,5,"Cypher,Sova,Omen,Jett,KAY/O","Sova,Killjoy,Omen,Jett,KAY/O"
Icebox,NOM Esports,Acend,13,15,9,5,10,4,"Sova,Killjoy,Viper,Sage,Jett","Killjoy,Viper,Jett,KAY/O,Gekko"
Sunset,Papara SuperMassive,Fenerbahçe Esports,13,6,7,5,1,6,"Raze,Cypher,Omen,KAY/O,Gekko","Raze,Cypher,Omen,KAY/O,Gekko"
Split,NOM Esports,Acend,13,7,4,4,3,9,"Raze,Cypher,Viper,Omen,Skye","Raze,Cypher,Sage,Omen,Jett"
Icebox,Papara SuperMassive,Fenerbahçe Esports,13,5,6,0,5,7,"Killjoy,Viper,Reyna,KAY/O,Gekko","Killjoy,Viper,Jett,KAY/O,Gekko"
Lotus,Mir Gaming GC,Beyond Stratos Gaming GC,13,4,5,0,4,8,"Raze,Killjoy,Viper,Omen,Fade","Raze,Killjoy,Viper,Omen,Fade"
Sunset,Mir Gaming GC,Beyond Stratos Gaming GC,13,3,9,3,0,4,"Raze,Cypher,Viper,Omen,Gekko","Cypher,Sova,Reyna,Omen,Jett"
Split,Mir Gaming GC,Beyond Stratos Gaming GC,13,9,5,7,2,8,"Raze,Viper,Omen,Jett,Skye","Raze,Viper,Jett,Skye,Astra"
Bind,REJECT,VARREL,13,8,7,2,6,6,"Raze,Viper,Brimstone,Fade,Gekko","Raze,Viper,Omen,Skye,Deadlock"
Ascent,Mir Gaming GC,Beyond Stratos Gaming GC,6,13,4,3,10,2,"Sova,Killjoy,Omen,Jett,KAY/O","Sova,Killjoy,Omen,Jett,KAY/O"
Split,REJECT,VARREL,13,7,8,4,3,5,"Raze,Cypher,Viper,Omen,Skye","Raze,Cypher,Viper,Omen,Skye"
Split,PIXEL (KR),Beyond Stratos Gaming GC,3,13,2,10,3,1,"Breach,Raze,Cypher,Omen,Skye","Raze,Viper,Jett,Skye,Astra"
Lotus,PIXEL (KR),Beyond Stratos Gaming GC,4,13,0,5,8,4,"Breach,Raze,Killjoy,Fade,Clove","Raze,Killjoy,Viper,Omen,Fade"
Ascent,RIDDLE ORDER,FENNEL,15,13,8,6,7,7,"Sova,Killjoy,Omen,Jett,KAY/O","Sova,Killjoy,Omen,Jett,KAY/O"
Icebox,RIDDLE ORDER,FENNEL,13,10,10,1,9,3,"Viper,Omen,Jett,KAY/O,Gekko","Sova,Killjoy,Viper,Omen,Harbor"
Lotus,Ragnus Esports,Bon Bon Bum Contra GC,8,13,2,7,6,6,"Breach,Raze,Killjoy,Omen,Neon","Breach,Raze,Cypher,Omen,Gekko"
Bind,Cafe Coke,Kryptic GC,13,8,4,5,3,9,"Raze,Viper,Skye,Gekko,Clove","Raze,Cypher,Viper,Brimstone,KAY/O"
Ascent,Endear Moon,Psycho Cats,13,9,7,5,4,6,"Sova,Killjoy,Reyna,Omen,Jett","Sova,Killjoy,Omen,Jett,KAY/O"
Ascent,Dreamstation,Nemesis GC,13,11,7,5,6,6,"Sova,Killjoy,Omen,Jett,KAY/O","Sova,Killjoy,Omen,Jett,KAY/O"
Sunset,Ragnus Esports,Bon Bon Bum Contra GC,5,13,4,8,5,1,"Raze,Cypher,Omen,KAY/O,Gekko","Breach,Sova,Sage,Omen,Gekko"
Ascent,minions united GC,house flippers,13,8,6,3,5,7,"Sova,Killjoy,Omen,Jett,KAY/O","Sova,Killjoy,Omen,Jett,KAY/O"
Split,C4C Flare,ASTANE GC,4,13,0,5,8,4,"Raze,Cypher,Omen,Jett,Skye","Breach,Raze,Cypher,Omen,Skye"
Icebox,Cafe Coke,Kryptic GC,13,7,10,2,5,3,"Sova,Killjoy,Viper,Sage,Jett","Sova,Killjoy,Viper,Jett,Harbor"
Lotus,Dreamstation,Nemesis GC,13,8,4,5,3,9,"Raze,Killjoy,Viper,Omen,Fade","Breach,Raze,Killjoy,Omen,Gekko"
Sunset,Vulcan Rising GC,mesos millionaires,7,13,3,5,8,4,"Breach,Raze,Cypher,Omen,Gekko","Raze,Cypher,KAY/O,Gekko,Clove"
Split,Endear Moon,Psycho Cats,13,11,5,7,4,8,"Raze,Cypher,Omen,Skye,Clove","Breach,Raze,Cypher,Omen,Skye"
Sunset,minions united GC,house flippers,13,2,10,2,0,3,"Breach,Raze,Cypher,Omen,Gekko","Raze,Cypher,Omen,KAY/O,Gekko"
Sunset,Luxoria GC,Skyline Dreamers GC,13,4,8,4,0,5,"Raze,Cypher,Omen,KAY/O,Gekko","Raze,Cypher,Omen,KAY/O,Gekko"
Ascent,Mystics GC,VO Blossoms,13,3,4,0,3,9,"Sova,Killjoy,Omen,Jett,KAY/O","Sova,Killjoy,Omen,Jett,KAY/O"
Lotus,C4C Flare,ASTANE GC,5,13,2,4,9,3,"Breach,Raze,Killjoy,Omen,Gekko","Raze,Cypher,Omen,Skye,Deadlock"
Ascent,OXEN GC,Zen eSports GC,13,9,6,4,5,7,"Breach,Sova,Killjoy,Omen,Jett","Sova,Killjoy,Omen,Jett,KAY/O"
Bind,Legacy,The7,3,13,0,4,9,3,"Raze,Brimstone,Omen,KAY/O,Gekko","Raze,Viper,Brimstone,Skye,Chamber"
Icebox,Vulcan Rising GC,mesos millionaires,4,13,1,4,9,3,"Sova,Killjoy,Viper,Yoru,Harbor","Sova,Killjoy,Viper,Sage,Jett"
Ascent,Minions United,FlyQuest RED,0,13,0,1,12,0,"Sova,Killjoy,Omen,Jett,KAY/O","Sova,Killjoy,Omen,Jett,KAY/O"
Bind,friends GC,SaD FROST,13,3,3,1,2,10,"Raze,Viper,Brimstone,Skye,Yoru","Breach,Raze,Brimstone,Fade,Gekko"
Ascent,Synergy GC,Teddy Tactics,1,13,0,2,11,1,"Sova,Killjoy,Omen,Jett,KAY/O","Sova,Killjoy,Omen,Jett,KAY/O"
Breeze,Dreamstation,Kirbee Squad,9,13,4,6,7,5,"Cypher,Sova,Viper,Jett,Yoru","Cypher,Sova,Viper,Jett,Clove"
Bind,Ukiyo,Reformed GC,1,13,1,11,2,0,"Raze,Cypher,Brimstone,Skye,Gekko","Raze,Viper,Brimstone,Skye,Deadlock"
Ascent,Kinetic GC,Nemesis GC,13,3,9,3,0,4,"Sova,Killjoy,Omen,Jett,KAY/O","Sova,Killjoy,Phoenix,Neon,Clove"
Lotus,Solstice GC,Detox GC,13,7,6,2,5,7,"Raze,Killjoy,Viper,Gekko,Clove","Breach,Raze,Killjoy,Omen,Fade"
Icebox,Endear Moon,Psycho Cats,11,13,4,8,5,7,"Sova,Killjoy,Viper,Reyna,Jett","Raze,Viper,Chamber,Harbor,Gekko"
Lotus,minions united GC,house flippers,10,13,5,6,7,5,"Breach,Raze,Killjoy,Omen,Fade","Breach,Raze,Cypher,Omen,Gekko"
Sunset,Tenax GC,Cafe Coke,12,14,7,6,8,5,"Raze,Cypher,Omen,KAY/O,Gekko","Breach,Raze,Cypher,Omen,Gekko"
Icebox,Mystics GC,VO Blossoms,13,3,10,2,1,3,"Sova,Killjoy,Viper,Sage,Jett","Sova,Killjoy,Viper,Reyna,Jett"
Sunset,C4C Flare,ASTANE GC,13,8,8,1,7,5,"Breach,Raze,Cypher,Omen,Gekko","Raze,Cypher,Omen,KAY/O,Gekko"
Sunset,Minions United,FlyQuest RED,1,13,0,2,11,1,"Breach,Raze,Cypher,Omen,Gekko","Breach,Raze,Cypher,Sova,Omen"
Bind,Synergy GC,Teddy Tactics,1,13,1,11,2,0,"Raze,Cypher,Reyna,Jett,Clove","Raze,Viper,Brimstone,KAY/O,Gekko"
Lotus,LazerrFreeks Ivy,Vulcan Rising GC,6,13,5,7,6,1,"Raze,Killjoy,Omen,Fade,Gekko","Breach,Raze,Killjoy,Omen,Skye"
Sunset,Kinetic GC,Nemesis GC,13,5,9,3,2,4,"Raze,Cypher,Omen,KAY/O,Gekko","Breach,Raze,Cypher,Omen,Gekko"
Icebox,Dreamstation,Kirbee Squad,5,13,3,9,4,2,"Sova,Killjoy,Viper,Jett,Gekko","Sova,Killjoy,Viper,Reyna,Jett"
Lotus,Ukiyo,Reformed GC,4,13,3,9,4,1,"Raze,Killjoy,Omen,Skye,Gekko","Raze,Killjoy,Viper,Omen,Gekko"
Lotus,Luxoria GC,Skyline Dreamers GC,13,11,6,6,5,7,"Raze,Killjoy,Viper,Omen,Fade","Breach,Raze,Killjoy,Omen,Gekko"
Split,Solstice GC,Detox GC,13,5,3,3,2,10,"Raze,Cypher,Viper,Skye,Clove","Raze,Cypher,Omen,Jett,Skye"
Breeze,Legacy,The7,12,14,4,9,5,8,"Cypher,Sova,Viper,Yoru,Astra","Cypher,Sova,Viper,Jett,KAY/O"
Split,friends GC,SaD FROST,13,11,7,5,6,6,"Raze,Viper,Omen,Jett,Skye","Raze,Cypher,Viper,Omen,Skye"
Lotus,Psycho Cats,house flippers,4,13,3,9,4,1,"Breach,Raze,Cypher,Omen,Gekko","Breach,Raze,Cypher,Omen,Gekko"
Ascent,2Game Esports,SAGAZ,12,14,5,8,6,7,"Sova,Killjoy,Omen,Jett,KAY/O","Sova,Killjoy,Omen,Jett,KAY/O"
Bind,Tenax GC,Cafe Coke,8,13,3,9,4,5,"Raze,Viper,Brimstone,Skye,Gekko","Raze,Viper,Skye,Gekko,Clove"
Bind,Zen Esports,Furious Gaming,13,9,8,2,7,5,"Raze,Viper,Brimstone,Skye,Chamber","Raze,Viper,Yoru,Harbor,Gekko"
Lotus,OXEN GC,Zen eSports GC,15,13,10,4,9,5,"Breach,Raze,Killjoy,Omen,Gekko","Breach,Raze,Killjoy,Brimstone,Neon"
Lotus,VO Blossoms,ASTANE GC,6,13,2,5,8,4,"Raze,Killjoy,Viper,Omen,Fade","Raze,Cypher,Omen,Skye,Deadlock"
Sunset,Dreamstation,Kinetic GC,1,13,1,11,2,0,"Raze,Cypher,Omen,Fade,Gekko","Raze,Cypher,Omen,KAY/O,Gekko"
Sunset,LazerrFreeks Ivy,Vulcan Rising GC,13,7,4,4,3,9,"Raze,Cypher,Fade,Gekko,Clove","Breach,Raze,Cypher,Omen,Gekko"
Lotus,fish with no eye,Ukiyo,1,13,1,11,2,0,"Raze,Killjoy,Viper,Omen,Skye","Raze,Killjoy,Omen,Skye,Gekko"
Lotus,C4C Flare,Mystics GC,13,6,6,1,5,7,"Breach,Raze,Killjoy,Omen,Gekko","Raze,Killjoy,Viper,Omen,Skye"
Lotus,Take Back Control,Synergy GC,13,9,6,4,5,7,"Breach,Raze,Cypher,Omen,Gekko","Raze,Killjoy,Omen,Skye,Gekko"
Ascent,floppers,Luxoria GC,13,4,10,2,2,3,"Jett,Astra,KAY/O,Fade,Deadlock","Sova,Killjoy,Omen,Jett,KAY/O"
Ascent,minions united GC,Endear Moon,13,8,3,6,2,10,"Sova,Killjoy,Omen,Jett,KAY/O","Sova,Killjoy,Reyna,Omen,Jett"
Bind,Catnappers,Solstice GC,3,13,0,4,9,3,"Raze,Brimstone,Skye,Harbor,Gekko","Raze,Viper,Brimstone,Skye,Yoru"
Bind,Labyrinth White,friends GC,2,13,1,2,11,1,"Breach,Raze,Viper,Brimstone,Gekko","Raze,Viper,Brimstone,Skye,Yoru"
Lotus,Thrive Vixens,Supernova x Pals,1,13,0,2,11,1,"Raze,Killjoy,Viper,Omen,Fade","Raze,Killjoy,Viper,Omen,Fade"
Bind,Harmony Opal,Minions United,13,3,9,3,0,4,"Raze,Cypher,Viper,Skye,Clove","Breach,Raze,Jett,Skye,Astra"
Lotus,Nemesis GC,Kirbee Squad,6,13,4,8,5,2,"Breach,Raze,Killjoy,Omen,Gekko","Raze,Killjoy,Fade,Gekko,Clove"
Split,Psycho Cats,house flippers,9,13,7,5,8,2,"Breach,Raze,Cypher,Omen,Skye","Raze,Cypher,Omen,Jett,Skye"
Split,Catnappers,Solstice GC,1,13,1,11,2,0,"Raze,Cypher,Omen,Skye,Yoru","Raze,Cypher,Viper,Skye,Clove"
Lotus,Dreamstation,Kinetic GC,5,13,2,4,9,3,"Raze,Killjoy,Viper,Omen,Fade","Breach,Raze,Cypher,Omen,Gekko"
Icebox,VO Blossoms,ASTANE GC,8,13,5,7,6,3,"Sova,Killjoy,Viper,Reyna,Jett","Sova,Viper,Reyna,KAY/O,Chamber"
Lotus,Tenax GC,Cafe Coke,13,11,7,5,6,6,"Raze,Killjoy,Omen,KAY/O,Gekko","Breach,Raze,Omen,Gekko,Deadlock"
Icebox,Thrive Vixens,Supernova x Pals,2,13,0,3,10,2,"Sova,Killjoy,Viper,Yoru,Gekko","Killjoy,Viper,Jett,KAY/O,Gekko"
Bind,evolutionSTARS,Team 7 Esports,13,11,8,4,7,5,"Raze,Cypher,Brimstone,Reyna,Gekko","Raze,Cypher,Phoenix,Brimstone,Gekko"
Lotus,Zen Esports,Furious Gaming,13,8,10,2,6,3,"Breach,Raze,Sova,Killjoy,Omen","Raze,Killjoy,Viper,Omen,Fade"
Breeze,fish with no eye,Ukiyo,5,13,4,8,5,1,"Cypher,Sova,Viper,Jett,KAY/O","Cypher,Sova,Viper,Jett,KAY/O"
Icebox,R8 Esports,Team RA'AD,2,13,0,3,10,2,"Sova,Killjoy,Viper,Sage,Jett","Killjoy,Viper,Sage,Gekko,Clove"
Ascent,C4C Flare,Mystics GC,13,6,7,0,6,6,"Sova,Killjoy,Omen,Jett,KAY/O","Sova,Killjoy,Omen,Jett,KAY/O"
Sunset,floppers,Luxoria GC,13,3,4,0,3,9,"Omen,KAY/O,Gekko,Deadlock,Clove","Raze,Cypher,Omen,KAY/O,Gekko"
Icebox,Labyrinth White,friends GC,3,13,3,9,4,0,"Sova,Killjoy,Viper,Jett,Harbor","Killjoy,Viper,Jett,KAY/O,Gekko"
Sunset,Harmony Opal,Minions United,13,1,11,1,0,2,"Breach,Raze,Cypher,Omen,Fade","Breach,Raze,Cypher,Omen,Gekko"
Bind,Take Back Control,Synergy GC,13,7,7,1,6,6,"Raze,Viper,Omen,Skye,Yoru","Raze,Cypher,Viper,Brimstone,Skye"
Lotus,minions united GC,Endear Moon,13,5,10,2,3,3,"Breach,Raze,Killjoy,Omen,Fade","Raze,Cypher,Viper,Omen,Skye"
Split,2Game Esports,SAGAZ,17,15,5,11,4,12,"Raze,Viper,Astra,Fade,Gekko","Raze,Cypher,Viper,Omen,Skye"
Bind,Nemesis GC,Kirbee Squad,2,13,0,3,10,2,"Raze,Viper,Brimstone,Skye,Gekko","Raze,Cypher,Viper,Skye,Clove"
Icebox,LazerrFreeks Ivy,Vulcan Rising GC,8,13,6,3,10,2,"Sova,Killjoy,Omen,Jett,Harbor","Sova,Killjoy,Viper,Yoru,Harbor"
Bind,Hero Base,RED Canids,13,9,7,3,6,6,"Raze,Viper,Brimstone,KAY/O,Gekko","Raze,Cypher,Viper,Brimstone,Skye"
Icebox,evolutionSTARS,Team 7 Esports,13,3,10,2,1,3,"Sova,Killjoy,Viper,Reyna,Jett","Sova,Killjoy,Viper,Sage,Yoru"
Sunset,R8 Esports,Team RA'AD,13,5,8,4,1,5,"Breach,Cypher,Sova,Omen,Yoru","Breach,Raze,Cypher,Omen,Gekko"
Split,Hero Base,RED Canids,13,6,7,5,1,6,"Breach,Raze,Viper,Omen,Skye","Raze,Killjoy,Viper,Skye,Astra"
Breeze,2Game Esports,SAGAZ,10,13,9,3,10,1,"Sova,Viper,Jett,Yoru,Astra","Cypher,Sova,Viper,Jett,KAY/O"
Lotus,Entry Frogs Iris,EKO Esports GC,4,13,0,5,8,4,"Breach,Raze,Killjoy,Omen,Fade","Breach,Raze,Killjoy,Omen,Gekko"
Split,All Knights,OXEN,13,9,7,5,4,6,"Raze,Killjoy,Viper,Skye,Astra","Raze,Cypher,Skye,Astra,Deadlock"
Bind,Team Occupy,Skulls Esports,13,6,6,6,0,7,"Raze,Cypher,Brimstone,Reyna,Skye","Raze,Viper,Omen,Skye,Chamber"
Lotus,SK Gaming,Permitta Unicorns,13,4,4,1,3,9,"Breach,Cypher,Sova,Omen,Jett","Breach,Raze,Sova,Killjoy,Omen"
Breeze,R8 Esports,Team RA'AD,11,13,3,9,4,8,"Cypher,Sova,Viper,Omen,Yoru","Sova,Viper,Jett,Yoru,Astra"
Ascent,Team Occupy,Skulls Esports,13,6,6,6,0,7,"Sova,Killjoy,Omen,Jett,KAY/O","Cypher,Sova,Phoenix,Omen,Jett"
Breeze,KPI Gaming,Falke Esports,13,8,9,3,5,4,"Cypher,Sova,Viper,Yoru,Astra","Cypher,Sova,Viper,Jett,KAY/O"
Breeze,All Knights,OXEN,13,3,4,0,3,9,"Cypher,Sova,Viper,Jett,Yoru","Sova,Viper,Yoru,Astra,Neon"
Sunset,Entry Frogs Iris,EKO Esports GC,10,13,7,4,9,3,"Breach,Raze,Cypher,Sova,Clove","Breach,Raze,Cypher,Omen,Gekko"
Sunset,SK Gaming,Permitta Unicorns,13,5,6,0,5,7,"Cypher,Viper,Omen,Jett,Gekko","Breach,Raze,Cypher,Sova,Omen"
Lotus,Twisted Minds Esports,Dragons Esports,12,14,6,7,7,6,"Breach,Raze,Killjoy,Omen,Gekko","Raze,Killjoy,Viper,Omen,Fade"
Breeze,Incognito,Zero Tenacity,11,13,6,6,7,5,"Cypher,Sova,Viper,Jett,Yoru","Sova,Viper,Jett,Yoru,Astra"
Lotus,LXT Esports GC,LuckyGirls,13,1,11,1,0,2,"Raze,Killjoy,Viper,Omen,Fade","Raze,Killjoy,Viper,Omen,Fade"
Split,Barça eSports,Ramboot Club,14,12,9,4,8,5,"Breach,Raze,Viper,Omen,Skye","Raze,Cypher,Viper,Omen,Skye"
Icebox,Eternal Fire,Istanbul Wildcats,8,13,2,7,6,6,"Raze,Killjoy,Viper,KAY/O,Gekko","Killjoy,Jett,KAY/O,Harbor,Gekko"
Sunset,Unity Esports,Underground Gaming,13,10,6,5,5,7,"Breach,Cypher,Omen,Jett,Fade","Cypher,Sova,Omen,Neon,Gekko"
Icebox,Twisted Minds Esports,Dragons Esports,13,3,4,0,3,9,"Killjoy,Viper,Jett,KAY/O,Gekko","Sova,Killjoy,Viper,Sage,Astra"
Lotus,Vision Esports,Fraggerz,9,13,4,6,7,5,"Breach,Raze,Cypher,Omen,Fade","Raze,Killjoy,Omen,Skye,Gekko"
Ascent,LXT Esports GC,LuckyGirls,13,0,1,0,0,12,"Sova,Killjoy,Omen,Jett,KAY/O","Sova,Killjoy,Omen,Jett,KAY/O"
Sunset,CGN Esports,MOUZ,13,9,7,3,6,6,"Raze,Sova,Killjoy,Omen,Clove","Raze,Cypher,Viper,Omen,Gekko"
Ascent,Team Falcons,The Ultimates,14,12,6,7,5,8,"Sova,Jett,Astra,KAY/O,Fade","Sova,Killjoy,Omen,Jett,KAY/O"
Split,Incognito,Zero Tenacity,13,15,5,9,6,8,"Raze,Cypher,Viper,Omen,Skye","Raze,Cypher,Viper,Omen,Skye"
Split,Eternal Fire,Istanbul Wildcats,11,13,7,5,8,4,"Raze,Viper,Omen,Skye,Chamber","Breach,Cypher,Omen,Jett,Skye"
Icebox,Vision Esports,Fraggerz,8,13,6,6,7,2,"Sova,Killjoy,Viper,Jett,Gekko","Sova,Killjoy,Viper,Jett,Gekko"
Split,Team Falcons,The Ultimates,13,5,10,2,3,3,"Breach,Raze,Cypher,Omen,Skye","Raze,Viper,Omen,Jett,Skye"
Sunset,Twisted Minds Esports,Dragons Esports,12,14,8,5,9,4,"Raze,Cypher,Omen,KAY/O,Gekko","Raze,Cypher,Viper,Omen,Fade"
Lotus,Unity Esports,Underground Gaming,16,14,10,5,9,6,"Breach,Cypher,Sova,Omen,Jett","Raze,Killjoy,Viper,Omen,Gekko"
Ascent,Imperium Gaming,ZETA Gaming,2,13,2,10,3,0,"Sova,Killjoy,Omen,Jett,KAY/O","Cypher,Sova,Phoenix,Omen,Jett"
Lotus,CGN Esports,MOUZ,13,11,8,4,7,5,"Raze,Sova,Killjoy,Omen,Gekko","Breach,Cypher,Omen,Yoru,Fade"
Sunset,ESC Gaming,GoNext Esports,8,13,2,10,3,6,"Raze,Cypher,Omen,KAY/O,Gekko","Breach,Raze,Cypher,Omen,KAY/O"
Ascent,PCIFIC Espor,Fire Flux Esports,4,13,2,3,10,2,"Sova,Killjoy,Omen,Jett,KAY/O","Sova,Killjoy,Omen,Jett,KAY/O"
Lotus,ESC Gaming,GoNext Esports,9,13,5,7,6,4,"Breach,Raze,Killjoy,Omen,Fade","Breach,Cypher,Sova,Omen,Jett"
Sunset,PCIFIC Espor,Fire Flux Esports,10,13,6,6,7,4,"Sova,Viper,Phoenix,Omen,Chamber","Raze,Sage,Omen,Fade,Gekko"
Icebox,SCARZ,NORTHEPTION,13,4,9,3,1,4,"Raze,Killjoy,Viper,KAY/O,Gekko","Killjoy,Viper,Reyna,Jett,Gekko"
Breeze,Special TiGers GC,Beyond Stratos Gaming GC,0,13,0,1,12,0,"Sova,Viper,Jett,Yoru,Astra","Sova,Viper,Jett,Yoru,Astra"
Ascent,Special TiGers GC,Beyond Stratos Gaming GC,4,13,3,9,4,1,"Sova,Killjoy,Omen,Jett,KAY/O","Sova,Killjoy,Omen,Jett,KAY/O"
Split,SCARZ,NORTHEPTION,10,13,4,7,6,6,"Raze,Cypher,Sage,Omen,Skye","Raze,Sova,Viper,Omen,Jett"
Lotus,SCARZ,NORTHEPTION,13,6,6,1,5,7,"Breach,Raze,Sova,Killjoy,Omen","Breach,Raze,Cypher,Omen,Gekko"
Lotus,PIXEL (KR),Mir Gaming GC,7,13,6,2,11,1,"Breach,Raze,Killjoy,Fade,Clove","Raze,Killjoy,Viper,Omen,Fade"
Ascent,PIXEL (KR),Mir Gaming GC,9,13,6,6,7,3,"Breach,Sova,Killjoy,Jett,Clove","Sova,Killjoy,Omen,Jett,KAY/O"
Ascent,Sengoku Gaming,Murash Gaming,9,13,6,4,9,3,"Cypher,Omen,Jett,KAY/O,Fade","Sova,Killjoy,Omen,Jett,KAY/O"
Sunset,Sengoku Gaming,Murash Gaming,9,13,8,4,9,1,"Raze,Viper,Sage,Omen,Gekko","Sova,Phoenix,Sage,Omen,Clove"
Lotus,Sengoku Gaming,Murash Gaming,13,10,5,6,4,8,"Raze,Killjoy,Viper,Omen,Fade","Breach,Raze,Killjoy,Brimstone,Gekko"
Bind,FENNEL,VARREL,13,11,8,4,7,5,"Viper,Brimstone,Yoru,Fade,Gekko","Raze,Viper,Omen,Skye,Deadlock"
Lotus,FENNEL,VARREL,13,5,5,1,4,8,"Breach,Raze,Cypher,Sova,Omen","Breach,Raze,Killjoy,Omen,Fade"
Icebox,FENNEL,VARREL,9,13,4,6,7,5,"Sova,Killjoy,Viper,Omen,Harbor","Sova,Killjoy,Viper,Reyna,Gekko"
Split,KS Esports GC,MYVRA,5,13,3,3,10,2,"Raze,Cypher,Viper,Omen,Skye","Breach,Raze,Cypher,Skye,Astra"
Ascent,KS Esports GC,MYVRA,10,13,8,4,9,2,"Sova,Killjoy,Omen,Jett,KAY/O","Sova,Killjoy,Omen,Jett,KAY/O"
Icebox,KS Esports GC,MYVRA,13,5,6,0,5,7,"Killjoy,Viper,Reyna,KAY/O,Gekko","Sova,Killjoy,Viper,Jett,Harbor"
Lotus,Leviatán GC,FiRePOWER GC,13,11,9,3,8,4,"Raze,Killjoy,Viper,Omen,Fade","Breach,Cypher,Omen,Neon,Gekko"
Split,Leviatán GC,FiRePOWER GC,13,2,3,0,2,10,"Breach,Raze,Cypher,Viper,Omen","Raze,Cypher,Sage,Omen,Skye"
Ascent,GAMAX eSports,Team Occupy,13,9,5,5,4,8,"Sova,Killjoy,Omen,Jett,KAY/O","Sova,Killjoy,Omen,Jett,KAY/O"
Icebox,Onyx Ravens,R8 Esports,13,11,8,4,7,5,"Killjoy,Viper,Sage,Jett,Gekko","Sova,Killjoy,Viper,Sage,Jett"
Bind,aNc Outplayed GC,TwentyStars GC,13,11,8,4,7,5,"Raze,Viper,Brimstone,Fade,Gekko","Raze,Viper,Brimstone,Reyna,Skye"
Split,Skulls Esports,NASR Esports,2,13,2,10,3,0,"Raze,Viper,Omen,Skye,Chamber","Breach,Raze,Cypher,Sova,Omen"
Split,GAMAX eSports,Team Occupy,12,14,6,7,7,6,"Breach,Raze,Cypher,Omen,Fade","Breach,Raze,Viper,Omen,Skye"
Ascent,Ovation eSports,XPERION NXT,9,13,3,7,6,6,"Breach,Viper,Omen,Jett,KAY/O","Sova,Killjoy,Omen,Jett,KAY/O"
Icebox,Team RA'AD,top gz,13,5,10,2,3,3,"Killjoy,Viper,Sage,Gekko,Clove","Sova,Killjoy,Viper,Sage,Jett"
Icebox,aNc Outplayed GC,TwentyStars GC,13,6,7,5,1,6,"Sova,Killjoy,Viper,Yoru,Gekko","Sova,Killjoy,Viper,Reyna,Jett"
Bind,Skulls Esports,NASR Esports,10,13,7,5,8,3,"Raze,Viper,Omen,Skye,Chamber","Viper,Omen,Yoru,Fade,Gekko"
Sunset,Team RA'AD,top gz,13,5,8,4,1,5,"Breach,Raze,Cypher,Omen,Gekko","Breach,Raze,Cypher,Omen,Gekko"
Lotus,GAMAX eSports,Team Occupy,13,11,8,4,7,5,"Breach,Raze,Cypher,Sova,Omen","Breach,Raze,Sova,Killjoy,Omen"
Split,Ovation eSports,XPERION NXT,11,13,6,6,7,5,"Breach,Cypher,Viper,Omen,Jett","Raze,Cypher,Viper,Omen,Skye"
Split,UCAM Esports Club,ZETA Gaming,13,4,9,3,1,4,"Breach,Raze,Cypher,Omen,Fade","Breach,Raze,Cypher,Omen,Skye"
Sunset,trashcan,Chipi Chapa's,4,13,0,5,8,4,"Raze,Cypher,Viper,Omen,Skye","Breach,Raze,Cypher,Omen,Yoru"
Bind,Onyx Ravens,R8 Esports,8,13,3,9,4,5,"Raze,Viper,Brimstone,Skye,Gekko","Raze,Cypher,Viper,Brimstone,Skye"
Icebox,HGE Esports GC,NOVO GC,7,13,5,7,6,2,"Killjoy,Viper,Jett,KAY/O,Gekko","Sova,Killjoy,Viper,Sage,Jett"
Icebox,trashcan,Chipi Chapa's,5,13,4,8,5,1,"Sova,Killjoy,Viper,KAY/O,Clove","Killjoy,Viper,Reyna,KAY/O,Gekko"
Sunset,Onyx Ravens,R8 Esports,13,1,11,1,0,2,"Breach,Raze,Cypher,Sova,Omen","Breach,Cypher,Sova,Omen,Yoru"
Split,ALTERNATE aTTaX,DIVIZON,5,13,3,9,4,2,"Raze,Cypher,Viper,Omen,Skye","Raze,Cypher,Sage,Omen,Skye"
Split,Ramboot Club,Five Media Clan,13,8,9,3,5,4,"Raze,Cypher,Viper,Omen,Skye","Breach,Raze,Cypher,Omen,Fade"
Icebox,Papara SuperMassive,Galakticos,15,13,6,8,5,9,"Killjoy,Viper,Jett,KAY/O,Gekko","Omen,KAY/O,Chamber,Gekko,Clove"
Lotus,HGE Esports GC,NOVO GC,11,13,3,9,4,8,"Breach,Raze,Killjoy,Omen,Gekko","Breach,Sova,Killjoy,Omen,Neon"
Lotus,Fraggerz,Twisted Minds Esports,13,3,3,1,2,10,"Raze,Killjoy,Omen,Skye,Gekko","Breach,Raze,Killjoy,Omen,Gekko"
Lotus,ALTERNATE aTTaX,DIVIZON,13,5,8,4,1,5,"Breach,Raze,Sova,Killjoy,Omen","Raze,Killjoy,Omen,Jett,Fade"
Split,Underground Gaming,Team Falcons,8,13,5,4,9,3,"Raze,Cypher,Viper,Omen,Skye","Breach,Raze,Cypher,Omen,Skye"
Ascent,B8 Esports,Diamant Esports,11,13,2,10,3,9,"Cypher,Sova,Phoenix,Omen,Jett","Cypher,Sova,Omen,Jett,KAY/O"
Ascent,Falke Esports,Barça eSports,6,13,2,5,8,4,"Sova,Killjoy,Omen,Jett,KAY/O","Killjoy,Viper,Omen,Jett,Skye"
Lotus,Dragons Esports,Unity Esports,9,13,6,4,9,3,"Raze,Killjoy,Viper,Omen,Fade","Breach,Cypher,Sova,Omen,Jett"
Icebox,The Ultimates,Vision Esports,13,10,6,5,5,7,"Killjoy,Viper,Jett,KAY/O,Gekko","Sova,Killjoy,Viper,Jett,Gekko"
Sunset,Papara SuperMassive,Galakticos,13,6,9,3,3,4,"Raze,Cypher,Omen,KAY/O,Gekko","Breach,Sage,Omen,Chamber,Gekko"
Icebox,Fraggerz,Twisted Minds Esports,13,7,6,6,1,7,"Sova,Killjoy,Viper,Jett,Gekko","Killjoy,Viper,Jett,KAY/O,Gekko"
Sunset,Underground Gaming,Team Falcons,3,13,3,9,4,0,"Cypher,Sova,Omen,Neon,Gekko","Breach,Raze,Cypher,Omen,Fade"
Sunset,B8 Esports,Diamant Esports,7,13,6,6,7,1,"Breach,Raze,Omen,KAY/O,Fade","Raze,Killjoy,Omen,Astra,Fade"
Icebox,Dragons Esports,Unity Esports,6,13,4,8,5,2,"Sova,Killjoy,Viper,Jett,Harbor","Killjoy,Viper,Jett,KAY/O,Gekko"
Split,The Ultimates,Vision Esports,13,8,6,6,2,7,"Raze,Viper,Omen,Jett,Skye","Breach,Raze,Cypher,Omen,Jett"
Icebox,Imperium Gaming,KPI Gaming,13,10,6,6,4,7,"Killjoy,Viper,Reyna,KAY/O,Gekko","Sova,Killjoy,Viper,Sage,Jett"
Ascent,ALTERNATE aTTaX,DIVIZON,9,13,3,7,6,6,"Sova,Killjoy,Omen,Jett,KAY/O","Sova,Killjoy,Omen,Jett,KAY/O"
Breeze,B8 Esports,Diamant Esports,14,12,7,6,6,7,"Cypher,Sova,Viper,Jett,Yoru","Cypher,Sova,Viper,Omen,Yoru"
Lotus,HOWL Esports,S2G Esports,13,11,5,7,4,8,"Raze,Cypher,Viper,Omen,Fade","Raze,Killjoy,Viper,Omen,Fade"
Bind,HOWL Esports,S2G Esports,13,7,8,4,3,5,"Raze,Viper,Brimstone,Skye,Gekko","Raze,Cypher,Viper,Omen,KAY/O"
Lotus,Beyond Stratos Gaming GC,Mir Gaming GC,11,13,7,5,8,4,"Raze,Killjoy,Viper,Omen,Fade","Raze,Killjoy,Viper,Omen,Fade"
Bind,Murash Gaming,NORTHEPTION,9,13,5,7,6,4,"Raze,Viper,Reyna,Gekko,Clove","Raze,Viper,Omen,Skye,Yoru"
Split,Beyond Stratos Gaming GC,Mir Gaming GC,5,13,3,9,4,2,"Raze,Viper,Jett,Skye,Astra","Raze,Viper,Omen,Jett,Skye"
Split,Murash Gaming,NORTHEPTION,11,13,3,9,4,8,"Raze,Cypher,Sage,Omen,Skye","Raze,Viper,Omen,Jett,Skye"
Bind,Beyond Stratos Gaming GC,Mir Gaming GC,13,11,7,5,6,6,"Raze,Viper,Brimstone,Skye,Gekko","Raze,Cypher,Viper,Brimstone,Skye"
Lotus,Murash Gaming,NORTHEPTION,13,5,5,1,4,8,"Breach,Raze,Killjoy,Brimstone,Gekko","Breach,Raze,Cypher,Omen,Gekko"
Sunset,PIXEL (KR),Special TiGers GC,13,7,6,2,5,7,"Breach,Raze,Cypher,Omen,Gekko","Cypher,Sova,Phoenix,Omen,KAY/O"
Split,RIDDLE ORDER,REJECT,13,4,10,2,2,3,"Raze,Viper,Omen,Jett,Skye","Raze,Cypher,Viper,Omen,Skye"
Ascent,PIXEL (KR),Special TiGers GC,13,1,11,1,0,2,"Breach,Sova,Killjoy,Jett,Clove","Sova,Killjoy,Omen,Jett,KAY/O"
Sunset,RIDDLE ORDER,REJECT,10,13,4,8,5,6,"Breach,Raze,Cypher,Omen,Gekko","Raze,Cypher,Omen,KAY/O,Gekko"
Bind,RIDDLE ORDER,REJECT,13,11,6,6,5,7,"Raze,Viper,Omen,Skye,Yoru","Raze,Viper,Brimstone,Fade,Gekko"
Lotus,Sengoku Gaming,SCARZ,13,10,3,9,1,10,"Raze,Killjoy,Viper,Omen,Fade","Breach,Raze,Sova,Killjoy,Omen"
Split,Sengoku Gaming,SCARZ,13,7,10,2,5,3,"Breach,Raze,Viper,Omen,Fade","Raze,Cypher,Sage,Omen,Skye"
Lotus,SaD Purple,RyZ Knights,6,13,2,5,8,4,"Breach,Raze,Cypher,Omen,Skye","Raze,Sova,Killjoy,Viper,Omen"
Bind,SaD Purple,RyZ Knights,13,4,10,2,2,3,"Raze,Cypher,Viper,Brimstone,Skye","Breach,Raze,Cypher,Sova,Brimstone"
Sunset,Volcano Gang,OPPY,13,9,7,3,6,6,"Raze,Cypher,Omen,KAY/O,Gekko","Raze,Cypher,Omen,KAY/O,Gekko"
Ascent,SaD Purple,RyZ Knights,11,13,4,8,5,7,"Cypher,Sova,Omen,Jett,KAY/O","Sova,Killjoy,Omen,Jett,KAY/O"
Icebox,Barcelona Sporting X,FUSION X,3,13,1,3,10,2,"Sova,Killjoy,Omen,Jett,Harbor","Sova,Killjoy,Reyna,Jett,Harbor"
Ascent,Volcano Gang,OPPY,0,13,0,1,12,0,"Cypher,Sova,Omen,Jett,Yoru","Sova,Killjoy,Omen,Jett,KAY/O"
Lotus,Barcelona Sporting X,FUSION X,6,13,1,6,7,5,"Breach,Raze,Omen,Skye,Chamber","Breach,Raze,Killjoy,Omen,Skye"
Breeze,SJSU Blue,UST Esports,3,13,2,10,3,1,"Cypher,Sova,Viper,Jett,Yoru","Cypher,Sova,Viper,Jett,KAY/O"
Bind,Volcano Gang,OPPY,13,10,7,4,6,6,"Raze,Cypher,Viper,Brimstone,Skye","Raze,Cypher,Viper,Brimstone,Skye"
Icebox,SaD Purple,Van Lyn,13,6,5,2,4,8,"Sova,Killjoy,Viper,Reyna,Jett","Sova,Killjoy,Viper,Jett,KAY/O"
Lotus,SJSU Blue,UST Esports,11,13,4,8,5,7,"Raze,Killjoy,Omen,Jett,Skye","Breach,Raze,Killjoy,Omen,Gekko"
Ascent,OPPY,AURA Valorant,13,4,5,0,4,8,"Sova,Killjoy,Omen,Jett,KAY/O","Sova,Killjoy,Omen,Jett,KAY/O"
Ascent,justice for jerwin,RyZ Knights,7,13,3,5,8,4,"Sova,Killjoy,Omen,Jett,KAY/O","Sova,Killjoy,Omen,Jett,KAY/O"
Split,Cruzados Esports GC,KRÜ BLAZE,6,13,3,4,9,3,"Viper,Jett,Skye,Astra,KAY/O","Raze,Viper,Omen,Skye,Clove"
Breeze,SaD Purple,Van Lyn,13,8,9,3,5,4,"Cypher,Sova,Viper,Jett,Yoru","Cypher,Sova,Viper,Reyna,Jett"
Icebox,BALLZ V3.0,Volcano Gang,12,14,5,8,6,7,"Sova,Killjoy,Viper,Reyna,Gekko","Sova,Killjoy,Jett,Harbor,Clove"
Lotus,justice for jerwin,RyZ Knights,13,9,8,2,7,5,"Raze,Killjoy,Viper,Omen,Gekko","Raze,Sova,Killjoy,Viper,Omen"
Icebox,Ball State,University of Virginia,4,13,0,5,8,4,"Killjoy,Viper,Sage,Reyna,Gekko","Sova,Killjoy,Viper,Sage,Jett"
Ascent,Cruzados Esports GC,KRÜ BLAZE,5,13,3,3,10,2,"Sova,Killjoy,Omen,Jett,KAY/O","Sova,Killjoy,Omen,Jett,KAY/O"
Lotus,SaD Purple,Van Lyn,11,13,6,6,7,5,"Breach,Raze,Cypher,Omen,Skye","Raze,Killjoy,Viper,Omen,Fade"
Bind,Team 7 Esports,Neverlanders eSports Baby's,13,8,8,4,4,5,"Raze,Cypher,Phoenix,Brimstone,Gekko","Raze,Cypher,Brimstone,Skye,Gekko"
Ascent,Ice Fishers,BALLZ V3.0,2,13,1,11,2,1,"Sova,Killjoy,Omen,Jett,KAY/O","Sova,Killjoy,Jett,KAY/O,Clove"
Bind,AURA Valorant,Dastardly Dogs,13,9,8,2,7,5,"Raze,Cypher,Viper,Brimstone,Skye","Raze,Viper,Brimstone,Fade,Gekko"
Icebox,justice for jerwin,RyZ Knights,6,13,6,6,7,0,"Sova,Killjoy,Viper,Reyna,Jett","Sova,Killjoy,Viper,Reyna,Jett"
Breeze,Zerance,Solary,13,9,8,4,5,5,"Sova,Viper,Jett,Yoru,Harbor","Cypher,Sova,Viper,Jett,KAY/O"
Breeze,Ball State,University of Virginia,7,13,3,5,8,4,"Cypher,Sova,Viper,Jett,Astra","Cypher,Sova,Viper,Jett,Yoru"
Icebox,LazerrFreeks8,Lionheart eSports,13,15,10,4,11,3,"Sova,Killjoy,Reyna,Omen,Harbor","Killjoy,Viper,Jett,KAY/O,Gekko"
Lotus,Area of Effect,Cataclysm Gaming,14,12,6,7,5,8,"Raze,Killjoy,Viper,Omen,Skye","Breach,Raze,Killjoy,Omen,Gekko"
Split,TAMU Maroon,Fisher Falcons,13,7,5,3,4,8,"Raze,Cypher,Viper,Omen,Skye","Raze,Cypher,Viper,Omen,Skye"
Lotus,TMC,OPPY,9,13,2,8,5,7,"Raze,Killjoy,Viper,Omen,Fade","Raze,Killjoy,Viper,Omen,Fade"
Bind,Oxygen Esports,DarkZero Esports,13,9,6,4,5,7,"Raze,Viper,Brimstone,Skye,Gekko","Raze,Viper,Brimstone,Skye,Gekko"
Sunset,Volcano Gang,Jack n Frens ,17,15,8,8,7,9,"Raze,Cypher,Omen,KAY/O,Gekko","Breach,Raze,Cypher,Omen,Gekko"
Breeze,SaD Purple,Lemonade Stand,13,5,9,3,2,4,"Cypher,Sova,Viper,Jett,Yoru","Cypher,Sova,Viper,Jett,KAY/O"
Split,Blinn Esports,TMU Blue,13,8,7,5,3,6,"Raze,Cypher,Viper,Omen,Skye","Breach,Raze,Cypher,Omen,Skye"
Sunset,Dumb Driods,Ice Fishers,10,13,8,3,10,2,"Raze,Cypher,Sova,Omen,Gekko","Raze,Killjoy,Omen,KAY/O,Gekko"
Sunset,Excane,Alliance Guardians,13,4,3,2,2,10,"Breach,Raze,Cypher,Omen,Gekko","Raze,Cypher,Omen,KAY/O,Gekko"
Lotus,Imperial Titans,ASTANE,10,13,1,10,3,9,"Raze,Killjoy,Viper,Omen,Fade","Raze,Killjoy,Fade,Gekko,Clove"
Sunset,Team 7 Esports,Neverlanders eSports Baby's,13,10,7,5,5,6,"Sage,Omen,Yoru,KAY/O,Gekko","Breach,Raze,Cypher,Omen,Gekko"
Lotus,Lucky 7 Gaming,Team Basillix,13,7,6,2,5,7,"Raze,Killjoy,Viper,Omen,Skye","Raze,Killjoy,Omen,Yoru,Fade"
Sunset,RyZe Eclipsa GC,Purpose Gaming,3,13,1,3,10,2,"Breach,Raze,Cypher,Astra,Gekko","Breach,Raze,Cypher,Omen,Fade"
Ascent,ShaBoingBoing Esports,Fractal Gaming,5,13,2,10,3,3,"Sova,Killjoy,Omen,Jett,KAY/O","Sova,Killjoy,Omen,Jett,KAY/O"
Icebox,Hyperion Gold,Chino Hills,13,3,3,1,2,10,"Sova,Killjoy,Viper,Sage,Reyna","Sova,Killjoy,Viper,Jett,Gekko"
Lotus,CCG Esports,Raven Esports,13,4,5,0,4,8,"Raze,Cypher,Viper,Omen,Fade","Breach,Cypher,Omen,Neon,Fade"
Ascent,spoof and pros,Van Lyn,10,13,3,9,4,7,"Sova,Killjoy,Jett,Astra,KAY/O","Sova,Killjoy,Omen,Jett,KAY/O"
Icebox,UW Esports,Spate Esports,17,15,8,8,7,9,"Sova,Killjoy,Jett,Harbor,Clove","Viper,Jett,KAY/O,Gekko,Clove"
Sunset,LazerrFreeks Mythic,1Millisecond,13,2,3,0,2,10,"Breach,Raze,Cypher,Omen,Fade","Breach,Raze,Cypher,Omen,Fade"
Breeze,Flowstate,OC Eagles,2,13,0,3,10,2,"Cypher,Sova,Viper,Jett,KAY/O","Cypher,Sova,Viper,Jett,KAY/O"
Split,Six Figures,Prospects,2,13,0,12,1,2,"Raze,Cypher,Omen,Jett,Deadlock","Breach,Raze,Cypher,Omen,Yoru"
Ascent,Nightblood Gaming,Event Horizon,13,3,4,0,3,9,"Sova,Killjoy,Omen,Jett,KAY/O","Sova,Killjoy,Omen,Jett,KAY/O"
Ascent,Hyjinx Black,DOOMSDAY,9,13,2,8,5,7,"Sova,Killjoy,Omen,Jett,KAY/O","Sova,Killjoy,Omen,Jett,KAY/O"
Bind,U4RIA Radiata,Supernova Nebula,9,13,6,6,7,3,"Raze,Cypher,Viper,Brimstone,Skye","Breach,Raze,Cypher,Brimstone,Gekko"
Lotus,Big Brim Gamers,Canadia Compooters,4,13,4,8,5,0,"Raze,Killjoy,Viper,Omen,Fade","Breach,Raze,Omen,Chamber,Fade"
Split,Outlast Gaming,Resonate,6,13,1,6,7,5,"Breach,Raze,Viper,Omen,Skye","Raze,Viper,Omen,Jett,Skye"
Ascent,Thinking Men,RyZ Knights,7,13,3,5,8,4,"Sova,Killjoy,Omen,Jett,KAY/O","Sova,Killjoy,Omen,Jett,KAY/O"
Ascent,Astane Anarchy,Risk,11,13,4,8,5,7,"Sova,Killjoy,Omen,Jett,KAY/O","Sova,Omen,Jett,KAY/O,Deadlock"
Sunset,Defiant Gaming,ENVEE YSL,15,13,5,9,4,10,"Raze,Cypher,Sova,Omen,Gekko","Breach,Raze,Cypher,Omen,Gekko"
Ascent,AURA Valorant,TEAM T2G,16,14,9,6,8,7,"Sova,Killjoy,Omen,Jett,KAY/O","Cypher,Sova,Omen,Jett,Skye"
Split,CHURCH OF CHAEWON KIM,french goats,5,13,2,10,3,3,"Raze,Cypher,Viper,Omen,Skye","Raze,Cypher,Omen,Jett,Skye"
Ascent,F1 Esports,Team Digital,13,11,6,6,5,7,"Cypher,Sova,Omen,Jett,KAY/O","Sova,Killjoy,Omen,Jett,KAY/O"
Split,Winthrop University,justice for jerwin,6,13,5,7,6,1,"Raze,Cypher,Viper,Omen,Skye","Raze,Cypher,Omen,Jett,Skye"
Icebox,Zerance,Solary,11,13,3,9,4,8,"Killjoy,Viper,Jett,Harbor,Gekko","Sova,Killjoy,Viper,Sage,Jett"
Lotus,M for Mini,Jack n Frens ,5,13,2,4,9,3,"Breach,Raze,Viper,Omen,Gekko","Breach,Raze,Cypher,Omen,Gekko"
Bind,Thug Shakers,Sky Esports (NA),11,13,3,9,4,8,"Raze,Viper,Brimstone,Skye,Gekko","Raze,Viper,Brimstone,Reyna,Skye"
Ascent,Blinn Esports,TMU Blue,13,4,4,1,3,9,"Sova,Killjoy,Omen,Jett,KAY/O","Breach,Sova,Killjoy,Omen,Jett"
Split,Hybrid Authority,Destro,13,7,6,6,1,7,"Raze,Cypher,Omen,Skye,KAY/O","Raze,Cypher,Jett,Skye,Astra"
Sunset,Predator X Gaming,Sizzle Esports,13,11,8,4,7,5,"Breach,Raze,Cypher,Sova,Omen","Raze,Cypher,Omen,KAY/O,Gekko"
Split,LazerrFreeks8,Cataclysm Gaming,9,13,6,6,7,3,"Raze,Cypher,Viper,Omen,Skye","Raze,Cypher,Viper,Omen,Skye"
Ascent,VZN E-SPORTS,Volcano Gang,7,13,4,4,9,3,"Sova,Killjoy,Omen,Jett,KAY/O","Sova,Killjoy,Omen,Jett,KAY/O"
Ascent,Team Spirit,Dastardly Dogs,12,14,5,8,6,7,"Raze,Sova,Killjoy,Brimstone,Omen","Sova,Killjoy,Omen,Jett,KAY/O"
Bind,TAMU Maroon,Fisher Falcons,13,7,10,2,5,3,"Raze,Viper,Brimstone,Skye,Deadlock","Raze,Viper,Brimstone,Skye,Gekko"
Lotus,ROSE,Eternal Focus Crimson,13,9,8,2,7,5,"Raze,Cypher,Omen,KAY/O,Gekko","Raze,Killjoy,Omen,Fade,Gekko"
Lotus,Baby Goats,BALLZ V3.0,10,13,5,6,7,5,"Breach,Raze,Killjoy,Omen,Gekko","Raze,Killjoy,Omen,Fade,Gekko"
Lotus,Ice Fishers,Fallen Angels Orias,13,1,2,0,1,11,"Raze,Cypher,Omen,KAY/O,Gekko","Raze,Killjoy,Omen,Yoru,Gekko"
Sunset,OPPY,Sky Esports (NA),13,9,7,3,6,6,"Raze,Cypher,Omen,KAY/O,Gekko","Raze,Cypher,Sova,Omen,KAY/O"
Icebox,Awaken,Dexterity Gaming,11,13,6,6,7,5,"Sova,Killjoy,Viper,Sage,Jett","Sova,Killjoy,Viper,Harbor,Gekko"
Icebox,Oxygen Esports,DarkZero Esports,13,5,9,3,2,4,"Sova,Killjoy,Viper,Reyna,Gekko","Killjoy,Viper,Omen,KAY/O,Gekko"
Split,R8 Esports,NASR Esports,13,11,6,6,5,7,"Raze,Cypher,Viper,Omen,Skye","Breach,Raze,Cypher,Sova,Omen"
Icebox,top gz,Onyx Ravens,11,13,7,5,8,4,"Sova,Killjoy,Viper,Sage,Jett","Killjoy,Viper,Sage,Jett,Gekko"
Bind,Team Occupy,Team RA'AD,13,11,8,4,7,5,"Raze,Cypher,Brimstone,Reyna,Skye","Raze,Viper,Brimstone,Skye,Gekko"
Bind,RyZe Eclipsa GC,Raven Esports,2,13,2,10,3,0,"Raze,Cypher,Omen,Skye,Yoru","Raze,Cypher,Viper,Brimstone,Skye"
Bind,Passion Project,Lemonade Stand,15,17,5,11,6,10,"Raze,Cypher,Viper,Brimstone,Skye","Raze,Brimstone,Skye,Harbor,Gekko"
Icebox,Big Brim Gamers,Flowstate,1,13,0,2,11,1,"Killjoy,Viper,Jett,KAY/O,Gekko","Sova,Killjoy,Viper,Jett,Gekko"
Ascent,spoof and pros,YDZ Esports,13,5,8,4,1,5,"Sova,Killjoy,Jett,Astra,KAY/O","Sova,Killjoy,Omen,Jett,KAY/O"
Sunset,Imperial Titans,Alliance Guardians,13,10,5,6,4,8,"Breach,Raze,Cypher,Omen,Gekko","Raze,Cypher,Omen,KAY/O,Gekko"
Lotus,Thinking Men,SHOW ME,13,5,7,5,0,6,"Raze,Omen,Fade,Gekko,Deadlock","Breach,Raze,Killjoy,Skye,Clove"
Lotus,Lionheart eSports,Area of Effect,9,13,7,5,8,2,"Breach,Raze,Cypher,Omen,Fade","Raze,Killjoy,Viper,Omen,Skye"
Split,LazerrFreeks Mythic,french goats,13,1,11,1,0,2,"Breach,Raze,Cypher,Omen,Gekko","Raze,Cypher,Omen,Jett,Skye"
Icebox,LONETEAM,NOVO Esports,6,13,4,3,10,2,"Sova,Killjoy,Viper,Sage,Reyna","Sova,Killjoy,Viper,Sage,Jett"
Lotus,Spate Esports,Team Basilix,13,8,6,3,5,7,"Breach,Raze,Cypher,Omen,Gekko","Raze,Killjoy,Omen,Yoru,Fade"
Sunset,CHURCH OF CHAEWON KIM,1Millisecond,9,13,0,10,3,9,"Breach,Raze,Cypher,Omen,Gekko","Breach,Raze,Cypher,Omen,Fade"
Bind,Six Figures,Risk,13,3,2,2,1,11,"Raze,Viper,Brimstone,Skye,Fade","Raze,Cypher,Brimstone,Skye,Fade"
Ascent,justice for jerwin,Special Grade,13,5,3,3,2,10,"Sova,Killjoy,Omen,Jett,KAY/O","Sova,Killjoy,Omen,Jett,KAY/O"
Ascent,Outlast Gaming,Defiant Gaming,13,8,7,2,6,6,"Sova,Killjoy,Omen,Jett,KAY/O","Sova,Killjoy,Omen,Jett,KAY/O"
Bind,Canadia Compooters,OC Eagles,9,13,6,6,7,3,"Raze,Cypher,Brimstone,Skye,Gekko","Raze,Cypher,Viper,Brimstone,Skye"
Ascent,Team Digital,Hyjinx Black,13,7,5,3,4,8,"Sova,Killjoy,Omen,Jett,KAY/O","Sova,Killjoy,Omen,Jett,KAY/O"
Lotus,Resonate,ENVEE YSL,13,9,7,5,4,6,"Raze,Killjoy,Viper,Omen,Fade","Breach,Raze,Cypher,Omen,Fade"
Sunset,F1 Esports,DOOMSDAY,13,6,5,2,4,8,"Breach,Omen,Jett,Skye,Deadlock","Breach,Raze,Cypher,Omen,Gekko"
Ascent,ASTANE,Excane,15,13,10,4,9,5,"Sova,Killjoy,Omen,Jett,KAY/O","Sova,Killjoy,Omen,Jett,KAY/O"
Sunset,Astane Anarchy,Prospects,7,13,5,3,10,2,"Raze,Cypher,Omen,KAY/O,Gekko","Raze,Cypher,Omen,KAY/O,Gekko"
Sunset,Valkyrie,RyZ Knights,11,13,4,8,5,7,"Raze,Cypher,Omen,KAY/O,Gekko","Breach,Raze,Cypher,Sova,Clove"
Icebox,Supernova Nebula,ROSE,5,13,5,7,6,0,"Killjoy,Viper,Jett,KAY/O,Gekko","Sova,Killjoy,Viper,Jett,KAY/O"
Icebox,Sizzle Esports,Chino Hills,2,13,0,3,10,2,"Sova,Viper,Sage,Reyna,Chamber","Sova,Killjoy,Viper,Jett,Gekko"
Lotus,Destro,Event Horizon,1,13,1,11,2,0,"Raze,Killjoy,Viper,Omen,Fade","Breach,Raze,Killjoy,Omen,Gekko"
Sunset,Zerance,Solary,13,9,5,5,4,8,"Breach,Raze,Cypher,Sova,Omen","Breach,Raze,Cypher,Omen,Fade"
Icebox,ShaBoingBoing Esports,Dexterity Gaming,5,13,4,8,5,1,"Sova,Killjoy,Viper,Reyna,Jett","Sova,Killjoy,Viper,Harbor,Gekko"
Bind,Lucky 7 Gaming,UW Esports,11,13,9,3,10,2,"Raze,Cypher,Brimstone,Skye,Gekko","Raze,Cypher,Sova,Brimstone,Gekko"
Lotus,SaD Purple,Orangutan Gang,13,8,6,3,5,7,"Breach,Raze,Cypher,Omen,Skye","Raze,Killjoy,Viper,Omen,Fade"
Split,Team Occupy,Team RA'AD,13,4,8,4,0,5,"Breach,Raze,Viper,Omen,Skye","Raze,Cypher,Viper,Omen,Skye"
Ascent,Purpose Gaming,CCG Esports,13,15,10,4,11,3,"Sova,Killjoy,Omen,Jett,KAY/O","Sova,Killjoy,Omen,Jett,KAY/O"
Lotus,U4RIA Radiata,Eternal Focus Crimson,7,13,2,6,7,5,"Breach,Raze,Cypher,Omen,Skye","Raze,Killjoy,Omen,Fade,Gekko"
Lotus,Fractal Gaming,Awaken,6,13,6,6,7,0,"Raze,Killjoy,Viper,Omen,Fade","Raze,Cypher,Omen,KAY/O,Gekko"
Lotus,top gz,Onyx Ravens,7,13,5,7,6,2,"Breach,Raze,Killjoy,Omen,Fade","Breach,Raze,Killjoy,Omen,Gekko"
Icebox,Hyperion Gold,Predator X Gaming,13,4,10,2,2,3,"Sova,Killjoy,Viper,Sage,Reyna","Omen,Jett,KAY/O,Harbor,Gekko"
Ascent,Van Lyn,Time Machine,13,8,5,4,4,8,"Sova,Killjoy,Omen,Jett,KAY/O","Sova,Killjoy,Omen,Jett,KAY/O"
Sunset,Dimonis,BEYOND eSports,13,7,6,2,5,7,"Raze,Cypher,Omen,KAY/O,Gekko","Breach,Cypher,Jett,Gekko,Clove"
Sunset,UCAM Esports Club,Ramboot Club,13,7,8,4,3,5,"Breach,Raze,Cypher,Sova,Omen","Breach,Raze,Cypher,Phoenix,Omen"
Ascent,Winthrop University,Sexy Gang,13,9,6,4,5,7,"Sova,Killjoy,Omen,Jett,KAY/O","Sova,Killjoy,Omen,Jett,KAY/O"
Sunset,R8 Esports,NASR Esports,13,11,7,5,6,6,"Breach,Cypher,Sova,Omen,Yoru","Breach,Raze,Cypher,Omen,Fade"
Breeze,Ursus Gaming,Tani eSports,13,6,6,1,5,7,"Cypher,Sova,Viper,Jett,KAY/O","Cypher,Sova,Viper,Jett,KAY/O"
Ascent,Void,YDZ Esports,12,14,5,8,6,7,"Sova,Killjoy,Omen,Jett,KAY/O","Sova,Killjoy,Omen,Jett,KAY/O"
Lotus,RyZ Knights,Thug Shakers,13,1,11,1,0,2,"Raze,Sova,Killjoy,Viper,Omen","Breach,Raze,Omen,Jett,Gekko"
Split,SHOW ME,Aspyre x Swarm,13,11,5,7,4,8,"Breach,Raze,Cypher,Skye,Clove","Raze,Cypher,Viper,Omen,Skye"
Ascent,HGE Esports,RTZN,13,5,8,4,1,5,"Sova,Killjoy,Omen,Jett,KAY/O","Sova,Killjoy,Omen,Jett,KAY/O"
Icebox,Sexy Gang,LAG,13,2,10,2,0,3,"Sova,Killjoy,Viper,Jett,KAY/O","Sova,Killjoy,Viper,Jett,Gekko"
Ascent,justice for jerwin,Goated,13,3,2,2,1,11,"Cypher,Sova,Omen,Jett,KAY/O","Sova,Killjoy,Omen,Jett,KAY/O"
Icebox,Special Grade,Street Sweepers,13,10,9,2,8,4,"Sova,Killjoy,Viper,Sage,Jett","Sova,Killjoy,Viper,Jett,Gekko"
Lotus,Undecisive,Valkyrie,11,13,6,6,7,5,"Raze,Killjoy,Viper,Omen,Fade","Breach,Raze,Omen,Jett,Skye"
Ascent,Van Lyn,Mitch's Mongeese,13,2,3,0,2,10,"Sova,Killjoy,Omen,Jett,KAY/O","Sova,Killjoy,Omen,Jett,KAY/O"
Ascent,spoof and pros,Sussy Players,13,3,9,3,0,4,"Sova,Killjoy,Omen,Jett,KAY/O","Sova,Killjoy,Omen,Jett,KAY/O"
Split,Time Machine,BALLZ V3.0,13,9,6,6,3,7,"Raze,Cypher,Viper,Omen,Skye","Breach,Raze,Cypher,Omen,Skye"
Ascent,Passion Project,IOUNL,20,18,7,12,6,13,"Sova,Killjoy,Omen,Jett,KAY/O","Cypher,Sova,Reyna,Omen,Jett"
Lotus,Winthrop University,Luxoria,13,5,5,1,4,8,"Raze,Cypher,Sage,Omen,Fade","Raze,Killjoy,Viper,Omen,Fade"
Breeze,Twisted Minds Esports,The Ultimates,13,7,5,3,4,8,"Cypher,Sova,Viper,Jett,Yoru","Cypher,Sova,Viper,Jett,KAY/O"
Sunset,Ursus Gaming,Tani eSports,13,2,11,1,1,2,"Raze,Cypher,Omen,KAY/O,Gekko","Breach,Raze,Cypher,Omen,Gekko"
Ascent,Dimonis,BEYOND eSports,11,13,3,9,4,8,"Sova,Killjoy,Omen,Jett,KAY/O","Sova,Killjoy,Jett,KAY/O,Clove"
Bind,SaD Purple,Ugly Hamsters,13,8,10,2,6,3,"Raze,Cypher,Viper,Brimstone,Skye","Raze,Viper,Brimstone,Skye,Gekko"
Icebox,Orangutan Gang,Volcano Gang,13,11,6,6,5,7,"Sova,Killjoy,Viper,Omen,Jett","Sova,Killjoy,Jett,Harbor,Clove"
Breeze,Lemonade Stand,Koala Pound,13,8,8,4,4,5,"Cypher,Sova,Viper,Jett,KAY/O","Cypher,Sova,Viper,Jett,KAY/O"
Icebox,Team Falcons,Unity Esports,13,5,5,1,4,8,"Reyna,Omen,KAY/O,Harbor,Gekko","Sova,Killjoy,Viper,Omen,Jett"
Ascent,DVM Esport,Cicadas Gaming,12,14,5,8,6,7,"Cypher,Sova,Omen,Jett,Deadlock","Sova,Killjoy,Omen,Jett,KAY/O"
Icebox,Five Media Clan,Falke Esports,13,7,7,5,2,6,"Killjoy,Viper,Jett,KAY/O,Gekko","Sova,Killjoy,Viper,Jett,KAY/O"
Lotus,Thinking Men,pasta fazool,13,5,3,3,2,10,"Raze,Omen,Fade,Gekko,Deadlock","Breach,Raze,Cypher,Gekko,Clove"
Lotus,Siko Esports,Yendez,13,11,8,4,7,5,"Raze,Killjoy,Viper,Omen,Fade","Cypher,Omen,Jett,Skye,Gekko"
Lotus,Sexy Gang,Goth Girl Sanctuary,13,9,8,2,7,5,"Breach,Raze,Killjoy,Omen,Fade","Raze,Killjoy,Viper,Omen,Gekko"
Sunset,RyZ Knights,OPPY,13,1,2,0,1,11,"Breach,Raze,Cypher,Sova,Omen","Raze,Cypher,Omen,KAY/O,Gekko"
Split,IOUNL,Sushi Taco,13,3,4,0,3,9,"Raze,Cypher,Omen,Jett,Skye","Cypher,Viper,Omen,Jett,Skye"
Lotus,Showdown Clowns,SHOW ME,11,13,6,6,7,5,"Raze,Viper,Omen,Fade,Deadlock","Breach,Raze,Killjoy,Skye,Clove"
Icebox,Dimonis,BEYOND eSports,13,2,10,2,0,3,"Sova,Killjoy,Viper,Reyna,Jett","Sova,Killjoy,Viper,Jett,Gekko"
Ascent,Valkyrie,Neglected,13,3,10,2,1,3,"Sova,Killjoy,Omen,Jett,KAY/O","Sova,Killjoy,Omen,Jett,KAY/O"
Ascent,Orangutan Gang,600s Shootas,13,2,3,0,2,10,"Sova,Killjoy,Omen,Jett,KAY/O","Sova,Killjoy,Reyna,Omen,Jett"
Ascent,Luxoria,Minions United,13,4,4,1,3,9,"Sova,Killjoy,Jett,KAY/O,Clove","Sova,Killjoy,Omen,Jett,KAY/O"
Ascent,Aspyre x Swarm,Flowstate,13,11,9,3,8,4,"Sova,Killjoy,Omen,Jett,KAY/O","Sova,Killjoy,Jett,KAY/O,Clove"
Ascent,Street Sweepers,Globe N Friends,13,6,4,3,3,9,"Cypher,Sova,Omen,Jett,KAY/O","Sova,Killjoy,Omen,Jett,KAY/O"
Lotus,Time Machine,Asians and Friend,13,7,6,2,5,7,"Breach,Raze,Killjoy,Omen,Skye","Breach,Raze,Cypher,Omen,Fade"
Ascent,FAWZ Purple,Ugly Hamsters,5,13,0,6,7,5,"Sova,Killjoy,Omen,Jett,KAY/O","Sova,Killjoy,Omen,Jett,KAY/O"
Icebox,LAG,Una Ludio,13,2,10,2,0,3,"Sova,Killjoy,Viper,Jett,Gekko","Killjoy,Viper,Omen,Jett,Gekko"
Bind,Colors Esport,lesptitesnieces,13,11,4,8,3,9,"Breach,Reyna,Astra,Neon,Fade","Raze,Cypher,Viper,Brimstone,Skye"
Split,Twisted Minds Esports,The Ultimates,10,13,5,6,7,5,"Raze,Viper,Omen,Jett,Skye","Raze,Viper,Omen,Jett,Skye"
Ascent,The GRID,Void,15,17,7,9,8,8,"Sova,Killjoy,Phoenix,Omen,Jett","Sova,Killjoy,Omen,Jett,KAY/O"
Lotus,Sussy Players,Some Lovers of Cheese,13,8,9,3,5,4,"Raze,Cypher,Omen,Fade,Gekko","Raze,Killjoy,Reyna,Omen,Gekko"
Icebox,BALLZ V3.0,Big Hot Men,13,10,6,5,5,7,"Sova,Killjoy,Viper,Reyna,Gekko","Sova,Killjoy,Viper,Jett,Gekko"
Lotus,DVM Esport,Cicadas Gaming,13,6,4,3,3,9,"Raze,Cypher,Sova,Omen,Deadlock","Raze,Killjoy,Viper,Omen,Fade"
Bind,Converse Purple,Volcano Gang,7,13,6,6,7,1,"Raze,Viper,Omen,Skye,Gekko","Raze,Cypher,Viper,Brimstone,Skye"
Bind,College Rejects,Mitch's Mongeese,6,13,4,8,5,2,"Raze,Viper,Brimstone,Fade,Gekko","Raze,Viper,Brimstone,Yoru,Fade"
Sunset,YDZ Esports,McGill Red,14,12,11,2,10,3,"Breach,Raze,Cypher,Sova,Omen","Raze,Cypher,Omen,KAY/O,Gekko"
Sunset,Koala Pound,Esoteric Kings,13,5,4,2,3,9,"Breach,Raze,Cypher,Omen,Gekko","Raze,Cypher,Omen,Fade,Gekko"
Ascent,Hanks Tanks,Goated,6,13,3,9,4,3,"Sova,Killjoy,Omen,Jett,KAY/O","Sova,Killjoy,Omen,Jett,KAY/O"
Sunset,Team Falcons,Unity Esports,13,8,5,4,4,8,"Breach,Raze,Cypher,Omen,Fade","Breach,Raze,Cypher,Omen,Fade"
Split,ZETA Gaming,KPI Gaming,4,13,1,11,2,3,"Breach,Raze,Cypher,Omen,Skye","Breach,Raze,Cypher,Omen,Skye"
Lotus,Axolotl,Outplayed,13,9,7,3,6,6,"Raze,Killjoy,Viper,Omen,Fade","Raze,Killjoy,Viper,Omen,Fade"
Lotus,XPERION NXT,ALTERNATE aTTaX,4,13,2,10,3,2,"Killjoy,Viper,Omen,Neon,Gekko","Breach,Raze,Sova,Killjoy,Omen"
Split,Siko Esports,Yendez,1,13,1,11,2,0,"Raze,Cypher,Astra,Gekko,Deadlock","Raze,Cypher,Sage,Omen,Skye"
Lotus,VexOficiaal,Tani eSports,7,13,4,4,9,3,"Breach,Killjoy,Astra,Neon,Gekko","Breach,Raze,Cypher,Omen,Gekko"
Lotus,Fraggerz,Dragons Esports,15,13,9,5,8,6,"Killjoy,Omen,Jett,Skye,Gekko","Raze,Killjoy,Viper,Omen,Fade"
Sunset,Division 7,POK,13,5,4,2,3,9,"Breach,Raze,Cypher,Omen,Gekko","Breach,Raze,Cypher,Omen,Gekko"
Ascent,Dimonis,Melilla Titans Academy,13,3,10,2,1,3,"Sova,Killjoy,Omen,Jett,KAY/O","Raze,Viper,Reyna,KAY/O,Harbor"
Breeze,Team Falcons,Unity Esports,6,13,5,7,6,1,"Cypher,Sova,Viper,Jett,KAY/O","Breach,Cypher,Sova,Viper,Jett"
Sunset,DVM Esport,Cicadas Gaming,10,13,3,9,4,7,"Breach,Raze,Cypher,Omen,Gekko","Breach,Raze,Cypher,Omen,Yoru"
Breeze,Colors Esport,lesptitesnieces,13,9,8,2,7,5,"Cypher,Sova,Viper,Jett,KAY/O","Cypher,Sova,Viper,Jett,KAY/O"
Split,XPERION NXT,ALTERNATE aTTaX,7,13,4,8,5,3,"Raze,Cypher,Viper,Omen,Skye","Raze,Cypher,Viper,Omen,Skye"
Breeze,VexOficiaal,Tani eSports,5,13,3,3,10,2,"Cypher,Sova,Viper,Yoru,KAY/O","Cypher,Sova,Viper,Jett,KAY/O"
Split,BEYOND eSports,AXIMZERO,13,8,4,5,3,9,"Breach,Raze,Cypher,Jett,Clove","Breach,Raze,Viper,Skye,Clove"
Ascent,Siko Esports,Yendez,13,7,6,2,5,7,"Sova,Killjoy,Omen,Jett,KAY/O","Cypher,Sova,Omen,Jett,KAY/O"
Bind,Fraggerz,Dragons Esports,13,2,10,2,0,3,"Raze,Cypher,Omen,Jett,Skye","Raze,Viper,Brimstone,Skye,Gekko"
Lotus,Twisted Minds Esports,The Ultimates,14,12,8,5,7,6,"Breach,Raze,Killjoy,Omen,Gekko","Breach,Cypher,Sova,Omen,Neon"
Bind,Barça eSports,Imperium Gaming,13,7,6,6,1,7,"Cypher,Viper,Yoru,Gekko,Clove","Raze,Viper,Omen,Skye,Yoru"
Breeze,1000rr club,Ursus Gaming,6,13,3,9,4,3,"Cypher,Sova,Viper,Jett,Yoru","Cypher,Sova,Viper,Jett,KAY/O"
Ascent,Division 7,POK,13,4,8,4,0,5,"Sova,Killjoy,Omen,Jett,KAY/O","Sova,Killjoy,Omen,Jett,KAY/O"
Bind,Dimonis,Melilla Titans Academy,13,7,8,4,3,5,"Raze,Cypher,Viper,Skye,Clove","Breach,Brimstone,Omen,Chamber,Gekko"
Lotus,1000rr club,Ursus Gaming,3,13,2,2,11,1,"Breach,Raze,Cypher,Omen,Gekko","Breach,Raze,Killjoy,Omen,Gekko"
Sunset,BEYOND eSports,AXIMZERO,13,8,7,5,3,6,"Breach,Cypher,Jett,Gekko,Clove","Breach,Raze,Cypher,Omen,Gekko"
Ascent,VexOficiaal,Tani eSports,13,10,9,3,7,4,"Breach,Sova,Killjoy,Jett,Astra","Cypher,Sova,Omen,Jett,KAY/O"
Lotus,lesptitesnieces,Yendez,13,7,6,2,5,7,"Raze,Killjoy,Viper,Omen,Skye","Breach,Killjoy,Omen,Jett,Gekko"
Lotus,FOKUS,Eintracht Frankfurt,10,13,5,6,7,5,"Raze,Cypher,Viper,Omen,Fade","Raze,Killjoy,Omen,Astra,Fade"
Ascent,lesptitesnieces,Yendez,13,5,8,4,1,5,"Sova,Killjoy,Omen,Jett,KAY/O","Cypher,Sova,Omen,Jett,KAY/O"
Lotus,Siko Esports,Colors Esport,10,13,3,8,5,7,"Raze,Killjoy,Viper,Omen,Fade","Breach,Sova,Killjoy,Omen,Neon"
Ascent,FOKUS,Eintracht Frankfurt,4,13,2,3,10,2,"Cypher,Sova,Omen,Jett,KAY/O","Cypher,Sova,Sage,Omen,Jett"
Breeze,Siko Esports,Colors Esport,4,13,0,5,8,4,"Cypher,Sova,Viper,Jett,KAY/O","Cypher,Sova,Viper,Jett,KAY/O"
Ascent,lesptitesnieces,Pingou Esport,13,5,9,3,2,4,"Sova,Killjoy,Omen,Jett,KAY/O","Sova,Killjoy,Omen,Jett,KAY/O"
Breeze,True Rippers,MLT Esports,7,13,3,9,4,4,"Sova,Yoru,Astra,Chamber,Harbor","Cypher,Sova,Viper,Jett,KAY/O"
Bind,MOUZ,Ovation eSports,13,7,10,2,5,3,"Breach,Raze,Viper,Brimstone,Gekko","Raze,Viper,Brimstone,KAY/O,Chamber"
Split,True Rippers,MLT Esports,2,13,2,10,3,0,"Raze,Cypher,Viper,Omen,Skye","Raze,Cypher,Viper,Omen,Skye"
Split,Siko Esports,Jupitar,13,7,7,5,2,6,"Raze,Cypher,Astra,Gekko,Deadlock","Breach,Raze,Cypher,Omen,Skye"
Icebox,Colors Esport,Two Faced,13,10,6,6,4,7,"Killjoy,Viper,Jett,KAY/O,Gekko","Killjoy,Viper,Jett,KAY/O,Gekko"
Split,Nuxeria,Yendez,11,13,9,3,10,2,"Raze,Viper,Omen,KAY/O,Deadlock","Cypher,Sage,Omen,Jett,Skye"
Bind,lesptitesnieces,Pingou Esport,10,13,5,6,7,5,"Raze,Brimstone,Skye,Harbor,Gekko","Raze,Viper,Brimstone,Skye,Gekko"
Lotus,MOUZ,Ovation eSports,13,2,10,2,0,3,"Breach,Cypher,Omen,Yoru,Fade","Raze,Killjoy,Viper,Omen,Fade"
Icebox,Dominus Esports,Crocodile Tear,4,13,1,4,9,3,"Sova,Killjoy,Viper,Jett,Gekko","Sova,Killjoy,Viper,Jett,KAY/O"
Ascent,True Rippers,MLT Esports,7,13,3,5,8,4,"Sova,Killjoy,Omen,Jett,KAY/O","Sova,Killjoy,Omen,Jett,KAY/O"
Lotus,K10 (OCE),DXA Esports,3,13,2,10,3,1,"Breach,Raze,Killjoy,Astra,Fade","Breach,Raze,Cypher,Gekko,Clove"
Sunset,Colors Esport,Two Faced,14,12,7,6,6,7,"Breach,Raze,Cypher,Sova,Omen","Raze,Cypher,Omen,KAY/O,Gekko"
Ascent,Nuxeria,Yendez,9,13,6,6,7,3,"Cypher,Sova,Omen,Jett,KAY/O","Cypher,Sova,Omen,Jett,KAY/O"
Lotus,Siko Esports,Jupitar,13,11,9,3,8,4,"Raze,Killjoy,Viper,Omen,Fade","Raze,Killjoy,Viper,Omen,Fade"
Lotus,lesptitesnieces,Pingou Esport,13,11,9,3,8,4,"Raze,Killjoy,Viper,Omen,Skye","Breach,Killjoy,Omen,Jett,Gekko"
Sunset,Dominus Esports,Crocodile Tear,12,14,7,6,8,5,"Breach,Raze,Cypher,Sova,Omen","Raze,Cypher,Omen,KAY/O,Gekko"
Sunset,YIPPEE,VLG X,13,4,10,2,2,3,"Raze,Cypher,Omen,KAY/O,Gekko","Breach,Raze,Cypher,Gekko,Clove"
Bind,K10 (OCE),DXA Esports,10,13,6,6,7,4,"Raze,Viper,Brimstone,Fade,Gekko","Raze,Cypher,Viper,Brimstone,Skye"
Bind,Dominus Esports,Crocodile Tear,5,13,2,4,9,3,"Raze,Brimstone,Skye,Harbor,Gekko","Raze,Brimstone,Skye,Harbor,Gekko"
Lotus,YIPPEE,VLG X,13,4,9,3,1,4,"Raze,Killjoy,Viper,Omen,Fade","Breach,Raze,Killjoy,Omen,Gekko"
Ascent,raindrops,YIPPEE,13,8,8,4,4,5,"Cypher,Sova,Omen,Jett,KAY/O","Sova,Killjoy,Omen,Jett,KAY/O"
Ascent,DXA Esports,Misses Worldwide,13,6,9,3,3,4,"Sova,Killjoy,Omen,Jett,KAY/O","Breach,Raze,Sova,Omen,Fade"
Split,raindrops,YIPPEE,7,13,5,7,6,2,"Raze,Cypher,Viper,Omen,Skye","Raze,Cypher,Viper,Skye,Astra"
Lotus,VLG X,Xu Gang Crimson,13,8,6,3,5,7,"Breach,Raze,Killjoy,Omen,Gekko","Raze,Killjoy,Omen,Skye,Gekko"
Icebox,DXA Esports,Misses Worldwide,13,9,7,5,4,6,"Sova,Killjoy,Viper,Reyna,Jett","Sova,Killjoy,Viper,Jett,Gekko"
Icebox,K10 (OCE),Balut Warriors,8,13,4,5,8,4,"Killjoy,Viper,Jett,KAY/O,Gekko","Sova,Killjoy,Viper,Jett,Yoru"
Lotus,LazerrFreeks8,Medics,13,9,6,6,3,7,"Raze,Killjoy,Omen,Fade,Gekko","Raze,Killjoy,Omen,Fade,Gekko"
Sunset,Hyjinx Violet,Destro,4,13,3,9,4,1,"Raze,Cypher,Viper,Omen,Gekko","Breach,Raze,Cypher,Fade,Clove"
Lotus,Spate Esports,Status Red,13,6,6,1,5,7,"Breach,Raze,Cypher,Omen,Gekko","Raze,Cypher,Fade,Gekko,Clove"
Split,K10 (OCE),Balut Warriors,1,13,0,2,11,1,"Raze,Cypher,Viper,Skye,Astra","Raze,Cypher,Omen,Gekko,Deadlock"
Lotus,DXA Esports,Misses Worldwide,5,13,4,8,5,1,"Breach,Raze,Cypher,Gekko,Clove","Killjoy,Omen,Chamber,Neon,Gekko"
Icebox,raindrops,YIPPEE,13,11,4,8,3,9,"Sova,Killjoy,Viper,Reyna,Jett","Killjoy,Viper,Jett,KAY/O,Gekko"
Breeze,VLG X,Xu Gang Crimson,13,11,10,2,9,3,"Cypher,Sova,Jett,KAY/O,Harbor","Cypher,Sova,Viper,Jett,KAY/O"
Ascent,LazerrFreeks8,Medics,13,8,5,4,4,8,"Sova,Killjoy,Omen,Jett,KAY/O","Sova,Killjoy,Omen,Jett,KAY/O"
Icebox,Supernova Nebula,Endear Gaming,13,5,9,3,2,4,"Killjoy,Viper,Jett,KAY/O,Gekko","Sova,Killjoy,Viper,Reyna,Jett"
Lotus,Prospects Amethyst,Cataclysm Gaming,2,13,2,10,3,0,"Breach,Raze,Cypher,Omen,Gekko","Breach,Raze,Killjoy,Omen,Gekko"
Breeze,Esoteric Kings,Fractal Gaming,10,13,6,6,7,4,"Cypher,Sova,Viper,Jett,Yoru","Cypher,Sova,Viper,Jett,Yoru"
Breeze,Fractal Gaming,Esoteric Kings,13,10,7,4,6,6,"Cypher,Sova,Viper,Jett,Yoru","Cypher,Sova,Viper,Jett,Yoru"
Lotus,Hyjinx Violet,Destro,4,13,1,4,9,3,"Raze,Killjoy,Viper,Omen,Fade","Raze,Viper,Omen,Fade,Deadlock"
Breeze,RyZe Eclipsa GC,C4C Flare,13,1,2,0,1,11,"Cypher,Sova,Jett,Yoru,Harbor","Cypher,Sova,Viper,Yoru,Astra"
Icebox,Spate Esports,Status Red,13,8,3,6,2,10,"Viper,Jett,KAY/O,Gekko,Clove","Raze,Sova,Killjoy,Viper,Jett"
Split,Prospects Amethyst,Cataclysm Gaming,5,13,1,5,8,4,"Raze,Cypher,Omen,Jett,Skye","Raze,Cypher,Viper,Omen,Skye"
Sunset,Supernova Nebula,Endear Gaming,13,11,8,4,7,5,"Raze,Cypher,Omen,KAY/O,Gekko","Breach,Raze,Cypher,Omen,Fade"
Sunset,RyZe Eclipsa GC,C4C Flare,13,8,8,1,7,5,"Breach,Raze,Cypher,Gekko,Clove","Breach,Raze,Cypher,Omen,Gekko"
Lotus,Alliance Guardians,Medics,13,9,6,4,5,7,"Breach,Raze,Cypher,Omen,Skye","Raze,Killjoy,Omen,Fade,Gekko"
Icebox,Esoteric Kings,Fractal Gaming,6,13,1,6,7,5,"Raze,Sova,Killjoy,Viper,KAY/O","Sova,Killjoy,Viper,Jett,KAY/O"
Icebox,Fractal Gaming,Esoteric Kings,13,6,7,5,1,6,"Sova,Killjoy,Viper,Jett,KAY/O","Raze,Sova,Killjoy,Viper,KAY/O"
Sunset,Hybrid Authority,Shinjitsu,13,6,9,3,3,4,"Raze,Cypher,Omen,KAY/O,Gekko","Breach,Raze,Cypher,Omen,Gekko"
Lotus,RyZe Eclipsa GC,C4C Flare,2,13,0,3,10,2,"Breach,Raze,Killjoy,Omen,Gekko","Breach,Raze,Killjoy,Omen,Gekko"
Lotus,U4RIA Radiata,LazerrFreeks8,13,6,10,2,4,3,"Breach,Raze,Cypher,Omen,Skye","Raze,Killjoy,Omen,Fade,Gekko"
Bind,Spate Esports,Una Ludio,13,2,2,1,1,11,"Viper,Jett,Yoru,Gekko,Clove","Raze,Cypher,Brimstone,Skye,Gekko"
Lotus,Prospects,Destro,13,8,7,5,3,6,"Raze,Killjoy,Viper,Omen,Fade","Raze,Killjoy,Viper,Omen,Fade"
Sunset,Imperial Titans,Sizzle Esports,13,5,4,2,3,9,"Breach,Raze,Cypher,Omen,Gekko","Raze,Cypher,Omen,KAY/O,Gekko"
Sunset,Eternal Focus Crimson,Endear Gaming,13,8,9,3,5,4,"Raze,Cypher,Omen,KAY/O,Gekko","Breach,Raze,Cypher,Omen,Fade"
Ascent,Alliance Guardians,Medics,8,13,6,6,7,2,"Breach,Raze,Omen,Fade,Gekko","Sova,Killjoy,Omen,Jett,KAY/O"
Breeze,Hyjinx Violet,Astane Anarchy,10,13,8,3,10,2,"Sova,Viper,Jett,Yoru,Astra","Cypher,Sova,Viper,Jett,KAY/O"
Split,Hybrid Authority,Shinjitsu,13,4,3,2,2,10,"Raze,Cypher,Omen,Skye,KAY/O","Raze,Cypher,Viper,Omen,Skye"
Sunset,Prospects Amethyst,Six Figures,4,13,3,9,4,1,"Raze,Cypher,Omen,KAY/O,Gekko","Raze,Cypher,Omen,KAY/O,Gekko"
Sunset,Poseidon Esports,Supernova Nebula,2,13,0,3,10,2,"Raze,Cypher,Sova,Omen,Gekko","Raze,Cypher,Omen,KAY/O,Gekko"
Icebox,F1 Esports,RyZe Eclipsa GC,13,2,10,2,0,3,"Raze,Reyna,Skye,Chamber,Clove","Sova,Viper,Jett,Chamber,Gekko"
Ascent,Fractal Gaming,Esoteric Kings,11,13,6,6,7,5,"Sova,Killjoy,Omen,Jett,KAY/O","Sova,Killjoy,Omen,Jett,KAY/O"
Ascent,Esoteric Kings,Fractal Gaming,13,11,7,5,6,6,"Sova,Killjoy,Omen,Jett,KAY/O","Sova,Killjoy,Omen,Jett,KAY/O"
Sunset,Prospects,Destro,13,7,5,3,4,8,"Raze,Cypher,Omen,KAY/O,Gekko","Breach,Raze,Cypher,Fade,Clove"
Ascent,Imperial Titans,Sizzle Esports,13,9,5,5,4,8,"Sova,Killjoy,Omen,Jett,KAY/O","Sova,Killjoy,Omen,Jett,KAY/O"
Split,Spate Esports,Una Ludio,13,9,6,6,3,7,"Raze,Cypher,Omen,Jett,Skye","Breach,Raze,Cypher,Astra,Gekko"
Lotus,Eternal Focus Crimson,Endear Gaming,13,8,7,5,3,6,"Raze,Killjoy,Omen,Fade,Gekko","Raze,Killjoy,Omen,Fade,Gekko"
Bind,U4RIA Radiata,LazerrFreeks8,13,11,7,5,6,6,"Raze,Cypher,Viper,Brimstone,Skye","Raze,Viper,Brimstone,Skye,Gekko"
Sunset,Lionheart eSports,Team Digital,13,7,5,3,4,8,"Breach,Cypher,Sova,Omen,Neon","Breach,Raze,Cypher,Omen,Fade"
Ascent,Hyjinx Violet,Astane Anarchy,5,13,1,5,8,4,"Breach,Raze,Omen,KAY/O,Fade","Sova,Killjoy,Omen,Jett,KAY/O"
Sunset,F1 Esports,RyZe Eclipsa GC,13,0,12,0,0,1,"Breach,Omen,Jett,Skye,Deadlock","Breach,Raze,Cypher,Gekko,Clove"
Bind,Prospects Amethyst,Six Figures,5,13,3,3,10,2,"Raze,Viper,Brimstone,Skye,Gekko","Raze,Viper,Brimstone,Skye,Fade"
Sunset,Alliance Guardians,Medics,13,11,5,7,4,8,"Raze,Cypher,Omen,KAY/O,Gekko","Raze,Cypher,Sova,Omen,Gekko"
Icebox,Poseidon Esports,Supernova Nebula,2,13,0,3,10,2,"Sova,Killjoy,Viper,Jett,Harbor","Killjoy,Viper,Jett,KAY/O,Gekko"
Ascent,OutGoing Esports,ShaBoingBoing Esports,12,14,8,5,9,4,"Sova,Killjoy,Omen,Jett,KAY/O","Sova,Killjoy,Omen,Jett,KAY/O"
Lotus,blueming,NCSU Red,9,13,3,9,4,6,"Breach,Raze,Omen,Jett,Skye","Raze,Killjoy,Viper,Omen,Fade"
Icebox,Vibin Out Vex,french goats,6,13,6,6,7,0,"Sova,Killjoy,Viper,Reyna,Jett","Sova,Killjoy,Viper,Reyna,Jett"
Ascent,K7 Esports GC,Akave Esports Black,1,13,0,2,11,1,"Sova,Killjoy,Phoenix,Omen,Jett","Sova,Killjoy,Omen,Jett,KAY/O"
Icebox,Imperial Titans,Sizzle Esports,7,13,5,7,6,2,"Sova,Killjoy,Viper,Jett,Gekko","Sova,Viper,Sage,Reyna,Chamber"
Bind,Lionheart eSports,Team Digital,9,13,8,4,9,1,"Raze,Cypher,Brimstone,Skye,Gekko","Raze,Viper,Brimstone,Skye,Gekko"
Bind,FinalFormHQ,Dexterity Gaming,1,13,0,2,11,1,"Raze,Cypher,Brimstone,Skye,Gekko","Raze,Viper,Brimstone,Skye,Gekko"
Sunset,Harmony,Terps Academy,13,2,10,2,0,3,"Breach,Raze,Cypher,Omen,Gekko","Breach,Raze,Cypher,Omen,Fade"
Ascent,Foreign Legion,BSC Bobcats VA,8,13,2,7,6,6,"Sova,Killjoy,Omen,Jett,KAY/O","Sova,Killjoy,Omen,Jett,KAY/O"
Ascent,Vibin Out Vex,french goats,9,13,6,6,7,3,"Sova,Killjoy,Omen,Jett,KAY/O","Cypher,Sova,Omen,Jett,KAY/O"
Lotus,OutGoing Esports,ShaBoingBoing Esports,12,14,6,7,7,6,"Raze,Killjoy,Viper,Omen,Fade","Breach,Raze,Killjoy,Omen,Gekko"
Bind,Canadia Compooters,Defiant Gaming,13,11,8,4,7,5,"Raze,Cypher,Brimstone,Skye,Gekko","Raze,Brimstone,Skye,Harbor,Gekko"
Icebox,blueming,NCSU Red,13,11,7,5,6,6,"Sova,Killjoy,Reyna,Jett,Harbor","Sova,Killjoy,Viper,Sage,Jett"
Lotus,Lucky 7 Gaming,No Sweat,13,1,2,0,1,11,"Raze,Killjoy,Viper,Omen,Skye","Breach,Raze,Killjoy,Omen,Fade"
Bind,K7 Esports GC,Akave Esports Black,4,13,1,4,9,3,"Raze,Brimstone,Skye,Harbor,Gekko","Raze,Cypher,Viper,Brimstone,Skye"
Ascent,1Millisecond,Nearest Airport,13,9,8,2,7,5,"Sova,Killjoy,Omen,Jett,KAY/O","Sova,Killjoy,Omen,Jett,KAY/O"
Ascent,FinalFormHQ,Dexterity Gaming,9,13,3,7,6,6,"Sova,Killjoy,Omen,Jett,KAY/O","Cypher,Sova,Omen,Jett,KAY/O"
Sunset,Purpose Gaming,Hyjinx Violet,15,13,10,4,9,5,"Breach,Raze,Cypher,Omen,Fade","Raze,Cypher,Viper,Omen,Gekko"
Ascent,SJSU Blue,Ball State,13,10,8,4,6,5,"Sova,Killjoy,Omen,Jett,KAY/O","Sova,Killjoy,Omen,Jett,KAY/O"
Split,Lionheart eSports,Team Digital,13,9,8,4,5,5,"Breach,Raze,Cypher,Omen,Gekko","Raze,Cypher,Viper,Skye,Astra"
Lotus,Harmony,Terps Academy,13,8,7,2,6,6,"Breach,Raze,Killjoy,Omen,Fade","Raze,Killjoy,Viper,Omen,Fade"
Sunset,Lucky 7 Gaming,No Sweat,13,2,3,0,2,10,"Breach,Raze,Cypher,Omen,Fade","Raze,Cypher,Sova,Omen,KAY/O"
Breeze,M80,DarkZero Esports,10,13,6,5,8,4,"Cypher,Sova,Viper,Jett,KAY/O","Cypher,Sova,Viper,Jett,KAY/O"
Bind,Foreign Legion,BSC Bobcats VA,9,13,7,5,8,2,"Raze,Viper,Skye,Gekko,Clove","Cypher,Sova,Jett,Gekko,Clove"
Split,OutGoing Esports,ShaBoingBoing Esports,13,1,2,0,1,11,"Raze,Cypher,Viper,Omen,Skye","Breach,Raze,Cypher,Omen,Skye"
Split,Kryptic GC,Status Red,6,13,2,5,8,4,"Raze,Cypher,Omen,Skye,Clove","Raze,Cypher,Omen,Jett,Skye"
Sunset,blueming,NCSU Red,4,13,3,9,4,1,"Raze,Cypher,Reyna,Omen,Gekko","Breach,Raze,Cypher,Omen,Gekko"
Lotus,Canadia Compooters,Defiant Gaming,13,6,10,2,4,3,"Breach,Raze,Cypher,Omen,Fade","Breach,Raze,Killjoy,Gekko,Clove"
Bind,Risk,Alliance Guardians,14,12,6,7,5,8,"Raze,Cypher,Brimstone,Skye,Fade","Breach,Raze,Cypher,Brimstone,Skye"
Icebox,Elation,Sushi Bois,13,9,5,5,4,8,"Sova,Killjoy,Viper,Omen,Gekko","Killjoy,Omen,KAY/O,Harbor,Gekko"
Lotus,SJSU Blue,Ball State,13,6,8,4,2,5,"Raze,Killjoy,Omen,Jett,Skye","Raze,Killjoy,Viper,Omen,Skye"
Breeze,University War GC,9z Team GC,10,13,7,5,8,3,"Cypher,Sova,Viper,Jett,KAY/O","Cypher,Sova,Viper,Jett,KAY/O"
Breeze,Spate Esports,ENG Gaming,13,5,6,0,5,7,"Sova,Viper,Yoru,Astra,Neon","Cypher,Sova,Jett,Yoru,Harbor"
Breeze,Purpose Gaming,Hyjinx Violet,9,13,6,6,7,3,"Cypher,Sova,Viper,Yoru,KAY/O","Sova,Viper,Jett,Yoru,Astra"
Breeze,Project 01,Flare,14,12,9,4,8,5,"Cypher,Sova,Viper,Jett,Yoru","Cypher,Sova,Viper,Jett,Yoru"
Ascent,Risk,Alliance Guardians,13,3,9,3,0,4,"Cypher,Sova,Omen,Jett,KAY/O","Sova,Killjoy,Omen,Jett,KAY/O"
Ascent,Hustlin Huskies,RyZe Academy,3,13,2,2,11,1,"Sova,Killjoy,Omen,Jett,KAY/O","Sova,Killjoy,Omen,Jett,KAY/O"
Ascent,Elation,Sushi Bois,13,1,11,1,0,2,"Sova,Killjoy,Omen,Jett,KAY/O","Sova,Killjoy,Omen,Jett,KAY/O"
Breeze,C4C Flare,BlanK,13,7,6,2,5,7,"Cypher,Sova,Viper,Yoru,Astra","Cypher,Sova,Viper,Jett,KAY/O"
Ascent,Chino Hills,Comet Esports Club,13,4,2,3,1,11,"Sova,Omen,Jett,KAY/O,Deadlock","Killjoy,Omen,Jett,KAY/O,Gekko"
Bind,Flowstate,U4RIA Radiata,13,5,4,2,3,9,"Raze,Viper,Fade,Gekko,Clove","Raze,Cypher,Viper,Brimstone,Skye"
Ascent,M80,DarkZero Esports,8,13,2,7,6,6,"Cypher,Sova,Omen,Jett,KAY/O","Cypher,Sova,Omen,Jett,Deadlock"
Sunset,Event Horizon Red,Terps Academy,6,13,4,8,5,2,"Breach,Raze,Cypher,Omen,Gekko","Breach,Raze,Cypher,Omen,Fade"
Lotus,Kryptic GC,Status Red,13,9,9,3,6,4,"Breach,Raze,Cypher,Omen,Gekko","Raze,Cypher,Omen,Jett,Gekko"
Ascent,F1 Esports,Raven Esports,9,13,3,9,4,6,"Cypher,Sova,Omen,Jett,KAY/O","Omen,Yoru,Astra,KAY/O,Fade"
Sunset,1Millisecond,Nearest Airport,18,16,11,6,10,7,"Breach,Raze,Cypher,Omen,Fade","Breach,Raze,Cypher,Omen,Gekko"
Sunset,Canadia Compooters,Defiant Gaming,12,14,3,10,4,9,"Breach,Raze,Cypher,Omen,Fade","Raze,Cypher,Sova,Omen,Gekko"
Ascent,Foreign Legion,STG Gaming,13,10,6,5,5,7,"Sova,Killjoy,Omen,Jett,KAY/O","Sova,Killjoy,Omen,Jett,KAY/O"
Split,alvins chipmunks,CKnights,13,3,4,0,3,9,"Raze,Cypher,Omen,Jett,Skye","Raze,Cypher,Viper,Omen,Skye"
Ascent,Orangutan Gang,Meow meow,13,2,10,2,0,3,"Sova,Killjoy,Omen,Jett,KAY/O","Sova,Killjoy,Reyna,Omen,Jett"
Bind,ROSE,DOOMSDAY,13,10,8,3,7,5,"Raze,Cypher,Brimstone,Skye,Gekko","Raze,Brimstone,Yoru,Harbor,Gekko"
Sunset,Medics,Destro,10,13,3,8,5,7,"Raze,Cypher,Sova,Omen,Gekko","Breach,Raze,Cypher,Fade,Clove"
Breeze,Flowstate,U4RIA Radiata,13,2,3,0,2,10,"Cypher,Sova,Viper,Jett,KAY/O","Cypher,Sova,Viper,Reyna,Jett"
Split,SJSU Blue,Ball State,9,13,4,8,5,5,"Raze,Cypher,Jett,Skye,Astra","Raze,Cypher,Viper,Omen,Skye"
Lotus,Spate Esports,ENG Gaming,13,6,5,2,4,8,"Breach,Raze,Cypher,Omen,Gekko","Raze,Killjoy,Viper,Omen,Fade"
Lotus,C4C Flare,BlanK,13,3,9,3,0,4,"Breach,Raze,Killjoy,Omen,Gekko","Breach,Raze,Killjoy,Omen,Gekko"
Icebox,Chino Hills,Comet Esports Club,13,4,2,3,1,11,"Sova,Killjoy,Viper,Jett,Gekko","Sova,Killjoy,Viper,Reyna,Jett"
Lotus,LazerrFreeks8,Fractal Gaming,13,7,7,5,2,6,"Raze,Killjoy,Omen,Fade,Gekko","Raze,Killjoy,Viper,Omen,Fade"
Split,University War GC,9z Team GC,7,13,5,7,6,2,"Raze,Cypher,Viper,Omen,Skye","Raze,Viper,Omen,Fade,Gekko"
Sunset,Lemonade Stand,Supernova Nebula,13,10,8,3,7,5,"Breach,Raze,Cypher,Omen,Gekko","Raze,Cypher,Omen,KAY/O,Gekko"
Bind,OC Eagles,Sizzle Esports,13,5,5,1,4,8,"Raze,Cypher,Viper,Brimstone,Skye","Raze,Viper,Skye,Yoru,Clove"
Sunset,Risk,Alliance Guardians,9,13,6,6,7,3,"Breach,Raze,Omen,Fade,Deadlock","Raze,Cypher,Omen,KAY/O,Gekko"
Icebox,Project 01,Flare,13,10,7,4,6,6,"Sova,Killjoy,Viper,Jett,Gekko","Sova,Killjoy,Viper,Jett,Clove"
Icebox,Sexy Gang,Hybrid Authority,13,4,5,0,4,8,"Sova,Killjoy,Viper,Jett,KAY/O","Killjoy,Viper,Jett,KAY/O,Gekko"
Lotus,F1 Esports,Raven Esports,6,13,5,7,6,1,"Breach,Omen,Jett,Gekko,Deadlock","Breach,Cypher,Omen,Neon,Fade"
Split,Outlast Gaming,Shinjitsu,13,5,6,0,5,7,"Breach,Raze,Viper,Omen,Skye","Raze,Cypher,Viper,Omen,Skye"
Bind,RyZe Eclipsa GC,Una Ludio,13,10,9,2,8,4,"Raze,Cypher,Omen,Skye,Yoru","Raze,Cypher,Brimstone,Skye,Gekko"
Bind,1Millisecond,Nearest Airport,3,13,0,4,9,3,"Raze,Viper,Brimstone,Skye,Gekko","Raze,Viper,Omen,Fade,Gekko"
Bind,Prospects Amethyst,Esoteric Kings,13,9,10,2,7,3,"Raze,Viper,Brimstone,Skye,Gekko","Raze,Cypher,Viper,Brimstone,Skye"
Sunset,Six Figures,Koala Pound,13,9,4,6,3,9,"Raze,Cypher,Omen,KAY/O,Gekko","Breach,Raze,Cypher,Omen,Gekko"
Bind,Kryptic GC,Status Red,6,13,4,3,10,2,"Raze,Cypher,Viper,Brimstone,KAY/O","Raze,Cypher,Brimstone,Jett,Skye"
Lotus,Prospects,Cataclysm Gaming,13,10,6,6,4,7,"Raze,Killjoy,Viper,Omen,Fade","Breach,Raze,Killjoy,Omen,Gekko"
Ascent,Endear Gaming,Anomaly Gaming,13,4,5,0,4,8,"Sova,Killjoy,Omen,Jett,KAY/O","Sova,Killjoy,Omen,Jett,KAY/O"
Ascent,Purpose Gaming,Hyjinx Violet,13,9,4,8,1,9,"Sova,Killjoy,Omen,Jett,KAY/O","Breach,Omen,Jett,KAY/O,Fade"
Sunset,Astane Anarchy,Utica Blue,13,11,11,1,10,2,"Raze,Cypher,Omen,KAY/O,Gekko","Raze,Cypher,Omen,Fade,Gekko"
Lotus,Petezatron 2000s,Eternal Focus Crimson,6,13,1,6,7,5,"Breach,Raze,Killjoy,Omen,Fade","Raze,Killjoy,Omen,Fade,Gekko"
Bind,Excane,ASTANE,8,13,5,7,6,3,"Raze,Cypher,Brimstone,Skye,Astra","Raze,Viper,Skye,Gekko,Clove"
Sunset,LazerrFreeks Mythic,UW Esports,13,4,9,3,1,4,"Breach,Raze,Cypher,Omen,Fade","Raze,Cypher,Sova,Omen,Gekko"
Lotus,ASTANE GC,Oni Occult,13,9,7,5,4,6,"Raze,Cypher,Omen,Skye,Deadlock","Raze,Killjoy,Omen,Fade,Gekko"
Breeze,Hustlin Huskies,RyZe Academy,11,13,5,7,6,6,"Cypher,Sova,Viper,Jett,Yoru","Cypher,Sova,Viper,Jett,Yoru"
Icebox,ROSE,DOOMSDAY,13,4,4,1,3,9,"Sova,Killjoy,Viper,Jett,KAY/O","Breach,Killjoy,Viper,Jett,Neon"
Ascent,Area of Effect,Resonate,7,13,2,6,7,5,"Sova,Killjoy,Omen,Jett,KAY/O","Sova,Killjoy,Sage,Omen,Jett"
Lotus,Event Horizon Red,Terps Academy,13,6,8,4,2,5,"Breach,Raze,Killjoy,Omen,Gekko","Raze,Killjoy,Viper,Omen,Fade"
Bind,BSC Bobcats VA,Vibin Out RISE,13,7,8,4,3,5,"Raze,Cypher,Sova,Gekko,Clove","Raze,Viper,Brimstone,Fade,Gekko"
Bind,Big Brim Gamers,Nightblood Gaming,6,13,2,5,8,4,"Raze,Cypher,Viper,Brimstone,Skye","Raze,Viper,Omen,Skye,Gekko"
Icebox,Awaken,Imperial Titans,13,4,2,3,1,11,"Sova,Killjoy,Viper,Sage,Jett","Sova,Killjoy,Viper,Jett,Gekko"
Sunset,Foreign Legion,STG Gaming,12,14,4,9,5,8,"Breach,Raze,Cypher,Omen,KAY/O","Raze,Cypher,Omen,KAY/O,Gekko"
Split,Meow meow,CKnights,13,15,5,9,6,8,"Raze,Cypher,Viper,Omen,Skye","Raze,Cypher,Viper,Omen,Skye"
Icebox,Orangutan Gang,alvins chipmunks,11,13,5,7,6,6,"Sova,Killjoy,Viper,Omen,Jett","Sova,Killjoy,Viper,Jett,Gekko"
Split,Moist x Shopify,Oxygen Esports,11,13,6,6,7,5,"Raze,Cypher,Viper,Skye,Astra","Raze,Killjoy,Viper,Skye,Astra"
Lotus,ROSE,DOOMSDAY,6,13,4,3,10,2,"Raze,Cypher,Omen,Skye,Gekko","Raze,Killjoy,Viper,Omen,Fade"
Lotus,Area of Effect,Resonate,5,13,1,5,8,4,"Raze,Killjoy,Viper,Omen,Skye","Raze,Killjoy,Viper,Omen,Fade"
Icebox,OC Eagles,Sizzle Esports,15,13,6,8,5,9,"Sova,Killjoy,Viper,Jett,Clove","Sova,Viper,Sage,Reyna,Chamber"
Icebox,University War GC,9z Team GC,13,9,5,5,4,8,"Sova,Killjoy,Viper,Sage,Chamber","Killjoy,Viper,Jett,KAY/O,Gekko"
Lotus,Utica Blue,Chino Hills,13,2,10,2,0,3,"Raze,Viper,Omen,Skye,Gekko","Breach,Raze,Cypher,Omen,Gekko"
Split,ASTANE GC,Oni Occult,13,8,5,4,4,8,"Breach,Raze,Cypher,Omen,Skye","Raze,Viper,Omen,Jett,Skye"
Sunset,BSC Bobcats VA,Vibin Out RISE,13,4,4,1,3,9,"Cypher,Sova,Omen,Jett,Gekko","Raze,Cypher,Omen,KAY/O,Gekko"
Bind,LazerrFreeks Mythic,UW Esports,15,13,6,8,5,9,"Raze,Viper,Skye,Gekko,Clove","Raze,Cypher,Sova,Brimstone,Gekko"
Lotus,Cataclysm Gaming,Kryptic GC,13,1,2,0,1,11,"Breach,Raze,Killjoy,Omen,Gekko","Breach,Raze,Cypher,Brimstone,Gekko"
Ascent,Big Brim Gamers,Nightblood Gaming,7,13,3,5,8,4,"Sova,Killjoy,Omen,Jett,KAY/O","Sova,Killjoy,Omen,Jett,KAY/O"
Lotus,Prospects,BlanK,13,1,2,0,1,11,"Raze,Killjoy,Viper,Omen,Fade","Breach,Raze,Killjoy,Omen,Gekko"
Lotus,Purpose Gaming,Hybrid Authority,16,14,6,9,5,10,"Breach,Raze,Cypher,Omen,Fade","Raze,Killjoy,Viper,Omen,Fade"
Split,Team Digital,Hyjinx Black,13,4,4,1,3,9,"Raze,Cypher,Viper,Skye,Astra","Raze,Cypher,Viper,Omen,Skye"
Lotus,Luna Esports,Lionheart eSports,8,13,6,6,7,2,"Breach,Raze,Killjoy,Omen,Gekko","Breach,Cypher,Omen,Neon,Gekko"
Bind,Spate Esports,Koala Pound,8,13,6,6,7,2,"Viper,Jett,Yoru,Gekko,Clove","Raze,Cypher,Viper,Brimstone,Skye"
Bind,Event Horizon Red,Terps Academy,7,13,5,7,6,2,"Raze,Viper,Brimstone,Fade,Gekko","Raze,Viper,Skye,Gekko,Clove"
Lotus,Destro,Raven Esports,4,13,4,8,5,0,"Raze,Killjoy,Viper,Omen,Fade","Breach,Cypher,Omen,Neon,Fade"
Ascent,Excane,ASTANE,13,15,5,9,6,8,"Sova,Killjoy,Omen,Jett,KAY/O","Sova,Killjoy,Omen,Jett,KAY/O"
Ascent,1Millisecond,Lemonade Stand,13,7,3,5,2,10,"Sova,Killjoy,Omen,Jett,KAY/O","Sova,Killjoy,Omen,Jett,KAY/O"
Sunset,Flowstate,Astane Anarchy,13,4,9,3,1,4,"Breach,Raze,Cypher,Sova,Clove","Raze,Cypher,Omen,KAY/O,Gekko"
Sunset,Defiant Gaming,Sexy Gang,13,2,10,2,0,3,"Raze,Cypher,Sova,Omen,Gekko","Raze,Cypher,Omen,KAY/O,Gekko"
Sunset,Outlast Gaming,Alliance Guardians,7,13,5,7,6,2,"Breach,Raze,Cypher,Omen,Gekko","Raze,Cypher,Omen,KAY/O,Gekko"
Bind,Six Figures,U4RIA Radiata,13,15,5,9,6,8,"Raze,Viper,Brimstone,Skye,Fade","Raze,Cypher,Viper,Brimstone,Skye"
Ascent,BHOP Esports,Elation,15,17,8,8,9,7,"Sova,Killjoy,Reyna,Omen,Jett","Sova,Killjoy,Omen,Jett,KAY/O"
Icebox,FinalFormHQ,NCSU Red,13,9,4,6,3,9,"Sova,Killjoy,Viper,Reyna,Jett","Sova,Killjoy,Viper,Sage,Jett"
Sunset,Canadia Compooters,Esoteric Kings,13,5,6,0,5,7,"Breach,Raze,Cypher,Omen,Fade","Raze,Cypher,Omen,Fade,Gekko"
Ascent,Fractal Gaming,Poseidon Esports,13,4,4,1,3,9,"Sova,Killjoy,Omen,Jett,KAY/O","Sova,Killjoy,Omen,Jett,KAY/O"
Sunset,C4C Flare,Endear Gaming,4,13,3,9,4,1,"Breach,Raze,Cypher,Omen,Gekko","Breach,Raze,Cypher,Omen,Fade"
Ascent,Event Horizon,Hyperion Gold,14,16,7,8,8,7,"Sova,Killjoy,Omen,Jett,KAY/O","Sova,Killjoy,Omen,Jett,KAY/O"
Icebox,RyZe Eclipsa GC,Sushi Bois,13,6,9,3,3,4,"Sova,Viper,Jett,Chamber,Gekko","Killjoy,Omen,KAY/O,Harbor,Gekko"
Ascent,Medics,Status Red,13,11,7,5,6,6,"Sova,Killjoy,Omen,Jett,KAY/O","Sova,Killjoy,Omen,Jett,KAY/O"
Icebox,Dexterity Gaming,Goth Girl Sanctuary,13,10,7,5,5,6,"Sova,Killjoy,Viper,Harbor,Gekko","Sova,Killjoy,Viper,Reyna,Jett"
Sunset,Awaken,Imperial Titans,13,4,8,4,0,5,"Raze,Cypher,Omen,KAY/O,Gekko","Breach,Raze,Cypher,Sova,Omen"
Breeze,ENG Gaming,Anomaly Gaming,6,13,1,6,7,5,"Cypher,Sova,Viper,Jett,KAY/O","Cypher,Sova,Viper,Jett,KAY/O"
Split,Vulcan Rising,Team Basilix,10,13,9,3,10,1,"Raze,Cypher,Omen,Skye,Astra","Raze,Cypher,Omen,Yoru,KAY/O"
Sunset,blueming,Lucky 7 Gaming,10,13,6,6,7,4,"Raze,Cypher,Reyna,Omen,Gekko","Breach,Raze,Cypher,Omen,Fade"
Lotus,NuElement,No Sweat,7,13,2,6,7,5,"Raze,Killjoy,Viper,Omen,Fade","Breach,Raze,Killjoy,Omen,Fade"
Sunset,Hyjinx Violet,Prospects Amethyst,13,10,7,4,6,6,"Raze,Cypher,Viper,Omen,Gekko","Raze,Cypher,Omen,KAY/O,Gekko"
Bind,Vibin Out Vex,Ultralight,13,3,11,1,2,2,"Raze,Brimstone,Yoru,Fade,Gekko","Raze,Viper,Brimstone,Skye,Gekko"
Split,KAOS Esports,SiXSENSE,14,12,7,6,6,7,"Raze,Cypher,Viper,Omen,Skye","Raze,Cypher,Omen,KAY/O,Gekko"
Ascent,F1 Esports,Una Ludio,13,3,9,3,0,4,"Cypher,Sova,Omen,Jett,KAY/O","Sova,Killjoy,Omen,Jett,KAY/O"
Lotus,ENVEE YSL,Minimum,13,4,4,1,3,9,"Breach,Raze,Cypher,Omen,Fade","Raze,Killjoy,Omen,Skye,Gekko"
Sunset,Hustlin Huskies,RyZe Academy,15,13,8,6,7,7,"Raze,Sova,Phoenix,Omen,Chamber","Breach,Raze,Cypher,Omen,Gekko"
Ascent,LazerrFreeks8,Flare,13,8,5,7,1,8,"Sova,Killjoy,Omen,Jett,KAY/O","Sova,Killjoy,Omen,Jett,KAY/O"
Sunset,Shinjitsu,Comet Esports Club,13,8,7,5,3,6,"Breach,Raze,Cypher,Omen,Gekko","Breach,Raze,Cypher,Omen,Fade"
Sunset,Project 01,Eternal Focus Crimson,5,13,1,5,8,4,"Raze,Cypher,Omen,Jett,Gekko","Raze,Cypher,Omen,KAY/O,Gekko"
Ascent,Risk,Petezatron 2000s,13,5,10,2,3,3,"Sova,Omen,Jett,KAY/O,Deadlock","Sova,Killjoy,Omen,Jett,KAY/O"
Bind,Supernova Nebula,Nearest Airport,11,13,7,5,8,4,"Breach,Raze,Cypher,Brimstone,Gekko","Raze,Viper,Omen,Fade,Gekko"
Sunset,CHURCH OF CHAEWON KIM,OutGoing Esports,13,9,8,2,7,5,"Breach,Raze,Cypher,Omen,Gekko","Breach,Raze,Cypher,Omen,Gekko"
Bind,Foreign Legion,STG Gaming,13,10,8,4,6,5,"Raze,Viper,Skye,Gekko,Clove","Raze,Cypher,Brimstone,Skye,Gekko"
Bind,Predator X Gaming,Luxoria,13,9,7,3,6,6,"Raze,Viper,Brimstone,Skye,Gekko","Raze,Viper,Brimstone,Skye,Gekko"
Icebox,Harmony,french goats,9,13,4,8,5,5,"Sova,Killjoy,Viper,Jett,Harbor","Sova,Killjoy,Viper,Reyna,Jett"
Split,Joblife,Akroma,11,13,6,6,7,5,"Raze,Cypher,Viper,Omen,Skye","Sage,Skye,Astra,Neon,Deadlock"
Icebox,Kaizen Esports Red,Orangutan Gang,2,13,2,10,3,0,"Sova,Killjoy,Viper,Jett,Gekko","Sova,Killjoy,Viper,Omen,Jett"
Sunset,YDZ Esports,Meow meow,9,13,6,6,7,3,"Breach,Raze,Cypher,Sova,Omen","Raze,Cypher,Phoenix,Gekko,Clove"
Split,alvins chipmunks,Ice Fishers,13,2,3,0,2,10,"Raze,Cypher,Reyna,Omen,Skye","Raze,Cypher,Viper,Omen,Skye"
Icebox,Moist x Shopify,Oxygen Esports,13,6,4,3,3,9,"Killjoy,Viper,Jett,KAY/O,Gekko","Sova,Killjoy,Viper,Reyna,Gekko"
Split,CKnights,EaUCD Blue,13,1,11,1,0,2,"Raze,Cypher,Viper,Omen,Skye","Raze,Cypher,Omen,Jett,Skye"
Ascent,DOOMSDAY,FinalFormHQ,13,7,4,4,3,9,"Sova,Killjoy,Omen,Jett,KAY/O","Sova,Killjoy,Omen,Jett,KAY/O"
Ascent,KAOS Esports,Big Brim Gamers,0,13,0,12,1,0,"Sova,Killjoy,Omen,Jett,KAY/O","Sova,Killjoy,Omen,Jett,KAY/O"
Lotus,Cataclysm Gaming,Sexy Gang,8,13,4,8,5,4,"Breach,Raze,Killjoy,Omen,Gekko","Breach,Raze,Cypher,Omen,Fade"
Sunset,RyZe Eclipsa GC,Esoteric Kings,4,13,2,3,10,2,"Breach,Raze,Cypher,Gekko,Clove","Raze,Cypher,Omen,Fade,Gekko"
Lotus,ENVEE YSL,Awaken,6,13,3,9,4,3,"Breach,Raze,Cypher,Omen,Fade","Raze,Cypher,Omen,KAY/O,Gekko"
Bind,Predator X Gaming,ROSE,11,13,4,8,5,7,"Raze,Viper,Brimstone,Skye,Gekko","Raze,Cypher,Phoenix,Brimstone,Skye"
Sunset,Prospects,1Millisecond,12,14,4,9,5,8,"Raze,Cypher,Omen,KAY/O,Gekko","Breach,Raze,Cypher,Omen,Fade"
Lotus,LazerrFreeks Mythic,Hyperion Gold,13,1,11,1,0,2,"Breach,Raze,Cypher,Omen,Gekko","Breach,Raze,Killjoy,Omen,Gekko"
Split,Dexterity Gaming,SYNTAX.FF,13,4,5,0,4,8,"Raze,Cypher,Viper,Omen,Skye","Raze,Viper,Jett,Skye,Astra"
Ascent,Event Horizon,BSC Bobcats VA,13,9,8,4,5,5,"Sova,Killjoy,Omen,Jett,KAY/O","Sova,Killjoy,Omen,Jett,KAY/O"
Split,Vibin Out Vex,Resonate,2,13,1,2,11,1,"Raze,Viper,Omen,Jett,Skye","Raze,Viper,Omen,Jett,Skye"
Lotus,Lionheart eSports,Imperial Titans,11,13,7,5,8,4,"Breach,Cypher,Neon,Fade,Clove","Raze,Killjoy,Viper,Omen,Fade"
Split,ShaBoingBoing Esports,CHURCH OF CHAEWON KIM,11,13,3,9,4,8,"Breach,Raze,Cypher,Omen,Skye","Raze,Viper,Omen,Jett,Skye"
Lotus,Hustlin Huskies,Goth Girl Sanctuary,5,13,3,3,10,2,"Breach,Raze,Omen,Jett,Skye","Raze,Killjoy,Viper,Omen,Gekko"
Ascent,SiXSENSE,ASTANE,1,13,1,11,2,0,"Breach,Cypher,Astra,KAY/O,Gekko","Sova,Killjoy,Omen,Jett,KAY/O"
Ascent,Koala Pound,Outlast Gaming,13,15,7,7,8,6,"Sova,Killjoy,Omen,Jett,KAY/O","Sova,Killjoy,Omen,Jett,KAY/O"
Lotus,Destro,Elation,13,4,10,2,2,3,"Raze,Killjoy,Viper,Omen,Fade","Raze,Viper,Sage,Omen,Gekko"
Ascent,OutGoing Esports,ASTANE GC,13,6,7,5,1,6,"Sova,Killjoy,Omen,Jett,KAY/O","Cypher,Sova,Omen,Jett,KAY/O"
Ascent,Nearest Airport,ENG Gaming,13,3,9,3,0,4,"Sova,Killjoy,Omen,Jett,KAY/O","Sova,Killjoy,Omen,Jett,KAY/O"
Lotus,Vulcan Rising,Area of Effect,4,13,4,8,5,0,"Breach,Raze,Killjoy,Brimstone,Gekko","Raze,Killjoy,Viper,Omen,Skye"
Sunset,Eternal Focus Crimson,Astane Anarchy,10,13,6,6,7,4,"Raze,Cypher,Omen,KAY/O,Gekko","Raze,Cypher,Omen,KAY/O,Gekko"
Ascent,F1 Esports,C4C Flare,13,4,8,4,0,5,"Cypher,Sova,Omen,Jett,KAY/O","Sova,Killjoy,Omen,Jett,KAY/O"
Lotus,NCSU Red,OC Eagles,11,13,7,5,8,4,"Raze,Killjoy,Viper,Omen,Fade","Raze,Killjoy,Viper,Omen,Gekko"
Lotus,Event Horizon Red,Team Basilix,8,13,3,9,4,5,"Breach,Raze,Killjoy,Omen,Fade","Raze,Killjoy,Omen,Yoru,Fade"
Bind,Six Figures,Utica Blue,13,7,6,2,5,7,"Raze,Viper,Brimstone,Skye,Fade","Raze,Viper,Brimstone,Skye,Gekko"
Ascent,Luna Esports,Nightblood Gaming,1,13,0,12,1,1,"Sova,Killjoy,Omen,Jett,KAY/O","Sova,Killjoy,Omen,Jett,KAY/O"
Ascent,REIGN (NA),Meow meow,11,13,3,9,4,8,"Cypher,Sova,Phoenix,Jett,Clove","Sova,Killjoy,Reyna,Jett,Clove"
Lotus,Vibin Out RISE,Minimum,9,13,3,7,6,6,"Breach,Raze,Killjoy,Omen,Gekko","Raze,Killjoy,Omen,Skye,Gekko"
Lotus,Spate Esports,Raven Esports,8,13,4,8,5,4,"Breach,Raze,Cypher,Omen,Gekko","Breach,Cypher,Omen,Neon,Fade"
Lotus,Terps Academy,Luxoria,7,13,1,7,6,6,"Raze,Killjoy,Viper,Omen,Fade","Raze,Killjoy,Viper,Omen,Fade"
Bind,UW Esports,Ultralight,13,8,3,6,2,10,"Raze,Cypher,Sova,Brimstone,Gekko","Raze,Viper,Brimstone,Skye,Gekko"
Sunset,blueming,RyZe Academy,13,1,2,0,1,11,"Raze,Cypher,Reyna,Omen,Gekko","Breach,Raze,Cypher,Omen,Gekko"
Ascent,Endear Gaming,Flowstate,7,13,4,8,5,3,"Sova,Killjoy,Omen,Jett,KAY/O","Sova,Killjoy,Omen,Jett,KAY/O"
Ascent,Purpose Gaming,Project 01,13,3,2,2,1,11,"Sova,Killjoy,Omen,Jett,KAY/O","Sova,Killjoy,Omen,Jett,KAY/O"
Icebox,Hybrid Authority,Comet Esports Club,13,4,9,3,1,4,"Killjoy,Viper,Jett,KAY/O,Gekko","Killjoy,Viper,Jett,KAY/O,Gekko"
Lotus,Alliance Guardians,Fractal Gaming,13,9,7,5,4,6,"Breach,Raze,Cypher,Omen,Skye","Raze,Killjoy,Viper,Omen,Fade"
Lotus,Joblife,Akroma,13,4,9,3,1,4,"Raze,Sova,Killjoy,Omen,Gekko","Raze,Killjoy,Viper,Omen,Fade"
Split,SRVR,Hyjinx Black,13,15,4,10,5,9,"Raze,Viper,Omen,Jett,Skye","Raze,Cypher,Viper,Omen,Skye"
Split,Lucky 7 Gaming,Foreign Legion,13,4,10,2,2,3,"Breach,Raze,Cypher,Skye,Astra","Raze,Viper,Omen,Jett,Skye"
Sunset,Sushi Bois,Risk,14,16,7,8,8,7,"Breach,Raze,Cypher,Omen,Gekko","Breach,Raze,Omen,Fade,Deadlock"
Icebox,NuElement,Sizzle Esports,6,13,5,7,6,1,"Sova,Killjoy,Viper,Jett,Harbor","Sova,Viper,Sage,Reyna,Chamber"
Bind,Shinjitsu,Defiant Gaming,6,13,3,9,4,3,"Raze,Cypher,Viper,Brimstone,Skye","Raze,Brimstone,Skye,Harbor,Gekko"
Sunset,Poseidon Esports,Prospects Amethyst,4,13,3,9,4,1,"Breach,Raze,Cypher,Sova,Omen","Raze,Cypher,Omen,KAY/O,Gekko"
Sunset,Anomaly Gaming,Petezatron 2000s,6,13,3,4,9,3,"Breach,Viper,Phoenix,Omen,KAY/O","Raze,Cypher,Sova,Omen,KAY/O"
Lotus,No Sweat,Oni Occult,13,7,6,2,5,7,"Breach,Raze,Killjoy,Omen,Fade","Raze,Killjoy,Omen,Fade,Gekko"
Sunset,Harmony,Excane,12,14,7,6,8,5,"Breach,Raze,Cypher,Omen,Gekko","Breach,Raze,Cypher,Omen,Gekko"
Lotus,Team Digital,CCG Esports,13,7,7,5,2,6,"Raze,Killjoy,Viper,Omen,Fade","Raze,Cypher,Omen,Fade,Harbor"
Bind,U4RIA Radiata,BHOP Esports,13,6,5,2,4,8,"Raze,Cypher,Viper,Brimstone,Skye","Raze,Cypher,Viper,Brimstone,Gekko"
Bind,Una Ludio,Kryptic GC,13,9,7,3,6,6,"Raze,Cypher,Brimstone,Skye,Gekko","Raze,Cypher,Viper,Brimstone,KAY/O"
Bind,Supernova Nebula,Chino Hills,13,8,4,5,3,9,"Breach,Raze,Cypher,Brimstone,Gekko","Raze,Viper,Brimstone,Skye,Gekko"
Lotus,Flare,Lemonade Stand,3,13,0,4,9,3,"Raze,Killjoy,Omen,Fade,Deadlock","Breach,Raze,Omen,Chamber,Gekko"
Split,Medics,LazerrFreeks8,13,11,6,6,5,7,"Breach,Raze,Cypher,Omen,Skye","Raze,Cypher,Viper,Omen,Skye"
Icebox,STG Gaming,french goats,6,13,4,3,10,2,"Raze,Killjoy,Viper,Harbor,Gekko","Sova,Killjoy,Viper,Reyna,Jett"
Lotus,Orangutan Gang,AURA Valorant,13,8,5,7,1,8,"Raze,Killjoy,Viper,Omen,Fade","Raze,Killjoy,Viper,Omen,Fade"
Ascent,BlanK,Canadia Compooters,9,13,3,9,4,6,"Sova,Killjoy,Omen,Jett,KAY/O","Sova,Killjoy,Omen,Jett,KAY/O"
Ascent,Y0Y,EaUCD Blue,1,13,0,2,11,1,"Sova,Killjoy,Omen,Jett,Gekko","Sova,Killjoy,Omen,Jett,KAY/O"
Lotus,Kaizen Esports Red,EXODIA (NA),13,5,8,4,1,5,"Breach,Raze,Killjoy,Omen,Fade","Raze,Cypher,Omen,Fade,Gekko"
Sunset,Neglected,YDZ Esports,7,13,1,7,6,6,"Breach,Raze,Cypher,Omen,Gekko","Breach,Raze,Cypher,Sova,Omen"
Bind,Team RA'AD,GAMAX eSports,13,4,4,1,3,9,"Raze,Viper,Brimstone,Skye,Gekko","Raze,Cypher,Brimstone,Fade,Gekko"
Ascent,Fisher Falcons,TMU Blue,15,13,5,9,4,10,"Sova,Killjoy,Omen,Jett,KAY/O","Breach,Sova,Killjoy,Omen,Jett"
Bind,TMX,Ice Fishers,8,13,4,5,8,4,"Raze,Cypher,Viper,Brimstone,Gekko","Raze,Viper,Brimstone,Skye,Gekko"
Bind,Moist x Shopify,Oxygen Esports,5,13,3,3,10,2,"Raze,Viper,Brimstone,Skye,Gekko","Raze,Viper,Brimstone,Skye,Gekko"
Icebox,CKnights,FAWZ Purple,13,10,7,5,5,6,"Killjoy,Viper,Jett,KAY/O,Gekko","Sova,Killjoy,Viper,Jett,Harbor"
Sunset,5 balding men,alvins chipmunks,1,13,0,2,11,1,"Raze,Cypher,Omen,Gekko","Raze,Cypher,Yoru,Gekko,Clove"
Split,Onyx Ravens,Team Occupy,13,11,9,3,8,4,"Raze,Viper,Omen,Skye,Chamber","Breach,Raze,Viper,Omen,Skye"
Breeze,Skulls Esports,R8 Esports,2,13,0,3,10,2,"Cypher,Sova,Viper,Reyna,Jett","Cypher,Sova,Viper,Omen,Yoru"
Ascent,NASR Esports,top gz,13,1,2,0,1,11,"Cypher,Sova,Phoenix,Omen,Jett","Sova,Killjoy,Omen,Jett,KAY/O"
Bind,FinalFormHQ,STG Gaming,13,5,5,1,4,8,"Raze,Cypher,Brimstone,Skye,Gekko","Raze,Viper,Brimstone,Skye,Gekko"
Lotus,Dexterity Gaming,LazerrFreeks Mythic,2,13,0,3,10,2,"Raze,Killjoy,Viper,Omen,Fade","Breach,Raze,Killjoy,Omen,Gekko"
Ascent,Imperial Titans,Team Digital,13,6,2,5,1,11,"Sova,Killjoy,Omen,Jett,KAY/O","Sova,Killjoy,Omen,Jett,KAY/O"
Lotus,Lucky 7 Gaming,Big Brim Gamers,10,13,3,8,5,7,"Raze,Killjoy,Viper,Omen,Skye","Raze,Killjoy,Viper,Omen,Fade"
Ascent,Orangutan Gang,Cocosters,13,0,12,0,0,1,"Sova,Killjoy,Omen,Jett,KAY/O","Cypher,Phoenix,Brimstone,Sage,Skye"
Bind,ShaBoingBoing Esports,Lionheart eSports,2,13,2,10,3,0,"Breach,Raze,Cypher,Brimstone,Gekko","Raze,Cypher,Brimstone,Skye,Gekko"
Lotus,BSC Bobcats VA,DOOMSDAY,11,13,6,6,7,5,"Raze,Sova,Killjoy,Omen,Gekko","Raze,Killjoy,Viper,Omen,Fade"
Lotus,CHURCH OF CHAEWON KIM,Area of Effect,8,13,5,7,6,3,"Raze,Killjoy,Viper,Omen,Skye","Raze,Killjoy,Viper,Omen,Skye"
Bind,Luxoria,KAOS Esports,7,13,3,5,8,4,"Raze,Viper,Brimstone,Skye,Yoru","Viper,Jett,KAY/O,Gekko,Clove"
Bind,Joblife,Akroma,11,13,9,3,10,2,"Raze,Viper,Brimstone,Skye,Gekko","Raze,Viper,Omen,Skye,Gekko"
Sunset,Hyjinx Black,Nightblood Gaming,10,13,8,4,9,2,"Breach,Raze,Cypher,Omen,Gekko","Breach,Raze,Cypher,Omen,Gekko"
Sunset,Nightblood Gaming,Hybrid Authority,13,10,9,2,8,4,Raze,"Raze,Cypher,Viper,Brimstone,Skye"
Lotus,EXODIA (NA),M for Mini,13,10,7,4,6,6,"Raze,Cypher,Omen,Fade,Gekko","Breach,Raze,Viper,Omen,Gekko"
Bind,Fisher Falcons,TMU Blue,13,7,7,1,6,6,"Raze,Viper,Brimstone,Skye,Gekko","Breach,Raze,Cypher,Brimstone,Skye"
Lotus,Peak Check Pacific,Y0Y,7,13,1,7,6,6,"Breach,Raze,Cypher,Omen,Gekko","Cypher,Viper,Omen,Jett,Skye"
Ascent,EaUCD Blue,Jack n Frens ,13,3,9,3,0,4,"Sova,Killjoy,Omen,Jett,KAY/O","Sova,Killjoy,Reyna,Omen,Jett"
Sunset,UW Esports,Team Basilix,13,11,9,3,8,4,"Raze,Cypher,Sova,Omen,Gekko","Raze,Cypher,Omen,KAY/O,Gekko"
Ascent,SYNTAX.FF,Sizzle Esports,6,13,1,6,7,5,"Sova,Killjoy,Omen,Jett,KAY/O","Sova,Killjoy,Omen,Jett,KAY/O"
Bind,Oni Occult,OC Eagles,5,13,0,6,7,5,"Raze,Brimstone,Skye,Harbor,Gekko","Raze,Cypher,Viper,Brimstone,Skye"
Bind,Shaboozey's Slimes,AURA Valorant,13,15,5,9,6,8,"Raze,Viper,Skye,Chamber,Clove","Raze,Viper,Brimstone,Skye,Gekko"
Icebox,The Real Team 7,Meow meow,14,16,5,10,6,9,"Killjoy,Viper,Jett,KAY/O,Gekko","Sova,Killjoy,Viper,Reyna,Jett"
Ascent,FAWZ Purple,Goon squad,13,0,1,0,0,12,"Sova,Killjoy,Omen,Jett,KAY/O","Sova,Phoenix,Sage,Omen,Jett"
Bind,Vibin Out Vex,ASTANE GC,13,10,4,8,2,9,"Raze,Brimstone,Yoru,Fade,Gekko","Raze,Cypher,Brimstone,Skye,Gekko"
Lotus,ROSE,blueming,13,8,8,1,7,5,"Raze,Cypher,Omen,Skye,Gekko","Breach,Raze,Omen,Jett,Skye"
Lotus,Ice Fishers,Baby Goats,13,11,7,5,6,6,"Raze,Cypher,Omen,KAY/O,Gekko","Breach,Raze,Killjoy,Omen,Gekko"
Lotus,ASTANE,RyZe Academy,13,3,11,1,2,2,"Raze,Killjoy,Fade,Gekko,Clove","Raze,Killjoy,Viper,Omen,Fade"
Icebox,NCSU Red,Minimum,13,5,5,1,4,8,"Sova,Killjoy,Viper,Sage,Jett","Sova,Killjoy,Viper,Yoru,Harbor"
Lotus,Predator X Gaming,Goth Girl Sanctuary,13,9,6,4,5,7,"Raze,Killjoy,Viper,Omen,Fade","Raze,Killjoy,Viper,Omen,Gekko"
Icebox,Luna Esports,Terps Academy,13,10,7,5,5,6,"Sova,Killjoy,Viper,Jett,Harbor","Sova,Killjoy,Viper,Omen,Jett"
Lotus,CCG Esports,Awaken,5,13,1,5,8,4,"Raze,Cypher,Omen,Fade,Harbor","Raze,Cypher,Omen,KAY/O,Gekko"
Sunset,No Sweat,SiXSENSE,7,13,5,3,10,2,"Raze,Cypher,Sova,Omen,KAY/O","Breach,Raze,Cypher,Omen,Fade"
Sunset,Event Horizon Red,Vulcan Rising,4,13,1,4,9,3,"Breach,Raze,Cypher,Omen,Gekko","Raze,Cypher,Omen,KAY/O,Gekko"
Bind,Resonate,Vibin Out RISE,13,1,11,1,0,2,"Raze,Viper,Brimstone,Fade,Gekko","Raze,Viper,Brimstone,Fade,Gekko"
Lotus,GOSU Cowgirls VAL,REIGN (NA),11,13,4,8,5,7,"Raze,Killjoy,Viper,Gekko,Clove","Raze,Killjoy,Phoenix,Gekko,Clove"
Bind,french goats,ENVEE YSL,10,13,6,5,8,4,"Raze,Cypher,Viper,Brimstone,Skye","Raze,Viper,Omen,Skye,Gekko"
Sunset,Hyperion Gold,Foreign Legion,13,8,6,6,2,7,"Breach,Raze,Cypher,Omen,Fade","Breach,Raze,Cypher,Omen,KAY/O"
Bind,Excane,Event Horizon,13,5,4,2,3,9,"Raze,Cypher,Brimstone,Skye,Astra","Raze,Viper,Brimstone,Skye,Yoru"
Lotus,Mimic,YDZ Esports,6,13,4,3,10,2,"Raze,Killjoy,Omen,Gekko,Clove","Breach,Raze,Killjoy,Omen,Fade"
Ascent,RTZN,Outplayed,9,13,1,9,4,8,"Sova,Killjoy,Omen,Jett,KAY/O","Sova,Killjoy,Omen,Jett,KAY/O"
Icebox,Hustlin Huskies,Harmony,2,13,2,10,3,0,"Killjoy,Viper,Jett,KAY/O,Gekko","Sova,Killjoy,Viper,Jett,Harbor"
Split,Team RA'AD,GAMAX eSports,11,13,8,4,9,3,"Raze,Cypher,Viper,Omen,Skye","Breach,Raze,Cypher,Omen,Fade"
Icebox,Onyx Ravens,Team Occupy,13,7,9,3,4,4,"Killjoy,Viper,Sage,Jett,Gekko","Sova,Killjoy,Viper,Omen,Jett"
Bind,Skulls Esports,R8 Esports,7,13,4,8,5,3,"Raze,Viper,Omen,Skye,Chamber","Raze,Cypher,Viper,Brimstone,Skye"
Lotus,NuElement,OutGoing Esports,14,12,9,4,8,5,"Raze,Killjoy,Viper,Omen,Fade","Raze,Killjoy,Viper,Omen,Fade"
Bind,AXIMZERO,KHORE GAMING,13,6,7,5,1,6,"Raze,Viper,Skye,Gekko,Clove","Breach,Raze,Cypher,Brimstone,Fade"
Breeze,Lotus Knights,Ursus Gaming,10,13,7,5,8,3,"Cypher,Sova,Jett,KAY/O,Harbor","Cypher,Sova,Viper,Jett,KAY/O"
Lotus,TEAM VELAXIS,Melilla Titans Academy,7,13,5,7,6,2,"Breach,Raze,Killjoy,Omen,Chamber","Breach,Killjoy,Omen,Neon,Gekko"
Sunset,Team RA'AD,GAMAX eSports,13,4,10,2,2,3,"Breach,Raze,Cypher,Omen,Gekko","Breach,Raze,Cypher,Omen,Fade"
Ascent,DIVIZON,Eintracht Frankfurt,7,13,3,9,4,4,"Sova,Killjoy,Omen,Jett,KAY/O","Cypher,Sova,Sage,Omen,Jett"
Sunset,DSYRE,LONETEAM,13,4,8,4,0,5,"Cypher,Sova,Omen,KAY/O,Neon","Breach,Raze,Cypher,Sova,Omen"
Sunset,Metizport,OnlyFins,8,13,2,7,6,6,"Breach,Raze,Cypher,Omen,Gekko","Breach,Raze,Cypher,Omen,Gekko"
Sunset,Mandatory,Valiant,13,11,7,5,6,6,"Breach,Raze,Cypher,Omen,Gekko","Breach,Raze,Cypher,Omen,Gekko"
Split,Underground Gaming,Twisted Minds Esports,12,14,7,6,8,5,"Raze,Cypher,Viper,Omen,Skye","Raze,Viper,Omen,Jett,Skye"
Breeze,Osguviipeek,Tani eSports,2,13,0,3,10,2,"Cypher,Sova,Viper,Jett,KAY/O","Cypher,Sova,Viper,Jett,KAY/O"
Breeze,Lotus Knights,DarkLions,13,6,8,4,2,5,"Cypher,Sova,Jett,KAY/O,Harbor","Cypher,Sova,Viper,Jett,KAY/O"
Lotus,BEYOND eSports Academy,Ursus Gaming,5,13,4,2,11,1,"Breach,Raze,Killjoy,Omen,Gekko","Breach,Raze,Killjoy,Omen,Gekko"
Icebox,AXIMZERO,bazinga esports,13,2,10,2,0,3,"Killjoy,Viper,Jett,KAY/O,Gekko","Cypher,Jett,KAY/O,Harbor,Gekko"
Split,Zenturions,KHORE GAMING,6,13,0,7,6,6,"Breach,Raze,Cypher,Viper,Astra","Phoenix,Omen,KAY/O,Chamber,Gekko"
Ascent,Unity Esports,Vision Esports,13,4,3,2,2,10,"Breach,Cypher,Sova,Omen,Jett","Breach,Sova,Killjoy,Omen,Jett"
Lotus,The Ultimates,Fraggerz,13,7,6,6,1,7,"Breach,Cypher,Sova,Omen,Neon","Raze,Killjoy,Omen,Jett,Skye"
Lotus,Melilla Titans Academy,Odyssey Gaming,13,8,8,1,7,5,"Breach,Killjoy,Omen,Neon,Gekko","Breach,Raze,Killjoy,Omen,Fade"
Icebox,Underground Gaming,Twisted Minds Esports,6,13,5,7,6,1,"Sova,Killjoy,Viper,Reyna,Jett","Killjoy,Viper,Jett,KAY/O,Gekko"
Lotus,Solar Flare,TEAM VELAXIS,12,14,5,8,6,7,"Raze,Viper,Omen,Chamber,Gekko","Breach,Raze,Killjoy,Omen,Chamber"
Bind,DIVIZON,Eintracht Frankfurt,11,13,8,4,9,3,"Raze,Cypher,Viper,Omen,Skye","Raze,Viper,Yoru,Gekko,Clove"
Icebox,Osguviipeek,TeamGamingProject,13,5,4,2,3,9,"Sova,Killjoy,Jett,Harbor,Gekko","Sova,Killjoy,Viper,Jett,Gekko"
Ascent,Tani eSports,Team GMask,13,5,3,3,2,10,"Cypher,Sova,Omen,Jett,KAY/O","Sova,Killjoy,Omen,Jett,KAY/O"
Lotus,Metizport,OnlyFins,13,9,8,4,5,5,"Raze,Killjoy,Viper,Omen,Fade","Breach,Killjoy,Omen,Neon,Gekko"
Breeze,Dragons Esports,Team Falcons,5,13,5,7,6,0,"Cypher,Sova,Viper,Omen,Jett","Cypher,Sova,Viper,Jett,KAY/O"
Breeze,Mandatory,Valiant,10,13,6,5,8,4,"Cypher,Sova,Viper,Omen,Yoru","Cypher,Sova,Viper,Jett,Yoru"
Lotus,VX300 Gaming,Axolotl,8,13,5,7,6,3,"Breach,Raze,Killjoy,Omen,Gekko","Raze,Killjoy,Viper,Omen,Fade"
Lotus,Stray Wolves,Zenturions,6,13,4,8,5,2,"Raze,Killjoy,Omen,Gekko,Clove","Breach,Killjoy,Astra,Neon,Gekko"
Ascent,Lotus Knights,Fractious Esports,13,9,5,7,2,8,"Cypher,Sova,Omen,Jett,KAY/O","Sova,Killjoy,Omen,Jett,KAY/O"
Ascent,AXIMZERO,Guinea Pink Baldwin,13,4,10,2,2,3,"Sova,Killjoy,Omen,Jett,KAY/O","Sova,Killjoy,Omen,Jett,KAY/O"
Lotus,TEAM VELAXIS,Arctic Ninjas,13,3,9,3,0,4,"Breach,Raze,Killjoy,Omen,Chamber","Breach,Raze,Cypher,Omen,Gekko"
Lotus,TeamGamingProject,hydragon esports,13,6,9,3,3,4,"Breach,Raze,Killjoy,Omen,Gekko","Breach,Raze,Killjoy,Omen,Fade"
Breeze,Locked Hanters,DarkLions,11,13,4,8,5,7,"Cypher,Sova,Viper,Jett,KAY/O","Cypher,Sova,Viper,Jett,KAY/O"
Lotus,Melilla Titans Academy,VOID (EU),13,2,3,0,2,10,"Breach,Killjoy,Omen,Neon,Gekko","Raze,Phoenix,Reyna,Jett,Yoru"
Sunset,Dragons Esports,Team Falcons,8,13,2,7,6,6,"Raze,Cypher,Viper,Omen,Fade","Breach,Raze,Cypher,Omen,Fade"
Split,The Ultimates,Fraggerz,13,11,4,8,3,9,"Raze,Viper,Omen,Jett,Skye","Breach,Raze,Cypher,Omen,Skye"
Lotus,Solar Flare,CROW DYNASTY,13,7,6,6,1,7,"Raze,Viper,Omen,Chamber,Gekko","Breach,Raze,Killjoy,Jett,Astra"
Sunset,Underground Gaming,Twisted Minds Esports,13,10,4,8,2,9,"Cypher,Sova,Omen,Neon,Gekko","Raze,Cypher,Omen,KAY/O,Gekko"
Ascent,DOJO Linares,La Cobra,5,13,3,9,4,2,"Sova,Killjoy,Omen,Jett,KAY/O","Sova,Killjoy,Omen,Jett,KAY/O"
Ascent,BEYOND eSports Academy,DOJO Linares,13,5,4,2,3,9,"Sova,Killjoy,Omen,Jett,KAY/O","Sova,Killjoy,Omen,Jett,KAY/O"
Sunset,Unity Esports,Vision Esports,14,12,9,4,8,5,"Breach,Raze,Cypher,Omen,Fade","Breach,Omen,Jett,Gekko,Deadlock"
Breeze,TLS eSports,Team GMask,2,13,2,10,3,0,"Cypher,Sova,Viper,Jett,Yoru","Cypher,Sova,Viper,Reyna,Jett"
Lotus,CDC Valorant,Osguviipeek,7,13,3,5,8,4,"Breach,Raze,Cypher,Omen,Gekko","Breach,Raze,Killjoy,Omen,Gekko"
Lotus,FusyonEC,Odyssey Gaming,9,13,5,5,8,4,"Breach,Raze,Killjoy,Omen,Gekko","Breach,Raze,Killjoy,Omen,Fade"
Sunset,Trunphant,bazinga esports,10,13,4,7,6,6,"Breach,Raze,Cypher,Omen,Gekko","Viper,Sage,Omen,KAY/O,Gekko"
Breeze,Tani eSports,A decoy,13,11,3,9,2,10,"Cypher,Sova,Viper,Jett,KAY/O","Cypher,Sova,Jett,Yoru,Harbor"
Icebox,Mandatory,Valiant,13,7,7,1,6,6,"Sova,Viper,Sage,Jett,KAY/O","Killjoy,Viper,Jett,KAY/O,Gekko"
Lotus,Karasu Eaters,KHORE GAMING,0,13,0,1,12,0,"Breach,Raze,Killjoy,Omen,Jett","Breach,Raze,Cypher,Omen,Gekko"
Lotus,NOVO Esports,HGE Esports,13,4,1,4,0,12,"Raze,Killjoy,Viper,Omen,Fade","Killjoy,Omen,Jett,KAY/O,Gekko"
Split,Zenturions,TeamGamingProject AC,18,16,1,16,0,17,"Breach,Raze,Cypher,Viper,Astra","Breach,Raze,Cypher,Viper,Omen"
Bind,Metizport,OnlyFins,6,13,4,8,5,2,"Raze,Cypher,Viper,Brimstone,Skye","Raze,Viper,Brimstone,Skye,Gekko"
Lotus,Permitta Unicorns,CGN Esports,4,13,2,10,3,2,"Breach,Raze,Killjoy,Omen,Fade","Raze,Sova,Killjoy,Omen,Gekko"
Split,DarkLions,Ultra Instinct,13,7,5,3,4,8,"Breach,Raze,Cypher,Omen,Skye","Raze,Cypher,Omen,Jett,Skye"
Ascent,TEAM VELAXIS,PCW,13,7,9,3,4,4,"Sova,Killjoy,Omen,Jett,KAY/O","Sova,Killjoy,Omen,Jett,KAY/O"
Bind,hydragon esports,Powerpuff GC,13,9,7,3,6,6,"Raze,Cypher,Brimstone,Skye,Fade","Raze,Brimstone,Skye,Yoru,Harbor"
Icebox,Tropadobagaço,evolutionSTARS,13,7,7,1,6,6,"Sova,Killjoy,Viper,Reyna,Jett","Sova,Killjoy,Viper,Reyna,Jett"
Icebox,Floristeria MariTere,Invictus Dominus Esports,6,13,1,6,7,5,"Sova,Killjoy,Viper,Jett,Gekko","Sova,Killjoy,Viper,Jett,Harbor"
Lotus,elionking val,TeamGamingProject,5,13,4,8,5,1,"Raze,Killjoy,Viper,Omen,Fade","Breach,Raze,Killjoy,Omen,Gekko"
Ascent,rivas red dragons,Team GMask,1,13,1,11,2,0,"Sova,Killjoy,Omen,Jett,KAY/O","Sova,Killjoy,Omen,Jett,KAY/O"
Sunset,Dragons Gaming,Trunphant,0,13,0,1,12,0,"Raze,Cypher,Viper,Gekko,Clove","Breach,Raze,Cypher,Omen,Gekko"
Lotus,Guinea Pink Baldwin,Acient,13,10,9,2,8,4,"Breach,Raze,Killjoy,Omen,Gekko","Raze,Cypher,Viper,Omen,Gekko"
Sunset,Fractious Esports,Team Orion,14,12,8,5,7,6,"Breach,Raze,Cypher,Omen,Gekko","Breach,Raze,Cypher,Sova,Omen"
Bind,Karasu Eaters,bloodmoon enjoyers,13,2,3,0,2,10,"Raze,Brimstone,Skye,Harbor,Gekko","Raze,Cypher,Brimstone,Reyna,Jett"
Split,TSA Galaxy,CROW DYNASTY,2,13,0,3,10,2,"Breach,Raze,Cypher,Omen,Skye","Breach,Raze,Cypher,Jett,Clove"
Bind,Arctic Ninjas,KAST Esports,13,4,3,2,2,10,"Raze,Cypher,Brimstone,Skye,Gekko","Raze,Cypher,Brimstone,Skye,Gekko"
Bind,Locked Hanters,Las Palmas Unity,13,9,8,4,5,5,"Raze,Viper,Brimstone,Fade,Gekko","Breach,Raze,Viper,Brimstone,Yoru"
Lotus,Blood Moon V2,Osguviipeek,5,13,2,4,9,3,"Breach,Killjoy,Omen,Neon,Gekko","Breach,Raze,Killjoy,Omen,Gekko"
Lotus,VOID (EU),Mighty Meerkats,13,10,6,5,5,7,"Raze,Cypher,Jett,Gekko,Clove","Breach,Raze,Cypher,Omen,Fade"
Ascent,zer0 club,A decoy,9,13,5,5,8,4,"Sova,Killjoy,Omen,Jett,KAY/O","Raze,Cypher,Omen,Jett,KAY/O"
Sunset,Permitta Unicorns,CGN Esports,5,13,2,4,9,3,"Breach,Raze,Cypher,Omen,Fade","Raze,Sova,Killjoy,Omen,Clove"
Icebox,Requiem,Apeks,9,13,3,7,6,6,"Killjoy,Reyna,Jett,KAY/O,Clove","Sova,Killjoy,Viper,Yoru,Harbor"
Ascent,Tropadobagaço,evolutionSTARS,13,5,11,1,4,2,"Sova,Killjoy,Omen,Jett,KAY/O","Sova,Killjoy,Reyna,Omen,Jett"
Ascent,MLT Esports,Revenant Esports,13,5,8,4,1,5,"Sova,Killjoy,Omen,Jett,KAY/O","Sova,Killjoy,Omen,Jett,KAY/O"
Icebox,Dominus Esports,Cyberking Esports,9,13,5,5,8,4,"Killjoy,Viper,Jett,KAY/O,Gekko","Sova,Killjoy,Viper,Jett,Gekko"
Sunset,Requiem,Apeks,2,13,1,11,2,1,"Raze,Cypher,Omen,KAY/O,Gekko","Viper,Sage,Omen,KAY/O,Gekko"
Sunset,SK Gaming,FOKUS,1,13,1,11,2,0,"Cypher,Viper,Omen,Jett,Gekko","Cypher,Sage,Omen,KAY/O,Gekko"
Lotus,MLT Esports,Revenant Esports,13,9,3,7,2,10,"Raze,Killjoy,Viper,Omen,Fade","Raze,Killjoy,Omen,Astra,Fade"
Sunset,Dominus Esports,Cyberking Esports,11,13,7,5,8,4,"Breach,Raze,Cypher,Sova,Omen","Breach,Raze,Cypher,Omen,Fade"
Lotus,SK Gaming,FOKUS,11,13,7,5,8,4,"Breach,Cypher,Sova,Omen,Jett","Raze,Cypher,Viper,Omen,Fade"
Bind,Dominus Esports,Cyberking Esports,10,13,6,5,8,4,"Raze,Brimstone,Skye,Harbor,Gekko","Raze,Cypher,Brimstone,Reyna,Skye"
Lotus,Grayfox Esports,True Rippers,4,13,2,3,10,2,"Breach,Raze,Killjoy,Omen,Skye","Raze,Killjoy,Viper,Omen,Fade"
Lotus,Dominus Esports,Cyberking Esports,13,11,8,4,7,5,"Breach,Raze,Killjoy,Omen,Fade","Raze,Killjoy,Omen,Jett,Gekko"
Split,Grayfox Esports,True Rippers,9,13,3,7,6,6,"Breach,Raze,Viper,Omen,Skye","Raze,Cypher,Viper,Omen,Skye"
Breeze,Original Gaming,Crocodile Tear,10,13,6,5,8,4,"Sova,Viper,Jett,Yoru,Harbor","Cypher,Sova,Viper,Jett,KAY/O"
Ascent,Dominus Esports,Cyberking Esports,13,5,5,1,4,8,"Sova,Killjoy,Omen,Jett,KAY/O","Sova,Killjoy,Omen,Jett,KAY/O"
Bind,Original Gaming,Crocodile Tear,13,7,9,3,4,4,"Raze,Cypher,Viper,Brimstone,Skye","Raze,Brimstone,Skye,Harbor,Gekko"
Icebox,DXA Esports,K10 (OCE),12,14,8,5,9,4,"Sova,Killjoy,Viper,Reyna,Jett","Killjoy,Viper,Jett,KAY/O,Gekko"
Lotus,raindrops,VLG X,13,5,9,3,2,4,"Cypher,Phoenix,Omen,Jett,Gekko","Breach,Raze,Killjoy,Omen,Gekko"
Ascent,FLUX GC,Misses Worldwide,5,13,4,8,5,1,"Sova,Killjoy,Omen,Jett,KAY/O","Breach,Sova,Omen,Jett,Fade"
Sunset,Original Gaming,Crocodile Tear,11,13,6,6,7,5,"Raze,Cypher,Viper,Omen,Gekko","Raze,Cypher,Omen,KAY/O,Gekko"
Sunset,FLUX GC,Misses Worldwide,5,13,1,5,8,4,"Cypher,Sova,Reyna,Omen,Gekko","Breach,Raze,Cypher,Omen,Gekko"
Sunset,raindrops,VLG X,13,7,7,5,2,6,"Breach,Raze,Cypher,Omen,Gekko","Breach,Raze,Cypher,Omen,Gekko"
Bind,DXA Esports,K10 (OCE),11,13,7,5,8,4,"Raze,Cypher,Viper,Brimstone,Skye","Raze,Viper,Brimstone,Fade,Gekko"
Icebox,Balut Warriors,Misses Worldwide,13,9,9,3,6,4,"Sova,Killjoy,Viper,Jett,Iso","Sova,Killjoy,Viper,Jett,Gekko"
Icebox,K10 (OCE),FLUX GC,13,5,5,1,4,8,"Killjoy,Viper,Jett,KAY/O,Gekko","Sova,Killjoy,Viper,Sage,Jett"
Icebox,Funcrew,Bandits OCE,12,14,7,6,8,5,"Sova,Killjoy,Viper,Reyna,Jett","Sova,Killjoy,Viper,Jett,Gekko"
Ascent,YIPPEE,Xu Gang Crimson,13,11,7,5,6,6,"Sova,Killjoy,Omen,Jett,KAY/O","Sova,Killjoy,Omen,Jett,KAY/O"
Bind,Funcrew,Bandits OCE,4,13,0,5,8,4,"Raze,Sova,Brimstone,Skye,Deadlock","Raze,Viper,Gekko,Deadlock,Clove"
Lotus,Balut Warriors,Misses Worldwide,13,4,5,0,4,8,"Raze,Cypher,Omen,Jett,Gekko","Killjoy,Omen,Chamber,Neon,Gekko"
Sunset,YIPPEE,Xu Gang Crimson,13,3,9,3,0,4,"Raze,Cypher,Omen,KAY/O,Gekko","Breach,Raze,Cypher,Omen,Gekko"
Bind,K10 (OCE),FLUX GC,15,13,8,6,7,7,"Raze,Viper,Brimstone,Fade,Gekko","Raze,Cypher,Brimstone,Jett,Skye"
Ascent,New Combat Line GC,Bon Bon Bum Contra GC,9,13,4,8,5,5,"Sova,Killjoy,Omen,Jett,KAY/O","Breach,Raze,Sova,Killjoy,Omen"
Ascent,Reven eClub,Six Karma,13,10,3,9,1,10,"Cypher,Sova,Omen,Jett,KAY/O","Sova,Killjoy,Omen,Jett,KAY/O"
Split,New Combat Line GC,Bon Bon Bum Contra GC,13,10,5,6,4,8,"Raze,Cypher,Viper,Omen,Skye","Raze,Viper,Omen,Jett,Skye"
Bind,DarkZero Esports,Blinn Esports,14,12,6,7,5,8,"Raze,Viper,Brimstone,Skye,Gekko","Raze,Viper,Brimstone,KAY/O,Gekko"
Lotus,UST Esports,University of Virginia,13,5,9,3,2,4,"Breach,Raze,Killjoy,Omen,Gekko","Raze,Killjoy,Viper,Omen,Fade"
Bind,Reven eClub,Six Karma,14,12,8,5,7,6,"Raze,Cypher,Viper,Omen,Skye","Raze,Viper,Brimstone,Fade,Gekko"
Lotus,New Combat Line GC,Bon Bon Bum Contra GC,8,13,4,5,8,4,"Breach,Raze,Killjoy,Omen,Gekko","Breach,Raze,Cypher,Omen,Gekko"
Split,DarkZero Esports,Blinn Esports,9,13,4,8,5,5,"Raze,Cypher,Skye,Astra,Gekko","Raze,Cypher,Viper,Omen,Skye"
Sunset,UST Esports,University of Virginia,13,6,5,2,4,8,"Breach,Raze,Cypher,Omen,Gekko","Breach,Raze,Cypher,Sova,Omen"
Ascent,Dasein Club GC,Zen eSports GC,4,13,1,4,9,3,"Sova,Killjoy,Omen,Jett,KAY/O","Sova,Killjoy,Omen,Jett,KAY/O"
Sunset,Reven eClub,Six Karma,9,13,6,6,7,3,"Breach,Raze,Cypher,Sova,Omen","Breach,Raze,Cypher,Omen,Fade"
Icebox,SAIDEIRA ESPORTS,ZAGAS,13,5,4,2,3,9,"Sova,Killjoy,Viper,Jett,Gekko","Killjoy,Viper,Jett,KAY/O,Gekko"
Ascent,DarkZero Esports,Blinn Esports,13,8,8,4,4,5,"Cypher,Sova,Omen,Jett,Deadlock","Sova,Killjoy,Omen,Jett,KAY/O"
Lotus,Dasein Club GC,Zen eSports GC,13,10,8,4,6,5,"Breach,Raze,Sova,Killjoy,Omen","Breach,Raze,Killjoy,Brimstone,Neon"
Bind,SAIDEIRA ESPORTS,ZAGAS,13,7,4,4,3,9,"Raze,Cypher,Viper,Brimstone,Skye","Raze,Brimstone,Skye,Gekko,Deadlock"
Lotus,FUSION,E-Xolos LAZER,5,13,3,9,4,2,"Raze,Cypher,Viper,Omen,Fade","Breach,Raze,Cypher,Omen,Gekko"
Lotus,M80,TSM,13,6,7,0,6,6,"Raze,Killjoy,Viper,Omen,Fade","Raze,Killjoy,Viper,Omen,Fade"
Split,Dasein Club GC,Zen eSports GC,5,13,3,9,4,2,"Raze,Cypher,Viper,Omen,Skye","Raze,Cypher,Jett,Skye,Astra"
Lotus,SAIDEIRA ESPORTS,ZAGAS,13,11,6,6,5,7,"Raze,Killjoy,Viper,Omen,Fade","Raze,Killjoy,Viper,Omen,Fade"
Bind,FUSION,E-Xolos LAZER,8,13,4,5,8,4,"Viper,Brimstone,Skye,Yoru,Gekko","Raze,Brimstone,Skye,Harbor,Gekko"
Sunset,M80,TSM,7,13,6,6,7,1,"Breach,Raze,Cypher,Omen,Gekko","Breach,Raze,Cypher,Omen,KAY/O"
Lotus,Twisted Minds Esports,Onyx Ravens,13,7,4,4,3,9,"Breach,Raze,Killjoy,Omen,Gekko","Breach,Raze,Killjoy,Omen,Gekko"
Lotus,Tropadobagaço,Skout Esports,11,13,4,8,5,7,"Breach,Raze,Killjoy,Viper,Omen","Breach,Raze,Killjoy,Omen,Skye"
Ascent,DIVINE,EvolutionSTARS Avis,13,8,4,5,3,9,"Breach,Viper,Omen,Jett,KAY/O","Cypher,Sova,Omen,Jett,KAY/O"
Sunset,Twisted Minds Esports,Onyx Ravens,13,9,5,5,4,8,"Raze,Cypher,Omen,KAY/O,Gekko","Breach,Raze,Cypher,Omen,Fade"
Icebox,HGE Esports GC,Entry Frogs Iris,13,2,2,1,1,11,"Killjoy,Viper,Jett,KAY/O,Gekko","Sova,Viper,Chamber,Harbor,Gekko"
Split,Tropadobagaço,Skout Esports,6,13,3,9,4,3,"Raze,Cypher,Sage,Omen,Skye","Breach,Raze,Cypher,Omen,Gekko"
Bind,The Ultimates,G3 Esports,13,8,8,4,4,5,"Raze,Viper,Brimstone,Reyna,Skye","Breach,Raze,Sova,Viper,Brimstone"
Lotus,DIVINE,EvolutionSTARS Avis,13,3,2,2,1,11,"Breach,Raze,Killjoy,Omen,Gekko","Breach,Raze,Omen,Gekko,Deadlock"
Breeze,M80,TSM,18,16,7,10,6,11,"Cypher,Sova,Viper,Jett,KAY/O","Sova,Viper,Jett,Yoru,Astra"
Split,Twisted Minds Esports,Onyx Ravens,9,13,3,9,4,6,"Raze,Viper,Omen,Jett,Skye","Breach,Raze,Cypher,Sage,Omen"
Lotus,HGE Esports GC,Entry Frogs Iris,13,11,5,7,4,8,"Breach,Raze,Killjoy,Omen,Gekko","Breach,Raze,Killjoy,Omen,Fade"
Lotus,1000rr club,Fractious Esports,13,10,8,3,7,5,"Breach,Raze,Cypher,Omen,Gekko","Breach,Raze,Killjoy,Omen,Gekko"
Lotus,The Ultimates,G3 Esports,13,4,10,2,2,3,"Breach,Cypher,Sova,Omen,Neon","Breach,Raze,Cypher,Omen,Gekko"
Sunset,Dimonis,Solar Flare,13,7,7,1,6,6,"Raze,Cypher,Omen,KAY/O,Gekko","Raze,Cypher,Sova,Omen,Gekko"
Breeze,BEYOND eSports,Invictus Dominus Esports,13,5,8,4,1,5,"Cypher,Sova,Viper,Jett,KAY/O","Cypher,Sova,Viper,Jett,Yoru"
Bind,Ursus Gaming,VexOficiaal,8,13,2,7,6,6,"Raze,Viper,Brimstone,Skye,Gekko","Raze,Viper,Skye,Gekko,Clove"
Sunset,Ultra Instinct,Fractious Esports,4,13,3,9,4,1,"Breach,Raze,Cypher,Omen,Gekko","Breach,Raze,Cypher,Omen,Gekko"
Ascent,Lotus Knights,BEYOND eSports,8,13,3,6,7,5,"Cypher,Sova,Omen,Jett,KAY/O","Sova,Killjoy,Jett,KAY/O,Clove"
Ascent,Apinaorkesteri,SweetNsour,6,13,2,10,3,4,"Cypher,Sova,Omen,Jett,KAY/O","Sova,Killjoy,Omen,Jett,KAY/O"
Split,NOVO GC,aNc Outplayed GC,13,8,6,6,2,7,"Raze,Cypher,Sage,Omen,Skye","Breach,Raze,Cypher,Omen,Fade"
Lotus,Capacitanes,Solar Flare,12,14,5,8,6,7,"Breach,Raze,Killjoy,Omen,Gekko","Raze,Viper,Omen,Chamber,Gekko"
Ascent,Underground Gaming,The Vicious,13,9,6,4,5,7,"Sova,Killjoy,Omen,Jett,KAY/O","Sova,Killjoy,Jett,Astra,KAY/O"
Ascent,VexOficiaal,AXIMZERO,13,6,3,4,2,10,"Breach,Sova,Killjoy,Jett,Astra","Sova,Killjoy,Phoenix,Omen,Jett"
Ascent,Dimonis,DOJO Linares,13,8,6,3,5,7,"Sova,Killjoy,Omen,Jett,KAY/O","Sova,Killjoy,Omen,Jett,KAY/O"
Lotus,Invictus Dominus Esports,TeamGamingProject,13,11,9,3,8,4,"Breach,Raze,Killjoy,Omen,Gekko","Breach,Raze,Killjoy,Omen,Gekko"
Lotus,1000rr club,Tani eSports,13,5,4,2,3,9,"Breach,Raze,Cypher,Omen,Gekko","Breach,Raze,Cypher,Omen,Gekko"
Breeze,Floristeria MariTere,Ursus Gaming,11,13,4,8,5,7,"Cypher,Sova,Viper,Jett,KAY/O","Cypher,Sova,Viper,Jett,KAY/O"
Ascent,parakeet academy,Ultra Instinct,4,13,3,2,11,1,"Breach,Sova,Killjoy,Omen,Jett","Cypher,Sova,Omen,Jett,KAY/O"
Lotus,Underground Gaming,The Vicious,13,7,5,3,4,8,"Breach,Raze,Killjoy,Omen,Gekko","Raze,Killjoy,Omen,Jett,Skye"
Bind,Solar Flare,Melilla Titans Academy,13,6,5,2,4,8,"Raze,Cypher,Brimstone,Skye,Gekko","Breach,Brimstone,Omen,Chamber,Gekko"
Sunset,Acient,BEYOND eSports,11,13,5,7,6,6,"Raze,Cypher,Omen,KAY/O,Gekko","Breach,Cypher,Jett,Gekko,Clove"
Lotus,TLS eSports,DOJO Linares,4,13,1,4,9,3,"Raze,Cypher,Omen,Fade,Gekko","Breach,Raze,Cypher,Omen,Fade"
Bind,NOVO GC,aNc Outplayed GC,10,13,3,9,4,7,"Raze,Viper,Brimstone,Skye,Gekko","Raze,Viper,Brimstone,Fade,Gekko"
Lotus,Guinea Pink Baldwin,Invictus Dominus Esports,5,13,2,4,9,3,"Breach,Raze,Killjoy,Omen,Gekko","Breach,Raze,Killjoy,Omen,Gekko"
Lotus,Stray Wolves,Fractious Esports,5,13,4,8,5,1,"Raze,Killjoy,Omen,Gekko,Clove","Breach,Raze,Killjoy,Omen,Gekko"
Lotus,Lotus Knights,Blood Moon V2,13,5,9,3,2,4,"Raze,Cypher,Viper,Omen,Fade","Breach,Killjoy,Omen,Neon,Gekko"
Lotus,Capacitanes,Locked Hanters,13,4,8,4,0,5,"Breach,Raze,Killjoy,Omen,Gekko","Breach,Raze,Killjoy,Omen,Fade"
Sunset,Apinaorkesteri,SweetNsour,14,12,7,6,6,7,"Raze,Cypher,Omen,Gekko,Deadlock","Raze,Cypher,Omen,KAY/O,Gekko"
Lotus,VexOficiaal,VOID (EU),14,12,4,9,3,10,"Breach,Killjoy,Astra,Neon,Gekko","Raze,Killjoy,Jett,Gekko,Clove"
Lotus,1000rr club,KHORE GAMING,13,3,4,0,3,9,"Breach,Raze,Cypher,Omen,Gekko","Breach,Raze,Cypher,Omen,Gekko"
Sunset,Tani eSports,Las Palmas Unity,13,5,5,1,4,8,"Breach,Raze,Cypher,Omen,Gekko","Breach,Raze,Cypher,Omen,Yoru"
Bind,Ursus Gaming,CROW DYNASTY,13,8,7,2,6,6,"Raze,Viper,Brimstone,Skye,Gekko","Raze,Cypher,Reyna,Gekko,Clove"
Lotus,AXIMZERO,Team GMask,13,9,10,2,7,3,"Breach,Raze,Killjoy,Omen,Fade","Raze,Killjoy,Omen,Fade,Gekko"
Bind,Dimonis,Osguviipeek,13,11,6,6,5,7,"Breach,Raze,Skye,Yoru,Clove","Raze,Cypher,Sova,Brimstone,Skye"
Lotus,CDC Valorant,TeamGamingProject,6,13,3,9,4,3,"Breach,Raze,Cypher,Omen,Gekko","Breach,Raze,Killjoy,Omen,Gekko"
Ascent,Floristeria MariTere,Mamba Mentality,13,7,8,4,3,5,"Sova,Killjoy,Omen,Jett,KAY/O","Sova,Killjoy,Omen,Jett,KAY/O"
Bind,PCW,KHORE GAMING,6,13,3,4,9,3,"Raze,Cypher,Brimstone,Skye,Fade","Breach,Raze,Cypher,Brimstone,Fade"
Sunset,FusyonEC,TLS eSports,10,13,7,5,8,3,"Breach,Raze,Cypher,Sova,Omen","Breach,Raze,Cypher,Omen,Gekko"
Ascent,Tani eSports,BETAZULES,13,1,2,0,1,11,"Cypher,Sova,Omen,Jett,KAY/O","Cypher,Sova,Killjoy,Omen,Jett"
Lotus,Solar Flare,TEAM VELAXIS,13,6,8,4,2,5,"Raze,Viper,Omen,Chamber,Gekko","Breach,Raze,Killjoy,Omen,Chamber"
Icebox,Fractious Esports,BEYOND eSports Academy,13,5,6,0,5,7,"Sova,Killjoy,Viper,Jett,Harbor","Sova,Killjoy,Viper,Reyna,Jett"
Bind,Ultra Instinct,vortex esports,14,12,6,7,5,8,"Raze,Cypher,Viper,Brimstone,Skye","Raze,Cypher,Brimstone,Reyna,Skye"
Lotus,Ursus Gaming,Trunphant,13,2,3,0,2,10,"Breach,Raze,Killjoy,Omen,Gekko","Raze,Killjoy,Viper,Omen,Gekko"
Lotus,Melilla Titans Academy,Zenturions,13,11,8,4,7,5,"Breach,Killjoy,Omen,Neon,Gekko","Breach,Killjoy,Astra,Neon,Gekko"
Lotus,Stray Wolves,elionking val,13,10,7,5,5,6,"Raze,Killjoy,Omen,Gekko,Clove","Raze,Killjoy,Viper,Omen,Fade"
Split,KAST Esports,Invictus Dominus Esports,10,13,4,7,6,6,"Breach,Raze,Cypher,Sage,Omen","Breach,Raze,Cypher,Omen,Yoru"
Sunset,BEYOND eSports,Kawaii Cafe,13,4,9,3,1,4,"Breach,Cypher,Jett,Gekko,Clove","Raze,Cypher,Fade,Gekko,Clove"
Split,CROW DYNASTY,zer0 club,13,9,8,2,7,5,"Breach,Raze,Cypher,Jett,Clove","Breach,Raze,Cypher,Omen,Skye"
Lotus,TeamGamingProject,Fnss Shokwave,13,2,10,2,0,3,"Breach,Raze,Killjoy,Omen,Gekko","Breach,Raze,Cypher,Omen,Fade"
Breeze,Odyssey Gaming,Locked Hanters,2,13,1,2,11,1,"Cypher,Sova,Viper,Jett,KAY/O","Cypher,Sova,Viper,Jett,KAY/O"
Lotus,Osguviipeek,Team Orion,13,3,10,2,1,3,"Breach,Raze,Killjoy,Omen,Gekko","Breach,Raze,Killjoy,Omen,Gekko"
Sunset,Acient,Powerpuff GC,13,7,7,1,6,6,"Raze,Cypher,Omen,KAY/O,Gekko","Cypher,Sova,Omen,KAY/O,Neon"
Ascent,TSA Galaxy,Team GMask,3,13,0,4,9,3,"Sova,Killjoy,Omen,Jett,KAY/O","Sova,Killjoy,Omen,Jett,KAY/O"
Split,Apinaorkesteri,SweetNsour,6,13,5,7,6,1,"Raze,Cypher,Omen,Skye,Astra","Raze,Cypher,Viper,Omen,Skye"
Breeze,Crocodile Tear,Cyberking Esports,9,13,7,3,10,2,"Cypher,Sova,Viper,Jett,KAY/O","Cypher,Sova,Viper,Jett,Yoru"
Bind,Crocodile Tear,Cyberking Esports,13,6,7,0,6,6,"Raze,Brimstone,Skye,Harbor,Gekko","Raze,Cypher,Brimstone,Reyna,Skye"
Ascent,Tyrant Esports PH,Oasis Gaming,3,13,0,4,9,3,"Killjoy,Reyna,Omen,Jett,Skye","Sova,Killjoy,Omen,Jett,KAY/O"
Sunset,Crocodile Tear,Cyberking Esports,11,13,5,7,6,6,"Raze,Cypher,Omen,KAY/O,Gekko","Breach,Raze,Cypher,Omen,Fade"
Split,Dominus Esports,Original Gaming,13,8,5,4,4,8,"Raze,Viper,Omen,Jett,Skye","Raze,Cypher,Viper,Omen,Skye"
Icebox,Tyrant Esports PH,Oasis Gaming,9,13,5,5,8,4,"Sova,Killjoy,Viper,Jett,Clove","Sova,Killjoy,Viper,Reyna,Jett"
Bind,Tyrant Esports PH,Oasis Gaming,13,5,4,2,3,9,"Raze,Cypher,Brimstone,Reyna,Skye","Raze,Skye,Chamber,Iso,Clove"
Bind,Dominus Esports,Original Gaming,13,8,6,3,5,7,"Raze,Brimstone,Skye,Harbor,Gekko","Raze,Cypher,Viper,Brimstone,Skye"
Lotus,Cop 'EM Manila,Subversive,15,13,8,6,7,7,"Raze,Killjoy,Viper,Omen,Fade","Raze,Killjoy,Viper,Omen,Gekko"
Sunset,Dominus Esports,Original Gaming,11,13,4,8,5,7,"Breach,Raze,Cypher,Sova,Omen","Raze,Cypher,Viper,Omen,Gekko"
Ascent,Cop 'EM Manila,Subversive,13,6,8,4,2,5,"Breach,Viper,Phoenix,Omen,KAY/O","Sova,Killjoy,Omen,Jett,KAY/O"
Bind,Bandits OCE,Corn Dogs (OCE),13,10,9,3,7,4,"Raze,Viper,Gekko,Deadlock,Clove","Raze,Cypher,Brimstone,Skye,Yoru"
Lotus,Bandits OCE,Corn Dogs (OCE),13,8,9,3,5,4,"Raze,Cypher,Omen,Yoru,Fade","Breach,Raze,Killjoy,Omen,Gekko"
Split,Ivy League Gaming,Rank El Cuties,4,13,2,3,10,2,"Raze,Cypher,Omen,Jett,Skye","Raze,Cypher,Viper,Omen,Skye"
Lotus,Ivy League Gaming,Rank El Cuties,7,13,3,5,8,4,"Raze,Killjoy,Viper,Omen,Skye","Raze,Killjoy,Viper,Omen,Fade"
Icebox,Bestial Esports,Astro World,11,13,7,5,8,4,"Sova,Killjoy,Viper,Jett,Gekko","Sova,Killjoy,Viper,Reyna,Jett"
Lotus,Bestial Esports,Astro World,8,13,8,4,9,0,"Raze,Killjoy,Omen,Jett,Skye","Raze,Killjoy,Viper,Omen,Fade"
Breeze,RETA Esports,Illicit Gaming,14,12,6,7,5,8,"Cypher,Sova,Viper,Jett,KAY/O","Cypher,Sova,Viper,Jett,KAY/O"
Lotus,Bon Bon Bum Contra GC,Kunai Esports FEM,13,1,2,0,1,11,"Breach,Raze,Cypher,Omen,Gekko","Breach,Raze,Cypher,Omen,Gekko"
Split,Bon Bon Bum Contra GC,Kunai Esports FEM,13,10,8,3,7,5,"Raze,Viper,Omen,Jett,Skye","Breach,Raze,Cypher,Omen,Skye"
Lotus,Ragnus Esports,New Combat Line GC,13,2,2,1,1,11,"Breach,Raze,Killjoy,Omen,Neon","Breach,Raze,Killjoy,Omen,Gekko"
Bind,RETA Esports,Illicit Gaming,17,15,12,4,11,5,"Raze,Viper,Brimstone,Skye,Gekko","Raze,Viper,Brimstone,Skye,Gekko"
Bind,Bon Bon Bum Contra GC,Kunai Esports FEM,8,13,3,6,7,5,"Raze,Cypher,Jett,Skye,Clove","Raze,Brimstone,Skye,Harbor,Gekko"
Icebox,Ragnus Esports,New Combat Line GC,13,6,9,3,3,4,"Viper,Jett,Skye,Harbor,Gekko","Sova,Killjoy,Viper,Jett,Gekko"
Bind,E-Xolos LAZER,Six Karma,13,4,10,2,2,3,"Raze,Brimstone,Skye,Harbor,Gekko","Raze,Viper,Brimstone,Fade,Gekko"
Sunset,Oxygen Esports,QoR,13,10,10,2,8,3,"Breach,Raze,Cypher,Omen,KAY/O","Breach,Raze,Cypher,Sova,Omen"
Lotus,Oxygen Esports,QoR,13,6,11,1,5,2,"Breach,Raze,Cypher,Gekko,Clove","Raze,Sova,Killjoy,Viper,Omen"
Lotus,Dasein Club GC,OXEN GC,5,13,4,8,5,1,"Breach,Raze,Sova,Killjoy,Omen","Breach,Raze,Killjoy,Omen,Gekko"
Breeze,Zen eSports GC,Deagle Ravagers,13,6,6,1,5,7,"Cypher,Sova,Reyna,Jett,Harbor","Cypher,Sova,Viper,Jett,KAY/O"
Lotus,E-Xolos LAZER,Six Karma,12,14,6,7,7,6,"Breach,Raze,Cypher,Omen,Gekko","Cypher,Omen,Jett,Gekko,Deadlock"
Lotus,MIBR GC,Team Liquid Brazil,14,16,5,10,6,9,"Raze,Killjoy,Viper,Omen,Fade","Raze,Killjoy,Viper,Omen,Fade"
Ascent,Dasein Club GC,OXEN GC,7,13,3,5,8,4,"Sova,Killjoy,Omen,Jett,KAY/O","Sova,Killjoy,Omen,Jett,KAY/O"
Ascent,E-Xolos LAZER,Six Karma,13,6,5,2,4,8,"Cypher,Sova,Omen,Jett,KAY/O","Sova,Killjoy,Omen,Jett,KAY/O"
Lotus,Zen eSports GC,Deagle Ravagers,13,9,9,3,6,4,"Breach,Raze,Killjoy,Brimstone,Neon","Breach,Raze,Sova,Killjoy,Omen"
Split,Moist x Shopify,FLUFFY AIMERS,13,10,6,6,4,7,"Raze,Cypher,Viper,Skye,Astra","Breach,Raze,Cypher,Omen,KAY/O"
Sunset,MIBR GC,Team Liquid Brazil,3,13,1,11,2,2,"Raze,Cypher,Omen,Fade,Gekko","Raze,Cypher,Omen,KAY/O,Gekko"
Bind,MIBR GC,Team Liquid Brazil,13,4,9,3,1,4,"Raze,Viper,Brimstone,Fade,Gekko","Raze,Viper,Brimstone,Skye,Gekko"
Breeze,Moist x Shopify,FLUFFY AIMERS,13,8,10,2,6,3,"Cypher,Sova,Viper,Jett,KAY/O","Sova,Viper,Jett,Astra,KAY/O"
Ascent,LuckyGirls,TwentyStars GC,12,14,4,9,5,8,"Sova,Killjoy,Omen,Jett,KAY/O","Sova,Killjoy,Phoenix,Omen,Jett"
Ascent,Moist x Shopify,FLUFFY AIMERS,7,13,5,3,10,2,"Sova,Killjoy,Omen,Jett,KAY/O","Sova,Killjoy,Omen,Jett,KAY/O"
Ascent,KR Esports,Onyx Ravens,9,13,5,7,6,4,"Breach,Sova,Viper,Omen,Jett","Sova,Killjoy,Omen,Jett,KAY/O"
Breeze,MIBR GC,Team Liquid Brazil,11,13,5,7,6,6,"Cypher,Sova,Viper,Jett,KAY/O","Cypher,Sova,Viper,Astra,Gekko"
Lotus,LuckyGirls,TwentyStars GC,7,13,1,11,2,6,"Raze,Killjoy,Viper,Omen,Fade","Breach,Raze,Killjoy,Omen,Chamber"
Lotus,KR Esports,Onyx Ravens,9,13,6,4,9,3,"Raze,Cypher,Viper,Omen,Fade","Breach,Raze,Killjoy,Gekko,Clove"
Lotus,Dragons Esports,Underground Gaming,13,1,11,1,0,2,"Raze,Killjoy,Viper,Omen,Fade","Breach,Raze,Killjoy,Omen,Gekko"
Lotus,NXT,Formulation Gaming,13,8,7,5,3,6,"Raze,Cypher,Omen,Fade,Gekko","Raze,Killjoy,Viper,Omen,Fade"
Split,Team Falcons,The Ultimates,13,4,3,2,2,10,"Breach,Raze,Cypher,Omen,Skye","Raze,Viper,Jett,Skye,Astra"
Lotus,EKO Esports GC,LXT Esports GC,3,13,2,2,11,1,"Breach,Raze,Killjoy,Omen,Gekko","Raze,Killjoy,Viper,Omen,Fade"
Ascent,Twisted Minds Esports,G3 Esports,13,8,3,6,2,10,"Sova,Reyna,Jett,Astra,KAY/O","Breach,Sova,Jett,Astra,KAY/O"
Split,KR Esports,Onyx Ravens,13,11,10,2,9,3,"Raze,Cypher,Viper,Omen,Skye","Breach,Raze,Omen,Skye,Neon"
Icebox,Team Falcons,The Ultimates,13,3,3,1,2,10,"Reyna,Omen,KAY/O,Harbor,Gekko","Sova,Killjoy,Viper,Jett,Gekko"
Sunset,Dragons Esports,Underground Gaming,13,9,6,6,3,7,"Raze,Cypher,Viper,Omen,Fade","Breach,Raze,Cypher,Omen,Fade"
Breeze,Twisted Minds Esports,G3 Esports,13,2,2,1,1,11,"Cypher,Sova,Viper,Jett,Yoru","Sova,Viper,Jett,Yoru,Chamber"
Ascent,EKO Esports GC,LXT Esports GC,3,13,1,3,10,2,"Cypher,Sova,Phoenix,Omen,Jett","Sova,Killjoy,Omen,Jett,KAY/O"
Ascent,NXT,Formulation Gaming,14,12,3,10,2,11,"Cypher,Sova,Omen,Jett,KAY/O","Cypher,Sova,Omen,Jett,KAY/O"
Icebox,G3 Esports,KR Esports,1,13,0,2,11,1,"Sova,Killjoy,Viper,Sage,Jett","Sova,Killjoy,Viper,Yoru,Chamber"
Bind,G3 Esports,KR Esports,11,13,6,6,7,5,"Breach,Raze,Sova,Viper,Brimstone","Raze,Cypher,Brimstone,Skye,Gekko"
Bind,NXT,Formulation Gaming,5,13,1,5,8,4,"Raze,Viper,Brimstone,KAY/O,Gekko","Raze,Viper,Brimstone,Skye,Gekko"
Bind,Corn Dogs (OCE),Peace & Love,13,10,3,8,2,10,"Raze,Brimstone,Skye,Yoru,Chamber","Raze,Phoenix,Brimstone,Reyna,Skye"
Lotus,Corn Dogs (OCE),Peace & Love,5,13,1,5,8,4,"Raze,Killjoy,Fade,Gekko,Clove","Raze,Killjoy,Omen,Jett,Skye"
Ascent,Corn Dogs (OCE),Peace & Love,13,6,5,2,4,8,"Killjoy,Omen,Jett,KAY/O,Gekko","Sova,Phoenix,Sage,Omen,Neon"
Bind,Rank El Cuties,Bestial Esports,8,13,4,5,8,4,"Raze,Skye,Astra,Gekko,Deadlock","Raze,Cypher,Brimstone,Jett,Skye"
Ascent,Ivy League Gaming,Astro World,12,14,3,10,4,9,"Sova,Killjoy,Omen,Jett,KAY/O","Sova,Killjoy,Omen,Jett,KAY/O"
Lotus,Ivy League Gaming,Astro World,13,6,7,0,6,6,"Raze,Killjoy,Viper,Omen,Skye","Raze,Killjoy,Viper,Omen,Fade"
Icebox,Rank El Cuties,Bestial Esports,13,15,6,8,7,7,"Killjoy,Viper,Jett,KAY/O,Harbor","Sova,Killjoy,Viper,Jett,Gekko"
Sunset,Tyrant Esports PH,SNAPZ,13,9,6,4,5,7,"Cypher,Sova,Phoenix,Gekko,Clove","Cypher,Sova,Omen,Jett,KAY/O"
Split,Ivy League Gaming,Astro World,7,13,4,8,5,3,"Raze,Cypher,Viper,Omen,Skye","Raze,Viper,Phoenix,Omen,Fade"
Ascent,Tyrant Esports PH,SNAPZ,13,5,3,3,2,10,"Killjoy,Reyna,Omen,Jett,Skye","Sova,Killjoy,Omen,Jett,KAY/O"
Ascent,Rank El Cuties,Bestial Esports,13,11,8,4,7,5,"Sova,Killjoy,Omen,Jett,KAY/O","Sova,Killjoy,Omen,Jett,KAY/O"
Ascent,New Combat Line GC,Kunai Esports FEM,13,7,8,4,3,5,"Sova,Killjoy,Omen,Jett,KAY/O","Sova,Killjoy,Omen,Jett,KAY/O"
Ascent,TMC,ST x WTP,15,17,7,9,8,8,"Sova,Killjoy,Omen,Jett,KAY/O","Sova,Killjoy,Jett,KAY/O,Clove"
Lotus,OPPY,reddots daycare,12,14,9,4,10,3,"Raze,Killjoy,Viper,Omen,Fade","Raze,Killjoy,Viper,Omen,Fade"
Lotus,New Combat Line GC,Kunai Esports FEM,11,13,5,7,6,6,"Breach,Raze,Killjoy,Omen,Gekko","Breach,Raze,Cypher,Omen,Gekko"
Bind,Bon Bon Bum Contra GC,Ragnus Esports,8,13,4,5,8,4,"Raze,Viper,Brimstone,Skye,Gekko","Raze,Cypher,Brimstone,Skye,Yoru"
Lotus,TMC,ST x WTP,7,13,2,6,7,5,"Raze,Killjoy,Viper,Omen,Fade","Raze,Killjoy,Fade,Gekko,Clove"
Sunset,TSM,YFP Gaming,13,8,7,2,6,6,"Breach,Raze,Cypher,Omen,KAY/O","Breach,Raze,Cypher,Omen,Gekko"
Icebox,ST x WTP,Eternal Focus Crimson,13,4,9,3,1,4,"Sova,Killjoy,Viper,Reyna,Jett","Killjoy,Viper,Yoru,Harbor,Gekko"
Ascent,Bon Bon Bum Contra GC,Ragnus Esports,8,13,2,7,6,6,"Breach,Raze,Sova,Killjoy,Omen","Breach,Sova,Killjoy,Jett,Clove"
Split,New Combat Line GC,Kunai Esports FEM,13,1,11,1,0,2,"Raze,Cypher,Viper,Omen,Skye","Breach,Raze,Cypher,Omen,Skye"
Ascent,Val's Little Swimmers,TMC,10,13,6,6,7,4,"Cypher,Sova,Omen,Jett,KAY/O","Sova,Killjoy,Omen,Jett,KAY/O"
Ascent,RUN IT BACK,OPPY,9,13,4,6,7,5,"Sova,Omen,Jett,KAY/O,Clove","Sova,Killjoy,Omen,Jett,KAY/O"
Lotus,Purpose Gaming,reddots daycare,17,19,9,9,10,8,"Breach,Raze,Cypher,Omen,Fade","Raze,Killjoy,Viper,Omen,Fade"
Lotus,TSM,YFP Gaming,13,7,6,2,5,7,"Raze,Killjoy,Viper,Omen,Fade","Breach,Raze,Cypher,Omen,Gekko"
Icebox,Deagle Ravagers,OXEN GC,13,15,7,7,8,6,"Raze,Sova,Killjoy,Viper,KAY/O","Sova,Killjoy,Viper,Reyna,Jett"
Lotus,Chamber 1 trick,ST x WTP,12,14,7,6,8,5,"Raze,Killjoy,Viper,Gekko,Clove","Breach,Raze,Killjoy,Omen,Fade"
Ascent,Val's Little Swimmers,pugggstarsf,13,7,6,2,5,7,"Cypher,Sova,Omen,Jett,KAY/O","Sova,Killjoy,Omen,Jett,KAY/O"
Ascent,SaD Esports,Blinn Esports,8,13,7,5,8,1,"Sova,Killjoy,Omen,Jett,KAY/O","Sova,Killjoy,Omen,Jett,KAY/O"
Sunset,Flare,reddots daycare,10,13,4,7,6,6,"Raze,Cypher,Omen,KAY/O,Gekko","Breach,Raze,Cypher,Omen,Gekko"
Ascent,VZN E-SPORTS,TMC,7,13,7,5,8,0,"Sova,Killjoy,Omen,Jett,KAY/O","Sova,Killjoy,Omen,Jett,KAY/O"
Split,Spate Esports,OPPY,10,13,5,7,6,5,"Raze,Cypher,Omen,Jett,Skye","Raze,Cypher,Viper,Omen,Skye"
Bind,TSM,YFP Gaming,7,13,4,8,5,3,"Raze,Viper,Brimstone,Skye,Gekko","Raze,Viper,Brimstone,Skye,Gekko"
Ascent,Purpose Gaming,Team Digital,13,8,3,6,2,10,"Sova,Killjoy,Omen,Jett,KAY/O","Sova,Killjoy,Omen,Jett,KAY/O"
Ascent,Shaboozey's Slimes,RUN IT BACK,4,13,2,3,10,2,"Sova,Killjoy,Omen,Jett,KAY/O","Sova,Killjoy,Omen,Jett,Clove"
Ascent,Zen eSports GC,Dasein Club GC,10,13,8,4,9,2,"Sova,Killjoy,Omen,Jett,KAY/O","Sova,Killjoy,Omen,Jett,KAY/O"
Lotus,Deagle Ravagers,OXEN GC,13,8,6,3,5,7,"Breach,Raze,Sova,Killjoy,Omen","Breach,Raze,Killjoy,Omen,Gekko"
Lotus,Shirtless Gamers,Eternal Focus Crimson,7,13,5,3,10,2,"Raze,Killjoy,Viper,Omen,Gekko","Raze,Killjoy,Omen,Fade,Gekko"
Ascent,breadwinners,Val's Little Swimmers,10,13,5,7,6,5,"Cypher,Sova,Omen,Jett,KAY/O","Cypher,Sova,Omen,Jett,KAY/O"
Ascent,Team Liquid Brazil,REVOADA,13,5,5,1,4,8,"Sova,Killjoy,Omen,Jett,KAY/O","Sova,Killjoy,Omen,Jett,KAY/O"
Bind,Chamber 1 trick,TMX,13,10,5,6,4,8,"Raze,Viper,Brimstone,Skye,Gekko","Raze,Cypher,Viper,Brimstone,Gekko"
Split,SaD Esports,Blinn Esports,8,13,4,8,5,4,"Raze,Cypher,Viper,Omen,Skye","Raze,Cypher,Viper,Omen,Skye"
Icebox,Team Digital,Venatus,13,1,2,0,1,11,"Sova,Killjoy,Viper,Jett,Harbor","Killjoy,Viper,Jett,Harbor,Gekko"
Ascent,reddots daycare,Sushi Bois,13,6,7,5,1,6,"Sova,Killjoy,Omen,Jett,KAY/O","Sova,Killjoy,Omen,Jett,KAY/O"
Split,9z Team,XSOUL,13,4,10,2,2,3,"Breach,Raze,Viper,Omen,Skye","Raze,Cypher,Viper,Skye,Astra"
Lotus,OPPY,BlanK,13,3,9,3,0,4,"Raze,Killjoy,Viper,Omen,Fade","Breach,Raze,Killjoy,Omen,Gekko"
Bind,RUN IT BACK,Holy Smokes,13,4,4,1,3,9,"Raze,Brimstone,Skye,Chamber,Deadlock","Viper,Yoru,Neon,Harbor,Gekko"
Lotus,TMC,ShaBoingBoing Esports,13,11,4,8,3,9,"Raze,Killjoy,Viper,Omen,Fade","Breach,Raze,Killjoy,Omen,Skye"
Ascent,VZN E-SPORTS,TMX B,13,2,10,2,0,3,"Sova,Killjoy,Omen,Jett,KAY/O","Raze,Killjoy,Omen,Gekko,Clove"
Ascent,pugggstarsf,Sky Esports (NA),13,9,4,6,3,9,"Sova,Killjoy,Omen,Jett,KAY/O","Cypher,Sova,Reyna,Omen,Jett"
Split,The Dealers,Val's Little Swimmers,3,13,2,2,11,1,"Raze,Cypher,Viper,Omen,Skye","Raze,Cypher,Viper,Omen,Skye"
Ascent,Hale,ST x WTP,4,13,3,9,4,1,"Sova,Killjoy,Omen,Jett,KAY/O","Sova,Killjoy,Jett,KAY/O,Clove"
Lotus,Eternal Focus Crimson,Rizzly Bears,13,11,5,7,4,8,"Raze,Killjoy,Omen,Fade,Gekko","Raze,Viper,Fade,Gekko,Deadlock"
Split,TMX,Something Funny,13,5,9,3,2,4,"Breach,Raze,Cypher,Omen,Gekko","Raze,Cypher,Omen,Jett,Gekko"
Split,Zen eSports GC,Dasein Club GC,10,13,6,6,7,4,"Raze,Cypher,Jett,Skye,Astra","Raze,Cypher,Viper,Omen,Skye"
Lotus,QoR,Dough Bros,13,9,7,3,6,6,"Raze,Sova,Killjoy,Viper,Omen","Raze,Killjoy,Viper,Omen,Fade"
Bind,Deagle Ravagers,OXEN GC,12,14,5,8,6,7,"Breach,Raze,Viper,Brimstone,KAY/O","Breach,Raze,Cypher,Brimstone,Gekko"
Bind,SaD Esports,Blinn Esports,13,9,9,3,6,4,"Raze,Viper,Omen,Skye,Gekko","Raze,Viper,Brimstone,KAY/O,Gekko"
Icebox,9z Team,XSOUL,13,5,8,4,1,5,"Sova,Killjoy,Viper,Sage,Jett","Sova,Killjoy,Viper,Reyna,Gekko"
Split,Team Liquid Brazil,REVOADA,11,13,4,8,5,7,"Breach,Raze,Viper,Omen,Skye","Raze,Cypher,Viper,Omen,Skye"
Breeze,QoR,Dough Bros,13,5,5,1,4,8,"Cypher,Sova,Viper,Jett,KAY/O","Cypher,Sova,Viper,Jett,KAY/O"
Icebox,The Vicious,Dragons Esports,16,14,11,4,10,5,"Sova,Killjoy,Viper,Sage,Jett","Sova,Killjoy,Viper,Sage,Omen"
Lotus,Team Liquid Brazil,REVOADA,13,6,8,4,2,5,"Raze,Killjoy,Viper,Omen,Fade","Raze,Killjoy,Viper,Omen,Fade"
Sunset,FLUFFY AIMERS,Winthrop University,13,11,6,6,5,7,"Breach,Raze,Cypher,Omen,Skye","Breach,Raze,Cypher,Omen,Fade"
Ascent,The Ultimates,KR Esports,13,4,9,3,1,4,"Sova,Killjoy,Omen,Jett,KAY/O","Sova,Killjoy,Omen,Jett,KAY/O"
Ascent,All Knights,Furious Gaming,13,11,7,5,6,6,"Sova,Killjoy,Omen,Jett,KAY/O","Sova,Killjoy,Omen,Jett,KAY/O"
Sunset,The Vicious,Dragons Esports,13,10,9,2,8,4,"Raze,Cypher,Sova,Omen,Gekko","Raze,Cypher,Viper,Omen,Fade"
Lotus,FLUFFY AIMERS,Winthrop University,13,3,2,2,1,11,"Breach,Raze,Cypher,Omen,Fade","Raze,Killjoy,Viper,Omen,Gekko"
Ascent,QoR,Dough Bros,11,13,7,5,8,4,"Sova,Killjoy,Omen,Jett,KAY/O","Sova,Killjoy,Omen,Jett,KAY/O"
Bind,Team Liquid Brazil,REVOADA,13,5,3,3,2,10,"Raze,Viper,Brimstone,Skye,Gekko","Raze,Viper,Brimstone,Skye,Gekko"
Split,The Ultimates,KR Esports,13,9,4,6,3,9,"Raze,Viper,Jett,Skye,Astra","Raze,Cypher,Omen,Jett,Skye"
Lotus,The Vicious,Dragons Esports,5,13,1,5,8,4,"Raze,Killjoy,Omen,Jett,Skye","Raze,Killjoy,Viper,Omen,Fade"
Lotus,All Knights,Furious Gaming,16,14,10,5,9,6,"Raze,Killjoy,Viper,Omen,Fade","Raze,Killjoy,Viper,Omen,Fade"
Lotus,KPI Gaming,Barça eSports,13,5,6,0,5,7,"Killjoy,Viper,Omen,Skye,Neon","Raze,Killjoy,Viper,Omen,Fade"
Lotus,Onyx Ravens,Underground Gaming,6,13,2,5,8,4,"Breach,Raze,Killjoy,Omen,Gekko","Breach,Raze,Killjoy,Omen,Gekko"
Split,Twisted Minds Esports,Team Falcons,10,13,5,6,7,5,"Raze,Viper,Omen,Jett,Skye","Breach,Raze,Cypher,Omen,Skye"
Lotus,Falke Esports,UCAM Esports Club,1,13,1,11,2,0,"Breach,Raze,Sova,Killjoy,Omen","Breach,Sova,Killjoy,Omen,Jett"
Ascent,Onyx Ravens,Underground Gaming,10,13,5,7,6,5,"Sova,Killjoy,Omen,Jett,KAY/O","Sova,Killjoy,Omen,Jett,KAY/O"
Bind,Twisted Minds Esports,Team Falcons,1,13,0,12,1,1,"Raze,Viper,Omen,Skye,Deadlock","Raze,Viper,Sage,Skye,Clove"
Ascent,Ramboot Club,ZETA Gaming,13,9,6,6,3,7,"Cypher,Sova,Phoenix,Omen,Jett","Sova,Killjoy,Omen,Jett,KAY/O"
Icebox,Imperium Gaming,Five Media Clan,13,7,9,3,4,4,"Killjoy,Viper,Reyna,KAY/O,Gekko","Killjoy,Viper,Jett,KAY/O,Gekko"
Split,Barn nong chok,The Infinity Esports,13,4,2,3,10,2,"Raze,Cypher,Jett,Skye,Astra","Raze,Cypher,Viper,Omen,Skye"
Lotus,Barn nong chok,The Infinity Esports,13,3,0,4,9,3,"Raze,Killjoy,Viper,Omen,Fade","Raze,Killjoy,Viper,Omen,Fade"
Bind,Barn nong chok,The Infinity Esports,10,13,6,6,4,7,"Raze,Viper,Brimstone,Jett,Skye","Raze,Viper,Brimstone,Skye,Gekko"
Split,XOXO-01,The Infinity Esports,13,11,4,8,3,9,"Raze,Cypher,Viper,Omen,Skye","Raze,Cypher,Jett,Skye,Astra"
Lotus,XOXO-01,The Infinity Esports,15,13,8,6,7,7,"Raze,Killjoy,Viper,Omen,Fade","Raze,Killjoy,Viper,Omen,Fade"
Lotus,Peace & Love,Xu Gang,13,7,7,5,2,6,"Raze,Killjoy,Omen,Neon,Gekko","Raze,Cypher,Sova,Omen,KAY/O"
Ascent,Peace & Love,Xu Gang,13,6,6,1,5,7,"Sova,Killjoy,Phoenix,Omen,Neon","Cypher,Sova,Omen,Jett,KAY/O"
Lotus,Corn Dogs (OCE),Tiny Turtle Squad,13,6,3,4,2,10,"Raze,Killjoy,Fade,Gekko,Clove","Viper,Omen,Chamber,Neon,Gekko"
Split,Peace & Love,Xu Gang,8,13,7,5,8,1,"Raze,Phoenix,Omen,Skye,Neon","Breach,Raze,Cypher,Omen,Deadlock"
Split,Corn Dogs (OCE),Tiny Turtle Squad,13,11,6,6,5,7,"Raze,Cypher,Reyna,Skye,Clove","Raze,Cypher,Viper,Omen,Skye"
Sunset,Bestial Esports,Ivy League Gaming,7,13,4,8,5,3,"Raze,Cypher,Omen,KAY/O,Gekko","Raze,Cypher,Sova,Omen,Gekko"
Ascent,AIM PH,Cop 'EM Manila,14,12,7,6,6,7,"Sova,Killjoy,Omen,Jett,KAY/O","Breach,Viper,Phoenix,Omen,KAY/O"
Breeze,SNAPZ,Oasis Gaming,2,13,0,3,10,2,"Cypher,Sova,Viper,Jett,Yoru","Sova,Viper,Jett,Yoru,Astra"
Ascent,Bestial Esports,Ivy League Gaming,8,13,4,8,5,4,"Sova,Killjoy,Omen,Jett,KAY/O","Sova,Killjoy,Omen,Jett,KAY/O"
Lotus,AIM PH,Cop 'EM Manila,13,6,5,2,4,8,"Raze,Killjoy,Viper,Omen,Fade","Raze,Killjoy,Viper,Omen,Fade"
Icebox,Astro World,Rank El Cuties,10,13,6,6,7,4,"Sova,Killjoy,Viper,Reyna,Jett","Killjoy,Viper,Jett,KAY/O,Harbor"
Lotus,SNAPZ,Oasis Gaming,7,13,3,9,4,4,"Raze,Killjoy,Omen,Fade,Gekko","Raze,Killjoy,Viper,Omen,Fade"
Split,Bestial Esports,Ivy League Gaming,13,11,5,7,4,8,"Raze,Viper,Omen,Jett,Skye","Raze,Cypher,Viper,Omen,Skye"
Icebox,AIM PH,Cop 'EM Manila,10,13,6,5,8,4,"Sova,Killjoy,Viper,Jett,Harbor","Sova,Killjoy,Jett,Harbor,Clove"
Split,Astro World,Rank El Cuties,7,13,5,7,6,2,"Raze,Viper,Phoenix,Omen,Fade","Raze,Cypher,Viper,Omen,Skye"
Lotus,Rebirth Esports,Red Eye,13,6,7,0,6,6,"Raze,Viper,Omen,Astra,Gekko","Raze,Viper,Omen,Chamber,Fade"
Icebox,Rebirth Esports,Red Eye,13,3,3,1,2,10,"Sova,Viper,Omen,Jett,Gekko","Killjoy,Viper,Jett,KAY/O,Gekko"
Split,9z Team,OXEN,11,13,6,6,7,5,"Breach,Raze,Viper,Omen,Skye","Raze,Cypher,Skye,Astra,Deadlock"
Ascent,Team Liquid Brazil,MIBR GC,11,13,1,11,2,10,"Sova,Killjoy,Omen,Jett,KAY/O","Sova,Killjoy,Omen,Jett,KAY/O"
Sunset,Maze Gaming,LRV Esports,10,13,6,5,8,4,"Breach,Sova,Viper,Phoenix,Omen","Raze,Cypher,Omen,KAY/O,Gekko"
Sunset,9z Team,OXEN,6,13,2,5,8,4,"Raze,Cypher,Omen,KAY/O,Gekko","Viper,Sage,Omen,KAY/O,Gekko"
Sunset,Team Liquid Brazil,MIBR GC,11,13,5,7,6,6,"Raze,Cypher,Omen,KAY/O,Gekko","Raze,Cypher,Omen,Fade,Gekko"
Ascent,Maze Gaming,LRV Esports,2,13,0,3,10,2,"Sova,Killjoy,Omen,Jett,KAY/O","Sova,Killjoy,Omen,Jett,KAY/O"
Lotus,Team Liquid Brazil,MIBR GC,13,5,10,2,3,3,"Raze,Killjoy,Viper,Omen,Fade","Raze,Killjoy,Viper,Omen,Fade"
Icebox,9z Team,OXEN,13,9,9,3,6,4,"Sova,Killjoy,Viper,Sage,Jett","Killjoy,Viper,Jett,KAY/O,Gekko"
Bind,XSOUL,Zen Esports,13,11,7,5,6,6,"Raze,Cypher,Viper,Brimstone,Skye","Raze,Viper,Brimstone,Skye,Chamber"
Lotus,Team Leveling,REVOADA,12,14,4,9,5,8,"Raze,Killjoy,Viper,Omen,Fade","Raze,Killjoy,Viper,Omen,Fade"
Ascent,Dragons Esports,The Ultimates,13,7,5,3,4,8,"Cypher,Sova,Omen,Jett,KAY/O","Sova,Killjoy,Omen,Jett,KAY/O"
Lotus,HGE Esports GC,LXT Esports GC,1,13,0,2,11,1,"Breach,Raze,Killjoy,Omen,Gekko","Raze,Killjoy,Viper,Omen,Fade"
Split,XSOUL,Zen Esports,13,7,8,4,3,5,"Raze,Cypher,Viper,Omen,Skye","Breach,Raze,Killjoy,Skye,Astra"
Icebox,Team Leveling,REVOADA,10,13,6,5,8,4,"Sova,Killjoy,Viper,Jett,Gekko","Sova,Killjoy,Viper,Jett,KAY/O"
Icebox,HGE Esports GC,LXT Esports GC,0,13,0,1,12,0,"Killjoy,Viper,Jett,KAY/O,Gekko","Killjoy,Viper,Jett,KAY/O,Gekko"
Icebox,Dragons Esports,The Ultimates,13,10,8,3,7,5,"Sova,Killjoy,Viper,Sage,Omen","Sova,Killjoy,Viper,Jett,Gekko"
Sunset,Five Media Clan,KPI Gaming,13,11,4,8,3,9,"Breach,Raze,Cypher,Omen,Gekko","Breach,Raze,Cypher,Omen,Gekko"
Lotus,XSOUL,Zen Esports,6,13,1,6,7,5,"Breach,Raze,Killjoy,Omen,Gekko","Breach,Raze,Sova,Killjoy,Omen"
Ascent,Underground Gaming,G3 Esports,13,8,3,6,2,10,"Sova,Killjoy,Omen,Jett,KAY/O","Breach,Sova,Jett,Astra,KAY/O"
Lotus,KR Esports,Twisted Minds Esports,8,13,3,6,7,5,"Raze,Killjoy,Omen,Jett,KAY/O","Breach,Raze,Killjoy,Omen,Gekko"
Icebox,Onyx Ravens,The Vicious,6,13,1,6,7,5,"Sova,Killjoy,Viper,Jett,Gekko","Sova,Killjoy,Viper,Sage,Jett"
Ascent,NOVO GC,TwentyStars GC,10,13,5,7,6,5,"Sova,Killjoy,Omen,Jett,KAY/O","Sova,Killjoy,Phoenix,Omen,Jett"
Ascent,Ramboot Club,Falke Esports,12,14,3,10,4,9,"Cypher,Sova,Phoenix,Omen,Jett","Sova,Killjoy,Omen,Jett,KAY/O"
Breeze,Underground Gaming,G3 Esports,13,5,11,1,4,2,"Cypher,Sova,Viper,Jett,Yoru","Sova,Viper,Jett,Yoru,Chamber"
Sunset,Onyx Ravens,The Vicious,6,13,5,7,6,1,"Breach,Raze,Cypher,Omen,Fade","Raze,Cypher,Sova,Omen,Gekko"
Bind,Team Falcons,Vision Esports,13,2,3,0,2,10,"Raze,Omen,Jett,Skye,Clove","Yoru,KAY/O,Neon,Iso,Clove"
Breeze,KR Esports,Twisted Minds Esports,6,13,4,8,5,2,"Cypher,Sova,Viper,Jett,Yoru","Cypher,Sova,Viper,Jett,Yoru"
Split,Team Falcons,Vision Esports,13,0,1,0,0,12,"Breach,Raze,Cypher,Omen,Skye","Breach,Jett,Yoru,KAY/O,Deadlock"
Lotus,NOVO GC,TwentyStars GC,13,6,7,0,6,6,"Breach,Sova,Killjoy,Omen,Neon","Breach,Raze,Killjoy,Omen,Chamber"
Split,ZETA Gaming,Barça eSports,8,13,6,6,7,2,"Breach,Raze,Cypher,Omen,Skye","Raze,Viper,Sage,Skye,Astra"
Split,UCAM Esports Club,Imperium Gaming,13,5,10,2,3,3,"Breach,Raze,Cypher,Omen,Fade","Raze,Cypher,Omen,Jett,Skye"
Lotus,Barn nong chok,gollum666,13,3,4,0,3,9,"Raze,Killjoy,Viper,Omen,Fade","Raze,Omen,Jett,Neon,Gekko"
Bind,Beaver41,Barn nong chok,7,13,3,9,4,4,"Raze,Cypher,Viper,Brimstone,KAY/O","Raze,Viper,Brimstone,Skye,Gekko"
Icebox,Z11,gollum666,7,13,4,4,9,3,"Sova,Killjoy,Viper,Reyna,Jett","Raze,Viper,Reyna,Jett,Yoru"
Ascent,The Infinity Esports,gollum666,13,11,6,6,5,7,"Sova,Killjoy,Omen,Jett,KAY/O","Sova,Killjoy,Omen,Jett,KAY/O"
Bind,Z11,The Reaper,13,11,7,5,6,6,"Raze,Cypher,Viper,Brimstone,Skye","Raze,Viper,Brimstone,Skye,Gekko"
Lotus,Barn nong chok,KaiJyu,13,11,6,6,5,7,"Raze,Killjoy,Viper,Omen,Fade","Raze,Killjoy,Omen,Skye,Fade"
Lotus,Beaver41,XOXO-01,7,13,4,8,5,3,"Raze,Killjoy,Omen,Astra,Gekko","Raze,Killjoy,Viper,Omen,Fade"
Breeze,Funcrew,Bandits OCE,13,11,5,7,4,8,"Sova,Viper,Jett,KAY/O,Deadlock","Cypher,Sova,Viper,Jett,Yoru"
Ascent,Funcrew,Bandits OCE,13,9,6,4,5,7,"Sova,Killjoy,Reyna,Omen,Jett","Sova,Killjoy,Omen,Yoru,KAY/O"
Split,KS Esports GC,FUSION X,9,13,4,8,5,5,"Raze,Cypher,Viper,Omen,Skye","Raze,Sage,Astra,Gekko,Deadlock"
Lotus,KS Esports GC,FUSION X,9,13,5,5,8,4,"Breach,Raze,Cypher,Omen,Gekko","Breach,Raze,Killjoy,Omen,Skye"
Ascent,Concordia University,SFU Pink,11,13,4,8,5,7,"Cypher,Omen,Jett,KAY/O,Deadlock","Sova,Killjoy,Sage,Omen,Jett"
Lotus,UCF Gold,Fisher Falcons,6,13,5,7,6,1,"Raze,Killjoy,Viper,Omen,Fade","Raze,Killjoy,Viper,Omen,Fade"
Split,uOttawa Garnet,SFU Raccoons,16,18,7,10,8,9,"Raze,Cypher,Omen,Jett,Skye","Raze,Cypher,Omen,Jett,Skye"
Lotus,Concordia University,SFU Pink,7,13,2,6,7,5,"Breach,Raze,Phoenix,Chamber,Clove","Sage,Omen,Yoru,Neon,Deadlock"
Icebox,KS Esports GC,FUSION X,13,11,4,8,3,9,"Killjoy,Viper,Reyna,KAY/O,Gekko","Sova,Killjoy,Reyna,Jett,Harbor"
Lotus,uOttawa Garnet,SFU Raccoons,5,13,3,3,10,2,"Raze,Killjoy,Omen,Fade,Gekko","Raze,Killjoy,Omen,Skye,Gekko"
Icebox,UCF Gold,Fisher Falcons,14,12,8,5,7,6,"Sova,Killjoy,Viper,Jett,Gekko","Sova,Killjoy,Viper,Reyna,Jett"
Split,Concordia University,SFU Pink,6,13,5,7,6,1,"Breach,Raze,Cypher,Omen,Gekko","Raze,Cypher,Jett,Skye,Clove"
Ascent,UCF Gold,Fisher Falcons,2,13,0,3,10,2,"Sova,Killjoy,Omen,Jett,KAY/O","Sova,Killjoy,Omen,Jett,KAY/O"
Bind,uOttawa Garnet,SFU Raccoons,9,13,3,7,6,6,"Raze,Viper,Brimstone,Skye,Gekko","Raze,Viper,Brimstone,Skye,Gekko"
Split,Leviatán GC,KRÜ BLAZE,3,13,0,4,9,3,"Breach,Cypher,Viper,Omen,Jett","Raze,Viper,Omen,Skye,Clove"
Icebox,Leviatán GC,KRÜ BLAZE,6,13,3,4,9,3,"Sova,Killjoy,Viper,Reyna,Gekko","Sova,Killjoy,Viper,Jett,Harbor"
Lotus,Twisted Minds Esports,Underground Gaming,11,13,5,7,6,6,"Breach,Raze,Killjoy,Omen,Gekko","Breach,Raze,Killjoy,Omen,Gekko"
Lotus,Entry Frogs Iris,aNc Outplayed GC,9,13,4,6,7,5,"Breach,Raze,Killjoy,Omen,Fade","Breach,Raze,Killjoy,Omen,Gekko"
Sunset,Twisted Minds Esports,Underground Gaming,7,13,4,8,5,3,"Raze,Cypher,Omen,KAY/O,Gekko","Breach,Raze,Cypher,Omen,Fade"
Bind,Entry Frogs Iris,aNc Outplayed GC,7,13,3,9,4,4,"Raze,Cypher,Viper,Brimstone,Skye","Raze,Viper,Brimstone,Fade,Gekko"
Sunset,KPI Gaming,UCAM Esports Club,5,13,5,7,6,0,"Breach,Raze,Cypher,Omen,Gekko","Breach,Raze,Cypher,Sova,Omen"
Sunset,Vision Esports,Dragons Esports,8,13,5,4,9,3,"Breach,Raze,Omen,Gekko,Deadlock","Raze,Cypher,Viper,Omen,Fade"
Lotus,The Ultimates,Onyx Ravens,13,7,9,3,4,4,"Breach,Raze,Cypher,Sova,Omen","Raze,Killjoy,Viper,Omen,Fade"
Split,KR Esports,Team Falcons,8,13,1,8,5,7,"Raze,Cypher,Viper,Omen,Skye","Breach,Raze,Cypher,Omen,Skye"
Lotus,EKO Esports GC,LuckyGirls,4,13,0,5,8,4,"Breach,Raze,Killjoy,Omen,Gekko","Raze,Killjoy,Viper,Omen,Fade"
Ascent,Falke Esports,ZETA Gaming,13,4,3,2,2,10,"Sova,Killjoy,Omen,Jett,KAY/O","Sova,Killjoy,Omen,Jett,KAY/O"
Ascent,The Ultimates,Onyx Ravens,13,8,5,7,1,8,"Sova,Killjoy,Omen,Jett,KAY/O","Sova,Killjoy,Omen,Jett,KAY/O"
Icebox,Vision Esports,Dragons Esports,10,13,7,5,8,3,"Sova,Killjoy,Viper,Jett,Gekko","Sova,Killjoy,Viper,Sage,Omen"
Breeze,KR Esports,Team Falcons,7,13,4,4,9,3,"Cypher,Sova,Viper,Jett,Yoru","Cypher,Sova,Viper,Jett,KAY/O"
Ascent,EKO Esports GC,LuckyGirls,13,10,7,4,6,6,"Cypher,Sova,Phoenix,Omen,Jett","Sova,Killjoy,Omen,Jett,KAY/O"
Ascent,Imperium Gaming,Ramboot Club,10,13,8,3,10,2,"Sova,Killjoy,Omen,Jett,KAY/O","Cypher,Sova,Phoenix,Omen,Jett"
Split,Barça eSports,Five Media Clan,13,4,8,4,0,5,"Raze,Viper,Sage,Skye,Astra","Cypher,Viper,Omen,Jett,Skye"
Lotus,Barn nong chok,Mara Esport,13,4,4,1,3,9,"Raze,Killjoy,Viper,Omen,Fade","Breach,Raze,Killjoy,Omen,Fade"
Sunset,SDobbies,The Reaper,6,13,0,7,6,6,"Raze,Cypher,Omen,KAY/O,Gekko","Breach,Raze,Cypher,Omen,KAY/O"
Ascent,KaiJyu,Aricat e-Sport,20,18,7,12,6,13,"Sova,Killjoy,Phoenix,Omen,Jett","Sova,Killjoy,Omen,Jett,KAY/O"
Icebox,Z11, RomChomPoo,13,8,6,3,5,7,"Sova,Killjoy,Viper,Reyna,Jett","Sova,Killjoy,Viper,Jett,Harbor"
Icebox,S4, RomChomPoo,6,13,4,8,5,2,"Sova,Killjoy,Viper,Jett,Gekko","Sova,Killjoy,Viper,Jett,Harbor"
Lotus,Barn nong chok,gollum666,13,15,5,9,6,8,"Raze,Killjoy,Viper,Omen,Fade","Breach,Raze,Killjoy,Omen,Jett"
Ascent,XOXO-01,Z11,13,3,9,3,0,4,"Breach,Sova,Killjoy,Jett,Astra","Sova,Killjoy,Reyna,Omen,Jett"
Sunset,SDobbies,Beaver41,9,13,5,7,6,4,"Raze,Cypher,Omen,KAY/O,Gekko","Breach,Raze,Cypher,Sova,Omen"
Lotus,Black Swan,Mara Esport,2,13,0,3,10,2,"Raze,Killjoy,Viper,Omen,Fade","Breach,Raze,Killjoy,Omen,Fade"
Bind,Aricat e-Sport, Base Beta Esport,13,6,7,5,1,6,"Raze,Cypher,Viper,Brimstone,Skye","Raze,Cypher,Brimstone,Skye,Yoru"
Breeze,Mara Esport,Beaver41,11,13,7,5,8,4,"Cypher,Sova,Viper,Jett,Gekko","Sova,Viper,Jett,Yoru,Astra"
Lotus,gollum666,The Reaper,13,5,7,5,0,6,"Breach,Raze,Killjoy,Omen,Jett","Breach,Raze,Cypher,Viper,Omen"
Lotus,Team Fully,The Reaper,13,5,7,5,0,6,"Breach,Raze,Killjoy,Omen,Jett","Breach,Raze,Cypher,Viper,Omen"
Split, Base Beta Esport,Z11,3,13,3,9,4,0,"Raze,Cypher,Omen,Jett,Skye","Raze,Cypher,Omen,Jett,Skye"
Icebox,SDobbies,Black Swan,13,5,8,4,1,5,"Killjoy,Viper,Jett,KAY/O,Gekko","Sova,Killjoy,Viper,Jett,Harbor"
Split,XOXO-01,Aricat e-Sport,13,11,6,6,5,7,"Raze,Cypher,Viper,Omen,Skye","Breach,Raze,Cypher,Omen,Fade"
Bind,Team Fully,Barn nong chok,8,13,6,6,7,2,"Raze,Brimstone,Reyna,Skye,Harbor","Raze,Viper,Brimstone,Skye,Gekko"
Lotus, RomChomPoo,The Infinity Esports,16,18,9,8,10,7,"Breach,Raze,Omen,Jett,Skye","Raze,Killjoy,Viper,Omen,Fade"
Bind,KaiJyu,S4,16,14,10,5,9,6,"Raze,Cypher,Brimstone,Skye,Gekko","Raze,Viper,Brimstone,Skye,Gekko"
Bind,KaiJyu,The Infinity Esports,16,14,10,5,9,6,"Raze,Cypher,Brimstone,Skye,Gekko","Raze,Viper,Brimstone,Skye,Gekko"
Lotus,The Zoo  (IN),Alternate Realities,8,13,6,6,7,2,"Breach,Raze,Killjoy,Omen,Fade","Raze,Killjoy,Viper,Omen,Fade"
Ascent,The Zoo  (IN),Alternate Realities,13,7,7,5,2,6,"Sova,Killjoy,Reyna,Omen,Jett","Killjoy,Phoenix,Omen,KAY/O,Fade"
Bind,The Zoo  (IN),Alternate Realities,9,13,7,3,10,2,"Raze,Brimstone,Skye,Chamber,Gekko","Raze,Viper,Brimstone,Fade,Gekko"
Sunset,Koopa Troopas,Tiny Turtle Squad,9,13,5,7,6,4,"Breach,Raze,Cypher,Omen,Fade","Breach,Raze,Cypher,Omen,Gekko"
Split,Xu Gang,Wolf Pack (OCE),13,3,9,3,0,4,"Breach,Raze,Cypher,Omen,Deadlock","Phoenix,Skye,Yoru,Chamber,Clove"
Lotus,Xu Gang,Wolf Pack (OCE),13,8,5,4,4,8,"Raze,Sova,Killjoy,Omen,KAY/O","Breach,Raze,Killjoy,Viper,Omen"
Lotus,Koopa Troopas,Tiny Turtle Squad,9,13,5,5,8,4,"Raze,Cypher,Omen,KAY/O,Fade","Viper,Omen,Chamber,Neon,Gekko"
Bind,We ARE PARTY CODE,Imperial Titans,13,9,5,7,2,8,"Breach,Raze,Brimstone,Yoru,Gekko","Raze,Viper,Brimstone,Jett,Skye"
Split,Demigods At UCSD,Ball State,8,13,2,7,6,6,"Breach,Raze,Cypher,Skye,Clove","Raze,Cypher,Viper,Omen,Skye"
Icebox,We ARE PARTY CODE,Imperial Titans,13,3,9,3,0,4,"Sova,Killjoy,Viper,Reyna,Clove","Sova,Killjoy,Viper,Jett,Gekko"
Lotus,Demigods At UCSD,Ball State,13,5,8,4,1,5,"Breach,Raze,Omen,Jett,Skye","Raze,Killjoy,Viper,Omen,Skye"
Lotus,Imperial Titans,LazerrFreeks8,15,13,11,3,10,4,"Raze,Killjoy,Viper,Omen,Fade","Raze,Killjoy,Omen,Fade,Gekko"
Icebox,Demigods At UCSD,Ball State,9,13,6,6,7,3,"Sova,Killjoy,Viper,Sage,Jett","Killjoy,Viper,Sage,Reyna,Gekko"
Sunset,100 Thieves,G2 Esports,13,8,5,4,4,8,"Raze,Cypher,Sova,Omen,Gekko","Breach,Raze,Cypher,Omen,Gekko"
Lotus,We ARE PARTY CODE,Fractal Gaming,13,6,3,4,2,10,"Raze,Killjoy,Omen,Yoru,Gekko","Raze,Killjoy,Viper,Omen,Fade"
Icebox,VZN E-SPORTS,Imperial Titans,7,13,4,4,9,3,"Killjoy,Viper,Jett,KAY/O,Gekko","Sova,Killjoy,Viper,Jett,Gekko"
Breeze,100 Thieves,G2 Esports,13,7,7,1,6,6,"Cypher,Sova,Viper,Jett,KAY/O","Cypher,Sova,Viper,Yoru,Astra"
Lotus,We ARE PARTY CODE,92' Dream Team,13,4,10,2,2,3,"Raze,Killjoy,Omen,Yoru,Gekko","Breach,Raze,Cypher,Omen,Gekko"
Bind,Columbia College,TMU Blue,11,13,6,6,7,5,"Raze,Cypher,Viper,Brimstone,Skye","Breach,Raze,Cypher,Brimstone,Skye"
Lotus,Twisted Minds Esports,The Ultimates,13,6,6,1,5,7,"Breach,Raze,Killjoy,Omen,Gekko","Breach,Cypher,Sova,Omen,Neon"
Ascent,St. Clair Saints,SJSU Blue,12,14,3,10,4,9,"Sova,Killjoy,Omen,Jett,KAY/O","Sova,Killjoy,Omen,Jett,KAY/O"
Ascent,SFU Pink,UST Esports,9,13,7,5,8,2,"Sova,Killjoy,Sage,Omen,Jett","Sova,Killjoy,Omen,Jett,KAY/O"
Lotus,LazerrFreeks8,UTC Valorant,13,8,8,1,7,5,"Raze,Killjoy,Omen,Fade,Gekko","Raze,Killjoy,Viper,Omen,Skye"
Icebox,Prospects Amethyst,VZN E-SPORTS,12,14,5,8,6,7,"Killjoy,Sage,KAY/O,Harbor,Gekko","Killjoy,Viper,Jett,KAY/O,Gekko"
Icebox,Team Falcons,Dragons Esports,10,13,5,6,7,5,"Sova,Killjoy,Viper,Jett,Gekko","Sova,Killjoy,Viper,Sage,Omen"
Breeze,Fractal Gaming,Lionheart eSports,13,9,6,6,3,7,"Cypher,Sova,Viper,Jett,Yoru","Cypher,Sova,Viper,Jett,Yoru"
Lotus,St. Clair Saints,SJSU Blue,13,3,4,0,3,9,"Raze,Cypher,Viper,Omen,Skye","Raze,Killjoy,Omen,Jett,Skye"
Ascent,Monsters Uni,We ARE PARTY CODE,7,13,4,8,5,3,"Cypher,Sova,Omen,Jett,KAY/O","Sova,Killjoy,Yoru,KAY/O,Clove"
Ascent,Winthrop University,Blinn Esports,10,13,5,6,7,5,"Sova,Killjoy,Omen,Jett,KAY/O","Sova,Killjoy,Omen,Jett,KAY/O"
Icebox,University of Virginia,LG Orange,13,11,7,5,6,6,"Sova,Killjoy,Viper,Sage,Jett","Sova,Killjoy,Viper,Jett,Harbor"
Bind,TAMU Maroon,CSUF Orange,13,8,8,4,4,5,"Raze,Viper,Brimstone,Skye,Deadlock","Raze,Viper,Brimstone,Reyna,Skye"
Split,Columbia College,TMU Blue,10,13,3,8,5,7,"Raze,Cypher,Omen,Jett,Skye","Breach,Raze,Cypher,Omen,Skye"
Bind,100 Thieves,G2 Esports,13,9,4,8,1,9,"Raze,Viper,Brimstone,Fade,Gekko","Raze,Viper,Brimstone,Skye,Gekko"
Split,SFU Pink,UST Esports,7,13,6,6,7,1,"Raze,Cypher,Jett,Skye,Astra","Breach,Raze,Sage,Omen,Skye"
Sunset,Twisted Minds Esports,The Ultimates,16,14,9,6,8,7,"Raze,Cypher,Omen,KAY/O,Gekko","Breach,Raze,Cypher,Omen,Gekko"
Sunset,Team Falcons,Dragons Esports,4,13,0,5,8,4,"Breach,Raze,Cypher,Omen,Fade","Raze,Cypher,Viper,Omen,Fade"
Ascent,Shinjitsu,Fractal Gaming,2,13,2,10,3,0,"Sova,Killjoy,Omen,Jett,KAY/O","Sova,Killjoy,Omen,Jett,KAY/O"
Breeze,Bean Bois,UTC Valorant,0,13,0,12,1,0,"Raze,Phoenix,Jett,Neon,Fade","Cypher,Sova,Jett,KAY/O,Harbor"
Lotus,Comet Esports Club,92' Dream Team,6,13,5,7,6,1,"Raze,Killjoy,Viper,Omen,Fade","Breach,Raze,Cypher,Omen,Gekko"
Sunset,Columbia College,TMU Blue,13,6,5,2,4,8,"Breach,Raze,Cypher,Sova,Omen","Breach,Raze,Cypher,Sova,Omen"
Bind,St. Clair Saints,SJSU Blue,11,13,5,7,6,6,"Raze,Viper,Brimstone,Skye,Deadlock","Raze,Cypher,Brimstone,Reyna,Skye"
Icebox,We Dig Holes,Imperial Titans,7,13,4,8,5,3,"Killjoy,Omen,Jett,KAY/O,Gekko","Sova,Killjoy,Viper,Jett,Gekko"
Bind,Psychopomp,Lionheart eSports,1,13,1,11,2,0,"Raze,Viper,Brimstone,Skye,Gekko","Raze,Viper,Brimstone,Skye,Yoru"
Lotus,University of Virginia,LG Orange,13,10,7,5,5,6,"Raze,Killjoy,Viper,Omen,Fade","Raze,Killjoy,Viper,Omen,Fade"
Lotus,SFU Pink,UST Esports,13,8,9,3,5,4,"Breach,Raze,Killjoy,Omen,Gekko","Breach,Raze,Killjoy,Omen,Gekko"
Split,TAMU Maroon,CSUF Orange,13,9,8,2,7,5,"Raze,Cypher,Viper,Omen,Skye","Raze,Viper,Jett,Skye,Astra"
Icebox,Winthrop University,Blinn Esports,8,13,7,5,8,1,"Sova,Killjoy,Viper,Reyna,Jett","Sova,Killjoy,Viper,Jett,Harbor"
Breeze,Team Heretics,FNATIC,8,13,4,8,5,4,"Cypher,Sova,Viper,Yoru,KAY/O","Cypher,Sova,Viper,Yoru,KAY/O"
Split,Team Falcons,Dragons Esports,13,4,9,3,1,4,"Breach,Raze,Cypher,Omen,Skye","Raze,Cypher,Viper,Omen,Skye"
Lotus,The Vicious,Twisted Minds Esports,13,6,7,0,6,6,"Raze,Killjoy,Omen,Jett,Skye","Breach,Raze,Killjoy,Omen,Gekko"
Breeze,The Vicious,Twisted Minds Esports,7,13,3,9,4,4,"Cypher,Sova,Viper,Reyna,Jett","Cypher,Sova,Viper,Jett,Yoru"
Bind,whats a pretzel,SaD Purple,8,13,5,7,6,3,"Raze,Viper,Brimstone,Reyna,Skye","Raze,Cypher,Viper,Brimstone,Skye"
Split,Team Heretics,FNATIC,5,13,0,6,7,5,"Raze,Cypher,Viper,Omen,Skye","Breach,Raze,Cypher,Omen,Yoru"
Ascent,Underground Gaming,KR Esports,15,13,4,10,3,11,"Sova,Killjoy,Omen,Jett,KAY/O","Breach,Sova,Killjoy,Omen,Jett"
Lotus,G3 Esports,The Ultimates,6,13,1,6,7,5,"Breach,Raze,Cypher,Sova,Omen","Breach,Cypher,Sova,Omen,Neon"
Breeze,TBS GC,sou proplayer lixo?,15,17,8,8,9,7,"Cypher,Sova,Yoru,Astra,Harbor","Cypher,Sova,Viper,Jett,KAY/O"
Icebox,The Vicious,Twisted Minds Esports,13,9,5,7,2,8,"Sova,Killjoy,Viper,Sage,Jett","Killjoy,Viper,Jett,KAY/O,Gekko"
Breeze,Underground Gaming,KR Esports,13,6,6,1,5,7,"Cypher,Sova,Viper,Jett,Yoru","Cypher,Sova,Viper,Jett,Yoru"
Breeze,whats a pretzel,SaD Purple,15,13,11,3,10,4,"Cypher,Sova,Viper,Jett,Yoru","Cypher,Sova,Viper,Jett,Yoru"
Ascent,G3 Esports,The Ultimates,0,13,0,12,1,0,"Breach,Sova,Jett,Astra,KAY/O","Sova,Killjoy,Omen,Jett,KAY/O"
Lotus,Team Heretics,FNATIC,8,13,7,5,8,1,"Breach,Raze,Cypher,Omen,Fade","Raze,Killjoy,Viper,Omen,Fade"
Split,whats a pretzel,SaD Purple,1,13,1,11,2,0,"Raze,Cypher,Viper,Omen,Skye","Raze,Cypher,Viper,Omen,Skye"
Icebox,TBS GC,sou proplayer lixo?,7,13,6,6,7,1,"Sova,Killjoy,Jett,Harbor,Gekko","Sova,Killjoy,Viper,Jett,KAY/O"
Split,TBS GC,sou proplayer lixo?,9,13,5,7,6,4,"Raze,Killjoy,Omen,Jett,Skye","Breach,Raze,Cypher,Omen,Skye"
Bind,Team Heretics,FNATIC,15,13,8,6,7,7,"Sova,Viper,Omen,Skye,Yoru","Raze,Viper,Brimstone,Skye,Gekko"
Sunset,Team Heretics,FNATIC,13,7,5,3,4,8,"Cypher,Sova,Omen,KAY/O,Neon","Breach,Sova,Omen,Yoru,Deadlock"
Sunset,Team 69,The Zoo  (IN),11,13,6,6,7,5,"Raze,Cypher,Omen,Jett,Gekko","Raze,Cypher,Sova,Reyna,Omen"
Lotus,S4,Mercurialz Esport,19,17,9,9,8,10,"Raze,Killjoy,Omen,Fade,Gekko","Raze,Killjoy,Viper,Omen,Gekko"
Lotus,Team 69,The Zoo  (IN),13,10,9,3,7,4,"Raze,Killjoy,Reyna,Omen,Gekko","Raze,Sova,Omen,Chamber,Harbor"
Sunset,Alternate Realities,Resonance,15,13,9,5,8,6,"Raze,Cypher,Omen,KAY/O,Gekko","Breach,Raze,Cypher,Omen,Fade"
Bind,Black Swan,Altair Esports,13,10,8,4,6,5,"Raze,Viper,Brimstone,Skye,Gekko","Raze,Viper,Brimstone,Skye,Gekko"
Breeze,KaiJyu,REBORN X2,13,7,6,2,5,7,"Cypher,Sova,Viper,Jett,Astra","Cypher,Sova,Viper,Jett,KAY/O"
Icebox,Da Feng Gou,yuanyoyin,13,9,8,2,7,5,"Killjoy,Viper,Sage,Jett,Gekko","Sova,Killjoy,Viper,Jett,Gekko"
Lotus,Alternate Realities,Resonance,13,5,5,1,4,8,"Raze,Killjoy,Viper,Omen,Fade","Raze,Killjoy,Viper,Omen,Fade"
Bind,Team 69,The Zoo  (IN),13,15,5,9,6,8,"Raze,Cypher,Brimstone,Reyna,Skye","Raze,Brimstone,Skye,Chamber,Gekko"
Lotus,The Infinity Esports,PIPPU,13,3,3,1,2,10,"Raze,Killjoy,Viper,Omen,Fade","Raze,Killjoy,Viper,Omen,Fade"
Bind,Aricat e-Sport,THAOteamwork,13,9,8,2,7,5,"Raze,Cypher,Viper,Brimstone,Skye","Breach,Raze,Viper,Brimstone,Skye"
Icebox, RomChomPoo,Exist Esports,13,4,4,1,3,9,"Sova,Killjoy,Viper,Jett,Harbor","Sova,Killjoy,Viper,Jett,KAY/O"
Split,Paper Rex,Gen.G Esports,13,8,5,7,1,8,"Raze,Viper,Omen,Jett,Skye","Raze,Viper,Omen,Jett,Skye"
Bind,Da Feng Gou,yuanyoyin,13,8,5,4,4,8,"Raze,Cypher,Viper,Omen,Gekko","Raze,Cypher,Viper,Brimstone,Skye"
Icebox,Asterisk (IN),The Zoo  (IN),6,13,2,5,8,4,"Sova,Killjoy,Viper,Jett,Harbor","Sova,Killjoy,Viper,Jett,Harbor"
Lotus,Resonance,UsualSuspects,13,4,10,2,2,3,"Raze,Killjoy,Viper,Omen,Fade","Raze,Killjoy,Viper,Omen,Fade"
Bind,Paper Rex,Gen.G Esports,9,13,6,6,7,3,"Raze,Brimstone,Skye,Harbor,Gekko","Raze,Cypher,Viper,Brimstone,Skye"
Ascent,Da Feng Gou,yuanyoyin,5,13,2,10,3,3,"Sova,Killjoy,Omen,Jett,KAY/O","Sova,Killjoy,Omen,Jett,KAY/O"
Lotus,Team 69,Bible Believers,13,9,6,6,3,7,"Raze,Killjoy,Reyna,Omen,Gekko","Breach,Raze,Omen,Jett,Skye"
Ascent,Asterisk (IN),The Zoo  (IN),13,5,5,1,4,8,"Sova,Killjoy,Omen,Jett,KAY/O","Sova,Killjoy,Omen,Jett,KAY/O"
Split,Resonance,UsualSuspects,13,7,6,6,1,7,"Raze,Cypher,Omen,Jett,Skye","Raze,Cypher,Viper,Omen,Skye"
Bind,Nuclear GC,PIXEL (KR),12,14,6,7,7,6,"Raze,Killjoy,Brimstone,Jett,Skye","Raze,Viper,Phoenix,Omen,Fade"
Ascent,Team 69,Bible Believers,13,7,6,6,1,7,"Raze,Cypher,Sova,Omen,Jett","Breach,Sova,Killjoy,Omen,Jett"
Icebox,Paper Rex,Gen.G Esports,13,11,7,5,6,6,"Killjoy,Viper,Sage,Jett,KAY/O","Killjoy,Viper,Jett,KAY/O,Gekko"
Lotus,Asterisk (IN),The Zoo  (IN),7,13,2,6,7,5,"Raze,Killjoy,Viper,Omen,Fade","Breach,Raze,Killjoy,Omen,Gekko"
Ascent,Special TiGers GC,으랏차차,14,12,6,7,5,8,"Sova,Killjoy,Omen,Jett,KAY/O","Sova,Killjoy,Omen,Jett,KAY/O"
Sunset,Paper Rex,Gen.G Esports,13,9,6,4,5,7,"Breach,Raze,Sage,Omen,Gekko","Cypher,Sova,Omen,Jett,KAY/O"
Sunset,Nuclear GC,PIXEL (KR),14,12,6,7,5,8,"Raze,Sova,Killjoy,Phoenix,Omen","Breach,Raze,Cypher,Omen,Gekko"
Icebox,Special TiGers GC,으랏차차,13,11,5,7,4,8,"Sova,Killjoy,Viper,Jett,Gekko","Sova,Viper,Jett,Yoru,Chamber"
Ascent,Nuclear GC,PIXEL (KR),7,13,4,8,5,3,"Sova,Killjoy,Omen,Jett,KAY/O","Sova,Killjoy,Omen,Jett,KAY/O"
Lotus,Paper Rex,Gen.G Esports,9,13,6,6,7,3,"Breach,Raze,Omen,Jett,Skye","Raze,Killjoy,Viper,Omen,Fade"
Sunset,Special TiGers GC,으랏차차,5,13,0,6,7,5,"Cypher,Sova,Phoenix,Omen,KAY/O","Raze,Cypher,Phoenix,Omen,Fade"
Lotus,Kazoku Esports,Doa Ibu Selamanya,1,13,1,11,2,0,"Raze,Killjoy,Viper,Omen,Fade","Raze,Viper,Omen,Skye,Chamber"
Bind,WGD,PIXEL (KR),7,13,2,6,7,5,"Raze,Cypher,Brimstone,Skye,Gekko","Raze,Viper,Phoenix,Omen,Fade"
Bind,OverQuality GC,Nuclear GC,11,13,4,8,5,7,"Raze,Cypher,Brimstone,Reyna,Gekko","Breach,Cypher,Brimstone,Jett,Gekko"
Icebox,FOS,Special TiGers GC,4,13,1,4,9,3,"Sova,Killjoy,Viper,Jett,Gekko","Sova,Killjoy,Viper,Jett,Gekko"
Sunset,Kazoku Esports,Doa Ibu Selamanya,5,13,4,8,5,1,"Raze,Cypher,Omen,KAY/O,Gekko","Cypher,Sage,Omen,Yoru,Gekko"
Bind,FLC,으랏차차,4,13,2,3,10,2,"Raze,Cypher,Brimstone,Skye,Gekko","Raze,Cypher,Skye,Astra,Deadlock"
Lotus,WGD,PIXEL (KR),1,13,1,11,2,0,"Raze,Killjoy,Omen,Fade,Gekko","Raze,Killjoy,Viper,Omen,Fade"
Sunset,FOS,Special TiGers GC,2,13,1,11,2,1,"Raze,Cypher,Sova,Omen,Gekko","Cypher,Sova,Phoenix,Omen,KAY/O"
Ascent,OverQuality GC,Nuclear GC,2,13,0,3,10,2,"Sova,Killjoy,Phoenix,Omen,Jett","Sova,Killjoy,Omen,Jett,KAY/O"
Ascent,FLC,으랏차차,2,13,2,10,3,0,"Sova,Killjoy,Omen,Jett,KAY/O","Sova,Killjoy,Omen,Jett,KAY/O"
Bind,SaD Purple,Katsumi Fan Club,13,9,5,7,2,8,"Raze,Cypher,Viper,Brimstone,Skye","Raze,Cypher,Brimstone,Reyna,Skye"
Bind,SaD Purple,L9,13,9,5,7,2,8,"Raze,Cypher,Viper,Brimstone,Skye","Raze,Cypher,Brimstone,Reyna,Skye"
Bind,Cosmic Divide,whats a pretzel,9,13,6,4,9,3,"Raze,Viper,Brimstone,Skye,Yoru","Raze,Viper,Brimstone,Jett,Skye"
Bind,Zero MarksMen Black,L9,12,14,5,8,6,7,"Breach,Viper,Phoenix,Brimstone,KAY/O","Breach,Raze,Cypher,Sova,Brimstone"
Bind,NoVice,Special TiGers GC,5,13,2,10,3,3,"Raze,Cypher,Viper,Brimstone,Skye","Raze,Jett,Skye,Astra,Gekko"
Ascent,Resilience,PIXEL (KR),11,13,4,8,5,7,"Breach,Sova,Killjoy,Omen,Jett","Sova,Killjoy,Omen,Jett,KAY/O"
Breeze,SaD Purple,L9,13,2,10,2,0,3,"Cypher,Sova,Viper,Jett,Yoru","Cypher,Sova,Viper,Jett,Yoru"
Breeze,SaD Purple,Katsumi Fan Club,13,2,10,2,0,3,"Cypher,Sova,Viper,Jett,Yoru","Cypher,Sova,Viper,Jett,Yoru"
Ascent,으랏차차,High Impact,13,10,7,5,5,6,"Sova,Killjoy,Omen,Jett,KAY/O","Sova,Killjoy,Omen,Jett,KAY/O"
Lotus,Cosmic Divide,whats a pretzel,7,13,2,10,3,5,"Breach,Raze,Killjoy,Omen,Gekko","Raze,Killjoy,Omen,Jett,Skye"
Bind,Dogo Fanclub,OC Eagles,13,1,2,0,1,11,"Raze,Viper,Brimstone,Skye,Gekko","Raze,Cypher,Viper,Brimstone,Skye"
Icebox,NoVice,Special TiGers GC,3,13,1,11,2,2,"Sova,Killjoy,Viper,Reyna,Jett","Sova,Killjoy,Viper,Jett,Gekko"
Ascent,Zero MarksMen Black,L9,13,15,9,5,10,4,"Sova,Killjoy,Omen,Jett,KAY/O","Sova,Killjoy,Omen,Jett,KAY/O"
Bind,으랏차차,High Impact,13,3,3,1,2,10,"Raze,Cypher,Skye,Astra,Deadlock","Raze,Brimstone,Reyna,Skye,Gekko"
Lotus,Resilience,PIXEL (KR),10,13,6,5,8,4,"Breach,Raze,Killjoy,Omen,Gekko","Raze,Killjoy,Viper,Omen,Fade"
Lotus,Dogo Fanclub,OC Eagles,13,2,10,2,0,3,"Raze,Killjoy,Omen,Fade,Gekko","Raze,Killjoy,Viper,Omen,Gekko"
Icebox,SaD Purple,Katsumi Fan Club,9,13,7,5,8,2,"Sova,Killjoy,Viper,Jett,Harbor","Sova,Killjoy,Viper,Jett,Gekko"
Lotus,YDZ Esports,Cosmic Divide,12,14,7,6,8,5,"Breach,Raze,Killjoy,Omen,Fade","Breach,Raze,Killjoy,Omen,Gekko"
Sunset,Zero MarksMen Black,L9,14,12,11,2,10,3,"Breach,Raze,Cypher,Omen,Gekko","Breach,Raze,Cypher,Sova,Clove"
Bind,SaD Purple,Nightblood Gaming,13,8,8,1,7,5,"Raze,Cypher,Viper,Brimstone,Skye","Raze,Viper,Omen,Skye,Gekko"
Ascent,OC Eagles,1Millisecond,13,8,5,4,4,8,"Sova,Killjoy,Omen,Jett,KAY/O","Sova,Killjoy,Omen,Jett,KAY/O"
Ascent,YDZ Esports,Cosmic Divide,8,13,6,6,7,2,"Sova,Killjoy,Omen,Jett,KAY/O","Sova,Killjoy,Omen,Jett,KAY/O"
Split,Concordia University,uOttawa Garnet,13,11,3,9,2,10,"Breach,Raze,Cypher,Omen,Gekko","Breach,Raze,Cypher,Skye,Clove"
Ascent,L9,Mindcontrol,13,8,8,4,4,5,"Sova,Killjoy,Omen,Jett,KAY/O","Sova,Killjoy,Omen,Jett,KAY/O"
Ascent,G2 Esports,Leviatán,13,11,5,7,4,8,"Sova,Killjoy,Omen,Jett,KAY/O","Sova,Killjoy,Omen,Jett,KAY/O"
Ascent,Zero MarksMen Black,Sexy Gang,13,7,9,3,4,4,"Sova,Killjoy,Omen,Jett,KAY/O","Sova,Killjoy,Omen,Jett,KAY/O"
Ascent,Katsumi Fan Club,Be Like Matt,13,2,3,0,2,10,"Sova,Killjoy,Omen,Jett,KAY/O","Sova,Killjoy,Omen,Jett,KAY/O"
Breeze,L9,Mindcontrol,13,2,1,2,0,12,"Cypher,Sova,Viper,Jett,KAY/O","Cypher,Sova,Viper,Jett,KAY/O"
Split,YDZ Esports,Cosmic Divide,13,9,4,6,3,9,"Raze,Cypher,Omen,Jett,Skye","Breach,Raze,Viper,Omen,Skye"
Icebox,OC Eagles,1Millisecond,11,13,8,4,9,3,"Sova,Killjoy,Viper,Sage,Jett","Killjoy,Viper,Jett,KAY/O,Gekko"
Bind,Concordia University,uOttawa Garnet,13,9,4,6,3,9,"Raze,Cypher,Brimstone,Jett,Skye","Raze,Viper,Brimstone,Skye,Gekko"
Icebox,Zero MarksMen Black,Sexy Gang,13,9,6,6,3,7,"Sova,Killjoy,Viper,Reyna,Jett","Sova,Killjoy,Viper,Jett,KAY/O"
Split,SFU Pink,SFU Raccoons,13,10,7,5,5,6,"Raze,Cypher,Skye,Neon,Clove","Raze,Cypher,Viper,Omen,Gekko"
Ascent,SaD Purple,Nightblood Gaming,15,13,8,6,7,7,"Cypher,Sova,Omen,Jett,KAY/O","Sova,Killjoy,Omen,Jett,KAY/O"
Lotus,lost passion,whats a pretzel,7,13,3,9,4,4,"Raze,Killjoy,Viper,Omen,Gekko","Raze,Killjoy,Omen,Jett,Skye"
Breeze,Katsumi Fan Club,Be Like Matt,13,8,4,5,3,9,"Cypher,Sova,Viper,Jett,Yoru","Cypher,Sova,Viper,Reyna,Jett"
Lotus,G2 Esports,Leviatán,13,10,8,4,6,5,"Raze,Killjoy,Viper,Omen,Fade","Raze,Killjoy,Viper,Omen,Fade"
Bind,OC Eagles,1Millisecond,13,6,10,2,4,3,"Raze,Cypher,Viper,Brimstone,Skye","Raze,Viper,Brimstone,Skye,Gekko"
Bind,Dogo Fanclub,Frosted Flakes,13,6,6,1,5,7,"Raze,Viper,Brimstone,Skye,Gekko","Raze,Viper,Brimstone,Reyna,Skye"
Split,UCF Gold,Cosmic Divide,5,13,1,5,8,4,"Raze,Cypher,Viper,Omen,Skye","Breach,Raze,Viper,Omen,Skye"
Bind,SFU Pink,SFU Raccoons,13,4,4,1,3,9,"Raze,Viper,Brimstone,Jett,Gekko","Raze,Viper,Brimstone,Skye,Gekko"
Icebox,L9,LazerrFreeks Mythic,13,9,6,4,5,7,"Sova,Killjoy,Viper,Reyna,Jett","Sova,Killjoy,Viper,Jett,Harbor"
Breeze,Concordia University,uOttawa Garnet,13,15,4,10,5,9,"Cypher,Sova,Viper,Jett,KAY/O","Cypher,Sova,Viper,Jett,Yoru"
Sunset,Zero MarksMen Black,Van Lyn,13,9,7,3,6,6,"Breach,Raze,Cypher,Omen,Gekko","Breach,Raze,Cypher,Sova,Omen"
Breeze,lost passion,whats a pretzel,13,15,4,10,5,9,"Cypher,Sova,Viper,Jett,KAY/O","Cypher,Sova,Viper,Jett,Yoru"
Ascent,Dogo Fanclub,Frosted Flakes,13,5,9,3,2,4,"Sova,Killjoy,Omen,Jett,KAY/O","Sova,Killjoy,Reyna,Omen,Jett"
Ascent,1Millisecond,Edamotic Fall,13,5,9,3,2,4,"Sova,Killjoy,Omen,Jett,KAY/O","Sova,Killjoy,Omen,Jett,KAY/O"
Icebox,G2 Esports,Leviatán,12,14,6,7,7,6,"Sova,Killjoy,Viper,Harbor,Gekko","Sova,Killjoy,Viper,Jett,Harbor"
Bind,ROSE,Nightblood Gaming,12,14,6,7,7,6,"Raze,Cypher,Reyna,Skye,Clove","Raze,Viper,Omen,Skye,Gekko"
Ascent,Be Like Matt,The GRID,17,15,7,9,6,10,"Sova,Killjoy,Omen,Jett,KAY/O","Sova,Killjoy,Phoenix,Omen,Jett"
Ascent,YDZ Esports,Nearest Airport,13,10,4,7,3,9,"Sova,Killjoy,Omen,Jett,KAY/O","Sova,Killjoy,Omen,Jett,KAY/O"
Ascent,UCF Gold,Cosmic Divide,10,13,6,5,8,4,"Sova,Killjoy,Omen,Jett,KAY/O","Sova,Killjoy,Omen,Jett,KAY/O"
Lotus,L9,LazerrFreeks Mythic,9,13,3,7,6,6,"Raze,Sova,Killjoy,Viper,Omen","Raze,Killjoy,Viper,Omen,Fade"
Lotus,SFU Raccoons,Carleton University JV Black,13,7,10,2,5,3,"Breach,Raze,Omen,Chamber,Gekko","Raze,Killjoy,Viper,Omen,Gekko"
Bind,The Pig Pen,Katsumi Fan Club,4,13,1,4,9,3,"Raze,Viper,Brimstone,Skye,Gekko","Raze,Cypher,Brimstone,Reyna,Skye"
Split,Concordia University,Fanshawe FUEL,13,4,8,4,0,5,"Breach,Raze,Cypher,Omen,Gekko","Breach,Raze,Cypher,Omen,Deadlock"
Lotus,1337 (NA),Sexy Gang,10,13,7,5,8,3,"Raze,Killjoy,Viper,Omen,Fade","Raze,Killjoy,Viper,Omen,KAY/O"
Ascent,OC Eagles,Area of Effect,14,12,8,5,7,6,"Sova,Killjoy,Omen,Jett,KAY/O","Sova,Killjoy,Omen,Jett,KAY/O"
Lotus,uOttawa Garnet,UBC Black,13,8,7,2,6,6,"Raze,Killjoy,Omen,Fade,Gekko","Raze,Killjoy,Omen,Fade,Gekko"
Ascent,SFU Pink,Conestoga Condors,13,4,4,1,3,9,"Sova,Killjoy,Sage,Omen,Jett","Sova,Killjoy,Omen,Jett,KAY/O"
Lotus,Dogo Fanclub,Orangutan Gang,13,5,9,3,2,4,"Raze,Killjoy,Omen,Fade,Gekko","Raze,Killjoy,Viper,Omen,Jett"
Ascent,Zero MarksMen Black,Van Lyn,14,12,6,7,5,8,"Sova,Killjoy,Omen,Jett,KAY/O","Sova,Killjoy,Omen,Jett,KAY/O"
Breeze,SaD Purple,NOTILT,13,8,8,4,4,5,"Cypher,Sova,Viper,Reyna,Jett","Cypher,Sova,Viper,Reyna,Jett"
Split,Be Like Matt,The GRID,8,13,3,6,7,5,"Raze,Viper,Jett,Skye,Astra","Breach,Raze,Cypher,Gekko,Clove"
Lotus,whats a pretzel,puchan fan club,13,7,5,3,4,8,"Raze,Viper,Omen,Fade,Deadlock","Breach,Raze,Killjoy,Omen,Gekko"
Icebox,1Millisecond,Edamotic Fall,11,13,8,4,9,3,"Killjoy,Viper,Jett,KAY/O,Gekko","Killjoy,Viper,Jett,KAY/O,Deadlock"
Icebox,Goth Girl Sanctuary,lost passion,2,13,0,3,10,2,"Killjoy,Viper,Jett,Gekko,Clove","Sova,Killjoy,Viper,Jett,Harbor"
Sunset,YDZ Esports,Nearest Airport,13,4,3,2,2,10,"Breach,Raze,Cypher,Sova,Omen","Raze,Cypher,Omen,KAY/O,Gekko"
Icebox,ROSE,Nightblood Gaming,11,13,6,6,7,5,"Sova,Killjoy,Viper,Reyna,Jett","Sova,Killjoy,Viper,Jett,KAY/O"
Split,overcook,Frosted Flakes,2,13,0,3,10,2,"Breach,Raze,Cypher,Omen,Skye","Raze,Cypher,Reyna,Skye,Clove"
Lotus,UCF Gold,Cosmic Divide,13,11,8,4,7,5,"Raze,Killjoy,Viper,Omen,Fade","Raze,Killjoy,Omen,Fade,Gekko"
Ascent,Dogo Fanclub,Orangutan Gang,13,4,8,4,0,5,"Sova,Killjoy,Omen,Jett,KAY/O","Sova,Killjoy,Omen,Jett,KAY/O"
Sunset,L9,LazerrFreeks Mythic,13,11,7,5,6,6,"Breach,Raze,Cypher,Sova,Clove","Breach,Raze,Cypher,Omen,Fade"
Ascent,1337 (NA),Sexy Gang,11,13,9,3,10,2,"Sova,Killjoy,Omen,Jett,KAY/O","Sova,Killjoy,Omen,Jett,KAY/O"
Icebox,Zero MarksMen Black,Van Lyn,5,13,0,6,7,5,"Sova,Killjoy,Viper,Reyna,Jett","Sova,Killjoy,Viper,Jett,KAY/O"
Lotus,Be Like Matt,The GRID,13,11,6,6,5,7,"Raze,Killjoy,Viper,Omen,Skye","Raze,Killjoy,Reyna,Omen,Gekko"
Breeze,G2 Esports,Leviatán,13,7,4,4,3,9,"Cypher,Sova,Viper,Yoru,Astra","Cypher,Sova,Viper,Jett,KAY/O"
Lotus,OC Eagles,Area of Effect,13,10,6,6,4,7,"Raze,Killjoy,Viper,Omen,Gekko","Raze,Killjoy,Omen,Jett,Skye"
Split,whats a pretzel,puchan fan club,13,4,3,2,2,10,"Raze,Cypher,Viper,Omen,Skye","Raze,Cypher,Omen,Skye,Harbor"
Bind,1Millisecond,Edamotic Fall,13,7,7,1,6,6,"Raze,Viper,Brimstone,Skye,Gekko","Raze,Viper,Brimstone,Skye,Gekko"
Ascent,The Pig Pen,Katsumi Fan Club,9,13,4,8,5,5,"Sova,Killjoy,Omen,Jett,KAY/O","Sova,Killjoy,Omen,Jett,KAY/O"
Breeze,Goth Girl Sanctuary,lost passion,8,13,7,2,11,1,"Cypher,Sova,Viper,Reyna,Jett","Cypher,Sova,Viper,Jett,KAY/O"
Lotus,SaD Purple,NOTILT,13,10,6,6,4,7,"Raze,Cypher,Reyna,Omen,Gekko","Breach,Raze,Omen,Chamber,Gekko"
Bind,YDZ Esports,Nearest Airport,3,13,0,4,9,3,"Breach,Raze,Cypher,Brimstone,Skye","Raze,Viper,Omen,Fade,Gekko"
Lotus,ROSE,Nightblood Gaming,13,1,2,0,1,11,"Raze,Cypher,Reyna,Omen,Gekko","Breach,Raze,Cypher,Omen,Gekko"
Lotus,overcook,Frosted Flakes,6,13,0,7,6,6,"Raze,Cypher,Omen,Fade,Gekko","Raze,Killjoy,Jett,Skye,Clove"
Lotus,Northwood University,UST Esports,5,13,4,8,5,1,"Raze,Sova,Killjoy,Omen,Clove","Breach,Raze,Killjoy,Omen,Gekko"
Icebox,Ball State,Brewton Parker College,13,10,9,3,7,4,"Killjoy,Viper,Sage,Reyna,Gekko","Sova,Killjoy,Viper,Jett,Harbor"
Lotus,Harrisburg University,CSUF Orange,9,13,7,3,10,2,"Killjoy,Viper,Omen,Neon,Gekko","Raze,Killjoy,Viper,Omen,Fade"
Lotus,TAMU Maroon,CSP Val Blue,13,6,5,2,4,8,"Raze,Killjoy,Viper,Omen,Fade","Raze,Viper,Omen,Chamber,Fade"
Lotus,Demigods At UCSD,York University Red,13,3,9,3,0,4,"Breach,Raze,Omen,Jett,Skye","Killjoy,Jett,Astra,Harbor,Gekko"
Lotus,University of Virginia,IVC Blue,13,5,6,0,5,7,"Raze,Killjoy,Viper,Omen,Fade","Raze,Killjoy,Viper,Omen,Fade"
Lotus,Ball State,Brewton Parker College,3,13,0,4,9,3,"Raze,Killjoy,Viper,Omen,Skye","Raze,Killjoy,Viper,Omen,Fade"
Sunset,UC Irvine,TMU Blue,7,13,2,6,7,5,"Raze,Cypher,Omen,KAY/O,Gekko","Breach,Raze,Cypher,Sova,Omen"
Ascent,Vision Esports,G3 Esports,13,8,7,2,6,6,"Breach,Sova,Killjoy,Omen,Jett","Breach,Sova,Jett,Astra,KAY/O"
Split,SJSU Blue,West Virginia University,13,5,8,4,1,5,"Raze,Cypher,Jett,Skye,Astra","Breach,Raze,Viper,Omen,Skye"
Bind,Northwood University,UST Esports,13,11,9,3,8,4,"Breach,Raze,Cypher,Sova,Brimstone","Raze,Viper,Brimstone,Skye,Gekko"
Bind,G2 Esports,Leviatán,12,14,6,7,7,6,"Raze,Viper,Brimstone,Skye,Gekko","Raze,Viper,Brimstone,Skye,Gekko"
Sunset,Winthrop University,SDSU Black,13,2,10,2,0,3,"Breach,Raze,Cypher,Omen,Fade","Raze,Cypher,Omen,Yoru,Gekko"
Bind,TAMU Maroon,CSP Val Blue,13,9,6,4,5,7,"Raze,Viper,Brimstone,Skye,Deadlock","Breach,Raze,Viper,Brimstone,Skye"
Icebox,Demigods At UCSD,York University Red,13,7,7,5,2,6,"Sova,Killjoy,Viper,Sage,Jett","Killjoy,KAY/O,Harbor,Gekko,Clove"
Bind,SJSU Blue,West Virginia University,13,3,10,2,1,3,"Raze,Cypher,Brimstone,Reyna,Skye","Raze,Viper,Brimstone,Skye,Yoru"
Sunset,Northwood University,UST Esports,7,13,3,5,8,4,"Breach,Cypher,Omen,Gekko,Clove","Breach,Raze,Cypher,Omen,Gekko"
Icebox,University of Virginia,IVC Blue,13,9,7,5,4,6,"Sova,Killjoy,Viper,Sage,Jett","Sova,Killjoy,Viper,Jett,Gekko"
Ascent,sou proplayer lixo?,Fourth Wall,13,11,8,4,7,5,"Sova,Killjoy,Omen,Jett,KAY/O","Sova,Killjoy,Omen,Jett,KAY/O"
Bind,UC Irvine,TMU Blue,8,13,2,10,3,6,"Raze,Cypher,Viper,Brimstone,Skye","Breach,Raze,Cypher,Brimstone,Skye"
Split,Harrisburg University,CSUF Orange,9,13,6,4,9,3,"Raze,Cypher,Viper,Omen,Skye","Raze,Viper,Jett,Skye,Astra"
Split,Ball State,Brewton Parker College,13,9,6,4,5,7,"Raze,Cypher,Viper,Omen,Skye","Raze,Cypher,Omen,Skye,Astra"
Bind,Winthrop University,SDSU Black,13,9,6,4,5,7,"Raze,Viper,Brimstone,Reyna,Skye","Raze,Cypher,Viper,Brimstone,Skye"
Bind,Vision Esports,G3 Esports,13,11,5,7,4,8,"Breach,Raze,Omen,Gekko,Deadlock","Breach,Raze,Sova,Viper,Brimstone"
Icebox,Fisher Falcons,GCU Esports,13,9,8,2,7,5,"Sova,Killjoy,Viper,Reyna,Jett","Killjoy,Viper,Sage,KAY/O,Gekko"
Breeze,sou proplayer lixo?,Fourth Wall,13,6,4,3,3,9,"Cypher,Sova,Viper,Jett,KAY/O","Cypher,Sova,Viper,Jett,KAY/O"
Ascent,Dragons Esports,Onyx Ravens,13,6,5,2,4,8,"Cypher,Sova,Omen,Jett,KAY/O","Sova,Killjoy,Omen,Jett,KAY/O"
Split,Fisher Falcons,GCU Esports,13,1,2,0,1,11,"Raze,Cypher,Viper,Omen,Skye","Raze,Viper,Omen,Jett,Skye"
Ascent,LG Orange,Indiana Hoosiers,13,8,7,5,3,6,"Sova,Killjoy,Omen,Jett,KAY/O","Sova,Killjoy,Omen,Jett,KAY/O"
Sunset,Underground Gaming,Team Falcons,8,13,4,5,8,4,"Breach,Raze,Cypher,Omen,Fade","Breach,Raze,Cypher,Omen,Fade"
Icebox,KR Esports,The Vicious,13,10,8,3,7,5,"Sova,Killjoy,Viper,Yoru,Chamber","Sova,Killjoy,Viper,Sage,Jett"
Lotus,Dragons Esports,Onyx Ravens,8,13,6,6,7,2,"Raze,Killjoy,Viper,Omen,Fade","Raze,Killjoy,Viper,Omen,Fade"
Split,FNATIC,FUT Esports,14,12,5,8,4,9,"Breach,Raze,Cypher,Omen,Yoru","Raze,Viper,Omen,Skye,Chamber"
Split,TBS GC,FURIA GC,13,4,4,1,3,9,"Raze,Killjoy,Omen,Jett,Skye","Raze,Cypher,Viper,Omen,Skye"
Breeze,Underground Gaming,Team Falcons,13,4,9,3,1,4,"Cypher,Sova,Viper,Jett,Yoru","Cypher,Sova,Viper,Yoru,KAY/O"
Lotus,LG Orange,Indiana Hoosiers,13,11,4,8,3,9,"Raze,Killjoy,Viper,Omen,Fade","Raze,Viper,Omen,Skye,Chamber"
Sunset,Dragons Esports,Onyx Ravens,13,10,7,5,5,6,"Raze,Cypher,Viper,Omen,Fade","Breach,Raze,Cypher,Omen,Fade"
Breeze,KR Esports,The Vicious,13,3,10,2,1,3,"Cypher,Sova,Viper,Jett,Yoru","Cypher,Sova,Viper,Jett,Gekko"
Split,Underground Gaming,Team Falcons,3,13,2,10,3,1,"Raze,Cypher,Sage,Omen,Skye","Breach,Raze,Cypher,Omen,Skye"
Bind,LG Orange,Indiana Hoosiers,5,13,2,4,9,3,"Raze,Cypher,Viper,Brimstone,Skye","Raze,Viper,Brimstone,Skye,Yoru"
Bind,TBS GC,FURIA GC,13,6,9,3,3,4,"Breach,Raze,Omen,Skye,Gekko","Raze,Viper,Brimstone,Skye,Gekko"
Breeze,FNATIC,FUT Esports,13,11,7,5,6,6,"Cypher,Sova,Viper,Yoru,KAY/O","Cypher,Sova,Viper,Jett,KAY/O"
Bind,Dimonis,Lotus Knights,4,13,4,8,5,0,"Raze,Cypher,Viper,Skye,Clove","Raze,Brimstone,Skye,Gekko,Clove"
Lotus,TwentyStars GC,EKO Esports GC,13,8,6,3,5,7,"Breach,Raze,Killjoy,Omen,Chamber","Breach,Raze,Killjoy,Omen,Gekko"
Lotus,TBS GC,FURIA GC,5,13,1,5,8,4,"Raze,Killjoy,Viper,Omen,Fade","Raze,Killjoy,Viper,Omen,Skye"
Bind,FNATIC,FUT Esports,13,6,7,0,6,6,"Raze,Viper,Brimstone,Skye,Gekko","Raze,Viper,Omen,KAY/O,Gekko"
Sunset,Dimonis,Lotus Knights,13,11,5,7,4,8,"Raze,Cypher,Omen,KAY/O,Gekko","Breach,Raze,Cypher,Omen,Gekko"
Ascent,TwentyStars GC,EKO Esports GC,13,8,7,2,6,6,"Sova,Killjoy,Phoenix,Omen,Jett","Cypher,Sova,Phoenix,Omen,Jett"
Icebox,FNATIC,FUT Esports,11,13,8,4,9,3,"Sova,Killjoy,Viper,Sage,Jett","Sova,Killjoy,Viper,Jett,KAY/O"
Bind,aNc Outplayed GC,HGE Esports GC,13,10,9,3,7,4,"Raze,Viper,Brimstone,Fade,Gekko","Breach,Raze,Cypher,Brimstone,Skye"
Breeze,Dimonis,Lotus Knights,14,16,6,9,7,8,"Cypher,Sova,Viper,Jett,KAY/O","Cypher,Sova,Jett,KAY/O,Harbor"
Lotus,aNc Outplayed GC,HGE Esports GC,13,10,8,4,6,5,"Breach,Raze,Killjoy,Omen,Gekko","Breach,Raze,Killjoy,Omen,Gekko"
Lotus,Da Feng Gou, ROA,12,14,6,7,7,6,"Raze,Killjoy,Viper,Omen,Fade","Raze,Killjoy,Omen,Astra,Gekko"
Lotus,Five Ace e-Sports,Team Kobolds,14,12,5,8,4,9,"Raze,Killjoy,Viper,Omen,Fade","Breach,Raze,Killjoy,Omen,Skye"
Sunset,Five Ace e-Sports,Team Kobolds,13,2,3,0,2,10,"Breach,Raze,Cypher,Sova,Omen","Breach,Cypher,Omen,Jett,KAY/O"
Sunset,Da Feng Gou, ROA,10,13,5,6,7,5,"Raze,Cypher,Phoenix,Omen,Gekko","Breach,Raze,Cypher,Sova,Omen"
Ascent,Kazoku Esports,Bigetron Arctic,6,13,2,5,8,4,"Sova,Killjoy,Omen,Jett,KAY/O","Sova,Killjoy,Omen,Jett,KAY/O"
Lotus,Kazoku Esports,Bigetron Arctic,13,10,3,8,2,10,"Raze,Killjoy,Viper,Omen,Fade","Raze,Killjoy,Viper,Omen,Fade"
Bind,T1,Gen.G Esports,9,13,5,7,6,4,"Raze,Viper,KAY/O,Harbor,Gekko","Raze,Cypher,Viper,Brimstone,Skye"
Lotus,Doa Ibu Selamanya,ARF TEAM,5,13,1,5,8,4,"Raze,Viper,Omen,Skye,Chamber","Raze,Killjoy,Viper,Omen,Skye"
Sunset,Kazoku Esports,Bigetron Arctic,9,13,5,5,8,4,"Raze,Cypher,Omen,KAY/O,Gekko","Breach,Raze,Cypher,Omen,Gekko"
Sunset,Special TiGers GC,Beyond Stratos Gaming GC,2,13,2,10,3,0,"Cypher,Sova,Phoenix,Omen,KAY/O","Cypher,Sova,Reyna,Omen,Jett"
Sunset,Doa Ibu Selamanya,ARF TEAM,3,13,3,9,4,0,"Cypher,Sage,Omen,Yoru,Gekko","Breach,Raze,Cypher,Omen,Gekko"
Icebox,T1,Gen.G Esports,11,13,4,8,5,7,"Sova,Viper,Sage,Reyna,Chamber","Killjoy,Viper,Jett,KAY/O,Gekko"
Split,Mir Gaming GC,Resilience,13,5,5,1,4,8,"Raze,Viper,Omen,Jett,Skye","Breach,Raze,Cypher,Sage,Omen"
Breeze,Special TiGers GC,Beyond Stratos Gaming GC,6,13,0,7,6,6,"Cypher,Sova,Viper,Jett,Yoru","Sova,Viper,Jett,Yoru,Astra"
Lotus,Cynical,THE HERO DETA,13,11,10,2,9,3,"Breach,Raze,Sova,Killjoy,Omen","Raze,Killjoy,Viper,Omen,Fade"
Lotus,T1,Gen.G Esports,2,13,2,10,3,0,"Breach,Raze,Omen,Skye,Neon","Raze,Killjoy,Viper,Omen,Fade"
Bind,Mir Gaming GC,Resilience,13,6,4,3,3,9,"Raze,Cypher,Viper,Brimstone,Skye","Breach,Raze,Cypher,Brimstone,Skye"
Split,OverQuality GC,Special TiGers GC,7,13,3,9,4,4,"Breach,Raze,Cypher,Omen,Jett","Raze,Cypher,Omen,Skye,Gekko"
Sunset,Cynical,THE HERO DETA,11,13,8,4,9,3,"Breach,Raze,Sage,Omen,Gekko","Breach,Raze,Cypher,Omen,Gekko"
Sunset,PIXEL (KR),Beyond Stratos Gaming GC,3,13,2,10,3,1,"Breach,Raze,Cypher,Omen,Gekko","Cypher,Sova,Reyna,Omen,Jett"
Split,5 Clown,THE HERO DETA,2,13,2,10,3,0,"Raze,Cypher,Viper,Omen,Skye","Breach,Raze,Cypher,Omen,Jett"
Split,Le Crapaud,5 Clown,13,2,3,0,2,10,"Breach,Raze,Cypher,Omen,Jett","Raze,Cypher,Viper,Omen,Skye"
Ascent,WGD,Mir Gaming GC,1,13,1,11,2,0,"Sova,Killjoy,Omen,Jett,KAY/O","Sova,Killjoy,Omen,Jett,KAY/O"
Lotus,FLC,Resilience,4,13,0,5,8,4,"Raze,Killjoy,Omen,Fade,Gekko","Breach,Raze,Killjoy,Omen,Gekko"
Icebox,OverQuality GC,Special TiGers GC,5,13,3,9,4,2,"Killjoy,Viper,Reyna,Jett,Gekko","Sova,Killjoy,Viper,Jett,Gekko"
Lotus,WGD,Mir Gaming GC,0,13,0,1,12,0,"Raze,Killjoy,Omen,Fade,Gekko","Raze,Killjoy,Viper,Omen,Fade"
Ascent,PIXEL (KR),Beyond Stratos Gaming GC,8,13,3,6,7,5,"Sova,Killjoy,Omen,Jett,KAY/O","Sova,Killjoy,Omen,Jett,KAY/O"
Ascent,Cynical,THE HERO DETA,14,12,8,5,7,6,"Sova,Viper,Omen,Jett,Skye","Sova,Killjoy,Omen,Jett,KAY/O"
Lotus,Le Crapaud,5 Clown,13,11,8,4,7,5,"Breach,Raze,Cypher,Omen,Gekko","Raze,Killjoy,Viper,Omen,Fade"
Lotus,5 Clown,THE HERO DETA,11,13,7,5,8,4,"Raze,Killjoy,Viper,Omen,Fade","Breach,Raze,Cypher,Omen,Gekko"
Ascent,FLC,Resilience,5,13,3,9,4,2,"Sova,Killjoy,Omen,Jett,KAY/O","Breach,Sova,Killjoy,Omen,Jett"
Lotus,NoVice,OverQuality GC,8,13,3,6,7,5,"Breach,Raze,Killjoy,Omen,Fade","Raze,Killjoy,Omen,Fade,Gekko"
Ascent,으랏차차,Special TiGers GC,11,13,5,7,6,6,"Sova,Killjoy,Omen,Jett,KAY/O","Sova,Killjoy,Omen,Jett,KAY/O"
Breeze,Nuclear GC,Beyond Stratos Gaming GC,5,13,3,9,4,2,"Cypher,Sova,Viper,Reyna,Jett","Sova,Viper,Jett,Yoru,Astra"
Split,Resilience,FOS,13,5,8,4,1,5,"Breach,Raze,Cypher,Sage,Omen","Cypher,Omen,Jett,Skye,Gekko"
Split,Mir Gaming GC,High Impact,13,8,5,4,4,8,"Raze,Viper,Omen,Jett,Skye","Raze,Sage,Reyna,Omen,Skye"
Sunset,Orangutan Gang,Cataclysm Gaming,13,5,4,2,3,9,"Raze,Cypher,Omen,KAY/O,Gekko","Raze,Cypher,Omen,Yoru,KAY/O"
Lotus,Nuclear GC,Beyond Stratos Gaming GC,3,13,1,11,2,2,"Breach,Raze,Omen,Jett,Gekko","Raze,Killjoy,Viper,Omen,Fade"
Ascent,Nearest Airport,Dog Team Club Org,13,8,6,6,2,7,"Sova,Killjoy,Omen,Jett,KAY/O","Sova,Killjoy,Omen,Jett,KAY/O"
Bind,NoVice,OverQuality GC,10,13,5,7,6,5,"Raze,Cypher,Viper,Brimstone,Skye","Raze,Cypher,Brimstone,Reyna,Gekko"
Bind,Mir Gaming GC,High Impact,13,3,9,3,0,4,"Raze,Cypher,Viper,Brimstone,Skye","Raze,Brimstone,Reyna,Skye,Gekko"
Sunset,으랏차차,Special TiGers GC,10,13,7,5,8,3,"Raze,Cypher,Phoenix,Omen,Fade","Cypher,Sova,Phoenix,Omen,KAY/O"
Sunset,Van Lyn,Dexterity Gaming,13,4,8,4,0,5,"Breach,Raze,Cypher,Omen,Gekko","Breach,Raze,Cypher,Sova,Omen"
Ascent,Katsumi Fan Club,Window Washers,13,7,7,5,2,6,"Sova,Killjoy,Omen,Jett,KAY/O","Sova,Killjoy,Omen,Jett,KAY/O"
Breeze,Nightblood Gaming,goose creek freaks,13,5,6,0,5,7,"Cypher,Sova,Viper,Jett,Yoru","Cypher,Sova,Viper,Jett,Yoru"
Bind,Orangutan Gang,Cataclysm Gaming,13,7,6,2,5,7,"Raze,Cypher,Brimstone,Skye,Gekko","Viper,Brimstone,Omen,KAY/O,Gekko"
Bind,DeTox,OC Eagles,7,13,3,5,8,4,"Raze,Viper,Brimstone,Skye,Gekko","Raze,Cypher,Viper,Brimstone,Skye"
Breeze,Sexy Gang,Imperium Neo,14,12,9,4,8,5,"Cypher,Sova,Viper,Jett,KAY/O","Cypher,Sova,Viper,Yoru,Harbor"
Split,Katsumi Fan Club,Window Washers,13,6,4,3,3,9,"Raze,Cypher,Jett,Skye,Astra","Breach,Raze,Omen,Skye,Deadlock"
Bind,Nearest Airport,Dog Team Club Org,13,9,8,4,5,5,"Raze,Viper,Omen,Fade,Gekko","Raze,Cypher,Brimstone,Jett,Skye"
Lotus,UCF Gold,CHURCH OF CHAEWON KIM,13,5,5,1,4,8,"Raze,Killjoy,Viper,Omen,Fade","Raze,Killjoy,Viper,Omen,Skye"
Icebox,Van Lyn,Dexterity Gaming,14,12,5,8,4,9,"Sova,Killjoy,Viper,Jett,KAY/O","Sova,Killjoy,Viper,Omen,Jett"
Icebox,Nightblood Gaming,goose creek freaks,13,11,3,9,2,10,"Sova,Killjoy,Viper,Jett,KAY/O","Sova,Killjoy,Viper,Jett,Gekko"
Icebox,Be Like Matt,Predator X Gaming,13,7,5,3,4,8,"Sova,Killjoy,Viper,Reyna,Jett","Sova,Killjoy,Viper,Jett,KAY/O"
Icebox,french goats,overcook,7,13,4,8,5,3,"Sova,Killjoy,Viper,Reyna,Clove","Sova,Killjoy,Viper,Jett,Gekko"
Lotus,Lionheart eSports,Cataclysm Gaming,9,13,7,5,8,2,"Cypher,Omen,Skye,Neon,Gekko","Breach,Raze,Killjoy,Omen,Gekko"
Lotus,Sexy Gang,Imperium Neo,13,10,7,5,5,6,"Raze,Killjoy,Viper,Omen,KAY/O","Raze,Killjoy,Viper,Omen,Fade"
Split,DeTox,OC Eagles,10,13,4,8,5,6,"Breach,Raze,Cypher,Viper,Omen","Raze,Cypher,Viper,Omen,Skye"
Ascent,BHOP Esports,Good Luck,11,13,7,5,8,4,"Sova,Killjoy,Omen,Jett,KAY/O","Sova,Killjoy,Omen,Jett,KAY/O"
Icebox,LazerrFreeks Mythic,blueming,13,7,9,3,4,4,"Sova,Killjoy,Viper,Jett,Harbor","Sova,Killjoy,Viper,Reyna,Jett"
Lotus,puchan fan club,Some Lovers of Cheese,13,3,9,3,0,4,"Breach,Raze,Killjoy,Jett,Iso","Raze,Killjoy,Omen,Fade,Gekko"
Icebox,UCF Gold,CHURCH OF CHAEWON KIM,13,11,9,3,8,4,"Sova,Killjoy,Viper,Jett,Gekko","Sova,Killjoy,Viper,Jett,Gekko"
Icebox,Goth Girl Sanctuary,Purpose Gaming,13,7,7,1,6,6,"Raze,Killjoy,Viper,Gekko,Clove","Killjoy,Viper,KAY/O,Gekko,Clove"
Lotus,Katsumi Fan Club,Area of Effect,9,13,6,6,7,3,"Raze,Killjoy,Viper,Omen,Fade","Raze,Killjoy,Omen,Jett,Skye"
Icebox,Van Lyn,YDZ Esports,9,13,6,4,9,3,"Sova,Killjoy,Viper,Jett,KAY/O","Sova,Killjoy,Viper,Reyna,Jett"
Lotus,french goats,overcook,6,13,4,8,5,2,"Raze,Killjoy,Viper,Omen,Fade","Raze,Cypher,Omen,Fade,Gekko"
Ascent,Zero MarksMen Black,Nearest Airport,13,8,5,4,4,8,"Sova,Killjoy,Omen,Jett,KAY/O","Sova,Killjoy,Omen,Jett,KAY/O"
Lotus,Dog Team Club Org,Last Chance (NA),13,10,9,2,8,4,"Killjoy,Reyna,Omen,Chamber,Fade","Breach,Raze,Cypher,Omen,Gekko"
Bind,Edmatoic Fall,DOOMSDAY,15,13,7,7,6,8,"Raze,Viper,Brimstone,Skye,Gekko","Raze,Viper,Brimstone,Skye,Deadlock"
Breeze,SaD Purple,Orangutan Gang,13,8,7,5,3,6,"Cypher,Sova,Viper,Jett,Yoru","Cypher,Sova,Viper,Reyna,Jett"
Sunset,KRÜ Esports,Leviatán,8,13,7,5,8,1,"Breach,Raze,Cypher,Omen,Gekko","Breach,Raze,Cypher,Omen,Gekko"
Ascent,Be Like Matt,Predator X Gaming,12,14,4,9,5,8,"Sova,Killjoy,Omen,Jett,KAY/O","Breach,Raze,Sova,Killjoy,Omen"
Lotus,NOTILT,Demigods At UCSD,13,11,9,3,8,4,"Breach,Raze,Omen,Chamber,Gekko","Breach,Raze,Omen,Jett,Skye"
Bind,Lionheart eSports,Cataclysm Gaming,13,7,6,2,5,7,"Cypher,Sova,Viper,Brimstone,Yoru","Viper,Brimstone,Omen,KAY/O,Gekko"
Split,BHOP Esports,Good Luck,12,14,7,6,8,5,"Raze,Cypher,Reyna,Skye,Clove","Raze,Omen,Skye,Yoru,Astra"
Sunset,Team Digital,goose creek freaks,13,15,5,9,6,8,"Breach,Raze,Cypher,Omen,Fade","Breach,Raze,Cypher,Omen,Fade"
Sunset,LazerrFreeks Mythic,blueming,13,7,9,3,4,4,"Breach,Raze,Cypher,Omen,Fade","Raze,Cypher,Reyna,Omen,Gekko"
Lotus,Goth Girl Sanctuary,Purpose Gaming,13,5,9,3,2,4,"Raze,Killjoy,Viper,Omen,Gekko","Breach,Raze,Cypher,Omen,Fade"
Ascent,puchan fan club,Some Lovers of Cheese,13,10,5,7,3,8,"Breach,Jett,KAY/O,Chamber,Clove","Sova,Killjoy,Jett,KAY/O,Clove"
Lotus,Edmatoic Fall,DOOMSDAY,4,13,1,4,9,3,"Breach,Raze,Omen,Jett,Skye","Raze,Killjoy,Viper,Omen,Fade"
Ascent,OC Eagles,Destro,13,11,9,3,8,4,"Sova,Killjoy,Omen,Jett,KAY/O","Sova,Killjoy,Omen,Jett,KAY/O"
Lotus,Window Washers,Medics,13,7,8,4,3,5,"Raze,Killjoy,Viper,Omen,Fade","Raze,Killjoy,Omen,Fade,Gekko"
Sunset,Katsumi Fan Club,Area of Effect,7,13,1,7,6,6,"Breach,Raze,Cypher,Omen,Fade","Raze,Cypher,Sova,Omen,Gekko"
Lotus,CHURCH OF CHAEWON KIM,CPU,13,7,7,1,6,6,"Raze,Killjoy,Viper,Omen,Skye","Raze,Cypher,Omen,KAY/O,Fade"
Icebox,BALLZ V3.0,Imperium Neo,16,18,8,9,9,8,"Sova,Viper,Reyna,Chamber,Gekko","Sova,Killjoy,Viper,Reyna,Jett"
Icebox,UCF Gold,1337 (NA),12,14,7,6,8,5,"Sova,Killjoy,Viper,Jett,Gekko","Sova,Killjoy,Viper,Sage,Chamber"
Sunset,Van Lyn,YDZ Esports,11,13,5,7,6,6,"Breach,Raze,Killjoy,Omen,Gekko","Breach,Raze,Cypher,Sova,Omen"
Bind,Dog Team Club Org,Last Chance (NA),10,13,4,7,6,6,"Raze,Cypher,Brimstone,Reyna,Skye","Raze,Brimstone,Skye,Harbor,Gekko"
Lotus,SaD Purple,Orangutan Gang,13,11,8,4,7,5,"Raze,Killjoy,Reyna,Omen,Gekko","Raze,Killjoy,Viper,Omen,Fade"
Lotus,SFU Pink,Fanshawe FUEL,13,9,8,4,5,5,"Breach,Raze,Killjoy,Omen,Gekko","Breach,Raze,Killjoy,Omen,Gekko"
Split,UBC Black,Conestoga Condors White,13,4,9,3,1,4,"Raze,Cypher,Viper,Omen,Skye","Raze,Cypher,Omen,Jett,Skye"
Icebox,Zero MarksMen Black,Nearest Airport,11,13,5,7,6,6,"Sova,Killjoy,Viper,Reyna,Jett","Sova,Killjoy,Viper,Jett,Harbor"
Bind,Be Like Matt,Predator X Gaming,13,9,8,2,7,5,"Raze,Cypher,Skye,Yoru,Clove","Raze,Viper,Brimstone,Skye,Gekko"
Ascent,SFU Raccoons,Université de Montréal,13,1,2,0,1,11,"Sova,Killjoy,Omen,Jett,KAY/O","Sova,Killjoy,Omen,Jett,KAY/O"
Breeze,overcook,Backyard Boys,13,9,8,4,5,5,"Cypher,Sova,Viper,Jett,KAY/O","Cypher,Sova,Viper,Jett,KAY/O"
Sunset,NOTILT,Demigods At UCSD,13,11,8,4,7,5,"Raze,Cypher,Omen,Jett,Gekko","Breach,Raze,Cypher,Omen,Gekko"
Split,Concordia University,Conestoga Condors,13,4,5,0,4,8,"Breach,Raze,Cypher,Omen,Jett","Breach,Raze,Cypher,Omen,Skye"
Sunset,Nightblood Gaming,1Millisecond,9,13,4,6,7,5,"Raze,Cypher,Omen,KAY/O,Gekko","Breach,Raze,Cypher,Omen,Fade"
Icebox,Team Digital,goose creek freaks,5,13,3,3,10,2,"Sova,Killjoy,Viper,Jett,Harbor","Sova,Killjoy,Viper,Jett,Gekko"
Split,The GRID,french goats,13,9,7,5,4,6,"Breach,Raze,Cypher,Gekko,Clove","Raze,Cypher,Viper,Skye,Astra"
Sunset,Edmatoic Fall,DOOMSDAY,13,6,4,3,3,9,"Breach,Raze,Cypher,Omen,Gekko","Breach,Raze,Cypher,Omen,Gekko"
Icebox,KRÜ Esports,Leviatán,11,13,4,8,5,7,"Killjoy,Viper,Jett,KAY/O,Gekko","Sova,Killjoy,Viper,Jett,Harbor"
Icebox,Good Luck,Imperial Titans,13,9,4,8,1,9,"Sova,Killjoy,Viper,Jett,Gekko","Sova,Killjoy,Viper,Jett,Gekko"
Lotus,University of Saskatchewan,Carleton University JV Black,6,13,3,4,9,3,"Raze,Killjoy,Omen,Skye,Gekko","Raze,Killjoy,Viper,Omen,Gekko"
Bind,Cosmic Divide,Sexy Gang,13,8,6,3,5,7,"Raze,Viper,Brimstone,Skye,Yoru","Raze,Cypher,Brimstone,Skye,Gekko"
Split,Window Washers,Medics,13,5,6,0,5,7,"Breach,Raze,Omen,Skye,Deadlock","Breach,Raze,Cypher,Omen,Skye"
Lotus,whats a pretzel,BHOP Esports,13,6,9,3,3,4,"Raze,Viper,Omen,Fade,Deadlock","Raze,Omen,Chamber,Fade,Gekko"
Ascent,Mindcontrol,puchan fan club,13,4,10,2,2,3,"Sova,Killjoy,Omen,Jett,KAY/O","Sova,Killjoy,Omen,Jett,KAY/O"
Icebox,Katsumi Fan Club,Area of Effect,13,7,7,1,6,6,"Sova,Killjoy,Viper,Jett,Gekko","Killjoy,Viper,Reyna,Jett,Gekko"
Icebox,Lionheart eSports,Cataclysm Gaming,12,14,6,7,7,6,"Sova,Killjoy,Viper,Omen,Jett","Sova,Killjoy,Viper,Chamber,Harbor"
Lotus,OC Eagles,Destro,10,13,3,8,5,7,"Breach,Raze,Killjoy,Omen,Gekko","Raze,Killjoy,Reyna,Gekko,Clove"
Split,BALLZ V3.0,Imperium Neo,15,13,9,5,8,6,"Raze,Cypher,Sova,Omen,Skye","Raze,Cypher,Viper,Omen,Skye"
Ascent,UCF Gold,1337 (NA),8,13,4,8,5,4,"Sova,Killjoy,Omen,Jett,KAY/O","Sova,Killjoy,Omen,Jett,KAY/O"
Split,The Pig Pen,DeTox,13,7,6,2,5,7,"Raze,Viper,Omen,Jett,Skye","Breach,Raze,Cypher,Viper,Omen"
Ascent,blueming,Toads,17,15,6,10,5,11,"Sova,Killjoy,Reyna,Omen,Jett","Sova,Killjoy,Omen,Jett,KAY/O"
Ascent,Purpose Gaming,Goomba Stompers,14,12,7,6,6,7,"Sova,Killjoy,Omen,Jett,KAY/O","Sova,Killjoy,Reyna,Jett,Clove"
Bind,Harmony White,Some Lovers of Cheese,5,13,3,9,4,2,"Raze,Cypher,Brimstone,Skye,Gekko","Raze,Cypher,Omen,Jett,Skye"
Ascent,Dog Team Club Org,Last Chance (NA),13,7,10,2,5,3,"Sova,Killjoy,Omen,Jett,KAY/O","Sova,Killjoy,Omen,Jett,KAY/O"
Lotus,Zero MarksMen Black,Nearest Airport,13,7,6,2,5,7,"Raze,Killjoy,Viper,Omen,Fade","Breach,Raze,Killjoy,Omen,Fade"
Bind,CHURCH OF CHAEWON KIM,CPU,14,12,10,3,9,4,"Raze,Viper,Brimstone,Reyna,Skye","Raze,Viper,Brimstone,Skye,Gekko"
Ascent,overcook,Backyard Boys,13,11,8,4,7,5,"Sova,Killjoy,Omen,Jett,KAY/O","Cypher,Sova,Omen,Jett,KAY/O"
Lotus,uOttawa Garnet,Langara College,13,2,3,0,2,10,"Raze,Killjoy,Omen,Fade,Gekko","Raze,Gekko,Deadlock,Iso,Clove"
Lotus,Team Digital,goose creek freaks,13,8,5,4,4,8,"Raze,Killjoy,Viper,Omen,Fade","Breach,Raze,Cypher,Omen,Fade"
Split,Demigods At UCSD,Hybrid Authority,13,7,6,2,5,7,"Breach,Raze,Cypher,Skye,Clove","Raze,Cypher,Viper,Omen,Skye"
Breeze,Good Luck,Imperial Titans,13,7,7,5,2,6,"Cypher,Sova,Viper,Yoru,Neon","Cypher,Sova,Viper,Jett,KAY/O"
Icebox,ROSE,Edmatoic Fall,13,1,2,0,1,11,"Sova,Killjoy,Viper,Reyna,Jett","Sova,Killjoy,Viper,Sage,Jett"
Bind,lost passion,LazerrFreeks Mythic,13,3,4,0,3,9,"Raze,Viper,Brimstone,Jett,Gekko","Raze,Viper,Skye,Gekko,Clove"
Ascent,Van Lyn,YDZ Esports,15,13,8,6,7,7,"Sova,Killjoy,Omen,Jett,KAY/O","Sova,Killjoy,Omen,Jett,KAY/O"
Sunset,DOOMSDAY,SHOW ME,13,7,5,7,0,8,"Breach,Raze,Cypher,Omen,Gekko","Raze,Cypher,Phoenix,Skye,Clove"
Icebox,The GRID,french goats,13,11,7,5,6,6,"Sova,Killjoy,Viper,Reyna,Jett","Sova,Killjoy,Viper,Reyna,Clove"
Ascent,Carleton University JV Black,Conestoga Condors,2,13,2,10,3,0,"Sova,Killjoy,Omen,Jett,KAY/O","Sova,Killjoy,Omen,Jett,KAY/O"
Ascent,L9,Goth Girl Sanctuary,13,4,9,3,1,4,"Sova,Killjoy,Omen,Jett,KAY/O","Sova,Killjoy,Omen,Jett,KAY/O"
Icebox,Nightblood Gaming,1Millisecond,7,13,6,6,7,1,"Sova,Killjoy,Viper,Jett,KAY/O","Killjoy,Viper,Jett,KAY/O,Gekko"
Sunset,Predator X Gaming,Luxoria,13,9,6,4,5,7,"Breach,Raze,Cypher,Sova,Omen","Raze,Cypher,Omen,Yoru,Fade"
Bind,Concordia University,University of Saskatchewan,13,1,11,1,0,2,"Raze,Brimstone,Jett,Skye,Deadlock","Raze,Cypher,Brimstone,Skye,Gekko"
Bind,UBC Black,SFU Raccoons,10,13,7,5,8,3,"Raze,Viper,Omen,Skye,Gekko","Raze,Sova,Viper,Brimstone,Gekko"
Ascent,Dogo Fanclub,NOTILT,13,8,5,4,4,8,"Sova,Killjoy,Omen,Jett,KAY/O","Sova,Killjoy,Reyna,Omen,Jett"
Bind,whats a pretzel,BHOP Esports,13,5,8,4,1,5,"Raze,Viper,Omen,Skye,Chamber","Raze,Cypher,Brimstone,Skye,Gekko"
Ascent,Université de Montréal,Conestoga Condors White,13,8,6,3,5,7,"Sova,Killjoy,Omen,Jett,KAY/O","Cypher,Sova,Omen,Jett,Skye"
Split,Mindcontrol,puchan fan club,13,7,6,2,5,7,"Raze,Viper,Jett,Skye,Astra","Raze,Cypher,Omen,Skye,Harbor"
Ascent,The Pig Pen,DeTox,13,1,11,1,0,2,"Sova,Killjoy,Omen,Jett,KAY/O","Sova,Killjoy,Omen,Jett,KAY/O"
Lotus,KRÜ Esports,Leviatán,13,6,7,5,1,6,"Raze,Killjoy,Viper,Omen,Fade","Raze,Killjoy,Viper,Omen,Fade"
Sunset,Orangutan Gang,Cataclysm Gaming,13,4,10,2,2,3,"Raze,Cypher,Omen,KAY/O,Gekko","Breach,Raze,Cypher,Omen,Yoru"
Icebox,Cosmic Divide,Sexy Gang,13,9,7,3,6,6,"Sova,Killjoy,Viper,Jett,Gekko","Sova,Killjoy,Viper,Jett,KAY/O"
Split,Be Like Matt,Frosted Flakes,8,13,2,10,3,6,"Raze,Cypher,Viper,Omen,Skye","Raze,Cypher,Reyna,Skye,Clove"
Bind,OC Eagles,Destro,13,1,11,1,0,2,"Raze,Cypher,Viper,Brimstone,Skye","Raze,Brimstone,Skye,Harbor,Gekko"
Ascent,OTSU Esports,Fanshawe FUEL,12,14,6,7,7,6,"Sova,Killjoy,Reyna,Omen,KAY/O","Sova,Killjoy,Omen,Jett,KAY/O"
Lotus,BALLZ V3.0,Imperium Neo,10,13,4,7,6,6,"Raze,Cypher,Omen,Fade,Gekko","Breach,Raze,Killjoy,Omen,Gekko"
Ascent,Harmony White,Some Lovers of Cheese,9,13,4,6,7,5,"Sova,Killjoy,Omen,Jett,KAY/O","Sova,Killjoy,Jett,KAY/O,Clove"
Bind,ROSE,Edmatoic Fall,13,4,5,0,4,8,"Raze,Cypher,Reyna,Skye,Clove","Raze,Cypher,Reyna,Gekko,Clove"
Ascent,lost passion,LazerrFreeks Mythic,13,3,11,1,2,2,"Sova,Killjoy,Jett,KAY/O,Clove","Sova,Killjoy,Omen,Jett,KAY/O"
Split,DOOMSDAY,SHOW ME,13,4,5,0,4,8,"Raze,Cypher,Viper,Omen,Skye","Cypher,Omen,Jett,Skye,Yoru"
Icebox,Katsumi Fan Club,Window Washers,13,9,8,4,5,5,"Sova,Killjoy,Viper,Jett,Gekko","Sova,Killjoy,Viper,Jett,Harbor"
Sunset,blueming,Toads,13,11,5,7,4,8,"Raze,Cypher,Reyna,Omen,Gekko","Breach,Raze,Cypher,Omen,KAY/O"
Ascent,UCF Gold,CHURCH OF CHAEWON KIM,13,5,4,2,3,9,"Sova,Killjoy,Omen,Jett,KAY/O","Sova,Killjoy,Omen,Jett,KAY/O"
Sunset,Purpose Gaming,Goomba Stompers,13,10,6,6,4,7,"Breach,Raze,Cypher,Omen,Fade","Breach,Raze,Cypher,Omen,Gekko"
Sunset,Zero MarksMen Black,Dog Team Club Org,13,6,6,1,5,7,"Breach,Raze,Cypher,Omen,Gekko","Raze,Cypher,Reyna,Omen,Gekko"
Icebox,Demigods At UCSD,Hybrid Authority,13,8,6,3,5,7,"Sova,Killjoy,Viper,Sage,Jett","Killjoy,Viper,Reyna,Jett,Gekko"
Ascent,Dexterity Gaming,YDZ Esports,5,13,2,4,9,3,"Sova,Killjoy,Sage,Omen,Jett","Sova,Killjoy,Omen,Jett,KAY/O"
Icebox,L9,Goth Girl Sanctuary,13,8,5,4,4,8,"Sova,Killjoy,Viper,Reyna,Jett","Raze,Killjoy,Viper,Gekko,Clove"
Lotus,The GRID,overcook,13,7,7,5,2,6,"Raze,Killjoy,Reyna,Omen,Gekko","Raze,Killjoy,Omen,Fade,Gekko"
Icebox,donas da bala,Fourth Wall,5,13,3,3,10,2,"Killjoy,Viper,Jett,KAY/O,Gekko","Sova,Killjoy,Viper,Jett,Gekko"
Lotus,Dogo Fanclub,NOTILT,13,7,5,3,4,8,"Raze,Killjoy,Omen,Fade,Gekko","Raze,Omen,Skye,Chamber,Gekko"
Lotus,Predator X Gaming,Luxoria,13,5,10,2,3,3,"Raze,Killjoy,Viper,Omen,Fade","Raze,Killjoy,Viper,Omen,Fade"
Ascent,Concordia University,Carleton University JV Black,13,5,9,3,2,4,"Cypher,Sova,Omen,Jett,KAY/O","Sova,Killjoy,Omen,Jett,KAY/O"
Bind,Be Like Matt,Frosted Flakes,9,13,6,6,7,3,"Raze,Cypher,Viper,Brimstone,Skye","Raze,Viper,Brimstone,Skye,Chamber"
Ascent,1Millisecond,goose creek freaks,13,11,2,10,1,11,"Sova,Killjoy,Omen,Jett,KAY/O","Sova,Killjoy,Omen,Jett,KAY/O"
Icebox,Sexy Gang,Imperium Neo,13,3,4,0,3,9,"Sova,Killjoy,Viper,Jett,KAY/O","Sova,Killjoy,Viper,Jett,Harbor"
Lotus,UBC Black,Université de Montréal,13,3,9,3,0,4,"Raze,Killjoy,Omen,Fade,Gekko","Cypher,Omen,Jett,Skye,Gekko"
Icebox,Imperial Titans,BHOP Esports,8,13,3,9,4,5,"Sova,Killjoy,Viper,Sage,Jett","Sova,Killjoy,Jett,Harbor,Gekko"
Ascent,SaD Purple,Lionheart eSports,13,3,4,0,3,9,"Sova,Killjoy,Omen,Jett,KAY/O","Sova,Killjoy,Omen,Jett,KAY/O"
Ascent,Conestoga Condors White,SFU Raccoons,6,13,2,5,8,4,"Cypher,Sova,Omen,Jett,Clove","Sova,Killjoy,Omen,Jett,KAY/O"
Lotus,TBS GC,Athena's e-Sports,13,11,6,6,5,7,"Raze,Killjoy,Viper,Omen,Fade","Breach,Raze,Killjoy,Omen,Fade"
Icebox,Backyard Boys,french goats,4,13,3,9,4,1,"Sova,Killjoy,Jett,Harbor,Gekko","Sova,Killjoy,Viper,Reyna,Harbor"
Bind,FURIA GC,curralzinho,13,6,6,1,5,7,"Raze,Viper,Brimstone,Skye,Gekko","Raze,Cypher,Skye,Gekko,Clove"
Lotus,Orangutan Gang,Cataclysm Gaming,13,5,3,3,2,10,"Raze,Killjoy,Viper,Omen,Fade","Breach,Raze,Killjoy,Omen,Gekko"
Split,DreamMax GC,sou proplayer lixo?,11,13,9,3,10,2,"Raze,Cypher,Omen,Jett,Skye","Raze,Cypher,Viper,Omen,Skye"
Lotus,Nightblood Gaming,Team Digital,14,12,8,5,7,6,"Breach,Raze,Cypher,Omen,Gekko","Raze,Killjoy,Viper,Omen,Fade"
Split,SFU Pink,OTSU Esports,13,1,2,0,1,11,"Raze,Cypher,Jett,Skye,Astra","Raze,Cypher,Omen,Jett,Skye"
Sunset,UCF Gold,CHURCH OF CHAEWON KIM,13,9,7,3,6,6,"Raze,Cypher,Omen,KAY/O,Gekko","Breach,Raze,Cypher,Omen,Gekko"
Ascent,Advogatos,ZAGAS,6,13,3,4,9,3,"Cypher,Sova,Omen,Jett,KAY/O","Sova,Killjoy,Omen,Jett,KAY/O"
Ascent,ROSE,DOOMSDAY,13,10,9,3,7,4,"Cypher,Sova,Phoenix,Omen,Jett","Sova,Killjoy,Omen,Jett,KAY/O"
Bind,1337 (NA),CPU,13,11,10,2,9,3,"Raze,Brimstone,Omen,Skye,Gekko","Raze,Viper,Brimstone,Skye,Gekko"
Sunset,LazerrFreeks Mythic,Toads,13,2,10,2,0,3,"Breach,Raze,Cypher,Omen,Fade","Raze,Cypher,Omen,KAY/O,Gekko"
Ascent,Cosmic Divide,BALLZ V3.0,13,9,7,3,6,6,"Sova,Killjoy,Omen,Jett,KAY/O","Sova,Killjoy,Omen,Jett,KAY/O"
Bind,Nearest Airport,Last Chance (NA),13,8,4,5,3,9,"Raze,Viper,Omen,Fade,Gekko","Raze,Brimstone,Skye,Harbor,Gekko"
Ascent,puchan fan club,Some Lovers of Cheese,13,9,7,5,4,6,"Cypher,Sova,Jett,Astra,KAY/O","Sova,Killjoy,Omen,Jett,Chamber"
Split,Destro,DeTox,9,13,4,6,7,5,"Raze,Cypher,Jett,Skye,Astra","Breach,Raze,Cypher,Viper,Omen"
Sunset,Area of Effect,Medics,13,5,6,0,5,7,"Raze,Cypher,Sova,Omen,Gekko","Breach,Raze,Cypher,Omen,Gekko"
Sunset,Katsumi Fan Club,Window Washers,11,13,7,5,8,4,"Breach,Raze,Cypher,Omen,Fade","Raze,Cypher,Omen,KAY/O,Gekko"
Sunset,lost passion,blueming,13,10,4,7,3,9,"Raze,Cypher,Omen,KAY/O,Gekko","Raze,Cypher,Reyna,Omen,Gekko"
Bind,The Pig Pen,OC Eagles,13,10,9,2,8,4,"Raze,Viper,Brimstone,Skye,Gekko","Raze,Cypher,Viper,Brimstone,Skye"
Sunset,whats a pretzel,Good Luck,13,10,7,5,5,6,"Breach,Raze,Cypher,Omen,Fade","Raze,Reyna,Omen,Gekko,Deadlock"
Split,G2 Esports,100 Thieves,11,13,3,9,4,8,"Breach,Raze,Viper,Omen,Fade","Raze,Viper,Astra,Fade,Gekko"
Icebox,Goth Girl Sanctuary,Goomba Stompers,13,3,9,3,0,4,"Raze,Killjoy,Viper,Gekko,Clove","Sova,Killjoy,Viper,Sage,Jett"
Icebox,Dogo Fanclub,Demigods At UCSD,13,1,11,1,0,2,"Sova,Killjoy,Jett,Harbor,Clove","Sova,Killjoy,Viper,Sage,Jett"
Sunset,Dexterity Gaming,YDZ Esports,13,11,9,3,8,4,"Breach,Raze,Cypher,Sova,Omen","Breach,Raze,Cypher,Sova,Omen"
Split,The GRID,overcook,12,14,6,7,7,6,"Breach,Raze,Cypher,Gekko,Clove","Breach,Raze,Cypher,Omen,Skye"
Ascent,Edmatoic Fall,SHOW ME,13,9,6,4,5,7,"Sova,Killjoy,Reyna,Omen,Jett","Sova,Killjoy,Omen,Jett,Deadlock"
Ascent,Zero MarksMen Black,Dog Team Club Org,12,14,4,9,5,8,"Sova,Killjoy,Omen,Jett,KAY/O","Sova,Killjoy,Omen,Jett,KAY/O"
Lotus,L9,Purpose Gaming,13,5,3,3,2,10,"Raze,Sova,Killjoy,Viper,Omen","Breach,Raze,Cypher,Omen,Fade"
Split,Frosted Flakes,Luxoria,13,2,11,1,1,2,"Raze,Cypher,Reyna,Skye,Clove","Raze,Cypher,Omen,Skye,Gekko"
Bind,NOTILT,Hybrid Authority,13,8,6,6,2,7,"Raze,Viper,Jett,Skye,Clove","Raze,Cypher,Brimstone,Skye,Gekko"
Breeze,Be Like Matt,Predator X Gaming,13,4,5,0,4,8,"Cypher,Sova,Viper,Reyna,Jett","Cypher,Sova,Viper,Jett,KAY/O"
Sunset,Mindcontrol,Harmony White,13,1,2,0,1,11,"Breach,Raze,Cypher,Sova,Omen","Breach,Raze,Cypher,Omen,KAY/O"
Sunset,donas da bala,Fourth Wall,11,13,9,3,10,2,"Raze,Cypher,Omen,KAY/O,Gekko","Raze,Cypher,Omen,Fade,Gekko"
Icebox,FURIA GC,curralzinho,13,5,8,4,1,5,"Sova,Killjoy,Viper,Jett,Gekko","Sova,Killjoy,Viper,Jett,Gekko"
Icebox,SaD Purple,Lionheart eSports,13,8,9,3,5,4,"Sova,Killjoy,Viper,Jett,Harbor","Sova,Killjoy,Viper,Jett,KAY/O"
Bind,ROSE,DOOMSDAY,13,9,5,7,2,8,"Raze,Cypher,Reyna,Skye,Clove","Raze,Viper,Brimstone,Skye,Deadlock"
Icebox,Advogatos,ZAGAS,4,13,1,4,9,3,"Sova,Killjoy,Viper,Jett,Gekko","Killjoy,Viper,Jett,KAY/O,Gekko"
Bind,TBS GC,Athena's e-Sports,13,6,10,2,4,3,"Breach,Raze,Omen,Skye,Gekko","Raze,Sova,Viper,Brimstone,Skye"
Icebox,Nightblood Gaming,Team Digital,13,6,9,3,3,4,"Sova,Killjoy,Viper,Jett,KAY/O","Sova,Killjoy,Viper,Jett,Harbor"
Bind,LazerrFreeks Mythic,Toads,13,6,5,2,4,8,"Raze,Viper,Skye,Gekko,Clove","Raze,Cypher,Brimstone,Skye,Gekko"
Icebox,DreamMax GC,sou proplayer lixo?,6,13,0,7,6,6,"Sova,Killjoy,Viper,Sage,Jett","Sova,Killjoy,Viper,Jett,Gekko"
Lotus,Sexy Gang,Imperium Neo,14,12,5,8,4,9,"Raze,Killjoy,Viper,Omen,Fade","Breach,Raze,Killjoy,Omen,Gekko"
Lotus,lost passion,blueming,13,6,7,0,6,6,"Raze,Cypher,Viper,Omen,Gekko","Raze,Killjoy,Omen,Fade,Gekko"
Ascent,The GRID,overcook,13,4,9,3,1,4,"Sova,Killjoy,Phoenix,Omen,Jett","Sova,Killjoy,Omen,Jett,KAY/O"
Ascent,Katsumi Fan Club,Window Washers,13,5,2,4,1,11,"Sova,Killjoy,Omen,Jett,KAY/O","Sova,Killjoy,Omen,Jett,KAY/O"
Bind,Orangutan Gang,Cataclysm Gaming,8,13,7,5,8,1,"Raze,Viper,Brimstone,Fade,Gekko","Viper,Brimstone,Omen,KAY/O,Gekko"
Lotus,puchan fan club,Some Lovers of Cheese,13,6,7,5,1,6,"Raze,Killjoy,Reyna,Astra,Harbor","Raze,Killjoy,Viper,Omen,Gekko"
Ascent,Area of Effect,Medics,13,7,6,2,5,7,"Sova,Killjoy,Reyna,Omen,Jett","Sova,Killjoy,Omen,Jett,KAY/O"
Lotus,whats a pretzel,Good Luck,13,5,9,3,2,4,"Raze,Viper,Omen,Fade,Deadlock","Raze,Killjoy,Viper,Omen,Fade"
Ascent,Backyard Boys,french goats,12,14,5,8,6,7,"Cypher,Sova,Omen,Jett,KAY/O","Sova,Killjoy,Jett,KAY/O,Clove"
Icebox,1Millisecond,goose creek freaks,16,14,7,8,6,9,"Killjoy,Viper,Jett,KAY/O,Gekko","Sova,Killjoy,Viper,Reyna,Jett"
Lotus,Be Like Matt,Predator X Gaming,13,2,10,2,0,3,"Raze,Cypher,Viper,Omen,Skye","Raze,Killjoy,Viper,Omen,Fade"
Sunset,L9,Purpose Gaming,13,4,3,2,2,10,"Breach,Raze,Cypher,Sova,Clove","Breach,Raze,Cypher,Omen,Fade"
Lotus,UCF Gold,CHURCH OF CHAEWON KIM,10,13,4,8,5,6,"Raze,Killjoy,Viper,Omen,Fade","Raze,Killjoy,Viper,Omen,Skye"
Split,Zero MarksMen Black,Dog Team Club Org,13,3,4,0,3,9,"Raze,Cypher,Viper,Omen,Skye","Raze,Cypher,Omen,Jett,Skye"
Ascent,Mindcontrol,Harmony White,13,2,3,0,2,10,"Sova,Killjoy,Omen,Jett,KAY/O","Sova,Killjoy,Omen,Jett,KAY/O"
Ascent,Mix9,Rebirth Esports,13,8,6,6,2,7,"Sova,Killjoy,Omen,Jett,KAY/O","Breach,Cypher,Omen,Jett,KAY/O"
Lotus,Cosmic Divide,BALLZ V3.0,13,7,11,1,6,2,"Raze,Killjoy,Omen,Fade,Gekko","Raze,Killjoy,Viper,Omen,Fade"
Sunset,Edmatoic Fall,SHOW ME,13,9,7,5,4,6,"Breach,Raze,Cypher,Omen,Fade","Raze,Omen,Skye,Gekko,Deadlock"
Ascent,Imperial Titans,BHOP Esports,13,15,4,10,5,9,"Sova,Killjoy,Omen,Jett,KAY/O","Sova,Killjoy,Omen,Jett,KAY/O"
Ascent,The Pig Pen,OC Eagles,13,7,7,5,2,6,"Sova,Killjoy,Omen,Jett,KAY/O","Sova,Killjoy,Omen,Jett,KAY/O"
Ascent,Dogo Fanclub,Demigods At UCSD,13,6,7,5,1,6,"Sova,Killjoy,Omen,Jett,KAY/O","Sova,Killjoy,Omen,Jett,KAY/O"
Bind,Goth Girl Sanctuary,Goomba Stompers,13,6,5,2,4,8,"Raze,Viper,Brimstone,Skye,Gekko","Raze,Viper,Jett,Skye,Clove"
Bind,Destro,DeTox,8,13,5,7,6,3,"Raze,Brimstone,Skye,Harbor,Gekko","Raze,Viper,Brimstone,Skye,Gekko"
Icebox,Dexterity Gaming,YDZ Esports,11,13,7,5,8,4,"Sova,Killjoy,Viper,Omen,Jett","Sova,Killjoy,Viper,Reyna,Jett"
Bind,Frosted Flakes,Luxoria,13,6,10,2,4,3,"Raze,Viper,Brimstone,Skye,Chamber","Raze,Viper,Brimstone,Skye,Gekko"
Split,Nearest Airport,Last Chance (NA),13,8,9,0,8,4,"Breach,Raze,Cypher,Omen,Skye","Raze,Cypher,Viper,Omen,Skye"
Lotus,1337 (NA),CPU,16,14,6,9,5,10,"Raze,Killjoy,Viper,Omen,Fade","Raze,Cypher,Omen,KAY/O,Fade"
Bind,G2 Esports,100 Thieves,13,8,7,2,6,6,"Raze,Viper,Brimstone,Skye,Gekko","Raze,Viper,Brimstone,Fade,Gekko"
Lotus,Mix9,Rebirth Esports,13,7,6,2,5,7,"Breach,Raze,Sova,Killjoy,Omen","Breach,Raze,Cypher,Omen,Jett"
Ascent,G2 Esports,100 Thieves,5,13,5,7,6,0,"Sova,Killjoy,Omen,Jett,KAY/O","Sova,Killjoy,Omen,Jett,KAY/O"
Split,Mix9,Rebirth Esports,13,10,6,6,4,7,"Breach,Raze,Killjoy,Skye,Astra","Killjoy,Viper,Phoenix,Omen,KAY/O"
Lotus,LXT Esports GC,NOVO GC,13,10,6,6,4,7,"Raze,Killjoy,Viper,Omen,Fade","Breach,Sova,Killjoy,Omen,Neon"
Bind,Twisted Minds Esports,Vision Esports,13,11,3,9,2,10,"Raze,Viper,Omen,Jett,Skye","Breach,Raze,Omen,Gekko,Deadlock"
Icebox,LXT Esports GC,NOVO GC,13,6,7,5,1,6,"Killjoy,Viper,Jett,KAY/O,Gekko","Sova,Killjoy,Viper,Sage,Jett"
Lotus,G3 Esports,Dragons Esports,4,13,1,4,9,3,"Breach,Raze,Cypher,Sova,Omen","Raze,Killjoy,Viper,Omen,Fade"
Sunset,Team Falcons,Onyx Ravens,13,10,6,5,5,7,"Breach,Raze,Cypher,Omen,Fade","Breach,Raze,Cypher,Omen,Fade"
Sunset,Karmine Corp,FUT Esports,10,13,4,8,5,6,"Raze,Cypher,Omen,KAY/O,Gekko","Breach,Raze,Cypher,Omen,Gekko"
Lotus,The Vicious,Underground Gaming,13,11,6,6,5,7,"Raze,Killjoy,Omen,Jett,Skye","Breach,Raze,Killjoy,Omen,Gekko"
Ascent,LuckyGirls,Entry Frogs Iris,13,2,3,0,2,10,"Sova,Killjoy,Omen,Jett,KAY/O","Raze,Viper,Reyna,Gekko,Clove"
Sunset,Twisted Minds Esports,Vision Esports,13,10,7,4,6,6,"Raze,Cypher,Omen,KAY/O,Gekko","Breach,Raze,Omen,Gekko,Deadlock"
Ascent,The Vicious,Underground Gaming,13,4,9,3,1,4,"Sova,Killjoy,Jett,Astra,KAY/O","Sova,Killjoy,Reyna,Omen,Jett"
Split,Team Falcons,Onyx Ravens,13,6,9,3,3,4,"Breach,Raze,Cypher,Omen,Skye","Breach,Raze,Cypher,Sage,Omen"
Ascent,G3 Esports,Dragons Esports,11,13,6,6,7,5,"Breach,Sova,Jett,Astra,KAY/O","Cypher,Sova,Omen,Jett,KAY/O"
Icebox,Karmine Corp,FUT Esports,3,13,1,3,10,2,"Sova,Killjoy,Viper,Sage,Reyna","Sova,Killjoy,Viper,Jett,KAY/O"
Lotus,LuckyGirls,Entry Frogs Iris,11,13,5,7,6,6,"Breach,Raze,Killjoy,Viper,Omen","Breach,Raze,Killjoy,Omen,Fade"
Breeze,FNATIC,Team Heretics,4,13,4,8,5,0,"Cypher,Sova,Viper,Yoru,KAY/O","Cypher,Sova,Viper,Yoru,KAY/O"
Lotus,FNATIC,Team Heretics,13,15,6,8,7,7,"Raze,Killjoy,Viper,Omen,Fade","Breach,Raze,Cypher,Omen,Fade"
Ascent,Da Feng Gou,SAIO,13,8,6,6,2,7,"Sova,Killjoy,Omen,Jett,KAY/O","Sova,Killjoy,Omen,Jett,KAY/O"
Ascent,Da Feng Gou,SAIO,13,8,6,6,2,7,"Sova,Killjoy,Omen,Jett,KAY/O","Sova,Killjoy,Omen,Jett,KAY/O"
Sunset,Da Feng Gou,SAIO,4,13,4,8,5,0,"Breach,Raze,Cypher,Omen,Gekko","Raze,Cypher,Sova,Omen,Gekko"
Sunset,Da Feng Gou,SAIO,4,13,4,8,5,0,"Breach,Raze,Cypher,Omen,Gekko","Raze,Cypher,Sova,Omen,Gekko"
Sunset,yuanyoyin,Team Kobolds,13,9,6,4,5,7,"Raze,Cypher,Phoenix,Gekko,Clove","Cypher,Sova,Omen,Gekko,Clove"
Lotus,Xu Gang,After Life Esports,13,10,8,3,7,5,"Raze,Sova,Killjoy,Omen,KAY/O","Raze,Killjoy,Viper,Omen,Fade"
Lotus,Da Feng Gou,SAIO,13,9,8,4,5,5,"Raze,Killjoy,Viper,Omen,Fade","Raze,Killjoy,Viper,Omen,Fade"
Lotus,Da Feng Gou,SAIO,13,9,8,4,5,5,"Raze,Killjoy,Viper,Omen,Fade","Raze,Killjoy,Viper,Omen,Fade"
Sunset,Xu Gang,After Life Esports,13,3,9,3,0,4,"Breach,Raze,Cypher,Sova,Omen","Raze,Cypher,Omen,KAY/O,Gekko"
Ascent,Koopa Troopas,Elite 5,19,17,5,13,4,14,"Cypher,Sova,Omen,Jett,KAY/O","Sova,Killjoy,Reyna,Omen,Jett"
Icebox,Slice of Life,Wolf Pack (OCE),5,13,4,8,5,1,"Sova,Killjoy,Viper,Jett,Gekko","Sova,Killjoy,Viper,Jett,Gekko"
Breeze,Xu Gang,After Life Esports,12,14,6,7,7,6,"Cypher,Sova,Viper,Jett,KAY/O","Cypher,Sova,Viper,Jett,Yoru"
Bind,Koopa Troopas,Elite 5,13,3,9,3,0,4,"Raze,Viper,Brimstone,Fade,Gekko","Raze,Cypher,Viper,Brimstone,Skye"
Lotus,club penguin,Tiny Turtle Squad,7,13,3,9,4,4,"Raze,Killjoy,Viper,Omen,Skye","Viper,Omen,Chamber,Neon,Gekko"
Icebox,Corn Dogs (OCE),Funcrew,7,13,5,7,6,2,"Killjoy,Viper,Jett,KAY/O,Gekko","Sova,Killjoy,Viper,Jett,Iso"
Lotus,Bandits OCE,Peace & Love,13,9,6,4,5,7,"Raze,Cypher,Omen,Yoru,Fade","Raze,Killjoy,Omen,Neon,Gekko"
Bind,Corn Dogs (OCE),Funcrew,9,13,5,7,6,4,"Raze,Viper,Brimstone,Skye,Yoru","Raze,Sova,Brimstone,Skye,Deadlock"
Lotus,Slice of Life,Wolf Pack (OCE),13,15,4,10,5,9,"Breach,Raze,Killjoy,Omen,Jett","Breach,Raze,Killjoy,Viper,Omen"
Bind,Bandits OCE,Peace & Love,13,10,6,6,4,7,"Raze,Viper,Gekko,Deadlock,Clove","Raze,Brimstone,Skye,Chamber,Neon"
Bind,club penguin,Tiny Turtle Squad,11,13,3,9,4,8,"Raze,Cypher,Skye,Gekko,Clove","Raze,Viper,Brimstone,Skye,Gekko"
Lotus,Koopa Troopas,Elite 5,11,13,7,5,8,4,"Breach,Raze,Cypher,Omen,Fade","Raze,Phoenix,Omen,Chamber,Gekko"
Split,Mizzou Esports,Columbia College,7,13,7,5,8,0,"Breach,Raze,Reyna,Jett,Astra","Raze,Cypher,Omen,Jett,Skye"
Sunset,Mizzou Esports,Columbia College,7,13,4,4,9,3,"Breach,Raze,Cypher,Reyna,Omen","Breach,Raze,Cypher,Sova,Omen"
Icebox,Leviatán,100 Thieves,10,13,6,6,7,4,"Sova,Killjoy,Viper,Jett,Harbor","Sova,Killjoy,Viper,Jett,Gekko"
Sunset,Leviatán,100 Thieves,14,12,9,4,8,5,"Breach,Raze,Cypher,Omen,Gekko","Raze,Cypher,Sova,Omen,Gekko"
Icebox,FURIA GC,RENEGADAS,13,11,6,6,5,7,"Sova,Killjoy,Viper,Jett,Gekko","Killjoy,Viper,Jett,KAY/O,Gekko"
Lotus,curralzinho,sem fazer careta,13,7,7,5,2,6,"Raze,Killjoy,Chamber,Gekko,Clove","Breach,Raze,Killjoy,Omen,Gekko"
Split,Athena's e-Sports,bom dia sofia e amigas,13,8,6,3,5,7,"Raze,Cypher,Viper,Omen,Skye","Raze,Cypher,Omen,Jett,Skye"
Breeze,Advogatos,SAIDEIRA ESPORTS,10,13,7,4,9,3,"Sova,Viper,Jett,Yoru,Astra","Cypher,Sova,Viper,Jett,KAY/O"
Lotus,FURIA GC,RENEGADAS,4,13,2,3,10,2,"Raze,Killjoy,Omen,Skye,Deadlock","Raze,Killjoy,Viper,Omen,Fade"
Split,DreamMax GC,VHL Valhalla,13,1,11,1,0,2,"Raze,Cypher,Omen,Jett,Skye","Raze,Cypher,Viper,Omen,Skye"
Bind,donas da bala,SAGE QUE DEUS QUISER,13,5,3,3,2,10,"Raze,Viper,Skye,Gekko,Clove","Raze,Cypher,Brimstone,Chamber,Fade"
Bind,Leviatán,100 Thieves,3,13,3,9,4,0,"Raze,Viper,Brimstone,Skye,Gekko","Raze,Viper,Brimstone,Fade,Gekko"
Ascent,TBS GC,RKT pANcaDELAS,13,3,9,3,0,4,"Sova,Killjoy,Jett,KAY/O,Clove","Sova,Killjoy,Omen,Jett,KAY/O"
Bind,curralzinho,sem fazer careta,13,1,2,0,1,11,"Raze,Cypher,Skye,Gekko,Clove","Raze,Cypher,Brimstone,Skye,Gekko"
Icebox,AXKRUM GC,Fourth Wall,8,13,4,5,8,4,"Sova,Killjoy,Jett,Harbor,Gekko","Sova,Killjoy,Viper,Jett,Harbor"
Lotus,BLOOD Stars,sou proplayer lixo?,0,13,0,1,12,0,"Raze,Killjoy,Omen,Astra,Gekko","Raze,Killjoy,Viper,Omen,Skye"
Sunset,donas da bala,SAGE QUE DEUS QUISER,13,4,5,0,4,8,"Raze,Cypher,Omen,KAY/O,Gekko","Raze,Cypher,Omen,Neon,Gekko"
Bind,Athena's e-Sports,bom dia sofia e amigas,13,11,7,5,6,6,"Raze,Sova,Viper,Brimstone,Skye","Raze,Cypher,Phoenix,Brimstone,Gekko"
Bind,FURIA GC,RENEGADAS,13,6,8,4,2,5,"Raze,Viper,Brimstone,Skye,Gekko","Raze,Viper,Skye,Gekko,Clove"
Bind,TBS GC,RKT pANcaDELAS,13,4,8,4,0,5,"Breach,Raze,Omen,Skye,Gekko","Breach,Raze,Cypher,Brimstone,Skye"
Sunset,Advogatos,SAIDEIRA ESPORTS,8,13,7,5,8,1,"Raze,Cypher,Omen,KAY/O,Gekko","Raze,Cypher,Omen,KAY/O,Gekko"
Lotus,DreamMax GC,VHL Valhalla,13,5,6,0,5,7,"Raze,Killjoy,Viper,Omen,Skye","Raze,Omen,Chamber,Fade,Deadlock"
Icebox,BLOOD Stars,sou proplayer lixo?,2,13,0,3,10,2,"Sova,Killjoy,Viper,Jett,Gekko","Sova,Killjoy,Viper,Jett,Gekko"
Sunset,AXKRUM GC,Fourth Wall,3,13,1,11,2,2,"Breach,Raze,Cypher,Sova,Omen","Raze,Cypher,Omen,Fade,Gekko"
Icebox,curralzinho,sem fazer careta,5,13,4,8,5,1,"Sova,Killjoy,Jett,Harbor,Gekko","Sova,Killjoy,Jett,Harbor,Gekko"
Ascent,KRÜ Esports,G2 Esports,8,13,2,7,6,6,"Sova,Killjoy,Omen,Jett,KAY/O","Sova,Killjoy,Omen,Jett,KAY/O"
Split,KR Esports,Dragons Esports,10,13,8,3,10,2,"Raze,Cypher,Viper,Omen,Skye","Raze,Cypher,Viper,Omen,Skye"
Icebox,KRÜ Esports,G2 Esports,5,13,4,8,5,1,"Killjoy,Viper,Reyna,KAY/O,Gekko","Sova,Killjoy,Viper,Harbor,Gekko"
Icebox,KR Esports,Dragons Esports,13,10,5,6,4,8,"Sova,Killjoy,Viper,Yoru,Chamber","Sova,Killjoy,Viper,Reyna,Gekko"
Lotus,KR Esports,Dragons Esports,9,13,5,7,6,4,"Raze,Omen,KAY/O,Chamber,Deadlock","Raze,Killjoy,Viper,Omen,Fade"
Lotus,Dragons Esports,Twisted Minds Esports,9,13,3,7,6,6,"Raze,Killjoy,Viper,Omen,Fade","Breach,Raze,Killjoy,Omen,Gekko"
Split,FUT Esports,Team Heretics,13,15,5,9,6,8,"Raze,Viper,Omen,Skye,Chamber","Raze,Cypher,Viper,Omen,Skye"
Ascent,KR Esports,Vision Esports,13,6,7,5,1,6,"Breach,Sova,Killjoy,Omen,Jett","Breach,Sova,Killjoy,Omen,Jett"
Split,The Vicious,Team Falcons,6,13,4,3,10,2,"Raze,Cypher,Sage,Omen,Skye","Breach,Raze,Cypher,Omen,Skye"
Ascent,Onyx Ravens,G3 Esports,16,14,7,8,6,9,"Sova,Killjoy,Omen,Jett,KAY/O","Breach,Sova,Jett,Astra,KAY/O"
Icebox,LANPACAN,BLINDOHOLIK,13,10,8,3,7,5,"Sova,Killjoy,Viper,Sage,Jett","Sova,Killjoy,Phoenix,Brimstone,Harbor"
Sunset,Dragons Esports,Twisted Minds Esports,11,13,8,4,9,3,"Raze,Cypher,Viper,Omen,Fade","Raze,Cypher,Omen,KAY/O,Gekko"
Icebox,The Vicious,Team Falcons,9,13,4,6,7,5,"Sova,Killjoy,Viper,Sage,Jett","Killjoy,Viper,Jett,KAY/O,Gekko"
Breeze,KR Esports,Vision Esports,13,5,9,3,2,4,"Cypher,Sova,Viper,Jett,Yoru","Cypher,Sova,Viper,Jett,KAY/O"
Lotus,Onyx Ravens,G3 Esports,13,6,7,5,1,6,"Raze,Killjoy,Viper,Omen,Fade","Breach,Raze,Cypher,Sova,Omen"
Lotus,FUT Esports,Team Heretics,10,13,6,6,7,4,"Cypher,Viper,Sage,Omen,Jett","Breach,Raze,Cypher,Omen,Fade"
Lotus,Szach Mat,FLYLESS BALTIC,11,13,6,6,7,5,"Raze,Killjoy,Viper,Omen,Skye","Breach,Killjoy,Omen,Jett,Fade"
Split,LANPACAN,BLINDOHOLIK,13,11,6,6,5,7,"Raze,Cypher,Viper,Omen,Skye","Raze,Cypher,Omen,Jett,Skye"
Sunset,Szach Mat,FLYLESS BALTIC,8,13,4,8,5,4,"Cypher,Sova,Omen,KAY/O,Neon","Breach,Cypher,Omen,Jett,KAY/O"
Lotus,LANPACAN,BLINDOHOLIK,10,13,4,7,6,6,"Breach,Raze,Killjoy,Omen,Gekko","Raze,Killjoy,Omen,Gekko,Deadlock"
Bind,Karmine Corp,FNATIC,9,13,8,4,9,1,"Raze,Viper,Omen,Skye,Gekko","Raze,Viper,Brimstone,Skye,Gekko"
Breeze,Karmine Corp,FNATIC,11,13,9,3,10,2,"Cypher,Sova,Viper,Jett,Yoru","Cypher,Sova,Viper,Yoru,KAY/O"
Bind,Da Feng Gou,Team Kobolds,13,8,6,3,5,7,"Raze,Cypher,Viper,Omen,Gekko","Raze,Viper,Brimstone,Skye,Gekko"
Ascent,yuanyoyin, ROA,5,13,0,6,7,5,"Sova,Killjoy,Omen,Jett,KAY/O","Sova,Killjoy,Omen,Jett,KAY/O"
Ascent,Da Feng Gou,Team Kobolds,13,9,5,7,2,8,"Sova,Killjoy,Omen,Jett,KAY/O","Sova,Killjoy,Omen,Jett,KAY/O"
Breeze,Five Ace e-Sports,SAIO,13,10,7,5,5,6,"Cypher,Sova,Viper,Jett,KAY/O","Cypher,Sova,Viper,Jett,Yoru"
Bind,yuanyoyin, ROA,13,11,9,3,8,4,"Raze,Viper,Brimstone,Skye,Chamber","Raze,Brimstone,Skye,Harbor,Gekko"
Sunset,Funcrew,Xu Gang,17,15,7,9,6,10,"Breach,Raze,Cypher,Omen,Gekko","Breach,Raze,Cypher,Sova,Omen"
Lotus,yuanyoyin, ROA,4,13,4,8,5,0,"Raze,Killjoy,Reyna,Gekko,Clove","Raze,Cypher,Omen,Astra,Gekko"
Lotus,Five Ace e-Sports,SAIO,13,6,4,3,3,9,"Raze,Killjoy,Viper,Omen,Fade","Raze,Killjoy,Viper,Omen,Fade"
Lotus,Da Feng Gou,Team Kobolds,6,13,5,7,6,1,"Raze,Killjoy,Viper,Omen,Fade","Breach,Raze,Killjoy,Omen,Skye"
Icebox,Funcrew,Xu Gang,13,7,10,2,5,3,"Killjoy,Viper,Jett,KAY/O,Gekko","Sova,Killjoy,Viper,KAY/O,Clove"
Sunset,Bandits OCE,club penguin,13,9,9,3,6,4,"Cypher,Sova,Omen,Yoru,Clove","Raze,Cypher,Skye,Gekko,Clove"
Icebox,Parallax,Wolf Pack (OCE),6,13,3,9,4,3,"Sova,Killjoy,Viper,Jett,Gekko","Sova,Killjoy,Viper,Jett,Gekko"
Sunset,Burger clan,Tiny Turtle Squad,5,13,1,5,8,4,"Raze,Cypher,Phoenix,Omen,Gekko","Breach,Raze,Cypher,Omen,Gekko"
Split,Funcrew,Xu Gang,8,13,7,5,8,1,"Raze,Cypher,Omen,Jett,Skye","Breach,Raze,Cypher,Omen,Deadlock"
Ascent,Burger clan,Tiny Turtle Squad,5,13,5,7,6,0,"Cypher,Sova,Omen,Jett,KAY/O","Cypher,Sova,Omen,Jett,KAY/O"
Split,Bandits OCE,club penguin,7,13,4,8,5,3,"Raze,Cypher,Omen,Skye,Yoru","Raze,Cypher,Sage,Skye,Clove"
Bind,Parallax,Wolf Pack (OCE),13,10,4,7,3,9,"Raze,Viper,Brimstone,Fade,Gekko","Raze,Viper,Brimstone,Skye,Gekko"
Ascent,Elite 5,VEND,13,2,3,0,2,10,"Sova,Killjoy,Reyna,Omen,Jett","Sova,Killjoy,Omen,Yoru,Clove"
Icebox,Slice of Life,Corn Dogs (OCE),6,13,4,8,5,2,"Sova,Killjoy,Viper,Phoenix,Jett","Killjoy,Viper,Jett,KAY/O,Gekko"
Bind,Peace & Love,Koopa Troopas,13,5,7,5,0,6,"Raze,Phoenix,Brimstone,Skye,Neon","Raze,Viper,Brimstone,Fade,Gekko"
Lotus,After Life Esports,Team Average,13,7,4,4,3,9,"Raze,Killjoy,Viper,Omen,Fade","Raze,Killjoy,Viper,Gekko,Clove"
Bind,Elite 5,VEND,13,5,7,5,0,6,"Raze,Cypher,Viper,Brimstone,Skye","Raze,Viper,Brimstone,Reyna,Skye"
Ascent,Bandits OCE,club penguin,13,11,9,3,8,4,"Sova,Killjoy,Omen,Yoru,KAY/O","Cypher,Sova,Omen,Jett,KAY/O"
Lotus,Slice of Life,Corn Dogs (OCE),6,13,3,4,9,3,"Breach,Raze,Killjoy,Phoenix,Omen","Raze,Killjoy,Omen,Fade,Gekko"
Split,Peace & Love,Koopa Troopas,13,6,8,4,2,5,"Raze,Phoenix,Omen,Skye,Neon","Breach,Raze,Cypher,Omen,Fade"
Ascent,After Life Esports,Team Average,13,4,3,2,2,10,"Sova,Killjoy,Omen,Jett,KAY/O","Sova,Killjoy,Omen,Jett,Skye"
Lotus,Parallax,Wolf Pack (OCE),11,13,5,7,6,6,"Raze,Killjoy,Viper,Omen,Fade","Breach,Raze,Killjoy,Viper,Omen"
Lotus,AXKRUM GC,YOSO GC,13,10,7,4,6,6,"Raze,Killjoy,Viper,Omen,Fade","Raze,Killjoy,Omen,Fade,Gekko"
Icebox,FURIA GC,VIC - Team Vae Victis,14,12,9,4,8,5,"Sova,Killjoy,Viper,Jett,Gekko","Sova,Killjoy,Jett,Astra,Harbor"
Icebox,100 Thieves,LOUD,13,4,3,2,2,10,"Sova,Killjoy,Viper,Jett,Gekko","Sova,Killjoy,Viper,Jett,Harbor"
Ascent,curralzinho,OVB Purple,13,0,1,0,0,12,"Sova,Killjoy,Omen,Jett,KAY/O","Killjoy,Omen,Jett,Skye,Gekko"
Lotus,donas da bala,Truedata GC,13,10,8,4,6,5,"Raze,Killjoy,Viper,Omen,Fade","Raze,Killjoy,Jett,Gekko,Clove"
Ascent,DreamMax GC,Porteiras do Imortal,13,5,4,2,3,9,"Sova,Killjoy,Omen,Jett,KAY/O","Sova,Killjoy,Omen,Jett,KAY/O"
Lotus,TBS GC,Abobras,13,4,9,3,1,4,"Raze,Killjoy,Viper,Omen,Fade","Breach,Raze,Killjoy,Omen,Fade"
Icebox,curralzinho,OVB Purple,13,0,1,0,0,12,"Sova,Killjoy,Reyna,Harbor,Gekko","Sova,Killjoy,Viper,Sage,Jett"
Bind,100 Thieves,LOUD,13,6,5,2,4,8,"Raze,Viper,Brimstone,Fade,Gekko","Breach,Raze,Viper,Brimstone,KAY/O"
Icebox,AXKRUM GC,YOSO GC,13,10,6,5,5,7,"Sova,Killjoy,Jett,Harbor,Gekko","Killjoy,Omen,Jett,Harbor,Gekko"
Bind,FURIA GC,VIC - Team Vae Victis,13,11,5,7,4,8,"Raze,Viper,Brimstone,Skye,Gekko","Raze,Cypher,Viper,Brimstone,Gekko"
Bind,SAGE QUE DEUS QUISER,2K Gaming Lunar,13,2,11,1,1,2,"Raze,Cypher,Brimstone,Chamber,Fade","Raze,Viper,Brimstone,Skye,Gekko"
Bind,bom dia sofia e amigas,CRONOS CRO,13,5,4,2,3,9,"Raze,Cypher,Phoenix,Brimstone,Gekko","Raze,Cypher,Brimstone,Skye,Fade"
Sunset,donas da bala,Truedata GC,13,5,5,1,4,8,"Raze,Cypher,Omen,KAY/O,Gekko","Raze,Cypher,Skye,Gekko,Clove"
Split,Athena's e-Sports,Higashi nine,13,2,2,1,1,11,"Raze,Cypher,Viper,Omen,Skye","Raze,Cypher,Omen,Skye,Gekko"
Breeze,Fourth Wall,JCG,13,3,3,1,2,10,"Cypher,Sova,Viper,Jett,KAY/O","Cypher,Sova,Viper,Jett,KAY/O"
Ascent,sem fazer careta,Whtever,13,4,4,1,3,9,"Sova,Killjoy,Jett,KAY/O,Clove","Sova,Killjoy,Omen,Jett,KAY/O"
Ascent,Unity Brasil,ZAGAS,3,13,3,9,4,0,"Sova,Viper,Phoenix,Deadlock,Clove","Sova,Killjoy,Omen,Jett,KAY/O"
Ascent,Shaboozey's Slimes,Medics,13,9,4,6,3,9,"Sova,Killjoy,Omen,Jett,KAY/O","Sova,Killjoy,Omen,Jett,KAY/O"
Bind,DreamMax GC,Porteiras do Imortal,13,4,9,3,1,4,"Raze,Brimstone,Skye,Chamber,Clove","Raze,Cypher,Brimstone,Reyna,Skye"
Sunset,BLOOD Stars,MAGIK ESPORTS,13,3,10,2,1,3,"Raze,Cypher,Omen,Jett,Gekko","Raze,Cypher,Sova,Omen,Gekko"
Split,Purpose Gaming,Spate Esports,11,13,6,6,7,5,"Breach,Raze,Cypher,Omen,Fade","Raze,Cypher,Omen,Jett,Skye"
Lotus,RENEGADAS,Armadas e Tiltadas,13,1,11,1,0,2,"Raze,Omen,Chamber,Fade,Deadlock","Killjoy,Sage,Reyna,Skye,Astra"
Lotus,RKT pANcaDELAS,Filhas da P...otter,13,4,9,3,1,4,"Breach,Raze,Omen,Chamber,Fade","Raze,Killjoy,Omen,Skye,Gekko"
Icebox,sou proplayer lixo?,IT GIRLS TEAM,13,0,12,0,0,1,"Sova,Killjoy,Viper,Jett,Gekko","Raze,Killjoy,Viper,Sage,Gekko"
Lotus,VHL Valhalla,VLA Gaming GC,13,4,3,2,2,10,"Raze,Omen,Chamber,Fade,Deadlock","Breach,Raze,Killjoy,Skye,Astra"
Breeze,Predator X Gaming,ST x WTP,15,13,6,8,5,9,"Cypher,Sova,Viper,Jett,KAY/O","Cypher,Sova,Viper,Jett,KAY/O"
Icebox,TBS GC,Abobras,13,11,7,5,6,6,"Sova,Killjoy,Jett,Harbor,Gekko","Sova,Killjoy,Jett,Harbor,Clove"
Split,Fourth Wall,JCG,13,1,11,1,0,2,"Raze,Cypher,Viper,Omen,Skye","Raze,Cypher,Omen,Chamber,Gekko"
Lotus,bom dia sofia e amigas,CRONOS CRO,13,6,7,5,1,6,"Raze,Killjoy,Phoenix,Omen,Gekko","Raze,Killjoy,Omen,Fade,Gekko"
Ascent,RENEGADAS,Armadas e Tiltadas,13,1,1,1,0,12,"Sova,Killjoy,Omen,Jett,KAY/O","Killjoy,Sage,Reyna,Astra,KAY/O"
Sunset,sem fazer careta,Whtever,13,6,6,6,0,7,"Raze,Cypher,Phoenix,Omen,Gekko","Cypher,Sova,Omen,Jett,Gekko"
Sunset,SAGE QUE DEUS QUISER,2K Gaming Lunar,13,11,3,9,2,10,"Raze,Cypher,Omen,Neon,Gekko","Breach,Raze,Sage,Omen,Gekko"
Ascent,sou proplayer lixo?,IT GIRLS TEAM,13,3,4,0,3,9,"Sova,Killjoy,Omen,Jett,KAY/O","Raze,Sova,Killjoy,Reyna,Omen"
Bind,Athena's e-Sports,Higashi nine,13,3,2,2,1,11,"Raze,Sova,Viper,Brimstone,Skye","Raze,Viper,Brimstone,Skye,Gekko"
Split,VHL Valhalla,VLA Gaming GC,13,4,5,0,4,8,"Raze,Cypher,Viper,Omen,Skye","Sova,Killjoy,Jett,Astra,Gekko"
Bind,RKT pANcaDELAS,Filhas da P...otter,13,2,10,2,0,3,"Breach,Raze,Cypher,Brimstone,Skye","Cypher,Viper,Jett,Harbor,Gekko"
Bind,Unity Brasil,ZAGAS,7,13,3,5,8,4,"Raze,Viper,Brimstone,Skye,Gekko","Raze,Brimstone,Skye,Gekko,Deadlock"
Lotus,BLOOD Stars,MAGIK ESPORTS,13,7,7,1,6,6,"Raze,Killjoy,Omen,Astra,Gekko","Raze,Killjoy,Omen,Fade,Gekko"
Ascent,Cloud9,G2 Esports,13,15,8,6,9,5,"Killjoy,Viper,Omen,Jett,Skye","Sova,Killjoy,Omen,Jett,KAY/O"
Lotus,Cloud9,G2 Esports,6,13,1,6,7,5,"Raze,Killjoy,Viper,Omen,Gekko","Raze,Killjoy,Viper,Omen,Fade"
Icebox,The Ultimates,The Vicious,13,11,7,5,6,6,"Sova,Killjoy,Viper,Sage,Jett","Sova,Killjoy,Viper,Sage,Jett"
Split,Natus Vincere,Team Heretics,9,13,6,6,7,3,"Breach,Raze,Viper,Omen,Fade","Raze,Cypher,Viper,Omen,Skye"
Ascent,The Ultimates,The Vicious,11,13,3,9,4,8,"Sova,Killjoy,Omen,Jett,KAY/O","Sova,Killjoy,Jett,Astra,KAY/O"
Lotus,Natus Vincere,Team Heretics,11,13,7,5,8,4,"Breach,Raze,Killjoy,Brimstone,Gekko","Breach,Raze,Cypher,Omen,Fade"
Breeze,Team Falcons,G3 Esports,13,1,11,1,0,2,"Cypher,Sova,Viper,Yoru,KAY/O","Sova,Viper,Jett,Yoru,Chamber"
Lotus,The Ultimates,The Vicious,13,11,6,6,5,7,"Breach,Cypher,Sova,Omen,Neon","Raze,Killjoy,Omen,Jett,Skye"
Split,Team Falcons,G3 Esports,13,4,9,3,1,4,"Breach,Raze,Cypher,Omen,Skye","Breach,Raze,Cypher,Omen,Jett"
Lotus,FNATIC,Team Liquid,13,5,2,4,1,11,"Raze,Killjoy,Viper,Omen,Fade","Breach,Raze,Cypher,Sova,Omen"
Icebox,FNATIC,Team Liquid,12,14,5,8,6,7,"Sova,Killjoy,Viper,Sage,Jett","Sova,Viper,Sage,Reyna,Chamber"
Ascent,FNATIC,Team Liquid,13,11,3,9,2,10,"Sova,Killjoy,Omen,Jett,KAY/O","Cypher,Sova,Omen,Jett,KAY/O"
Bind,Murash Gaming,Crest Gaming ZST,13,10,8,3,7,5,"Raze,Viper,Reyna,Gekko,Clove","Raze,Cypher,Viper,Omen,Skye"
Bind,Corn Dogs (OCE),VEND,13,7,6,2,5,7,"Raze,Viper,Skye,Yoru,Clove","Raze,Viper,Brimstone,Reyna,Skye"
Split,club penguin,Team Average,13,9,9,1,8,4,"Raze,Cypher,Sage,Skye,Clove","Raze,Cypher,Omen,Jett,Skye"
Ascent,After Life Esports,Bandits OCE,6,13,4,8,5,2,"Sova,Killjoy,Omen,Jett,KAY/O","Sova,Killjoy,Omen,Yoru,KAY/O"
Ascent,Corn Dogs (OCE),VEND,7,13,4,4,9,3,"Sova,Killjoy,Omen,Jett,KAY/O","Sova,Killjoy,Omen,Yoru,Clove"
Bind,club penguin,Team Average,13,5,5,1,4,8,"Raze,Cypher,Skye,Gekko,Clove","Raze,Brimstone,Chamber,Fade,Gekko"
Ascent,Murash Gaming,Crest Gaming ZST,8,13,4,5,8,4,"Sova,Killjoy,Omen,Jett,KAY/O","Sova,Killjoy,Omen,Jett,KAY/O"
Icebox,Slice of Life,Elite 5,13,3,3,1,2,10,"Sova,Killjoy,Viper,Phoenix,Jett","Sova,Killjoy,Viper,Sage,Jett"
Split,Xu Gang,Tiny Turtle Squad,13,3,10,2,1,3,"Breach,Raze,Cypher,Omen,Deadlock","Raze,Cypher,Viper,Omen,Skye"
Sunset,Koopa Troopas,Wolf Pack (OCE),13,7,9,3,4,4,"Breach,Raze,Cypher,Omen,Fade","Breach,Raze,Cypher,Omen,Gekko"
Breeze,Peace & Love,Parallax,13,6,8,4,2,5,"Cypher,Sova,Reyna,Neon,Harbor","Cypher,Sova,Viper,Jett,Yoru"
Bind,After Life Esports,Bandits OCE,8,13,5,7,6,3,"Raze,Viper,KAY/O,Gekko,Clove","Raze,Viper,Skye,Yoru,Clove"
Ascent,Funcrew,Burger clan,13,9,6,6,3,7,"Sova,Killjoy,Omen,Jett,KAY/O","Cypher,Sova,Jett,KAY/O,Clove"
Lotus,Corn Dogs (OCE),VEND,13,8,5,7,1,8,"Raze,Killjoy,Omen,Fade,Gekko","Breach,Raze,Killjoy,Reyna,Astra"
Lotus,Xu Gang,Tiny Turtle Squad,13,3,4,0,3,9,"Raze,Sova,Killjoy,Omen,KAY/O","Viper,Omen,Chamber,Neon,Gekko"
Lotus,Slice of Life,Elite 5,13,6,4,3,3,9,"Breach,Raze,Killjoy,Phoenix,Omen","Raze,Phoenix,Omen,Chamber,Gekko"
Ascent,Peace & Love,Parallax,13,3,9,3,0,4,"Sova,Phoenix,Sage,Omen,Neon","Cypher,Sova,Omen,Jett,KAY/O"
Breeze,Funcrew,Burger clan,13,8,5,4,4,8,"Cypher,Sova,Viper,Jett,Yoru","Cypher,Sova,Viper,Reyna,Jett"
Sunset,Murash Gaming,Crest Gaming ZST,13,9,6,4,5,7,"Sova,Phoenix,Sage,Omen,Clove","Breach,Raze,Cypher,Omen,Gekko"
Lotus,After Life Esports,Bandits OCE,13,6,8,4,2,5,"Raze,Killjoy,Viper,Omen,Fade","Raze,Killjoy,Yoru,Astra,Fade"
Ascent,club penguin,Team Average,13,15,3,11,4,10,"Sova,Killjoy,Omen,Jett,KAY/O","Sova,Killjoy,Omen,Jett,Skye"
Icebox,VARREL,IGZIST,13,10,8,3,7,5,"Killjoy,Viper,Jett,KAY/O,Gekko","Killjoy,Viper,Jett,KAY/O,Gekko"
Breeze,VARREL,IGZIST,13,4,3,2,2,10,"Cypher,Sova,Viper,Jett,KAY/O","Cypher,Sova,Viper,Jett,Yoru"
Ascent,UNLP Esports,Cruzados Esports,8,13,2,7,6,6,"Sova,Killjoy,Omen,Jett,KAY/O","Sova,Killjoy,Omen,Jett,KAY/O"
Bind,UNLP Esports,Cruzados Esports,14,12,9,4,8,5,"Breach,Raze,Viper,Brimstone,Gekko","Raze,Cypher,Brimstone,Reyna,Skye"
Icebox,CO-OP,SAGAZ,8,13,4,8,5,4,"Sova,Killjoy,Viper,Jett,Gekko","Sova,Killjoy,Viper,Sage,Jett"
Sunset,Resonate,Dough Bros,8,13,6,6,7,2,"Raze,Cypher,Omen,KAY/O,Gekko","Breach,Raze,Cypher,Sova,Omen"
Sunset,Reven eClub,CONTRAxSCRUB,13,8,6,6,2,7,"Breach,Raze,Cypher,Sova,Omen","Breach,Raze,Cypher,Omen,Fade"
Split,CO-OP,SAGAZ,8,13,5,7,6,3,"Raze,Cypher,Viper,Omen,Skye","Raze,Cypher,Viper,Omen,Skye"
Ascent,Resonate,Dough Bros,3,13,3,9,4,0,"Sova,Killjoy,Sage,Omen,Jett","Sova,Killjoy,Omen,Jett,KAY/O"
Ascent,Border Monsters Chile,Stone Esports,12,14,5,8,6,7,"Sova,Killjoy,Omen,Jett,KAY/O","Sova,Killjoy,Omen,Jett,KAY/O"
Split,Reven eClub,CONTRAxSCRUB,13,6,6,6,0,7,"Breach,Raze,Cypher,Omen,Gekko","Raze,Cypher,Omen,Skye,Fade"
Lotus,CO-OP,SAGAZ,13,11,6,6,5,7,"Raze,Killjoy,Viper,Omen,Fade","Raze,Killjoy,Viper,Omen,Fade"
Sunset,Border Monsters Chile,Stone Esports,10,13,6,5,8,4,"Raze,Cypher,Omen,KAY/O,Gekko","Raze,Cypher,Omen,Fade,Clove"
Ascent,Reven eClub,CONTRAxSCRUB,13,5,4,2,3,9,"Cypher,Sova,Omen,Jett,KAY/O","Sova,Killjoy,Omen,Jett,KAY/O"
Breeze,Thinking Men,Dough Bros,9,13,6,6,7,3,"Sova,Viper,Jett,Yoru,Astra","Cypher,Sova,Viper,Jett,KAY/O"
Ascent,B8 Esports,Szach Mat,13,9,5,7,2,8,"Cypher,Sova,Phoenix,Omen,Jett","Sova,Killjoy,Omen,Jett,KAY/O"
Ascent,CO-OP,SAGAZ,12,14,3,10,4,9,"Sova,Killjoy,Omen,Jett,KAY/O","Sova,Killjoy,Omen,Jett,KAY/O"
Sunset,Thinking Men,Dough Bros,8,13,2,7,6,6,"Breach,Raze,Sage,Omen,Gekko","Breach,Raze,Cypher,Sova,Omen"
Bind,B8 Esports,Szach Mat,13,6,7,5,1,6,"Raze,Cypher,Viper,Brimstone,Skye","Raze,Viper,Brimstone,Skye,Gekko"
Icebox,TeamOrangeGaming,XPERION NXT,14,16,5,10,6,9,"Killjoy,Viper,Reyna,Jett,Gekko","Sova,Killjoy,Viper,Sage,Jett"
Icebox,Termina Enjoyers,QLASH,8,13,3,6,7,5,"Sova,Killjoy,Viper,Jett,Harbor","Killjoy,Viper,Jett,KAY/O,Gekko"
Bind,NAPOLYON,Eternal Fire,10,13,8,4,9,2,"Raze,Viper,Brimstone,Skye,Gekko","Raze,Viper,Omen,KAY/O,Gekko"
Breeze,Termina Enjoyers,QLASH,0,13,0,12,1,0,"Cypher,Sova,Viper,Jett,KAY/O","Cypher,Sova,Viper,Reyna,Jett"
Lotus,B8 Esports,Szach Mat,9,13,5,7,6,4,"Raze,Killjoy,Viper,Omen,Fade","Raze,Killjoy,Viper,Omen,Skye"
Ascent,TeamOrangeGaming,XPERION NXT,9,13,3,7,6,6,"Sova,Killjoy,Jett,Yoru,Astra","Sova,Killjoy,Omen,Jett,KAY/O"
Icebox,NAPOLYON,Eternal Fire,9,13,5,5,8,4,"Sova,Killjoy,Viper,Sage,Jett","Raze,Killjoy,Viper,KAY/O,Gekko"
Bind,Termina Enjoyers,QLASH,13,15,6,8,7,7,"Raze,Viper,Brimstone,Skye,Yoru","Breach,Raze,Viper,Gekko,Clove"
Bind,Sila4i,Szach Mat,10,13,4,7,6,6,"Raze,Viper,Omen,Skye,Gekko","Raze,Viper,Brimstone,Skye,Gekko"
Sunset,ALTERNATE aTTaX,TeamOrangeGaming,13,8,8,4,4,5,"Raze,Cypher,Omen,KAY/O,Gekko","Cypher,Omen,Jett,Skye,Yoru"
Lotus,NAPOLYON,Eternal Fire,11,13,8,4,9,3,"Raze,Killjoy,Viper,Omen,Fade","Breach,Raze,Viper,Omen,Gekko"
Ascent,Termina Enjoyers,QLASH,13,11,5,7,4,8,"Sova,Killjoy,Phoenix,Omen,Jett","Cypher,Sova,Omen,Jett,KAY/O"
Icebox,ALTERNATE aTTaX,TeamOrangeGaming,13,8,5,4,4,8,"Killjoy,Viper,Jett,KAY/O,Gekko","Killjoy,Viper,Reyna,Jett,Gekko"
Sunset,Sila4i,Szach Mat,14,12,9,4,8,5,"Raze,Cypher,Viper,Omen,Gekko","Cypher,Sova,Omen,KAY/O,Neon"
Breeze,NAPOLYON,Eternal Fire,13,8,6,3,5,7,"Cypher,Sova,Viper,Omen,Jett","Cypher,Sova,Viper,Jett,Skye"
Lotus,Sila4i,Szach Mat,6,13,6,6,7,0,"Breach,Raze,Killjoy,Brimstone,Gekko","Raze,Killjoy,Viper,Omen,Skye"
Lotus,Murash Gaming,SCARZ,9,13,5,5,8,4,"Raze,Cypher,Sova,Omen,KAY/O","Breach,Sova,Killjoy,Omen,Jett"
Sunset,Murash Gaming,SCARZ,13,15,6,8,7,7,"Sova,Phoenix,Sage,Omen,Clove","Raze,Cypher,Omen,KAY/O,Gekko"
Bind,VARREL,RIDDLE ORDER,10,13,6,6,7,4,"Raze,Viper,Brimstone,Skye,Gekko","Raze,Viper,Omen,Skye,Yoru"
Breeze,VARREL,RIDDLE ORDER,13,3,4,0,3,9,"Cypher,Sova,Viper,Jett,KAY/O","Sova,Viper,Omen,Jett,Yoru"
Split,VARREL,RIDDLE ORDER,11,13,3,9,4,8,"Raze,Cypher,Viper,Omen,Skye","Raze,Viper,Omen,Jett,Skye"
Ascent,K7 Esports GC,MYVRA,8,13,3,9,4,5,"Sova,Killjoy,Phoenix,Omen,Jett","Sova,Killjoy,Omen,Jett,KAY/O"
Split,OLIMPO,CO-OP,13,9,6,6,3,7,"Raze,Viper,Omen,Jett,Skye","Raze,Cypher,Viper,Omen,Skye"
Icebox,K7 Esports GC,MYVRA,9,13,6,4,9,3,"Sova,Killjoy,Viper,Sage,Jett","Sova,Killjoy,Viper,Jett,Harbor"
Bind,Resonate,Blinn Esports,4,13,1,4,9,3,"Raze,Cypher,Viper,Brimstone,Skye","Raze,Viper,Brimstone,KAY/O,Gekko"
Sunset,OLIMPO,CO-OP,13,9,4,6,3,9,"Raze,Cypher,Omen,KAY/O,Gekko","Cypher,Sova,Omen,KAY/O,Neon"
Split,Resonate,Blinn Esports,7,13,1,11,2,6,"Raze,Cypher,Sage,Omen,Jett","Raze,Cypher,Viper,Omen,Skye"
Lotus,Cruzados Esports GC,9z Team GC,8,13,3,6,7,5,"Raze,Killjoy,Viper,Omen,Fade","Breach,Raze,Killjoy,Omen,Gekko"
Ascent,OLIMPO,CO-OP,12,14,6,7,7,6,"Sova,Killjoy,Omen,Jett,KAY/O","Sova,Killjoy,Omen,Jett,KAY/O"
Bind,Cruzados Esports GC,9z Team GC,5,13,2,10,3,3,"Raze,Viper,Brimstone,Fade,Gekko","Breach,Raze,Cypher,Brimstone,Fade"
Bind,Thinking Men,Resonate,9,13,5,7,6,4,"Raze,Viper,Omen,Skye,Gekko","Raze,Cypher,Viper,Brimstone,Skye"
Sunset,Incognito,B8 Esports,13,9,6,6,3,7,"Breach,Raze,Cypher,Sova,Omen","Breach,Raze,Cypher,Omen,Gekko"
Lotus,SAGAZ,Spirit Academy,13,6,6,1,5,7,"Raze,Killjoy,Viper,Omen,Fade","Raze,Killjoy,Viper,Omen,Fade"
Breeze,Incognito,B8 Esports,10,13,4,7,6,6,"Cypher,Sova,Viper,Reyna,Jett","Cypher,Sova,Viper,Jett,Yoru"
Ascent,Thinking Men,Resonate,11,13,4,8,5,7,"Sova,Killjoy,Omen,Jett,KAY/O","Sova,Killjoy,Sage,Omen,Jett"
Breeze,Dough Bros,Blinn Esports,12,14,7,6,8,5,"Cypher,Sova,Viper,Jett,KAY/O","Cypher,Sova,Viper,Jett,Yoru"
Split,SAGAZ,Spirit Academy,13,11,8,4,7,5,"Raze,Cypher,Viper,Omen,Skye","Breach,Raze,Viper,Omen,Skye"
Sunset,Dough Bros,Blinn Esports,5,13,2,4,9,3,"Breach,Raze,Cypher,Sova,Omen","Raze,Cypher,Omen,KAY/O,Gekko"
Split,Thinking Men,Resonate,13,3,9,3,0,4,"Raze,Cypher,Viper,Omen,Skye","Raze,Cypher,Sage,Omen,Jett"
Sunset,XPERION NXT,RIZON,13,11,8,4,7,5,"Raze,Cypher,Reyna,Omen,KAY/O","Breach,Raze,Cypher,Omen,Gekko"
Split,Incognito,B8 Esports,13,11,7,5,6,6,"Raze,Cypher,Sage,Omen,Jett","Raze,Viper,Omen,Yoru,Fade"
Ascent,NAPOLYON,PCIFIC Espor,8,13,1,8,5,7,"Sova,Killjoy,Omen,Jett,KAY/O","Sova,Killjoy,Omen,Jett,KAY/O"
Breeze,GTZ Esports,ehehxd,13,7,7,5,2,6,"Cypher,Sova,Viper,Jett,Yoru","Cypher,Sova,Viper,Reyna,Jett"
Ascent,Termina Enjoyers,LONETEAM,14,16,9,6,10,5,"Sova,Killjoy,Phoenix,Omen,Jett","Sova,Killjoy,Omen,Jett,KAY/O"
Lotus,XPERION NXT,RIZON,13,4,10,2,2,3,"Killjoy,Viper,Omen,Neon,Gekko","Breach,Sova,Killjoy,Omen,Jett"
Bind,B8 Esports,Szach Mat,13,6,4,3,3,9,"Raze,Cypher,Viper,Brimstone,Skye","Raze,Viper,Brimstone,Skye,Gekko"
Bind,NAPOLYON,PCIFIC Espor,14,16,5,10,6,9,"Raze,Viper,Brimstone,Skye,Gekko","Raze,Viper,Omen,Skye,Gekko"
Lotus,GTZ Esports,ehehxd,15,13,10,4,9,5,"Breach,Raze,Cypher,Omen,Fade","Breach,Raze,Sova,Killjoy,Omen"
Icebox,Termina Enjoyers,LONETEAM,11,13,4,8,5,7,"Sova,Killjoy,Viper,Jett,Harbor","Sova,Killjoy,Viper,Reyna,Jett"
Bind,RIZON,TeamOrangeGaming,7,13,4,8,5,3,"Raze,Viper,Brimstone,Skye,Gekko","Viper,Brimstone,Jett,Skye,Yoru"
Breeze,B8 Esports,Szach Mat,13,11,5,7,4,8,"Cypher,Sova,Viper,Jett,Yoru","Cypher,Sova,Viper,Jett,KAY/O"
Lotus,NAPOLYON,PCIFIC Espor,13,9,8,2,7,5,"Raze,Killjoy,Viper,Omen,Fade","Breach,Raze,Killjoy,Omen,Fade"
Sunset,ALTERNATE aTTaX,XPERION NXT,13,3,10,2,1,3,"Raze,Cypher,Omen,KAY/O,Gekko","Raze,Cypher,Sage,Omen,KAY/O"
Breeze,Termina Enjoyers,LONETEAM,13,9,7,3,6,6,"Cypher,Sova,Viper,Jett,KAY/O","Cypher,Sova,Viper,Yoru,KAY/O"
Ascent,RIZON,TeamOrangeGaming,13,7,9,3,4,4,"Sova,Killjoy,Omen,Jett,KAY/O","Sova,Killjoy,Jett,Yoru,Astra"
Lotus,Digital Athletics,Eternal Fire,4,13,1,4,9,3,"Raze,Cypher,Omen,Fade,Gekko","Breach,Raze,Viper,Omen,Gekko"
Lotus,B8 Esports,Szach Mat,13,15,11,3,12,2,"Raze,Killjoy,Viper,Omen,Fade","Raze,Killjoy,Viper,Omen,Skye"
Split,ALTERNATE aTTaX,XPERION NXT,13,10,7,4,6,6,"Breach,Raze,Cypher,Omen,Skye","Raze,Cypher,Viper,Omen,Skye"
Breeze,RIZON,TeamOrangeGaming,7,13,5,7,6,2,"Cypher,Sova,Viper,Jett,Yoru","Cypher,Sova,Viper,Jett,Yoru"
Sunset,Termina Enjoyers,LONETEAM,8,13,6,6,7,2,"Raze,Cypher,Omen,Yoru,Gekko","Breach,Raze,Cypher,Sova,Omen"
Lotus,Incognito,Sila4i,13,4,8,4,0,5,"Breach,Raze,Sova,Killjoy,Omen","Breach,Raze,Killjoy,Brimstone,Gekko"
Split,Digital Athletics,Eternal Fire,9,13,8,4,9,1,"Raze,Viper,Omen,Jett,Skye","Breach,Raze,Viper,Skye,Clove"
Icebox,Incognito,Sila4i,10,13,7,5,8,3,"Sova,Killjoy,Viper,Reyna,Jett","Sova,Killjoy,Viper,Jett,KAY/O"
Breeze,Incognito,Sila4i,13,6,6,1,5,7,"Cypher,Sova,Viper,Reyna,Jett","Cypher,Sova,Viper,Jett,KAY/O"
Ascent,SCARZ,Crest Gaming ZST,13,8,5,4,4,8,"Killjoy,Omen,Jett,KAY/O,Fade","Sova,Killjoy,Omen,Jett,KAY/O"
Bind,SCARZ,Crest Gaming ZST,10,13,8,4,9,2,"Raze,Viper,Brimstone,Skye,Gekko","Raze,Cypher,Viper,Omen,Skye"
Sunset,IGZIST,RIDDLE ORDER,10,13,5,7,6,5,"Raze,Cypher,Omen,KAY/O,Gekko","Raze,Cypher,Omen,KAY/O,Gekko"
Ascent,Maru Gaming,fOu Clan,10,13,4,7,6,6,"Breach,Sova,Killjoy,Omen,Jett","Sova,Killjoy,Omen,Jett,KAY/O"
Lotus,SCARZ,Crest Gaming ZST,13,5,3,3,2,10,"Breach,Sova,Killjoy,Omen,Jett","Raze,Killjoy,Viper,Omen,Fade"
Breeze,IGZIST,RIDDLE ORDER,7,13,3,5,8,4,"Cypher,Sova,Viper,Jett,Yoru","Sova,Viper,Omen,Jett,Yoru"
Sunset,Maru Gaming,fOu Clan,14,16,6,9,7,8,"Raze,Cypher,Viper,Omen,Fade","Raze,Cypher,Phoenix,Astra,Fade"
Breeze,Maru Gaming,fOu Clan,13,6,7,5,1,6,"Cypher,Sova,Viper,Jett,Yoru","Cypher,Sova,Viper,Jett,KAY/O"
Lotus,ENVEE YSL,UCF Gold,6,13,4,3,10,2,"Raze,Killjoy,Viper,Omen,Fade","Raze,Killjoy,Viper,Omen,Fade"
Sunset,ENVEE YSL,UCF Gold,7,13,5,3,10,2,"Breach,Raze,Cypher,Omen,Gekko","Raze,Cypher,Omen,KAY/O,Gekko"
Split,CO-OP,Spirit Academy,13,9,7,5,4,6,"Raze,Cypher,Viper,Omen,Skye","Breach,Raze,Cypher,Omen,Skye"
Icebox,G2 Esports,LOUD,4,13,3,9,4,1,"Sova,Killjoy,Viper,Harbor,Gekko","Sova,Killjoy,Viper,Jett,Harbor"
Ascent,UCF Gold,WASTED TALENT,13,10,7,5,5,6,"Sova,Killjoy,Omen,Jett,KAY/O","Sova,Killjoy,Omen,Jett,KAY/O"
Lotus,Rush Hour,ENVEE YSL,10,13,5,6,7,5,"Raze,Killjoy,Viper,Omen,Fade","Raze,Killjoy,Viper,Omen,Fade"
Lotus,CO-OP,Spirit Academy,13,11,10,2,9,3,"Raze,Killjoy,Viper,Omen,Fade","Raze,Killjoy,Viper,Omen,Fade"
Lotus,Winthrop University,Fisher Falcons,7,13,3,9,4,4,"Raze,Killjoy,Viper,Omen,Fade","Raze,Killjoy,Viper,Omen,Fade"
Ascent,UC Irvine,CSUF Orange,13,5,10,2,3,3,"Sova,Killjoy,Omen,Jett,KAY/O","Sova,Killjoy,Omen,Jett,KAY/O"
Sunset,Maxim Shepelev,Puppy Cuddle Pile,6,13,4,8,5,2,"Breach,Raze,Cypher,Omen,Gekko","Breach,Raze,Cypher,Astra,Fade"
Sunset,Chamber 1 trick,WASTED TALENT,6,13,2,5,8,4,"Breach,Raze,Cypher,Omen,Gekko","Raze,Cypher,Sova,Omen,Gekko"
Bind,G2 Esports,LOUD,11,13,6,6,7,5,"Raze,Viper,Brimstone,Skye,Gekko","Breach,Raze,Viper,Brimstone,KAY/O"
Ascent,2 Arbres 3 quebs,Rush Hour,6,13,5,7,6,1,"Sova,Killjoy,Omen,Jett,KAY/O","Sova,Killjoy,Omen,Jett,KAY/O"
Lotus,ENVEE YSL,Fractal Gaming,13,8,6,6,2,7,"Raze,Killjoy,Viper,Omen,Fade","Raze,Killjoy,Viper,Omen,Fade"
Icebox,UC Irvine,CSUF Orange,13,6,6,6,0,7,"Killjoy,Viper,Jett,KAY/O,Gekko","Sova,Killjoy,Viper,Jett,Harbor"
Bind,Winthrop University,Fisher Falcons,13,11,9,3,8,4,"Raze,Viper,Brimstone,Reyna,Skye","Breach,Viper,Phoenix,Brimstone,KAY/O"
Split,Maxim Shepelev,Puppy Cuddle Pile,11,13,5,7,6,6,"Raze,Cypher,Omen,Jett,Skye","Raze,Viper,Jett,Skye,Clove"
Sunset,OLIMPO,SAGAZ,13,6,8,4,2,5,"Raze,Cypher,Omen,KAY/O,Gekko","Raze,Cypher,Omen,KAY/O,Gekko"
Ascent,Imperial Titans,UCF Gold,8,13,2,7,6,6,"Sova,Killjoy,Omen,Jett,KAY/O","Sova,Killjoy,Omen,Jett,KAY/O"
Bind,2 Arbres 3 quebs,swagged out,13,3,9,3,0,4,"Raze,Brimstone,Skye,Harbor,Gekko","Raze,Viper,Brimstone,Skye,Gekko"
Icebox,WASTED TALENT,U4RIA Radiata,13,9,7,3,6,6,"Sova,Killjoy,Viper,Reyna,Jett","Sova,Killjoy,Viper,Sage,Jett"
Sunset,Cloud9,MIBR,13,9,8,4,5,5,"Raze,Cypher,Viper,Omen,Skye","Raze,Cypher,Viper,Omen,Skye"
Breeze,ENVEE YSL,ST x WTP,13,11,6,6,5,7,"Cypher,Sova,Viper,Jett,Yoru","Cypher,Sova,Viper,Jett,KAY/O"
Lotus,Maxim Shepelev,Puppy Cuddle Pile,13,9,7,3,6,6,"Breach,Raze,Killjoy,Omen,Gekko","Raze,Phoenix,Omen,Chamber,Fade"
Sunset,UC Irvine,CSUF Orange,13,7,6,6,1,7,"Raze,Cypher,Omen,KAY/O,Gekko","Raze,Cypher,Reyna,Omen,Fade"
Sunset,Winthrop University,Fisher Falcons,11,13,7,5,8,4,"Breach,Raze,Cypher,Omen,Fade","Breach,Raze,Cypher,Omen,Gekko"
Sunset,Shirtless Gamers,UCF Gold,3,13,2,10,3,1,"Raze,Cypher,Omen,KAY/O,Gekko","Raze,Cypher,Omen,KAY/O,Gekko"
Lotus,92' Dream Team,Chamber 1 trick,3,13,2,2,11,1,"Raze,Killjoy,Omen,Fade,Gekko","Raze,Killjoy,Viper,Gekko,Clove"
Ascent,Fractal Gaming,:D,13,7,5,3,4,8,"Sova,Killjoy,Omen,Jett,KAY/O","Killjoy,Viper,Omen,Yoru,Fade"
Breeze,UST Esports,TAMU Maroon,13,11,10,2,9,3,"Cypher,Sova,Viper,Jett,KAY/O","Cypher,Sova,Viper,Yoru,Astra"
Lotus,Imperial Titans,LazerrFreeks8,14,12,8,5,7,6,"Raze,Killjoy,Viper,Omen,Fade","Raze,Killjoy,Omen,Fade,Gekko"
Icebox,NoPrac,WASTED TALENT,8,13,4,8,5,4,"Sova,Killjoy,Viper,Jett,Gekko","Sova,Killjoy,Reyna,Jett,Harbor"
Lotus,Rush Hour,Spate Esports,13,8,9,3,5,4,"Raze,Killjoy,Viper,Omen,Fade","Breach,Raze,Cypher,Omen,Gekko"
Icebox,OLIMPO,SAGAZ,10,13,5,7,6,5,"Killjoy,Viper,Reyna,KAY/O,Gekko","Sova,Killjoy,Viper,Sage,Jett"
Icebox,Winthrop University,Fisher Falcons,7,13,5,3,10,2,"Sova,Killjoy,Viper,Reyna,Jett","Sova,Killjoy,Viper,Reyna,Jett"
Split,2 Arbres 3 quebs,Big Sniffuhs,14,12,7,6,6,7,"Raze,Cypher,Viper,Omen,Skye","Raze,Cypher,Omen,Skye,Gekko"
Lotus,Raven Esports,ENVEE YSL,7,13,7,5,8,0,"Breach,Killjoy,Omen,Neon,Fade","Raze,Killjoy,Viper,Omen,Fade"
Icebox,Puppy Cuddle Pile,mesos millionaires,13,5,4,2,3,9,"Sova,Killjoy,Viper,Sage,Jett","Sova,Viper,Reyna,Jett,Deadlock"
Lotus,92' Dream Team,OverTheWeather,13,7,7,1,6,6,"Raze,Killjoy,Omen,Fade,Gekko","Raze,Killjoy,Omen,Fade,Gekko"
Ascent,Bean Bois,Imperial Titans,2,13,0,3,10,2,"Breach,Raze,Omen,Chamber,Deadlock","Sova,Killjoy,Omen,Jett,KAY/O"
Split,UC Irvine,CSUF Orange,11,13,8,4,9,3,"Cypher,Sova,Viper,Omen,Iso","Raze,Viper,Jett,Skye,Astra"
Split,UST Esports,TAMU Maroon,13,7,5,3,4,8,"Breach,Raze,Sage,Omen,Skye","Raze,Cypher,Viper,Omen,Skye"
Bind,Shirtless Gamers,VZN E-SPORTS,13,8,8,1,7,5,"Raze,Viper,Brimstone,Skye,Gekko","Raze,Cypher,Viper,Brimstone,Skye"
Icebox,Cloud9,MIBR,14,12,4,9,3,10,"Sova,Killjoy,Viper,Sage,Jett","Killjoy,Viper,Sage,KAY/O,Gekko"
Lotus,Permitta Unicorns,XPERION NXT,11,13,8,4,9,3,"Breach,Raze,Killjoy,Omen,Fade","Killjoy,Viper,Omen,Neon,Gekko"
Lotus,Maxim Shepelev,Tu Mama,14,12,6,7,5,8,"Killjoy,Brimstone,Harbor,Deadlock,Iso","Killjoy,Phoenix,Jett,Astra,Deadlock"
Lotus,Spate Esports,LC,15,13,6,8,5,9,"Breach,Raze,Cypher,Omen,Gekko","Raze,Killjoy,Viper,Omen,Fade"
Ascent,UCF Gold,Team Throh,13,0,1,0,0,12,"Sova,Killjoy,Omen,Jett,KAY/O","Sova,Killjoy,Omen,Jett,Skye"
Sunset,swagged out,Event Horizon Red,13,11,6,6,5,7,"Breach,Raze,Cypher,Omen,Gekko","Raze,Cypher,Omen,KAY/O,Gekko"
Split,U4RIA Radiata,Void,13,10,6,5,5,7,"Raze,Cypher,Viper,Omen,Skye","Raze,Cypher,Viper,Skye,Astra"
Lotus,Chamber 1 trick,Bird Watchers,13,4,10,2,2,3,"Raze,Killjoy,Viper,Gekko,Clove","Raze,Omen,Skye,Chamber,Fade"
Ascent,UST Esports,TAMU Maroon,13,9,6,6,3,7,"Sova,Killjoy,Omen,Jett,KAY/O","Sova,Killjoy,Omen,Jett,KAY/O"
Lotus,LazerrFreeks8,All Good Gaming ,13,4,10,2,2,3,"Raze,Killjoy,Omen,Fade,Gekko","Breach,Raze,Cypher,Omen,Yoru"
Bind,Puppy Cuddle Pile,mesos millionaires,13,8,8,1,7,5,"Raze,Viper,Brimstone,Reyna,Skye","Raze,Viper,Brimstone,Skye,Chamber"
Split,OLIMPO,SAGAZ,13,10,7,5,5,6,"Raze,Viper,Omen,Jett,Skye","Raze,Cypher,Viper,Omen,Skye"
Split,FDR,Rush Hour,2,13,0,3,10,2,"Breach,Raze,Cypher,Skye,Clove","Raze,Cypher,Viper,Omen,Skye"
Ascent,Maxim Shepelev,Tu Mama,13,3,4,0,3,9,"Sova,Killjoy,Jett,KAY/O,Clove","Phoenix,Omen,Jett,Yoru,Chamber"
Ascent,UCLA Academy,:D,5,13,4,8,5,1,"Sova,Killjoy,Omen,Jett,KAY/O","Killjoy,Viper,Omen,Yoru,Fade"
Ascent,RAMPAGE Esports BLK,ST x WTP,4,13,2,10,3,2,"Cypher,Sova,Omen,Jett,KAY/O","Sova,Killjoy,Omen,Jett,KAY/O"
Split,Permitta Unicorns,XPERION NXT,13,11,8,4,7,5,"Raze,Cypher,Omen,Jett,Fade","Raze,Cypher,Viper,Omen,Skye"
Split,Baby Goats,Luminescent Sapphire,11,13,8,4,9,3,"Breach,Raze,Cypher,Omen,Skye","Breach,Raze,Cypher,Omen,Skye"
Icebox,QLASH,RTZN,13,4,10,2,2,3,"Killjoy,Viper,Jett,KAY/O,Gekko","Sova,Killjoy,Viper,Jett,Harbor"
Ascent,Valiant GC,Zerance Mint,7,13,3,9,4,4,"Sova,Killjoy,Omen,Jett,KAY/O","Sova,Killjoy,Omen,Jett,KAY/O"
Icebox,Rebirth Esports,Red Eye,13,9,8,2,7,5,"Viper,Reyna,Omen,Jett,Gekko","Killjoy,Viper,Jett,KAY/O,Gekko"
Breeze,Eternal Fire,PCIFIC Espor,10,13,3,8,5,7,"Cypher,Sova,Viper,Skye,Chamber","Cypher,Sova,Viper,Jett,KAY/O"
Ascent,ehehxd,Los Bandidos,13,6,7,0,6,6,"Breach,Sova,Killjoy,Omen,Jett","Sova,Killjoy,Omen,Jett,KAY/O"
Ascent,QLASH,RTZN,9,13,1,9,4,8,"Sova,Killjoy,Omen,Jett,KAY/O","Sova,Killjoy,Phoenix,Omen,Jett"
Sunset,Permitta Unicorns,XPERION NXT,11,13,8,4,9,3,"Breach,Raze,Cypher,Omen,Fade","Raze,Cypher,Sage,Omen,KAY/O"
Breeze,Baby Goats,Luminescent Sapphire,11,13,8,4,9,3,"Cypher,Sova,Viper,Jett,Yoru","Cypher,Sova,Viper,Jett,KAY/O"
Icebox,Valiant GC,Zerance Mint,8,13,5,7,6,3,"Sova,Killjoy,Viper,Sage,Jett","Sova,Killjoy,Viper,Jett,Gekko"
Split,Rebirth Esports,Red Eye,13,7,6,2,5,7,"Killjoy,Viper,Phoenix,Omen,KAY/O","Raze,Cypher,Viper,Omen,Skye"
Icebox,Bakim Corp,Zerance,5,13,3,3,10,2,"Sova,Killjoy,Viper,Sage,Jett","Killjoy,Viper,Sage,Jett,Gekko"
Lotus,QLASH,RTZN,13,3,3,1,2,10,"Raze,Killjoy,Viper,Omen,Fade","Raze,Killjoy,Viper,Omen,Skye"
Lotus,Eternal Fire,PCIFIC Espor,13,11,9,3,8,4,"Breach,Raze,Viper,Omen,Gekko","Breach,Raze,Killjoy,Omen,Fade"
Lotus,ehehxd,Los Bandidos,13,8,4,5,3,9,"Breach,Raze,Sova,Killjoy,Omen","Breach,Killjoy,Omen,Jett,Gekko"
Ascent,AntyDPM,Clown9 Valorant,9,13,2,8,5,7,"Breach,Raze,Killjoy,Omen,Fade","Cypher,Sova,Omen,Jett,KAY/O"
Bind,QLASH,RTZN,13,4,3,2,2,10,"Breach,Raze,Viper,Gekko,Clove","Raze,Viper,Brimstone,Skye,Gekko"
Sunset,G2 Gozen,XPERION NXT,7,13,4,8,5,3,"Breach,Raze,Cypher,Omen,Gekko","Raze,Cypher,Sage,Omen,KAY/O"
Sunset,HUGE Esports GC,Zerance Mint,4,13,2,10,3,2,"Breach,Raze,Cypher,Omen,Neon","Breach,Raze,Cypher,Sova,Omen"
Split,Bakim Corp,Zerance,11,13,5,7,6,6,"Raze,Cypher,Viper,Omen,Skye","Raze,Viper,Omen,Jett,Skye"
Lotus,ALTERNATE aTTaX Ruby,RIZON Sugar,15,17,8,8,9,7,"Breach,Raze,Cypher,Omen,Fade","Breach,Raze,Killjoy,Omen,Deadlock"
Sunset,Eternal Fire,PCIFIC Espor,10,13,6,6,7,4,"Breach,Raze,Killjoy,KAY/O,Clove","Sova,Viper,Phoenix,Omen,Chamber"
Bind,AntyDPM,Clown9 Valorant,11,13,6,6,7,5,"Breach,Raze,Cypher,Brimstone,Skye","Raze,Viper,Omen,Skye,Gekko"
Lotus,POK,evolutionSTARS,12,14,3,10,4,9,"Breach,Raze,Killjoy,Omen,Harbor","Breach,Raze,Killjoy,Viper,Omen"
Icebox,ehehxd,Los Bandidos,17,19,8,10,9,9,"Sova,Killjoy,Viper,Sage,Jett","Sova,Killjoy,Viper,Jett,Gekko"
Ascent,who cars?,Formulation Gaming,6,13,1,6,7,5,"Sova,Killjoy,Omen,Jett,KAY/O","Cypher,Sova,Omen,Jett,KAY/O"
Split,QLASH,RTZN,11,13,4,8,5,7,"Raze,Viper,Omen,Jett,Skye","Raze,Viper,Omen,Jett,Skye"
Icebox,G2 Gozen,XPERION NXT,13,7,9,3,4,4,"Sova,Killjoy,Viper,Jett,Clove","Sova,Killjoy,Viper,Jett,Harbor"
Bind,Szach Mat,FULL BOX 200,13,2,11,1,1,2,"Raze,Viper,Brimstone,Skye,Gekko","Breach,Raze,Brimstone,Sage,Fade"
Bind,Bakim Corp,Zerance,13,7,9,3,4,4,"Raze,Cypher,Viper,Brimstone,Skye","Raze,Viper,Brimstone,Skye,Gekko"
Icebox,Permitta Unicorns,Dortmund Esports,13,6,4,3,3,9,"Sova,Killjoy,Viper,Omen,Jett","Breach,Viper,Reyna,Omen,Neon"
Ascent,Valiant GC,HUGE Esports GC,13,5,9,3,2,4,"Sova,Killjoy,Omen,Jett,KAY/O","Sova,Killjoy,Omen,Jett,Neon"
Split,ALTERNATE aTTaX Ruby,RIZON Sugar,12,14,4,9,5,8,"Breach,Raze,Cypher,Omen,Skye","Breach,Raze,Cypher,Skye,Clove"
Lotus,Digital Athletics,NAPOLYON,6,13,4,8,5,2,"Cypher,Omen,Neon,Fade,Gekko","Raze,Killjoy,Viper,Omen,Fade"
Breeze,who cars?,Formulation Gaming,2,13,0,3,10,2,"Cypher,Sova,Viper,Jett,KAY/O","Cypher,Sova,Viper,Yoru,KAY/O"
Ascent,Szach Mat,FULL BOX 200,13,7,5,3,4,8,"Sova,Killjoy,Omen,Jett,KAY/O","Sova,Killjoy,Omen,Jett,KAY/O"
Split,G2 Gozen,XPERION NXT,6,13,2,5,8,4,"Breach,Raze,Viper,Omen,Fade","Raze,Cypher,Viper,Omen,Skye"
Sunset,GTZ Esports,HOF Esports,5,13,2,4,9,3,"Raze,Cypher,Omen,KAY/O,Harbor","Breach,Raze,Cypher,Sova,Omen"
Lotus,Permitta Unicorns,Dortmund Esports,13,3,11,1,2,2,"Breach,Raze,Killjoy,Omen,Fade","Raze,Viper,Omen,Yoru,Gekko"
Lotus,Bakim Corp,Zerance,4,13,1,4,9,3,"Raze,Killjoy,Viper,Omen,Skye","Raze,Killjoy,Viper,Omen,Skye"
Lotus,Valiant GC,HUGE Esports GC,6,13,1,6,7,5,"Breach,Cypher,Sova,Omen,Jett","Raze,Killjoy,Omen,Skye,Neon"
Ascent,Digital Athletics,NAPOLYON,14,16,3,12,4,11,"Sova,Killjoy,Omen,Jett,KAY/O","Sova,Killjoy,Omen,Jett,KAY/O"
Ascent,AntyDPM,Alpha Vortexx,13,10,9,3,7,4,"Breach,Raze,Killjoy,Omen,Fade","Sova,Killjoy,Omen,Jett,KAY/O"
Lotus,duplaw,Sila4i,5,13,3,9,4,2,"Raze,Killjoy,Viper,Omen,Fade","Breach,Raze,Killjoy,Brimstone,Gekko"
Sunset,K10,Formulation Gaming,6,13,1,6,7,5,"Raze,Cypher,Viper,Omen,Skye","Cypher,Sova,Omen,KAY/O,Neon"
Lotus,GTZ Esports,HOF Esports,9,13,7,5,8,2,"Breach,Raze,Cypher,Omen,Fade","Breach,Raze,Sova,Killjoy,Omen"
Sunset,FOKUS Sakura,RIZON Sugar,9,13,1,9,4,8,"Breach,Cypher,Omen,Jett,Gekko","Breach,Raze,Cypher,Sova,Omen"
Breeze,who cars?,Requiem,5,13,2,10,3,3,"Cypher,Sova,Viper,Jett,KAY/O","Cypher,Sova,Viper,Jett,Yoru"
Sunset,Valiant GC,HUGE Esports GC,13,11,3,9,2,10,"Breach,Raze,Cypher,Omen,Gekko","Breach,Raze,Cypher,Omen,Neon"
Sunset,FAV gaming,Crest Gaming ZST,8,13,4,5,8,4,"Raze,Cypher,Omen,KAY/O,Gekko","Breach,Raze,Cypher,Omen,Gekko"
Lotus,AntyDPM,Alpha Vortexx,13,11,9,3,8,4,"Breach,Raze,Killjoy,Omen,Fade","Breach,Raze,Killjoy,Omen,Fade"
Ascent,Clown9 Valorant,One6,13,2,11,1,1,2,"Cypher,Sova,Omen,Jett,KAY/O","Sova,Killjoy,Omen,Jett,KAY/O"
Breeze,duplaw,Sila4i,10,13,5,6,7,5,"Cypher,Sova,Viper,Jett,KAY/O","Cypher,Sova,Viper,Jett,KAY/O"
Icebox,who cars?,Requiem,7,13,5,7,6,2,"Sova,Killjoy,Viper,Sage,Jett","Killjoy,Viper,Jett,KAY/O,Gekko"
Bind,K10,Formulation Gaming,11,13,7,5,8,4,"Raze,Cypher,Viper,Brimstone,Skye","Raze,Viper,Brimstone,Skye,Gekko"
Sunset,Zerance Mint,Bohr,13,7,4,4,3,9,"Breach,Raze,Cypher,Sova,Omen","Raze,Cypher,Omen,KAY/O,Gekko"
Breeze,FOKUS Sakura,RIZON Sugar,11,13,9,3,10,2,"Cypher,Sova,Viper,Jett,Yoru","Cypher,Sova,Viper,Jett,Yoru"
Sunset,K10 (OCE),Xu Gang Crimson,5,13,5,7,6,0,"Breach,Raze,Cypher,Omen,Fade","Raze,Cypher,Omen,KAY/O,Gekko"
Split,FAV gaming,Crest Gaming ZST,13,5,7,5,0,6,"Breach,Raze,Viper,Omen,Fade","Raze,Viper,Omen,Jett,Skye"
Sunset,AntyDPM,Alpha Vortexx,8,13,4,5,8,4,"Breach,Raze,Cypher,Omen,Fade","Breach,Cypher,Sova,Omen,Neon"
Bind,Clown9 Valorant,One6,13,11,5,7,4,8,"Raze,Viper,Omen,Skye,Gekko","Raze,Cypher,Viper,Brimstone,Skye"
Ascent,Gen.G Esports,DRX,13,8,8,4,4,5,"Sova,Killjoy,Omen,Jett,KAY/O","Cypher,Viper,Omen,Jett,KAY/O"
Icebox,Misses Worldwide,VLG X,13,8,7,2,6,6,"Sova,Killjoy,Omen,Jett,Gekko","Sova,Killjoy,Phoenix,Jett,Harbor"
Split,RIDDLE ORDER,NOEZ FOXX,14,12,7,6,6,7,"Raze,Viper,Omen,Jett,Skye","Raze,Viper,Omen,Jett,Skye"
Lotus,FAV gaming,Crest Gaming ZST,7,13,3,9,4,4,"Raze,Killjoy,Viper,Omen,Fade","Raze,Killjoy,Viper,Omen,Fade"
Ascent,Bohr,Divergentes GC,13,8,7,2,6,6,"Sova,Killjoy,Omen,Jett,KAY/O","Killjoy,Omen,Jett,KAY/O,Gekko"
Icebox,Balut Warriors,raindrops,13,11,9,3,8,4,"Sova,Killjoy,Viper,Jett,Gekko","Sova,Killjoy,Viper,Reyna,Jett"
Bind,K10 (OCE),Xu Gang Crimson,15,13,7,7,6,8,"Raze,Cypher,Viper,Brimstone,Skye","Raze,Cypher,Brimstone,Skye,Gekko"
Sunset,RIDDLE ORDER,NOEZ FOXX,13,2,10,2,0,3,"Raze,Cypher,Omen,KAY/O,Gekko","Raze,Cypher,Omen,KAY/O,Gekko"
Breeze,HEROIC Valkyries,ALTERNATE aTTaX Ruby,6,13,3,4,9,3,"Cypher,Sova,Viper,Jett,KAY/O","Cypher,Sova,Viper,Omen,Jett"
Sunset,Gen.G Esports,DRX,13,11,9,3,8,4,"Cypher,Sova,Omen,Jett,KAY/O","Breach,Raze,Cypher,Omen,Gekko"
Lotus,Misses Worldwide,VLG X,13,9,6,6,3,7,"Killjoy,Omen,Chamber,Neon,Gekko","Breach,Raze,Killjoy,Gekko,Clove"
Split,Balut Warriors,raindrops,13,8,4,5,3,9,"Raze,Cypher,Omen,Jett,Skye","Raze,Cypher,Viper,Omen,Skye"
Icebox,Zerance Mint,F9 Wonders,13,10,4,8,2,9,"Sova,Killjoy,Viper,Jett,Gekko","Sova,Killjoy,Viper,Jett,Gekko"
Breeze,WOMP WOMP,Jamcat,13,6,6,1,5,7,"Cypher,Sova,Viper,Jett,KAY/O","Cypher,Sova,Viper,Yoru,Neon"
Lotus,K10 (OCE),Xu Gang Crimson,6,13,4,8,5,2,"Raze,Killjoy,Viper,Omen,Fade","Raze,Killjoy,Omen,Skye,Gekko"
Split,Crest Gaming ZST,BC SWELL,13,10,9,2,8,4,"Raze,Viper,Omen,Jett,Skye","Raze,Viper,Omen,Jett,Skye"
Lotus,HEROIC Valkyries,ALTERNATE aTTaX Ruby,13,8,7,5,3,6,"Raze,Viper,Sage,Omen,Skye","Breach,Raze,Cypher,Omen,Fade"
Icebox,FLUX GC,YIPPEE,2,13,2,10,3,0,"Sova,Killjoy,Viper,Reyna,Gekko","Killjoy,Viper,Jett,KAY/O,Gekko"
Bind,Gen.G Esports,DRX,8,13,2,7,6,6,"Raze,Cypher,Viper,Brimstone,Skye","Raze,Cypher,Viper,Brimstone,KAY/O"
Ascent,DopeNess Esports,NOEZ FOXX,9,13,5,7,6,4,"Sova,Killjoy,Omen,Jett,KAY/O","Sova,Killjoy,Omen,Jett,KAY/O"
Sunset,Misses Worldwide,VLG X,11,13,9,3,10,2,"Breach,Raze,Cypher,Omen,Gekko","Breach,Raze,Cypher,Gekko,Clove"
Lotus,Balut Warriors,raindrops,8,13,6,3,10,2,"Raze,Cypher,Phoenix,Omen,Gekko","Cypher,Phoenix,Omen,Jett,Gekko"
Lotus,Valiant GC,Bohr,13,9,4,6,3,9,"Breach,Raze,Sova,Killjoy,Omen","Breach,Raze,Killjoy,Omen,Gekko"
Ascent,WOMP WOMP,Jamcat,13,4,10,2,2,3,"Sova,Killjoy,Omen,Jett,KAY/O","Sova,Killjoy,Omen,Jett,KAY/O"
Breeze,FLUX GC,YIPPEE,5,13,1,11,2,4,"Sova,Viper,Reyna,KAY/O,Chamber","Cypher,Sova,Viper,Jett,Yoru"
Lotus,Crest Gaming ZST,BC SWELL,13,6,9,3,3,4,"Raze,Killjoy,Viper,Omen,Fade","Raze,Killjoy,Viper,Omen,Fade"
Sunset,HEROIC Valkyries,ALTERNATE aTTaX Ruby,6,13,4,8,5,2,"Raze,Cypher,Omen,KAY/O,Gekko","Breach,Raze,Cypher,Sova,Omen"
Sunset,DopeNess Esports,NOEZ FOXX,6,13,3,4,9,3,"Raze,Cypher,Omen,KAY/O,Gekko","Raze,Cypher,Omen,KAY/O,Gekko"
Sunset,T1,Paper Rex,5,13,2,10,3,3,"Raze,Cypher,Omen,KAY/O,Gekko","Breach,Raze,Sage,Omen,Gekko"
Split,Valiant GC,Bohr,13,11,7,5,6,6,"Raze,Cypher,Sage,Omen,Skye","Raze,Cypher,Viper,Omen,Skye"
Lotus,Jamcat,VLG X,15,17,6,10,7,9,"Raze,Killjoy,Omen,Jett,Gekko","Breach,Raze,Killjoy,Omen,Gekko"
Lotus,T1,Paper Rex,3,13,2,2,11,1,"Raze,Viper,Omen,Chamber,Fade","Breach,Raze,Omen,Jett,Skye"
Ascent,Sa Kour'A,Divergentes GC,3,13,3,9,4,0,"Phoenix,Reyna,KAY/O,Clove","Killjoy,Omen,Jett,KAY/O,Gekko"
Sunset,ENDER,Reve Drift Arena,9,13,8,4,9,1,"Raze,Cypher,Omen,KAY/O,Gekko","Breach,Raze,Cypher,Omen,Gekko"
Split,FLUX GC,K10 (OCE),10,13,3,8,5,7,"Raze,Cypher,Jett,Skye,Clove","Raze,Cypher,Viper,Skye,Astra"
Bind,YIPPEE,WOMP WOMP,9,13,6,4,9,3,"Raze,Cypher,Viper,Brimstone,Skye","Raze,Cypher,Viper,Brimstone,Skye"
Lotus,raindrops,Misses Worldwide,18,16,8,9,7,10,"Cypher,Phoenix,Omen,Jett,Gekko","Killjoy,Omen,Chamber,Neon,Gekko"
Lotus,Balut Warriors,Xu Gang Crimson,13,4,3,2,2,10,"Raze,Cypher,Phoenix,Omen,Gekko","Raze,Killjoy,Omen,Skye,Gekko"
Icebox,ENDER,Reve Drift Arena,13,6,10,2,4,3,"Sova,Killjoy,Viper,Jett,Harbor","Sova,Killjoy,Viper,Jett,Gekko"
Bind,Jamcat,VLG X,13,6,6,1,5,7,"Raze,Cypher,Brimstone,Reyna,Skye","Raze,Cypher,Brimstone,Jett,Skye"
Icebox,YIPPEE,WOMP WOMP,13,6,6,1,5,7,"Killjoy,Viper,Jett,KAY/O,Gekko","Sova,Killjoy,Viper,Reyna,Jett"
Ascent,FLUX GC,K10 (OCE),13,5,3,3,2,10,"Sova,Killjoy,Reyna,Jett,Clove","Sova,Killjoy,Omen,Jett,KAY/O"
Breeze,Balut Warriors,Xu Gang Crimson,13,10,4,8,2,9,"Cypher,Sova,Viper,Jett,Yoru","Cypher,Sova,Viper,Jett,KAY/O"
Lotus,ENDER,Reve Drift Arena,10,13,6,5,8,4,"Raze,Killjoy,Viper,Omen,Fade","Raze,Killjoy,Viper,Omen,Skye"
Breeze,raindrops,Misses Worldwide,13,10,4,7,3,9,"Cypher,Sova,Viper,Jett,Yoru","Cypher,Sova,Viper,Chamber,Neon"
Split,Jamcat,VLG X,11,13,10,2,11,1,"Raze,Cypher,Jett,Skye,Clove","Breach,Raze,Cypher,Omen,Skye"
Icebox,FLUX GC,K10 (OCE),3,13,1,3,10,2,"Sova,Killjoy,Viper,Jett,Clove","Killjoy,Viper,Jett,KAY/O,Gekko"
Lotus,YIPPEE,WOMP WOMP,11,13,10,2,11,1,"Raze,Killjoy,Viper,Omen,Fade","Breach,Raze,Cypher,Gekko,Clove"
Sunset,HomeBois,Reve Drift Arena,2,13,2,10,3,0,"Breach,Raze,Cypher,Omen,Gekko","Breach,Raze,Cypher,Omen,Gekko"
Breeze,HomeBois,Reve Drift Arena,13,5,8,4,1,5,"Cypher,Sova,Viper,Jett,KAY/O","Cypher,Sova,Viper,Jett,Yoru"
Lotus,Kizuna Esports,ENDER,13,10,7,4,6,6,"Raze,Killjoy,Viper,Omen,Fade","Raze,Killjoy,Viper,Omen,Fade"
Split,mesos millionaires,Teddy Tactics,13,7,6,6,1,7,"Raze,Cypher,Omen,Jett,Skye","Raze,Viper,Omen,Skye,Deadlock"
Sunset,Kizuna Esports,ENDER,13,2,3,0,2,10,"Breach,Raze,Cypher,Omen,Gekko","Raze,Cypher,Omen,KAY/O,Gekko"
Lotus,HomeBois,Reve Drift Arena,7,13,2,6,7,5,"Raze,Killjoy,Viper,Omen,Skye","Raze,Killjoy,Viper,Omen,Skye"
Lotus,Team Freakret,Tu Mama,5,13,5,7,6,0,"Breach,Raze,Cypher,Brimstone,Gekko","Raze,Phoenix,Chamber,Gekko,Clove"
Bind,mesos millionaires,Teddy Tactics,13,10,6,6,4,7,"Raze,Viper,Brimstone,Skye,Chamber","Raze,Viper,Brimstone,KAY/O,Gekko"
Breeze,Maxim Shepelev,Kirbee Squad,13,2,10,2,0,3,"Cypher,Sova,Viper,Jett,KAY/O","Cypher,Sova,Viper,Jett,Clove"
Ascent,Team Freakret,Tu Mama,4,13,2,3,10,2,"Sova,Killjoy,Sage,Omen,Jett","Sova,Sage,Omen,Jett,Yoru"
Icebox,mesos millionaires,Teddy Tactics,7,13,4,4,9,3,"Sova,Viper,Reyna,Jett,Deadlock","Sova,Killjoy,Viper,Sage,Jett"
Lotus,Maxim Shepelev,Kirbee Squad,13,2,3,0,2,10,"Raze,Omen,Skye,Chamber,Gekko","Raze,Killjoy,Reyna,Skye,Clove"
Lotus,KRÜ Esports,Leviatán,10,13,6,6,7,4,"Raze,Killjoy,Viper,Omen,Fade","Raze,Killjoy,Viper,Omen,Fade"
Lotus,Puppy Cuddle Pile, RITUAL RËAL,13,3,4,0,3,9,"Raze,Phoenix,Omen,Chamber,Fade","Raze,Killjoy,Omen,Skye,Fade"
Ascent,Kirbee Squad,Alliance Angels,13,8,8,1,7,5,"Sova,Killjoy,Reyna,Omen,Jett","Sova,Killjoy,Phoenix,Omen,Jett"
Ascent,Cafe Coke,Teddy Tactics,9,13,6,6,7,3,"Sova,Killjoy,Omen,Jett,KAY/O","Sova,Killjoy,Omen,Jett,KAY/O"
Icebox,RyZe Eclipsa GC,Team Freakret,11,13,5,7,6,6,"Sova,Killjoy,Viper,Jett,Deadlock","Sova,Killjoy,Viper,Sage,Jett"
Breeze,KRÜ Esports,Leviatán,14,12,5,8,4,9,"Cypher,Sova,Viper,Jett,KAY/O","Cypher,Sova,Viper,Jett,KAY/O"
Split,Maxim Shepelev,mili's kittens,13,4,8,4,0,5,"Reyna,Omen,Skye,Chamber,Fade","Raze,Cypher,Omen,Jett,Skye"
Icebox,Kirbee Squad,Alliance Angels,13,8,5,4,4,8,"Sova,Killjoy,Viper,Reyna,Jett","Sova,Killjoy,Viper,Reyna,Jett"
Breeze,SAGAZ,Spirit Academy,11,13,7,5,8,4,"Cypher,Sova,Viper,Jett,KAY/O","Cypher,Sova,Viper,Jett,KAY/O"
Sunset, RITUAL RËAL,Blahaj Huggers,13,6,9,3,3,4,"Breach,Raze,Cypher,Omen,Fade","Breach,Raze,Cypher,Omen,Yoru"
Lotus,RyZe Eclipsa GC,Team Freakret,3,13,2,2,11,1,"Raze,Killjoy,Viper,Omen,Skye","Breach,Raze,Cypher,Brimstone,Gekko"
Sunset,Cafe Coke,Teddy Tactics,9,13,7,5,8,2,"Breach,Raze,Cypher,Omen,Gekko","Raze,Cypher,Omen,KAY/O,Gekko"
Split,SFU Pink,CSUF Orange,10,13,3,8,5,7,"Raze,Cypher,Jett,Skye,Astra","Raze,Viper,Jett,Skye,Astra"
Split,Tu Mama,Skyline Dreamers GC,13,8,6,3,5,7,"Cypher,Jett,Yoru,Astra,Fade","Raze,Cypher,Viper,Omen,Skye"
Split,mesos millionaires,Hoppy Frogs,13,4,9,3,1,4,"Raze,Cypher,Omen,Jett,Skye","Breach,Raze,Cypher,Omen,Fade"
Ascent,Puppy Cuddle Pile,Sizzle Roses,13,1,11,1,0,2,"Sova,Killjoy,Phoenix,Jett,Astra","Breach,Raze,Killjoy,Fade,Clove"
Bind,Lucky 7 Gaming,Luminescent Sapphire,9,13,4,8,5,5,"Raze,Cypher,Brimstone,Jett,Skye","Raze,Viper,Brimstone,Skye,Gekko"
Lotus,Maxim Shepelev,mili's kittens,13,8,6,3,5,7,"Raze,Omen,Skye,KAY/O,Deadlock","Raze,Killjoy,Omen,Skye,Gekko"
Bind,Kirbee Squad,Alliance Angels,11,13,3,9,4,8,"Raze,Cypher,Viper,Skye,Clove","Raze,Cypher,Brimstone,Reyna,Skye"
Icebox,Cafe Coke,Teddy Tactics,13,2,10,2,0,3,"Sova,Killjoy,Viper,Sage,Jett","Sova,Killjoy,Viper,Sage,Jett"
Lotus, RITUAL RËAL,Blahaj Huggers,13,5,7,5,0,6,"Raze,Killjoy,Omen,Skye,Fade","Breach,Raze,Killjoy,Omen,Gekko"
Ascent,KRÜ Esports,Leviatán,4,13,3,9,4,1,"Sova,Killjoy,Omen,Jett,KAY/O","Sova,Killjoy,Omen,Jett,KAY/O"
Bind,mesos millionaires,Hoppy Frogs,13,4,3,2,2,10,"Raze,Viper,Brimstone,Skye,Chamber","Raze,Cypher,Brimstone,Skye,Fade"
Lotus,Tu Mama,Skyline Dreamers GC,13,5,6,0,5,7,"Raze,Reyna,Omen,Chamber,Gekko","Raze,Killjoy,Viper,Omen,Skye"
Sunset,RyZe Eclipsa GC,Team Freakret,13,7,6,2,5,7,"Breach,Raze,Cypher,Gekko,Clove","Breach,Raze,Cypher,Omen,Gekko"
Lotus,Puppy Cuddle Pile,Sizzle Roses,13,2,3,0,2,10,"Raze,Phoenix,Omen,Chamber,Fade","Raze,Killjoy,Viper,Omen,Gekko"
Sunset,SAGAZ,Spirit Academy,11,13,8,4,9,3,"Raze,Cypher,Omen,KAY/O,Gekko","Breach,Sova,Viper,Phoenix,Omen"
Icebox,SFU Pink,CSUF Orange,9,13,7,5,8,2,"Sova,Killjoy,Viper,Reyna,Jett","Sova,Killjoy,Viper,Jett,Harbor"
Ascent,Chivas Esports,CONTRAxSCRUB,12,14,7,6,8,5,"Sova,Killjoy,Omen,Jett,KAY/O","Sova,Killjoy,Omen,Jett,KAY/O"
Ascent,Kirbee Squad,Sizzle Roses,13,1,2,0,1,11,"Sova,Killjoy,Reyna,Omen,Jett","Cypher,Sova,Omen,Jett,KAY/O"
Split,Skyline Dreamers GC,mesos millionaires,3,13,2,2,11,1,"Raze,Cypher,Viper,Omen,Skye","Raze,Cypher,Omen,Jett,Skye"
Ascent,Northwood University,Mizzou Esports,13,10,6,6,4,7,"Sova,Phoenix,Brimstone,Jett,Deadlock","Killjoy,Phoenix,Reyna,Omen,Jett"
Breeze,OutGoing Esports,Luminescent Sapphire,12,14,6,7,7,6,"Cypher,Sova,Viper,Jett,KAY/O","Cypher,Sova,Viper,Jett,KAY/O"
Icebox,fish with no eye,Maxim Shepelev,6,13,2,5,8,4,"Sova,Killjoy,Viper,Jett,Gekko","Breach,Sova,Jett,Harbor,Gekko"
Bind,SFU Pink,CSUF Orange,11,13,4,8,5,7,"Raze,Viper,Brimstone,Reyna,Skye","Raze,Viper,Brimstone,Reyna,Skye"
Sunset,Elation Misfits,Team Freakret,2,13,0,3,10,2,"Breach,Raze,Cypher,Omen,Gekko","Breach,Raze,Cypher,Omen,Gekko"
Split,SAGAZ,Spirit Academy,13,11,4,8,3,9,"Raze,Cypher,Viper,Omen,Skye","Breach,Raze,Cypher,Omen,Skye"
Bind,NRG Esports,100 Thieves,7,13,4,8,5,3,"Raze,Viper,Brimstone,Skye,Gekko","Raze,Viper,Brimstone,Fade,Gekko"
Bind,Van Lyn Venus,Cafe Coke,7,13,6,6,7,1,"Raze,Cypher,Viper,Brimstone,Skye","Raze,Viper,Skye,Gekko,Clove"
Icebox, RITUAL RËAL,Labyrinth White,13,5,6,0,5,7,"Sova,Killjoy,Viper,Jett,Gekko","Sova,Killjoy,Viper,Jett,Harbor"
Ascent,Tu Mama,Hoppy Frogs,13,0,12,0,0,1,"Cypher,Sova,Reyna,Jett,Clove","Sova,Killjoy,Omen,Jett,KAY/O"
Icebox,Northwood University,Mizzou Esports,13,4,11,1,3,2,"Sova,Viper,Reyna,Jett,Deadlock","Viper,Sage,Reyna,Jett,Yoru"
Bind,Chivas Esports,CONTRAxSCRUB,13,4,8,4,0,5,"Raze,Viper,Brimstone,Skye,Gekko","Raze,Viper,Brimstone,Skye,Gekko"
Bind,RyZe Eclipsa GC,Teddy Tactics,13,3,4,0,3,9,"Raze,Cypher,Omen,Skye,Yoru","Raze,Viper,Brimstone,KAY/O,Gekko"
Bind,mili's kittens,Nemesis GC,13,5,3,3,2,10,"Raze,Viper,Brimstone,Skye,Gekko","Raze,Killjoy,Skye,Yoru,Clove"
Split,Reven eClub,KTANA,13,3,4,0,3,9,"Breach,Raze,Cypher,Omen,Gekko","Breach,Raze,Cypher,Omen,Gekko"
Lotus,Puppy Cuddle Pile,Luxoria GC,13,8,8,4,4,5,"Raze,Phoenix,Omen,Fade,Deadlock","Raze,Killjoy,Viper,Omen,Skye"
Bind,Harmony Amethyst,Kirbee Squad,0,13,0,12,1,0,"Breach,Raze,Viper,Brimstone,Gekko","Raze,Cypher,Viper,Skye,Clove"
Icebox,Mystics GC,mesos millionaires,10,13,7,4,9,3,"Sova,Killjoy,Viper,Sage,Jett","Sova,Viper,Reyna,Jett,Deadlock"
Sunset,Sizzle Roses,SaD FROST,13,11,8,4,7,5,"Raze,Cypher,Sova,Omen,Gekko","Breach,Raze,Cypher,Omen,Gekko"
Bind,Northwood University,Mizzou Esports,6,13,5,7,6,1,"Breach,Raze,Cypher,Sova,Brimstone","Breach,Raze,Brimstone,Reyna,Jett"
Ascent,Blahaj Huggers,Maxim Shepelev,6,13,1,6,7,5,"Sage,Reyna,Jett,KAY/O,Clove","Sova,Killjoy,Yoru,Chamber,Clove"
Ascent,Minions United,Teddy Tactics,2,13,1,11,2,1,"Sova,Killjoy,Omen,Jett,KAY/O","Sova,Killjoy,Omen,Jett,KAY/O"
Ascent,Zero MarksMen Black,Resonate,11,13,7,5,8,4,"Sova,Killjoy,Omen,Jett,KAY/O","Sova,Killjoy,Sage,Omen,Jett"
Sunset,Cafe Coke,Team Freakret,13,9,4,6,3,9,"Breach,Raze,Cypher,Omen,Gekko","Breach,Raze,Cypher,Omen,Gekko"
Split,Luxoria,OutGoing Esports,11,13,4,8,5,7,"Raze,Cypher,Omen,Skye,Gekko","Raze,Cypher,Viper,Omen,Skye"
Lotus,Spirit Academy,Salamaleiko,13,9,7,3,6,6,"Raze,Killjoy,Viper,Omen,Fade","Breach,Raze,Killjoy,Omen,Yoru"
Ascent,Elation Misfits,Van Lyn Venus,1,13,0,2,11,1,"Sova,Killjoy,Omen,Jett,KAY/O","Sova,Killjoy,Omen,Jett,KAY/O"
Bind,Reven eClub,KTANA,13,1,2,0,1,11,"Raze,Cypher,Viper,Brimstone,Skye","Breach,Raze,Cypher,Gekko,Clove"
Bind,Sya Unity,Luminescent Sapphire,2,13,0,3,10,2,"Viper,Brimstone,Jett,Yoru,Gekko","Raze,Viper,Brimstone,Skye,Gekko"
Lotus,Tenax GC,Hoppy Frogs,7,13,5,7,6,2,"Breach,Raze,Cypher,Omen,Gekko","Breach,Raze,Cypher,Omen,Fade"
Sunset,Chivas Esports,CONTRAxSCRUB,9,13,5,5,8,4,"Raze,Cypher,Viper,Omen,Fade","Breach,Raze,Cypher,Omen,Fade"
Lotus,mili's kittens, RITUAL RËAL,5,13,3,3,10,2,"Raze,Killjoy,Omen,Skye,Gekko","Raze,Killjoy,Omen,Skye,Fade"
Bind,Lucky 7 Gaming,Baby Goats,12,14,8,5,9,4,"Raze,Cypher,Brimstone,Jett,Skye","Raze,Viper,Brimstone,Yoru,Gekko"
Breeze,Vision Esports,Underground Gaming,13,15,3,11,4,10,"Cypher,Sova,Viper,Jett,KAY/O","Cypher,Sova,Viper,Jett,Yoru"
Split,NRG Esports,100 Thieves,8,13,7,5,8,1,"Raze,Viper,Omen,Jett,Skye","Raze,Viper,Astra,Fade,Gekko"
Lotus,SAGAZ,NIGERIA 96,15,13,7,7,6,8,"Raze,Killjoy,Viper,Omen,Fade","Raze,Killjoy,Viper,Omen,Fade"
Icebox,Labyrinth White,Nemesis GC,13,1,11,1,0,2,"Sova,Killjoy,Viper,Jett,Harbor","Sova,Killjoy,Viper,Jett,Gekko"
Icebox,Alliance Angels,Luxoria GC,13,5,5,1,4,8,"Sova,Killjoy,Viper,Reyna,Jett","Sova,Killjoy,Viper,Jett,Gekko"
Ascent,Cicadas Gaming,Bakim Corp,13,10,3,9,1,10,"Sova,Killjoy,Omen,Jett,KAY/O","Sova,Killjoy,Omen,Jett,KAY/O"
Lotus,fish with no eye,Blahaj Huggers,3,13,3,9,4,0,"Raze,Cypher,Viper,Omen,Skye","Breach,Raze,Killjoy,Omen,Gekko"
Lotus,RyZe Eclipsa GC,Minions United,13,5,5,1,4,8,"Raze,Killjoy,Viper,Omen,Skye","Breach,Raze,Killjoy,Astra,Fade"
Ascent,SAGAZ,NIGERIA 96,13,4,3,2,2,10,"Sova,Killjoy,Omen,Jett,KAY/O","Sova,Killjoy,Omen,Jett,KAY/O"
Bind,Spirit Academy,Salamaleiko,13,5,5,1,4,8,"Raze,Viper,Brimstone,KAY/O,Gekko","Raze,Viper,Brimstone,Jett,Skye"
Bind,SaD FROST,Kirbee Squad,16,18,11,6,12,5,"Viper,Brimstone,Jett,Skye,Gekko","Raze,Cypher,Viper,Skye,Clove"
Lotus,Puppy Cuddle Pile,Alliance Angels,13,1,2,0,1,11,"Raze,Phoenix,Omen,Chamber,Fade","Raze,Killjoy,Viper,Omen,Skye"
Split,Zero MarksMen Black,Resonate,8,13,5,4,9,3,"Raze,Cypher,Viper,Omen,Skye","Raze,Cypher,Sage,Omen,Jett"
Sunset,Lucky 7 Gaming,Baby Goats,2,13,0,3,10,2,"Breach,Raze,Cypher,Omen,Gekko","Breach,Raze,Cypher,Omen,Gekko"
Icebox,Team Freakret,Van Lyn Venus,13,5,10,2,3,3,"Sova,Killjoy,Viper,Sage,Jett","Viper,Jett,KAY/O,Harbor,Gekko"
Split,OutGoing Esports,Celestial Dawn,13,1,2,0,1,11,"Raze,Cypher,Viper,Omen,Skye","Breach,Raze,Sage,Omen,Jett"
Ascent,Tamaria Altunga Esports,NAPOLYON,14,16,8,7,9,6,"Sova,Killjoy,Omen,Jett,KAY/O","Sova,Killjoy,Omen,Jett,KAY/O"
Lotus,Skyline Dreamers GC,Mystics GC,14,12,8,5,7,6,"Raze,Killjoy,Viper,Omen,Skye","Raze,Killjoy,Skye,Astra,Gekko"
Lotus,Harmony Amethyst,Sizzle Roses,5,13,3,9,4,2,"Breach,Raze,Killjoy,Omen,Gekko","Raze,Killjoy,Viper,Omen,Gekko"
Icebox,Twisted Minds Esports,Onyx Ravens,13,4,4,1,3,9,"Killjoy,Viper,Jett,KAY/O,Gekko","Sova,Killjoy,Viper,Jett,Gekko"
Lotus,Nemesis GC, RITUAL RËAL,1,13,1,11,2,0,"Raze,Killjoy,Omen,Skye,Gekko","Raze,Killjoy,Omen,Skye,Fade"
Lotus,Tu Mama,Tenax GC,13,6,5,2,4,8,"Raze,Cypher,Omen,Skye,Gekko","Breach,Raze,Cypher,Omen,Gekko"
Sunset,mili's kittens,Labyrinth White,13,6,7,0,6,6,"Breach,Cypher,Gekko,Iso,Clove","Breach,Cypher,Sova,Omen,Yoru"
Split,MOUZ,CGN Esports,12,14,7,6,8,5,"Breach,Raze,Viper,Omen,Skye","Raze,Viper,Sage,Omen,Jett"
Sunset,Elation Misfits,Cafe Coke,6,13,6,6,7,0,"Breach,Raze,Cypher,Omen,Gekko","Breach,Raze,Cypher,Omen,Gekko"
Lotus,Vision Esports,Underground Gaming,11,13,5,7,6,6,"Killjoy,Viper,Omen,Neon,Fade","Raze,Killjoy,Viper,Omen,Fade"
Lotus,RTZN,LONETEAM,7,13,3,5,8,4,"Raze,Killjoy,Viper,Omen,Skye","Raze,Killjoy,Omen,Fade,Gekko"
Sunset,Zerance Mint,HUGE Esports GC,11,13,6,6,7,5,"Breach,Raze,Cypher,Sova,Omen","Breach,Raze,Cypher,Omen,Neon"
Ascent,Border Monsters Chile,Rebirth Esports,15,17,5,11,6,10,"Sova,Killjoy,Omen,Jett,KAY/O","Breach,Cypher,Omen,Jett,KAY/O"
Lotus,Cicadas Gaming,Bakim Corp,6,13,5,2,11,1,"Raze,Killjoy,Viper,Omen,Fade","Raze,Killjoy,Viper,Omen,Skye"
Lotus,Twisted Minds Esports,Onyx Ravens,13,7,7,1,6,6,"Breach,Raze,Killjoy,Omen,Gekko","Breach,Raze,Killjoy,Omen,Gekko"
Bind,Red Eye,LRV Esports,13,3,9,3,0,4,"Raze,Cypher,Viper,Brimstone,Skye","Raze,Viper,Brimstone,Fade,Gekko"
Split,Tamaria Altunga Esports,NAPOLYON,11,13,6,6,7,5,"Breach,Raze,Viper,Omen,Fade","Raze,Cypher,Viper,Omen,Skye"
Sunset,Border Monsters Chile,Rebirth Esports,4,13,3,9,4,1,"Raze,Cypher,Omen,KAY/O,Gekko","Breach,Raze,Cypher,Omen,KAY/O"
Ascent,RTZN,LONETEAM,13,7,6,2,5,7,"Sova,Killjoy,Phoenix,Omen,Jett","Sova,Killjoy,Omen,Jett,KAY/O"
Breeze,Cicadas Gaming,Bakim Corp,13,5,9,3,2,4,"Cypher,Sova,Viper,Jett,Skye","Cypher,Sova,Viper,Reyna,Jett"
Breeze,MOUZ,CGN Esports,10,13,7,5,8,3,"Cypher,Sova,Viper,Jett,KAY/O","Cypher,Sova,Viper,Jett,Clove"
Breeze,Zerance Mint,HUGE Esports GC,12,14,8,5,9,4,"Cypher,Sova,Viper,Jett,KAY/O","Cypher,Sova,Viper,Jett,Yoru"
Bind,HOF Esports,Los Bandidos,13,6,6,1,5,7,"Breach,Raze,Viper,Brimstone,Gekko","Raze,Cypher,Skye,Gekko,Clove"
Sunset,Twisted Minds Esports,Onyx Ravens,5,13,3,9,4,2,"Raze,Cypher,Omen,KAY/O,Gekko","Breach,Raze,Cypher,Omen,Fade"
Sunset,Red Eye,LRV Esports,14,12,10,3,9,4,"Raze,Cypher,Omen,KAY/O,Gekko","Raze,Cypher,Omen,KAY/O,Gekko"
Split,Border Monsters Chile,Rebirth Esports,13,8,5,4,4,8,"Raze,Viper,Omen,Jett,Skye","Killjoy,Viper,Phoenix,Omen,KAY/O"
Lotus,QLASH,Termina Enjoyers,11,13,5,7,6,6,"Raze,Killjoy,Viper,Omen,Fade","Raze,Killjoy,Viper,Omen,Skye"
Lotus,Tamaria Altunga Esports,NAPOLYON,13,11,2,10,1,11,"Raze,Killjoy,Viper,Omen,Fade","Raze,Killjoy,Viper,Omen,Fade"
Icebox,Cicadas Gaming,Bakim Corp,13,5,5,1,4,8,"Sova,Killjoy,Viper,Jett,Harbor","Sova,Killjoy,Viper,Sage,Jett"
Icebox,RTZN,LONETEAM,11,13,6,6,7,5,"Sova,Killjoy,Viper,Jett,Harbor","Sova,Killjoy,Viper,Reyna,Jett"
Lotus,FULL BOX 200,Lenovo Honvéd,13,9,4,6,3,9,"Breach,Raze,Killjoy,Omen,Gekko","Breach,Raze,Killjoy,Omen,Chamber"
Lotus,Zerance Mint,HUGE Esports GC,13,6,10,2,4,3,"Raze,Killjoy,Viper,Omen,Gekko","Raze,Killjoy,Omen,Skye,Neon"
Lotus,Team 7 Esports,Tropadobagaço,13,10,4,7,3,9,"Breach,Sova,Viper,Omen,Neon","Breach,Raze,Killjoy,Omen,Gekko"
Sunset,AntyDPM,Washed5,13,4,9,3,1,4,"Breach,Raze,Cypher,Omen,Fade","Breach,Raze,Cypher,Omen,Fade"
Icebox,MOUZ,CGN Esports,13,0,12,0,0,1,"Sova,Killjoy,Viper,Sage,Jett","Killjoy,Viper,Sage,KAY/O,Gekko"
Ascent,HOF Esports,Los Bandidos,13,4,3,2,2,10,"Sova,Killjoy,Omen,Jett,KAY/O","Cypher,Sova,Omen,Jett,KAY/O"
Ascent,QLASH,Termina Enjoyers,9,13,2,8,5,7,"Sova,Killjoy,Omen,Jett,KAY/O","Sova,Killjoy,Phoenix,Omen,Jett"
Split,RTZN,LONETEAM,6,13,0,7,6,6,"Raze,Viper,Omen,Jett,Skye","Raze,Cypher,Viper,Skye,Astra"
Icebox,Tamaria Altunga Esports,NAPOLYON,11,13,6,6,7,5,"Killjoy,Viper,Jett,KAY/O,Gekko","Sova,Killjoy,Viper,Sage,Jett"
Ascent,FULL BOX 200,Lenovo Honvéd,13,9,5,5,4,8,"Sova,Killjoy,Omen,Jett,KAY/O","Sova,Killjoy,Omen,Jett,KAY/O"
Bind,Cicadas Gaming,Bakim Corp,11,13,5,7,6,6,"Breach,Cypher,Sova,Brimstone,Yoru","Raze,Cypher,Viper,Brimstone,Skye"
Lotus,AntyDPM,Washed5,5,13,0,6,7,5,"Breach,Raze,Killjoy,Omen,Fade","Breach,Raze,Killjoy,Omen,Fade"
Breeze,Formulation Gaming,Requiem,0,13,0,1,12,0,"Cypher,Sova,Viper,Jett,KAY/O","Cypher,Sova,Viper,Jett,Yoru"
Lotus,NOMAD GC,F9 Wonders,4,13,2,10,3,2,"Raze,Killjoy,Omen,Fade,Gekko","Breach,Raze,Killjoy,Omen,Gekko"
Sunset,Team 7 Esports,Tropadobagaço,13,8,6,3,5,7,"Raze,Omen,Astra,KAY/O,Deadlock","Breach,Raze,Cypher,Sova,Omen"
Ascent,Symbol,Clown9 Valorant,11,13,4,8,5,7,"Killjoy,Omen,Jett,KAY/O,Fade","Sova,Killjoy,Omen,Jett,KAY/O"
Sunset,RTZN,LONETEAM,13,7,3,5,2,10,"Cypher,Sova,Omen,KAY/O,Neon","Breach,Raze,Cypher,Sova,Omen"
Bind,GTZ Esports,ehehxd,13,9,5,5,4,8,"Breach,Raze,Cypher,Viper,Brimstone","Raze,Sova,Viper,Brimstone,KAY/O"
Icebox,QLASH,Termina Enjoyers,12,14,7,6,8,5,"Killjoy,Viper,Jett,KAY/O,Gekko","Sova,Killjoy,Viper,Jett,Harbor"
Ascent,PCIFIC Espor,There is no tomorrow,13,8,5,4,4,8,"Sova,Killjoy,Omen,Jett,KAY/O","Sova,Killjoy,Omen,Jett,KAY/O"
Sunset,FULL BOX 200,Lenovo Honvéd,10,13,5,7,6,5,"Breach,Raze,Cypher,Sova,Omen","Breach,Raze,Cypher,Omen,Gekko"
Split,Zerance,FAMILY,13,8,8,4,4,5,"Raze,Viper,Omen,Jett,Skye","Breach,Raze,Cypher,Omen,Skye"
Ascent,AntyDPM,Washed5,13,9,10,0,9,3,"Sova,Killjoy,Omen,Jett,KAY/O","Cypher,Sova,Viper,Omen,Jett"
Icebox,Formulation Gaming,Requiem,11,13,3,9,4,8,"Killjoy,Viper,Omen,KAY/O,Gekko","Killjoy,Viper,Jett,KAY/O,Gekko"
Bind,Symbol,Clown9 Valorant,13,10,9,2,8,4,"Raze,Cypher,Jett,Skye,Astra","Raze,Viper,Omen,Skye,Gekko"
Ascent,One6,Team Calamity,13,8,8,4,4,5,"Sova,Killjoy,Omen,Jett,KAY/O","Sova,Killjoy,Omen,Jett,KAY/O"
Sunset,Alpha Vortexx,BG chilling,13,9,7,5,4,6,"Breach,Cypher,Sova,Omen,Neon","Breach,Raze,Cypher,Omen,Fade"
Bind,CGN Esports,SK Gaming,13,7,10,2,5,3,"Raze,Viper,Brimstone,Sage,Gekko","Viper,Omen,Jett,Skye,Gekko"
Bind,F9 Wonders,Bohr,4,13,3,2,11,1,"Raze,Viper,Brimstone,Skye,Gekko","Raze,Viper,Skye,Gekko,Clove"
Breeze,GTZ Esports,ehehxd,13,11,9,3,8,4,"Cypher,Sova,Viper,Jett,Yoru","Cypher,Sova,Viper,Jett,KAY/O"
Bind,PCIFIC Espor,There is no tomorrow,13,6,4,3,3,9,"Raze,Viper,Omen,Skye,Gekko","Raze,Cypher,Viper,Brimstone,Skye"
Bind,Zerance,FAMILY,13,9,9,1,8,4,"Raze,Viper,Brimstone,Skye,Gekko","Raze,Viper,Brimstone,Skye,Gekko"
Breeze,Alpha Vortexx,BG chilling,13,2,2,1,1,11,"Cypher,Sova,Viper,Omen,Yoru","Cypher,Sova,Viper,Jett,Yoru"
Bind,Sila4i,delman,13,11,6,6,5,7,"Raze,Viper,Omen,Skye,Gekko","Raze,Sova,Phoenix,Brimstone,Gekko"
Lotus,Symbol,Clown9 Valorant,9,13,3,7,6,6,"Breach,Raze,Killjoy,Omen,Fade","Raze,Killjoy,Viper,Omen,Fade"
Lotus,Valiant GC,NOMAD GC,13,6,10,2,4,3,"Breach,Sova,Killjoy,Omen,Jett","Raze,Killjoy,Omen,Fade,Gekko"
Sunset,PCIFIC Espor,There is no tomorrow,13,1,2,0,1,11,"Sova,Viper,Phoenix,Omen,Chamber","Breach,Raze,Cypher,Sova,Omen"
Split,One6,Team Calamity,13,11,5,7,4,8,"Raze,Cypher,Viper,Omen,Skye","Raze,Cypher,Viper,Omen,Skye"
Split,CGN Esports,SK Gaming,13,4,4,1,3,9,"Raze,Viper,Sage,Omen,Jett","Cypher,Viper,Omen,Jett,Skye"
Lotus,GTZ Esports,ehehxd,6,13,4,8,5,2,"Breach,Raze,Cypher,Omen,Fade","Breach,Raze,Sova,Killjoy,Omen"
Bind,who cars?,K10,13,11,8,4,7,5,"Raze,Viper,Brimstone,Skye,Gekko","Raze,Cypher,Viper,Brimstone,Skye"
Ascent,Zerance,FAMILY,5,13,3,3,10,2,"Sova,Killjoy,Omen,Jett,KAY/O","Sova,Killjoy,Omen,Jett,KAY/O"
Sunset,Sila4i,delman,13,11,6,6,5,7,"Raze,Cypher,Viper,Omen,Gekko","Raze,Cypher,Phoenix,Omen,Gekko"
Lotus,AntyDPM,INF ESPORTS NXTGN,13,2,10,2,0,3,"Breach,Raze,Killjoy,Omen,Fade","Raze,Killjoy,Omen,Fade,Harbor"
Lotus,BG chilling,REAL1Z,13,7,7,5,2,6,"Raze,Viper,Omen,Chamber,Fade","Raze,Killjoy,Viper,Omen,Skye"
Ascent,Symbol,HL Tauri eSports,13,7,5,3,4,8,"Killjoy,Omen,Jett,KAY/O,Fade","Sova,Killjoy,Omen,Jett,KAY/O"
Lotus,Clown9 Valorant,BSK Esport,13,7,6,2,5,7,"Raze,Killjoy,Viper,Omen,Fade","Breach,Killjoy,Omen,Skye,Neon"
Ascent,F9 Wonders,Bohr,7,13,5,7,6,2,"Sova,Killjoy,Phoenix,Omen,Jett","Sova,Killjoy,Omen,Jett,KAY/O"
Lotus,PCIFIC Espor,There is no tomorrow,11,13,7,5,8,4,"Breach,Raze,Killjoy,Omen,Fade","Breach,Sova,Killjoy,Omen,Jett"
Bind,AXELERATE,BC SWELL,4,13,1,11,2,3,"Breach,Viper,Phoenix,Brimstone,KAY/O","Raze,Cypher,Viper,Brimstone,Skye"
Icebox,Washed5,Defient Esports,13,10,8,3,7,5,"Sova,Killjoy,Viper,Jett,KAY/O","Sova,Killjoy,Viper,Sage,Jett"
Lotus,NOEZ FOXX,Delight,13,11,6,6,5,7,"Raze,Killjoy,Viper,Omen,Fade","Raze,Killjoy,Viper,Omen,Fade"
Breeze,who cars?,K10,13,3,10,2,1,3,"Cypher,Sova,Viper,Jett,KAY/O","Cypher,Sova,Viper,Omen,Yoru"
Bind,Team Calamity,Frosty Fridge,13,9,6,6,3,7,"Raze,Viper,Brimstone,Skye,Yoru","Raze,Viper,Brimstone,Skye,Yoru"
Sunset,Alpha Vortexx,5STARS,13,6,7,0,6,6,"Breach,Cypher,Sova,Omen,Neon","Raze,Cypher,Omen,KAY/O,Gekko"
Icebox,Sila4i,delman,6,13,6,6,7,0,"Sova,Killjoy,Viper,Jett,KAY/O","Sova,Killjoy,Phoenix,Brimstone,Harbor"
Bind,DRX,Paper Rex,6,13,2,5,8,4,"Raze,Cypher,Viper,Brimstone,KAY/O","Raze,Brimstone,Skye,Harbor,Gekko"
Sunset,Valiant GC,NOMAD GC,13,10,7,4,6,6,"Breach,Raze,Cypher,Omen,Gekko","Cypher,Sova,Omen,Jett,Gekko"
Lotus,AXELERATE,BC SWELL,5,13,1,5,8,4,"Raze,Killjoy,Viper,Omen,Fade","Raze,Killjoy,Viper,Omen,Fade"
Bind,NOEZ FOXX,Delight,4,13,2,3,10,2,"Raze,Viper,Brimstone,Yoru,Fade","Raze,Viper,Omen,Skye,Yoru"
Split,NOEZ FOXX,Delight,13,4,5,0,4,8,"Raze,Viper,Omen,Jett,Skye","Raze,Cypher,Viper,Omen,Skye"
Ascent,DRX,Paper Rex,13,10,5,7,3,8,"Cypher,Viper,Omen,Jett,KAY/O","Sova,Sage,Omen,Jett,KAY/O"
Lotus,F9 Wonders,Bohr,13,10,8,4,6,5,"Breach,Raze,Killjoy,Omen,Gekko","Breach,Raze,Killjoy,Omen,Gekko"
Icebox,AXELERATE,Father's Back,13,11,8,4,7,5,"Sova,Killjoy,Viper,Reyna,Gekko","Killjoy,Viper,KAY/O,Harbor,Gekko"
Lotus,DRX,Paper Rex,6,13,4,8,5,2,"Raze,Killjoy,Viper,Omen,Fade","Breach,Raze,Omen,Jett,Skye"
Lotus,Crest Gaming ZST,FAV gaming,11,13,6,6,7,5,"Raze,Killjoy,Viper,Omen,Fade","Raze,Killjoy,Viper,Omen,Fade"
Ascent,Jamcat,Misses Worldwide,15,13,5,9,4,10,"Sova,Killjoy,Reyna,Omen,Jett","Breach,Raze,Sova,Omen,Fade"
Lotus,FOKUS,SK Gaming,6,13,4,3,10,2,"Cypher,Yoru,Astra,Neon,Fade","Breach,Sova,Killjoy,Omen,Jett"
Breeze,NOEZ FOXX,esports team αD,13,3,3,1,2,10,"Cypher,Sova,Viper,Jett,KAY/O","Cypher,Sova,Viper,Jett,Yoru"
Sunset,Divergentes GC,HUGE Esports GC,4,13,0,5,8,4,"Breach,Cypher,Omen,Jett,Gekko","Breach,Raze,Cypher,Omen,Neon"
Icebox,Zerance Mint,Sa Kour'A,13,5,2,4,1,11,"Sova,Killjoy,Viper,Jett,Gekko","Sova,Killjoy,Viper,Reyna,Jett"
Lotus,AXELERATE,Father's Back,13,11,9,3,8,4,"Raze,Killjoy,Viper,Omen,Fade","Raze,Killjoy,Viper,Omen,Fade"
Split,Crest Gaming ZST,FAV gaming,7,13,4,8,5,3,"Raze,Viper,Omen,Jett,Skye","Breach,Raze,Viper,Omen,Fade"
Split,RIDDLE ORDER,DopeNess Esports,13,5,9,3,2,4,"Raze,Viper,Omen,Jett,Skye","Raze,Cypher,Omen,Jett,Skye"
Sunset,BC SWELL,BLUE BEES.ESP,13,11,4,8,3,9,"Raze,Cypher,Omen,KAY/O,Gekko","Raze,Cypher,Phoenix,Omen,Fade"
Ascent,Delight,SETOUCHI SPARKS,13,11,3,9,2,10,"Cypher,Sova,Omen,Jett,KAY/O","Sova,Killjoy,Omen,Jett,KAY/O"
Breeze,Gen.G Esports,T1,7,13,3,5,8,4,"Sova,Viper,Jett,Yoru,Astra","Sova,Viper,Jett,Yoru,Harbor"
Split,NOEZ FOXX,esports team αD,11,13,3,9,4,8,"Raze,Viper,Omen,Jett,Skye","Breach,Raze,Cypher,Sage,Omen"
Split,VLG X,K10 (OCE),6,13,2,5,8,4,"Raze,Sage,Omen,Jett,Skye","Raze,Cypher,Viper,Omen,Skye"
Lotus,Reve Drift Arena,TODAK,13,8,8,4,4,5,"Raze,Killjoy,Viper,Omen,Skye","Raze,Killjoy,Viper,Omen,Fade"
Lotus,Jamcat,Misses Worldwide,7,13,1,7,6,6,"Raze,Killjoy,Omen,Jett,Gekko","Killjoy,Omen,Chamber,Neon,Gekko"
Breeze,FLUX GC,Xu Gang Crimson,11,13,6,6,7,5,"Sova,Viper,Reyna,KAY/O,Chamber","Cypher,Sova,Viper,Jett,KAY/O"
Sunset,FOKUS,SK Gaming,12,14,7,6,8,5,"Raze,Cypher,Omen,KAY/O,Gekko","Cypher,Viper,Omen,Jett,Gekko"
Bind,raindrops,YIPPEE,13,7,4,4,3,9,"Raze,Cypher,Viper,Brimstone,Skye","Raze,Cypher,Viper,Brimstone,Skye"
Breeze,WOMP WOMP,Balut Warriors,13,10,5,6,4,8,"Cypher,Sova,Viper,Jett,KAY/O","Cypher,Sova,Viper,Jett,Yoru"
Breeze,BC SWELL,BLUE BEES.ESP,13,4,8,4,0,5,"Cypher,Sova,Viper,Omen,Yoru","Cypher,Sova,Viper,Jett,Yoru"
Sunset,Crest Gaming ZST,FAV gaming,13,11,6,6,5,7,"Breach,Raze,Cypher,Omen,Gekko","Raze,Cypher,Omen,KAY/O,Gekko"
Lotus,Divergentes GC,HUGE Esports GC,10,13,3,8,5,7,"Breach,Raze,Cypher,Omen,Gekko","Raze,Killjoy,Omen,Skye,Neon"
Ascent,AXELERATE,Father's Back,14,16,6,9,7,8,"Breach,Viper,Phoenix,Omen,KAY/O","Sova,Killjoy,Omen,Jett,KAY/O"
Sunset,Gen.G Esports,T1,13,8,7,2,6,6,"Cypher,Sova,Omen,Jett,KAY/O","Raze,Cypher,Omen,KAY/O,Gekko"
Ascent,RIDDLE ORDER,DopeNess Esports,13,11,9,3,8,4,"Sova,Killjoy,Omen,Jett,KAY/O","Sova,Killjoy,Omen,Jett,KAY/O"
Lotus,NOEZ FOXX,esports team αD,13,7,7,1,6,6,"Raze,Killjoy,Viper,Omen,Fade","Raze,Killjoy,Viper,Omen,Fade"
Split,Delight,SETOUCHI SPARKS,13,10,6,5,5,7,"Raze,Cypher,Viper,Omen,Skye","Breach,Raze,Cypher,Omen,Gekko"
Icebox,Reve Drift Arena,TODAK,13,5,5,1,4,8,"Sova,Killjoy,Viper,Jett,Gekko","Killjoy,Viper,Jett,KAY/O,Gekko"
Ascent,HomeBois,Redsea Esport,13,9,6,6,3,7,"Sova,Killjoy,Omen,Jett,KAY/O","Sova,Killjoy,Omen,Jett,KAY/O"
Split,Jamcat,Misses Worldwide,13,11,8,4,7,5,"Raze,Cypher,Jett,Skye,Clove","Raze,Cypher,Viper,Omen,Skye"
Icebox,WOMP WOMP,Balut Warriors,13,5,8,4,1,5,"Sova,Killjoy,Viper,Reyna,Jett","Sova,Killjoy,Viper,Phoenix,Jett"
Ascent,FLUX GC,Xu Gang Crimson,7,13,4,8,5,3,"Sova,Killjoy,Reyna,Jett,Clove","Sova,Killjoy,Omen,Jett,KAY/O"
Lotus,VLG X,K10 (OCE),8,13,3,6,7,5,"Breach,Omen,Jett,Chamber,Gekko","Raze,Killjoy,Viper,Omen,Fade"
Lotus,raindrops,YIPPEE,13,5,10,2,3,3,"Cypher,Phoenix,Omen,Jett,Gekko","Raze,Killjoy,Viper,Omen,Fade"
Breeze,HomeBois,Redsea Esport,13,2,3,0,2,10,"Cypher,Sova,Viper,Jett,KAY/O","Cypher,Sova,Viper,Yoru,Astra"
Lotus,Blitz Esports,TODAK,6,13,2,5,8,4,"Breach,Killjoy,Omen,Jett,Gekko","Raze,Killjoy,Viper,Omen,Fade"
Ascent,Gen.G Esports,T1,9,13,3,9,4,6,"Sova,Killjoy,Omen,Jett,KAY/O","Sova,Killjoy,Omen,Jett,KAY/O"
Sunset,HomeBois,ENDER,8,13,3,6,7,5,"Breach,Raze,Cypher,Omen,Gekko","Raze,Cypher,Omen,KAY/O,Gekko"
Lotus,Misses Worldwide,Xu Gang Crimson,13,9,9,3,6,4,"Killjoy,Omen,Chamber,Neon,Gekko","Raze,Killjoy,Omen,Skye,Gekko"
Breeze,Blitz Esports,TODAK,10,13,3,8,5,7,"Cypher,Sova,Viper,Jett,Yoru","Cypher,Sova,Viper,Jett,KAY/O"
Ascent,Reve Drift Arena,Kizuna Esports,6,13,3,4,9,3,"Sova,Killjoy,Jett,KAY/O,Clove","Sova,Killjoy,Omen,Jett,KAY/O"
Breeze,VLG X,FLUX GC,10,13,7,4,9,3,"Cypher,Sova,Viper,Reyna,Jett","Cypher,Sova,Viper,Reyna,Jett"
Icebox,YIPPEE,Balut Warriors,13,7,5,3,4,8,"Killjoy,Viper,Jett,KAY/O,Gekko","Sova,Killjoy,Viper,Jett,Clove"
Lotus,HomeBois,ENDER,6,13,5,7,6,1,"Raze,Killjoy,Viper,Omen,Skye","Raze,Killjoy,Viper,Omen,Fade"
Lotus,raindrops,Jamcat,13,6,9,3,3,4,"Cypher,Phoenix,Omen,Jett,Gekko","Raze,Killjoy,Omen,Jett,Fade"
Breeze,Misses Worldwide,Xu Gang Crimson,4,13,1,4,9,3,"Cypher,Sova,Viper,Jett,KAY/O","Cypher,Sova,Viper,Jett,KAY/O"
Ascent,WOMP WOMP,K10 (OCE),13,7,7,1,6,6,"Sova,Killjoy,Omen,Jett,KAY/O","Sova,Killjoy,Omen,Jett,KAY/O"
Ascent,Redsea Esport,negativegirlrizz,13,11,2,10,1,11,"Sova,Killjoy,Omen,Jett,KAY/O","Sova,Killjoy,Omen,Jett,KAY/O"
Sunset,Reve Drift Arena,Kizuna Esports,6,13,1,6,7,5,"Breach,Raze,Cypher,Omen,Gekko","Breach,Raze,Cypher,Omen,Gekko"
Icebox,VLG X,FLUX GC,9,13,2,8,5,7,"Sova,Killjoy,Jett,Harbor,Gekko","Sova,Killjoy,Viper,Jett,Clove"
Sunset,YIPPEE,Balut Warriors,13,8,8,4,4,5,"Raze,Cypher,Omen,KAY/O,Gekko","Raze,Cypher,Sage,Omen,Gekko"
Icebox,WOMP WOMP,K10 (OCE),13,5,5,1,4,8,"Sova,Killjoy,Viper,Reyna,Jett","Killjoy,Viper,Jett,KAY/O,Gekko"
Icebox,TODAK,ENDER,9,13,4,8,5,5,"Killjoy,Viper,Jett,KAY/O,Gekko","Sova,Killjoy,Viper,Jett,Harbor"
Icebox,Misses Worldwide,Xu Gang Crimson,13,7,5,3,4,8,"Sova,Killjoy,Viper,Jett,Gekko","Sova,Killjoy,Viper,Jett,KAY/O"
Split,raindrops,Jamcat,13,9,6,6,3,7,"Raze,Cypher,Viper,Omen,Skye","Raze,Cypher,Jett,Skye,Clove"
Bind,Redsea Esport,negativegirlrizz,13,10,5,6,4,8,"Raze,Viper,Brimstone,Skye,Gekko","Raze,Viper,Skye,Gekko,Clove"
Icebox,Reve Drift Arena,Kizuna Esports,13,9,10,2,7,3,"Sova,Killjoy,Viper,Jett,Gekko","Sova,Killjoy,Viper,Jett,Gekko"
Ascent,TODAK,ENDER,15,13,9,5,8,6,"Sova,Killjoy,Omen,Jett,KAY/O","Sova,Killjoy,Omen,Jett,KAY/O"
Breeze,HomeBois,Blitz Esports,13,10,9,2,8,4,"Cypher,Sova,Viper,Jett,KAY/O","Cypher,Sova,Jett,Yoru,Harbor"
Split,Kizuna Esports,negativegirlrizz,13,6,5,2,4,8,"Raze,Cypher,Omen,Jett,Skye","Raze,Cypher,Omen,Skye,Clove"
Lotus,Redsea Esport,Reve Drift Arena,3,13,2,10,3,1,"Breach,Raze,Killjoy,Omen,Gekko","Raze,Killjoy,Viper,Omen,Skye"
Ascent,HomeBois,Blitz Esports,13,5,9,3,2,4,"Sova,Killjoy,Omen,Jett,KAY/O","Breach,Sova,Killjoy,Jett,Astra"
Lotus,TODAK,ENDER,11,13,3,9,4,8,"Raze,Killjoy,Viper,Omen,Fade","Raze,Killjoy,Viper,Omen,Fade"
Sunset,Kizuna Esports,negativegirlrizz,13,6,5,2,4,8,"Breach,Raze,Cypher,Omen,Gekko","Raze,Cypher,Omen,KAY/O,Clove"
Ascent,Redsea Esport,Reve Drift Arena,1,13,0,12,1,1,"Sova,Killjoy,Omen,Jett,KAY/O","Sova,Killjoy,Jett,KAY/O,Clove"
Bind,Agropesca Jacare,Salamaleiko,11,13,5,7,6,6,"Raze,Viper,Brimstone,Skye,Gekko","Raze,Viper,Brimstone,Jett,Skye"
Icebox,Sentinels,FURIA,13,9,5,5,4,8,"Killjoy,Viper,Jett,KAY/O,Gekko","Sova,Killjoy,Viper,Reyna,Gekko"
Bind,CONTRAxSCRUB,Panters Esports,14,12,9,4,8,5,"Raze,Viper,Brimstone,Skye,Gekko","Raze,Cypher,Brimstone,Skye,Gekko"
Lotus,Illicit Gaming,Chivas Esports,5,13,3,3,10,2,"Raze,Killjoy,Viper,Omen,Fade","Raze,Cypher,Omen,Neon,Gekko"
Icebox,KTANA,Old School Kr3w,15,13,8,6,7,7,"Sova,Viper,Chamber,Harbor,Gekko","Sova,Killjoy,Viper,Jett,KAY/O"
Sunset,Reven eClub,iKU,13,2,3,0,2,10,"Breach,Raze,Cypher,Sova,Omen","Breach,Raze,Cypher,Omen,Fade"
Bind,KTANA,Old School Kr3w,13,2,10,2,0,3,"Breach,Raze,Cypher,Gekko,Clove","Raze,Cypher,Brimstone,Sage,Skye"
Sunset,CONTRAxSCRUB,Panters Esports,13,2,3,0,2,10,"Breach,Raze,Cypher,Omen,Fade","Breach,Raze,Cypher,Sova,Omen"
Bind,Reven eClub,iKU,13,1,2,0,1,11,"Raze,Cypher,Viper,Brimstone,Skye","Raze,Cypher,Viper,Brimstone,Gekko"
Bind,Illicit Gaming,Chivas Esports,9,13,7,3,10,2,"Raze,Viper,Brimstone,Skye,KAY/O","Raze,Viper,Brimstone,Skye,Gekko"
Split,Sentinels,FURIA,13,5,5,1,4,8,"Raze,Cypher,Viper,Omen,Skye","Raze,Viper,Omen,Jett,Skye"
Sunset,Blinn Esports,Zero MarksMen Black,13,7,8,4,3,5,"Raze,Cypher,Omen,KAY/O,Gekko","Breach,Sova,Viper,Phoenix,Omen"
Sunset,Spirit Academy,Tropa do A,13,7,5,3,4,8,"Breach,Sova,Viper,Phoenix,Omen","Raze,Cypher,Omen,KAY/O,Gekko"
Breeze,Burger Boyz 2.0,Resonate,14,16,6,9,7,8,"Cypher,Sova,Viper,Jett,Yoru","Cypher,Sova,Viper,Jett,KAY/O"
Icebox,Agropesca Jacare,Salamaleiko,7,13,4,4,9,3,"Killjoy,Viper,Jett,KAY/O,Gekko","Breach,Killjoy,Viper,Jett,Neon"
Sunset,SAGAZ,SAIDEIRA ESPORTS,13,3,11,1,2,2,"Raze,Cypher,Omen,KAY/O,Gekko","Breach,Raze,Cypher,Sova,Omen"
Bind,Blinn Esports,Zero MarksMen Black,13,10,9,3,7,4,"Raze,Viper,Brimstone,KAY/O,Gekko","Breach,Viper,Phoenix,Brimstone,KAY/O"
Ascent,Burger Boyz 2.0,Resonate,4,13,2,3,10,2,"Sova,Killjoy,Omen,Jett,KAY/O","Sova,Killjoy,Sage,Omen,Jett"
Breeze,SANJA,NIGERIA 96,5,13,3,9,4,2,"Cypher,Sova,Viper,Jett,KAY/O","Cypher,Sova,Viper,Yoru,KAY/O"
Breeze,SAGAZ,SAIDEIRA ESPORTS,13,6,4,3,3,9,"Cypher,Sova,Viper,Jett,KAY/O","Cypher,Sova,Viper,Jett,KAY/O"
Split,Spirit Academy,Tropa do A,14,12,6,7,5,8,"Breach,Raze,Cypher,Omen,Skye","Raze,Cypher,Viper,Omen,Skye"
Bind,Novita Esports,XPERION NXT,13,11,5,7,4,8,"Viper,Brimstone,Jett,Skye,Yoru","Raze,Viper,Brimstone,Skye,Gekko"
Bind,NoOrg9,Salamaleiko,6,13,2,5,8,4,"Raze,Viper,Brimstone,Skye,Gekko","Raze,Viper,Brimstone,Jett,Skye"
Lotus,Rebirth Esports,ONA Family,14,12,6,7,5,8,"Breach,Raze,Cypher,Omen,Jett","Raze,Killjoy,Viper,Omen,Fade"
Sunset,SANJA,NIGERIA 96,4,13,3,9,4,1,"Raze,Cypher,Omen,Fade,Gekko","Raze,Cypher,Sova,Omen,Gekko"
Lotus,Zen Esports,LRV Esports,11,13,5,7,6,6,"Raze,Killjoy,Viper,Omen,Fade","Raze,Killjoy,Viper,Omen,Fade"
Icebox,Red Eye,Gishki,13,4,4,1,3,9,"Killjoy,Viper,Jett,KAY/O,Gekko","Killjoy,Viper,Jett,KAY/O,Gekko"
Icebox,EvolutionSTARS Avis,Sky Esports,5,13,2,4,9,3,"Sova,Killjoy,Jett,Harbor,Gekko","Sova,Killjoy,Viper,Jett,Harbor"
Ascent,Border Monsters Chile,DOLPHINS GAMING,13,6,4,3,3,9,"Sova,Killjoy,Omen,Jett,KAY/O","Sova,Killjoy,Omen,Jett,KAY/O"
Split,MEOW CONTROL,Burger Boyz 2.0,9,13,6,4,9,3,"Raze,Cypher,Viper,Omen,Skye","Raze,Viper,Omen,Jett,Skye"
Breeze,Agropesca Jacare,Atlanta Esports,14,12,6,7,5,8,"Cypher,Sova,Viper,Jett,Yoru","Cypher,Sova,Viper,Jett,Yoru"
Split,SAGAZ,Largados e Baitados,13,0,1,0,0,12,"Raze,Cypher,Viper,Omen,Skye","Raze,Cypher,Viper,Omen,Skye"
Lotus,OS CARA CEGO 2.0,SAIDEIRA ESPORTS,7,13,6,6,7,1,"Raze,Killjoy,Viper,Omen,Fade","Raze,Killjoy,Viper,Omen,Fade"
Icebox,Novita Esports,XPERION NXT,13,9,9,3,6,4,"Killjoy,Viper,Reyna,Jett,Gekko","Sova,Killjoy,Viper,Jett,Harbor"
Split,Van Lyn,Resonate,10,13,2,9,4,8,"Raze,Cypher,Viper,Omen,Skye","Raze,Cypher,Sage,Omen,Jett"
Bind,Tropa do A,Unity Brasil,15,13,12,2,11,3,"Raze,Viper,Brimstone,Skye,Gekko","Raze,Viper,Brimstone,Skye,Gekko"
Ascent,NoOrg9,Salamaleiko,12,14,6,7,7,6,"Sova,Killjoy,Omen,Jett,KAY/O","Sova,Killjoy,Omen,Jett,KAY/O"
Icebox,Spirit Academy,Smoke Meio,13,8,5,4,4,8,"Killjoy,Viper,Jett,KAY/O,Gekko","Sova,Killjoy,Viper,Jett,Gekko"
Breeze,NIGERIA 96,Fenda dos Streamers,13,2,3,0,2,10,"Cypher,Sova,Viper,Yoru,KAY/O","Sova,Viper,Jett,KAY/O,Chamber"
Icebox,Rebirth Esports,ONA Family,13,9,5,7,2,8,"Viper,Reyna,Omen,Jett,Gekko","Killjoy,Viper,Sage,KAY/O,Gekko"
Ascent,Zen Esports,LRV Esports,5,13,1,5,8,4,"Sova,Killjoy,Omen,Jett,KAY/O","Sova,Killjoy,Omen,Jett,KAY/O"
Sunset,Border Monsters Chile,DOLPHINS GAMING,13,0,12,0,0,1,"Raze,Cypher,Omen,KAY/O,Gekko","Breach,Raze,Cypher,Sova,Omen"
Lotus,Red Eye,Gishki,13,4,10,2,2,3,"Raze,Killjoy,Viper,Omen,Fade","Raze,Killjoy,Viper,Omen,Fade"
Sunset,Underhounds,SANJA,6,13,2,5,8,4,"Breach,Raze,Killjoy,Omen,Gekko","Raze,Cypher,Omen,Fade,Gekko"
Split,K10,Free Orbs,13,9,5,7,2,8,"Raze,Cypher,Viper,Omen,Skye","Raze,Cypher,Viper,Omen,Skye"
Ascent,EvolutionSTARS Avis,Sky Esports,6,13,2,10,3,4,"Sova,Killjoy,Omen,Jett,KAY/O","Sova,Killjoy,Omen,Jett,KAY/O"
Lotus,Spirit Academy,Smoke Meio,13,4,8,4,0,5,"Raze,Killjoy,Viper,Omen,Fade","Raze,Killjoy,Viper,Omen,Skye"
Lotus,SAGAZ,Largados e Baitados,13,5,4,2,3,9,"Raze,Killjoy,Viper,Omen,Fade","Breach,Killjoy,Omen,Skye,Neon"
Sunset,Tropa do A,Unity Brasil,13,3,2,2,1,11,"Raze,Cypher,Omen,KAY/O,Gekko","Breach,Raze,Cypher,Omen,Gekko"
Bind,OS CARA CEGO 2.0,SAIDEIRA ESPORTS,11,13,6,6,7,5,"Raze,Viper,Brimstone,Skye,Gekko","Raze,Cypher,Viper,Brimstone,Skye"
Lotus,NIGERIA 96,Fenda dos Streamers,13,5,9,3,2,4,"Raze,Killjoy,Viper,Omen,Fade","Raze,Cypher,Omen,Chamber,Fade"
Icebox,Agropesca Jacare,Atlanta Esports,13,9,6,4,5,7,"Killjoy,Viper,Jett,KAY/O,Gekko","Sova,Killjoy,Viper,Omen,Jett"
Sunset,Van Lyn,Resonate,10,13,6,5,8,4,"Breach,Raze,Cypher,Sova,Omen","Raze,Cypher,Omen,KAY/O,Gekko"
Icebox,Underhounds,SANJA,8,13,4,8,5,4,"Killjoy,Viper,Jett,KAY/O,Gekko","Sova,Killjoy,Viper,Jett,Gekko"
Lotus,NoOrg9,Salamaleiko,13,4,9,3,1,4,"Raze,Killjoy,Viper,Omen,Fade","Raze,Killjoy,Viper,Omen,Fade"
Breeze,MEOW CONTROL,Burger Boyz 2.0,15,17,7,9,8,8,"Cypher,Sova,Viper,Jett,KAY/O","Cypher,Sova,Viper,Jett,Yoru"
Sunset,Requiem,CTRL x YARI Esports,15,13,9,5,8,6,"Raze,Cypher,Omen,KAY/O,Gekko","Breach,Raze,Cypher,Omen,Gekko"
Sunset,Novita Esports,XPERION NXT,11,13,6,6,7,5,"Raze,Cypher,Omen,Skye,Neon","Raze,Cypher,Sage,Omen,KAY/O"
Lotus,Zerance,Cicadas Gaming,10,13,5,7,6,5,"Raze,Killjoy,Viper,Omen,Fade","Raze,Killjoy,Viper,Omen,Fade"
Lotus,Entry Frogs Iris,TwentyStars GC,1,13,1,11,2,0,"Breach,Raze,Killjoy,Omen,Fade","Breach,Raze,Killjoy,Omen,Chamber"
Bind,K10,Free Orbs,14,16,7,8,8,7,"Raze,Cypher,Viper,Brimstone,Skye","Raze,Viper,Omen,Skye,Deadlock"
Split,ZFT GC 2,Axolotl PinkDevils,3,13,1,11,2,2,"Breach,Killjoy,Sage,Reyna,Omen","Raze,Cypher,Viper,Omen,Skye"
Lotus,Nemesi,EKO Esports GC,1,13,0,2,11,1,"Breach,Killjoy,Neon,Fade,Clove","Breach,Raze,Killjoy,Omen,Gekko"
Lotus,EKO Esports GC,Nemesi,13,1,11,1,0,2,"Breach,Raze,Killjoy,Omen,Gekko","Breach,Killjoy,Neon,Fade,Clove"
Ascent,ENIGMA GC,LuckyGirls,1,13,1,11,2,0,"Sova,Killjoy,Omen,Jett,KAY/O","Sova,Killjoy,Omen,Jett,KAY/O"
Breeze,Requiem,CTRL x YARI Esports,13,8,4,5,3,9,"Cypher,Sova,Viper,Jett,Yoru","Cypher,Sova,Viper,Yoru,Astra"
Ascent,Cobweb eSports,Los Bandidos,10,13,5,6,7,5,"Sova,Killjoy,Phoenix,Omen,Jett","Cypher,Sova,Omen,Jett,KAY/O"
Split,FAMILY,Bakim Corp,7,13,4,4,9,3,"Breach,Raze,Cypher,Omen,Skye","Raze,Cypher,Viper,Omen,Skye"
Breeze,InTenZive,ehehxd,8,13,2,7,6,6,"Cypher,Sova,Viper,Jett,KAY/O","Cypher,Sova,Viper,Jett,KAY/O"
Breeze,Novita Esports,XPERION NXT,13,8,5,4,4,8,"Cypher,Sova,Viper,Jett,Yoru","Sova,Viper,Skye,Neon,Harbor"
Ascent,Zerance,Cicadas Gaming,8,13,3,9,4,5,"Sova,Killjoy,Omen,Jett,KAY/O","Sova,Killjoy,Omen,Jett,KAY/O"
Sunset,K10,Free Orbs,13,9,6,4,5,7,"Raze,Cypher,Viper,Omen,Skye","Breach,Cypher,Sova,Omen,Neon"
Sunset,EKO Esports GC,Axolotl PinkDevils,13,3,4,0,3,9,"Breach,Raze,Cypher,Omen,Gekko","Breach,Cypher,Phoenix,Gekko,Clove"
Icebox,Entry Frogs Iris,ZFT GC 2,13,8,7,5,3,6,"Sova,Killjoy,Viper,Jett,KAY/O","Sova,Killjoy,Viper,Reyna,KAY/O"
Lotus,Nemesi,LuckyGirls,11,13,6,6,7,5,"Breach,Raze,Killjoy,Omen,Fade","Breach,Raze,Killjoy,Viper,Omen"
Lotus,Cobweb eSports,Los Bandidos,10,13,7,5,8,3,"Breach,Raze,Killjoy,Omen,Fade","Breach,Raze,Killjoy,Omen,Gekko"
Bind,Zerance,Cicadas Gaming,13,4,10,2,2,3,"Raze,Viper,Brimstone,Skye,Gekko","Breach,Cypher,Sova,Brimstone,Yoru"
Bind,InTenZive,ehehxd,8,13,4,8,5,4,"Raze,Viper,Brimstone,Skye,Gekko","Raze,Sova,Viper,Brimstone,KAY/O"
Lotus,FAMILY,Bakim Corp,7,13,7,5,8,0,"Breach,Raze,Killjoy,Omen,Skye","Raze,Killjoy,Viper,Omen,Skye"
Icebox,BBL Esports,FUT Esports,6,13,3,4,9,3,"Sova,Killjoy,Viper,Sage,Omen","Sova,Killjoy,Viper,Jett,KAY/O"
Sunset,NoodleSoupWarriors,Requiem,13,15,7,7,8,6,"Raze,Cypher,Omen,KAY/O,Gekko","Raze,Cypher,Omen,KAY/O,Gekko"
Lotus,Novita Esports,XPERION NXT,13,15,8,6,9,5,"Killjoy,Omen,Jett,Skye,Yoru","Killjoy,Viper,Omen,Neon,Gekko"
Bind,K10,Chingu,13,7,6,6,1,7,"Raze,Cypher,Viper,Brimstone,Skye","Raze,Cypher,Viper,Brimstone,Skye"
Sunset,CTRL x YARI Esports,Vennegjengen,13,8,6,3,5,7,"Breach,Raze,Cypher,Omen,Gekko","Cypher,Sova,Omen,KAY/O,Neon"
Lotus,EKO Esports GC,Entry Frogs Iris,13,6,5,2,4,8,"Breach,Raze,Killjoy,Omen,Gekko","Breach,Raze,Killjoy,Omen,Fade"
Ascent,ENIGMA GC,ZFT GC 2,14,12,7,6,6,7,"Sova,Killjoy,Omen,Jett,KAY/O","Sova,Killjoy,Reyna,Omen,KAY/O"
Sunset,Nemesi,Axolotl PinkDevils,2,13,0,3,10,2,"Cypher,Sova,Omen,Jett,Gekko","Breach,Cypher,Phoenix,Gekko,Clove"
Lotus,EXO Clan,Free Orbs,9,13,8,4,9,1,"Raze,Viper,Omen,Chamber,Fade","Breach,Raze,Killjoy,Omen,Fade"
Icebox,NoodleSoupWarriors,Requiem,13,4,9,3,1,4,"Raze,Sova,Killjoy,Viper,Jett","Killjoy,Viper,Jett,KAY/O,Gekko"
Bind,BBL Esports,FUT Esports,9,13,4,8,5,5,"Breach,Raze,Viper,Brimstone,Skye","Raze,Viper,Omen,KAY/O,Gekko"
Ascent,CTRL x YARI Esports,Vennegjengen,13,9,5,5,4,8,"Breach,Viper,Phoenix,Omen,KAY/O","Cypher,Sova,Omen,Jett,Deadlock"
Sunset,EXO Clan,Free Orbs,8,13,5,7,6,3,"Viper,Sage,Omen,KAY/O,Gekko","Breach,Cypher,Sova,Omen,Neon"
Sunset,K10,Chingu,18,16,8,9,7,10,"Raze,Cypher,Viper,Omen,Skye","Raze,Cypher,Omen,KAY/O,Gekko"
Split,NoodleSoupWarriors,Requiem,1,13,1,11,2,0,"Raze,Cypher,Viper,Omen,Skye","Raze,Cypher,Viper,Omen,Skye"
Icebox,Team Liquid,Gentle Mates,13,2,10,2,0,3,"Sova,Viper,Sage,Reyna,Chamber","Killjoy,Viper,Sage,KAY/O,Gekko"
Lotus,Team Liquid,Gentle Mates,13,4,8,4,0,5,"Breach,Raze,Cypher,Sova,Omen","Breach,Raze,Cypher,Sage,Omen"
Sunset,BLUE BEES.ESP,Striders,13,7,6,6,1,7,"Raze,Cypher,Phoenix,Omen,Fade","Breach,Raze,Cypher,Omen,Gekko"
Breeze,esports team αD,RABILIS BURST,13,6,9,3,3,4,"Cypher,Sova,Viper,Jett,Yoru","Cypher,Sova,Viper,Jett,KAY/O"
Bind,AXELERATE,FAV gaming,3,13,1,11,2,2,"Breach,Viper,Phoenix,Brimstone,KAY/O","Raze,Cypher,Viper,Brimstone,Skye"
Lotus,Father's Back,NTPOJA,13,10,9,2,8,4,"Raze,Killjoy,Viper,Omen,Fade","Raze,Killjoy,Viper,Omen,Fade"
Lotus,BLUE BEES.ESP,Striders,13,11,9,3,8,4,"Raze,Killjoy,Viper,Omen,Fade","Raze,Sage,Omen,Skye,Clove"
Lotus,AXELERATE,FAV gaming,2,13,0,3,10,2,"Raze,Killjoy,Viper,Omen,Fade","Raze,Killjoy,Viper,Omen,Fade"
Breeze,Crest Gaming ZST,BC SWELL,13,9,8,4,5,5,"Sova,Viper,Jett,Yoru,Astra","Cypher,Sova,Viper,Omen,Yoru"
Split,esports team αD,RABILIS BURST,13,7,8,4,3,5,"Breach,Raze,Cypher,Sage,Omen","Raze,Viper,Omen,Jett,Skye"
Ascent,RIDDLE ORDER,Delight,13,4,5,0,4,8,"Sova,Killjoy,Omen,Jett,KAY/O","Sova,Killjoy,Omen,Jett,KAY/O"
Bind,Xu Gang Crimson,YIPPEE,7,13,5,7,6,2,"Raze,Cypher,Brimstone,Skye,Gekko","Raze,Cypher,Viper,Brimstone,Skye"
Breeze,Father's Back,NTPOJA,13,8,6,3,5,7,"Sova,Viper,Jett,Yoru,Astra","Cypher,Sova,Viper,Omen,Yoru"
Split,SETOUCHI SPARKS,HIT GAMING CLAN,13,5,7,5,0,6,"Breach,Raze,Cypher,Omen,Gekko","Breach,Raze,Cypher,Omen,Skye"
Sunset,Paper Rex,Talon Esports,13,9,3,7,2,10,"Breach,Raze,Sage,Omen,Gekko","Cypher,Sova,Omen,KAY/O,Neon"
Lotus,NOEZ FOXX,DopeNess Esports,5,13,4,8,5,1,"Raze,Killjoy,Viper,Omen,Fade","Raze,Killjoy,Omen,Jett,Skye"
Icebox,FLUX GC,Jamcat,7,13,4,8,5,3,"Sova,Killjoy,Viper,Reyna,Jett","Raze,Sova,Killjoy,Viper,Sage"
Ascent,Misses Worldwide,K10 (OCE),13,8,6,3,5,7,"Breach,Raze,Sova,Omen,Fade","Sova,Killjoy,Omen,Jett,KAY/O"
Lotus,Crest Gaming ZST,BC SWELL,13,10,6,6,4,7,"Raze,Killjoy,Viper,Omen,Fade","Raze,Killjoy,Viper,Omen,Fade"
Lotus,RIDDLE ORDER,Delight,13,8,6,6,2,7,"Raze,Viper,Omen,Chamber,Fade","Raze,Killjoy,Viper,Omen,Fade"
Icebox,Father's Back,NTPOJA,8,13,5,4,9,3,"Killjoy,Viper,KAY/O,Harbor,Gekko","Sova,Killjoy,Viper,Jett,Harbor"
Sunset,Xu Gang Crimson,YIPPEE,7,13,3,5,8,4,"Raze,Cypher,Omen,KAY/O,Gekko","Raze,Cypher,Omen,KAY/O,Gekko"
Icebox,esports team αD,RABILIS BURST,11,13,5,7,6,6,"Cypher,Sova,Viper,Jett,Harbor","Killjoy,Viper,Jett,KAY/O,Gekko"
Split,WOMP WOMP,raindrops,0,13,0,1,12,0,"Raze,Cypher,Reyna,Omen,Skye","Raze,Cypher,Viper,Omen,Skye"
Ascent,Balut Warriors,VLG X,13,1,2,0,1,11,"Cypher,Sova,Phoenix,Omen,Jett","Breach,Sova,Killjoy,Omen,Jett"
Lotus,BLUE BEES.ESP,AXELERATE,11,13,8,4,9,3,"Raze,Killjoy,Viper,Omen,Fade","Raze,Killjoy,Viper,Omen,Fade"
Lotus,SETOUCHI SPARKS,HIT GAMING CLAN,13,8,6,6,2,7,"Breach,Cypher,Sova,Omen,Jett","Raze,Killjoy,Viper,Omen,Fade"
Ascent,NOEZ FOXX,DopeNess Esports,7,13,1,7,6,6,"Sova,Killjoy,Omen,Jett,KAY/O","Sova,Killjoy,Omen,Jett,KAY/O"
Bind,Paper Rex,Talon Esports,7,13,4,4,9,3,"Raze,Brimstone,Skye,Harbor,Gekko","Raze,Viper,Skye,Harbor,Gekko"
Ascent,FLUX GC,Jamcat,9,13,4,8,5,5,"Raze,Killjoy,Reyna,Omen,Jett","Sova,Killjoy,Phoenix,Omen,Jett"
Breeze,Balut Warriors,VLG X,13,3,10,2,1,3,"Cypher,Sova,Viper,Jett,Clove","Cypher,Sova,Viper,Jett,KAY/O"
Breeze,WOMP WOMP,raindrops,10,13,6,6,7,4,"Cypher,Sova,Viper,Jett,KAY/O","Cypher,Sova,Viper,Jett,Yoru"
Lotus,Misses Worldwide,K10 (OCE),13,9,8,2,7,5,"Killjoy,Omen,Chamber,Neon,Gekko","Raze,Killjoy,Viper,Omen,Gekko"
Lotus,Xu Gang Crimson,YIPPEE,13,7,9,3,4,4,"Raze,Killjoy,Omen,Skye,Gekko","Raze,Killjoy,Viper,Omen,Fade"
Lotus,Paper Rex,Talon Esports,13,0,12,0,0,1,"Breach,Raze,Omen,Jett,Skye","Raze,Killjoy,Viper,Omen,Fade"
Breeze,BC SWELL,NTPOJA,13,4,5,0,4,8,"Cypher,Sova,Viper,Omen,Yoru","Cypher,Sova,Viper,Omen,Yoru"
Sunset,BLUE BEES.ESP,AXELERATE,15,13,10,4,9,5,"Raze,Cypher,Phoenix,Omen,Fade","Raze,Cypher,Omen,KAY/O,Gekko"
Split,Delight,RABILIS BURST,13,6,6,1,5,7,"Raze,Cypher,Viper,Omen,Skye","Raze,Viper,Omen,Jett,Skye"
Lotus,RIDDLE ORDER,esports team αD,13,7,7,5,2,6,"Raze,Viper,Omen,Chamber,Fade","Raze,Killjoy,Viper,Omen,Fade"
Ascent,Crest Gaming ZST,Father's Back,13,6,8,4,2,5,"Sova,Killjoy,Omen,Jett,KAY/O","Sova,Killjoy,Omen,Jett,KAY/O"
Sunset,FAV gaming,Striders,13,6,4,3,3,9,"Raze,Cypher,Omen,KAY/O,Gekko","Breach,Raze,Cypher,Omen,Gekko"
Sunset,HIT GAMING CLAN,DopeNess Esports,10,13,6,6,7,4,"Breach,Raze,Cypher,Omen,Gekko","Raze,Cypher,Omen,KAY/O,Gekko"
Split,NOEZ FOXX,SETOUCHI SPARKS,13,7,6,2,5,7,"Raze,Viper,Omen,Jett,Skye","Breach,Raze,Cypher,Omen,Gekko"
Lotus,FAV gaming,Striders,13,1,11,1,0,2,"Raze,Killjoy,Viper,Omen,Fade","Raze,Sage,Omen,Skye,Clove"
Lotus,Crest Gaming ZST,Father's Back,13,2,3,0,2,10,"Raze,Killjoy,Viper,Omen,Fade","Raze,Killjoy,Viper,Omen,Fade"
Split,RIDDLE ORDER,esports team αD,13,6,10,2,4,3,"Raze,Viper,Omen,Jett,Skye","Breach,Raze,Cypher,Sage,Omen"
Ascent,BLUE BEES.ESP,AXELERATE,9,13,1,9,4,8,"Sova,Killjoy,Omen,Jett,KAY/O","Breach,Viper,Phoenix,Omen,KAY/O"
Lotus,VLG X,Xu Gang Crimson,13,15,10,4,11,3,"Breach,Killjoy,Omen,Jett,Gekko","Raze,Killjoy,Omen,Skye,Gekko"
Icebox,BC SWELL,NTPOJA,14,12,10,3,9,4,"Killjoy,Viper,Jett,KAY/O,Gekko","Sova,Killjoy,Viper,Jett,Harbor"
Ascent,NOEZ FOXX,SETOUCHI SPARKS,13,7,6,6,1,7,"Sova,Killjoy,Omen,Jett,KAY/O","Sova,Killjoy,Omen,Jett,KAY/O"
Ascent,HIT GAMING CLAN,DopeNess Esports,7,13,2,6,7,5,"Sova,Killjoy,Omen,Jett,KAY/O","Sova,Killjoy,Omen,Jett,KAY/O"
Sunset,YIPPEE,K10 (OCE),13,3,2,2,1,11,"Raze,Cypher,Omen,KAY/O,Gekko","Breach,Raze,Cypher,Omen,Fade"
Ascent,Delight,RABILIS BURST,13,11,7,5,6,6,"Sova,Killjoy,Omen,Jett,KAY/O","Sova,Killjoy,Omen,Jett,KAY/O"
Sunset,T1,Team Secret,13,11,3,9,2,10,"Raze,Cypher,Omen,KAY/O,Gekko","Breach,Raze,Cypher,Sova,Omen"
Ascent,Jamcat,Balut Warriors,2,13,2,10,3,0,"Sova,Killjoy,Omen,Jett,KAY/O","Cypher,Sova,Phoenix,Omen,Jett"
Ascent,WOMP WOMP,Misses Worldwide,13,5,4,2,3,9,"Sova,Killjoy,Omen,Jett,KAY/O","Sova,Jett,Astra,KAY/O,Fade"
Icebox,raindrops,FLUX GC,13,1,11,1,0,2,"Sova,Killjoy,Viper,Reyna,Jett","Viper,Sage,KAY/O,Harbor,Gekko"
Lotus,Jamcat,Balut Warriors,8,13,3,9,4,5,"Raze,Killjoy,Jett,Gekko,Clove","Raze,Cypher,Omen,Jett,Skye"
Split,raindrops,FLUX GC,13,1,11,1,0,2,"Raze,Cypher,Viper,Omen,Skye","Raze,Cypher,Sage,Omen,Skye"
Breeze,YIPPEE,K10 (OCE),13,5,4,2,3,9,"Cypher,Sova,Viper,Jett,Yoru","Cypher,Sova,Viper,Jett,KAY/O"
Breeze,VLG X,Xu Gang Crimson,8,13,4,8,5,4,"Cypher,Sova,Viper,Jett,Skye","Cypher,Sova,Viper,Jett,KAY/O"
Breeze,WOMP WOMP,Misses Worldwide,13,8,5,4,4,8,"Cypher,Sova,Viper,Jett,KAY/O","Cypher,Sova,Viper,Jett,KAY/O"
Lotus,T1,Team Secret,13,7,6,2,5,7,"Raze,Viper,Omen,Chamber,Fade","Raze,Killjoy,Viper,Omen,Fade"
Breeze,Barcelona Sporting X,Akave Esports Black,3,13,0,4,9,3,"Sova,Viper,Jett,Yoru,Chamber","Cypher,Sova,Viper,Jett,KAY/O"
Ascent,Blinn Esports,Van Lyn,13,6,8,4,2,5,"Sova,Killjoy,Omen,Jett,KAY/O","Sova,Killjoy,Omen,Jett,KAY/O"
Ascent,Barcelona Sporting X,Akave Esports Black,2,13,0,3,10,2,"Sova,Killjoy,Omen,Jett,KAY/O","Sova,Killjoy,Omen,Jett,KAY/O"
Split,Blinn Esports,Van Lyn,13,2,10,2,0,3,"Raze,Cypher,Viper,Omen,Skye","Raze,Cypher,Sage,Omen,Skye"
Split,MEOW CONTROL,Zero MarksMen Black,6,13,6,6,7,0,"Raze,Cypher,Viper,Omen,Skye","Raze,Cypher,Viper,Omen,Skye"
Icebox,Baguette,Burger Boyz 2.0,1,13,0,2,11,1,"Sova,Killjoy,Viper,Jett,Harbor","Sova,Killjoy,Viper,Jett,Gekko"
Sunset,Blinn Esports,Van Lyn,9,13,5,7,6,4,"Raze,Cypher,Viper,Omen,Skye","Breach,Raze,Cypher,Sova,Omen"
Icebox,University War GC,FiRePOWER GC,8,13,7,5,8,1,"Sova,Killjoy,Viper,Sage,Chamber","Sova,Killjoy,Viper,Phoenix,Brimstone"
Split,Baguette,Burger Boyz 2.0,3,13,0,4,9,3,"Raze,Cypher,Viper,Omen,Gekko","Raze,Viper,Omen,Jett,Skye"
Sunset,Resonate,Prospects,13,8,7,2,6,6,"Raze,Cypher,Omen,KAY/O,Gekko","Raze,Cypher,Omen,KAY/O,Gekko"
Ascent,RED Canids,Hero Base,6,13,1,6,7,5,"Sova,Killjoy,Omen,Jett,KAY/O","Breach,Viper,Omen,Jett,KAY/O"
Ascent,University War GC,FiRePOWER GC,10,13,0,11,2,10,"Sova,Killjoy,Omen,Jett,KAY/O","Cypher,Sova,Omen,Jett,KAY/O"
Ascent,MEOW CONTROL,Zero MarksMen Black,12,14,3,10,4,9,"Sova,Killjoy,Omen,Jett,KAY/O","Sova,Killjoy,Omen,Jett,KAY/O"
Split,Resonate,Prospects,13,2,10,2,0,3,"Raze,Cypher,Sage,Omen,Jett","Raze,Cypher,Viper,Omen,Skye"
Icebox,Van Lyn,Burger Boyz 2.0,13,11,7,5,6,6,"Sova,Killjoy,Viper,Sage,Jett","Sova,Killjoy,Viper,Jett,Gekko"
Icebox,RED Canids,Hero Base,16,14,5,10,4,11,"Sova,Killjoy,Viper,Sage,Jett","Killjoy,Viper,Jett,KAY/O,Gekko"
Bind,Resonate,MEOW CONTROL,8,13,1,8,5,7,"Raze,Cypher,Viper,Brimstone,Skye","Raze,Viper,Phoenix,Brimstone,Skye"
Ascent,Zero MarksMen Black,Prospects,13,5,9,3,2,4,"Sova,Killjoy,Omen,Jett,KAY/O","Cypher,Sova,Phoenix,Omen,Jett"
Breeze,Van Lyn,Burger Boyz 2.0,13,8,7,5,3,6,"Cypher,Sova,Viper,Reyna,Jett","Cypher,Sova,Viper,Jett,Yoru"
Sunset,RED Canids,Hero Base,8,13,1,8,5,7,"Raze,Cypher,Viper,Omen,Fade","Breach,Raze,Viper,Omen,KAY/O"
Breeze,Resonate,MEOW CONTROL,8,13,0,12,1,8,"Cypher,Sova,Viper,Jett,KAY/O","Cypher,Sova,Viper,Jett,KAY/O"
Split,Blinn Esports,Baguette,13,5,10,2,3,3,"Raze,Cypher,Viper,Omen,Skye","Raze,Cypher,Jett,Deadlock,Clove"
Lotus,ENIGMA GC,EKO Esports GC,9,13,5,7,6,4,"Breach,Raze,Killjoy,Gekko,Clove","Breach,Raze,Killjoy,Omen,Gekko"
Sunset,Axolotl PinkDevils,LuckyGirls,13,4,10,2,2,3,"Breach,Cypher,Phoenix,Gekko,Clove","Breach,Raze,Cypher,Omen,Gekko"
Icebox,TwentyStars GC,ZFT GC 2,13,2,2,1,1,11,"Sova,Killjoy,Viper,Reyna,Jett","Sova,Killjoy,Viper,Jett,KAY/O"
Sunset,Zero MarksMen Black,Prospects,14,12,6,7,5,8,"Breach,Sova,Viper,Phoenix,Omen","Raze,Cypher,Omen,KAY/O,Gekko"
Ascent,Blinn Esports,Baguette,13,3,2,2,1,11,"Sova,Killjoy,Omen,Jett,KAY/O","Sova,Killjoy,Omen,Jett,KAY/O"
Sunset,Van Lyn,Burger Boyz 2.0,6,13,0,7,6,6,"Breach,Raze,Cypher,Sova,Omen","Raze,Cypher,Omen,KAY/O,Gekko"
Split,Resonate,MEOW CONTROL,13,5,9,3,2,4,"Raze,Cypher,Sage,Omen,Jett","Raze,Cypher,Viper,Omen,Skye"
Sunset,Pingou Esport,Cicadas Gaming,5,13,4,8,5,1,"Raze,Cypher,Omen,KAY/O,Gekko","Breach,Raze,Cypher,Omen,Yoru"
Lotus,RED Canids,Hero Base,9,13,2,8,5,7,"Raze,Killjoy,Viper,Omen,Skye","Killjoy,Viper,Omen,Neon,Gekko"
Bind,Natus Vincere,FNATIC,13,3,4,0,3,9,"Raze,Cypher,Viper,Brimstone,KAY/O","Raze,Viper,Brimstone,Skye,Gekko"
Ascent,TwentyStars GC,EKO Esports GC,13,9,8,2,7,5,"Sova,Killjoy,Phoenix,Omen,Jett","Raze,Cypher,Sova,Phoenix,Omen"
Lotus,Axolotl PinkDevils,Entry Frogs Iris,11,13,7,5,8,4,"Breach,Raze,Killjoy,Omen,Gekko","Breach,Raze,Killjoy,Omen,Fade"
Ascent,ZFT GC 2,LuckyGirls,5,13,3,3,10,2,"Sova,Killjoy,Omen,Jett,KAY/O","Sova,Killjoy,Omen,Jett,KAY/O"
Lotus,Nemesi,ENIGMA GC,5,13,2,4,9,3,"Breach,Raze,Killjoy,Omen,Gekko","Breach,Raze,Killjoy,Gekko,Clove"
Icebox,MadView,ehehxd,10,13,4,7,6,6,"Sova,Killjoy,Viper,Reyna,Jett","Sova,Killjoy,Viper,Sage,Jett"
Lotus,Sopa du Macaco,Cobweb eSports,12,14,7,6,8,5,"Breach,Raze,Killjoy,Omen,Gekko","Breach,Raze,Killjoy,Omen,Fade"
Ascent,Pingou Esport,Cicadas Gaming,13,11,5,7,4,8,"Sova,Killjoy,Omen,Jett,KAY/O","Sova,Killjoy,Omen,Jett,KAY/O"
Ascent,Natus Vincere,FNATIC,13,8,9,3,5,4,"Cypher,Sova,Omen,Jett,KAY/O","Sova,Killjoy,Omen,Jett,KAY/O"
Ascent,MouzKings eSports,Los Bandidos,7,13,4,4,9,3,"Sova,Killjoy,Omen,Jett,KAY/O","Cypher,Sova,Omen,Jett,KAY/O"
Ascent,Entry Frogs Iris,LuckyGirls,4,13,0,5,8,4,"Sova,Killjoy,Omen,Jett,KAY/O","Sova,Killjoy,Omen,Jett,KAY/O"
Bind,TwentyStars GC,Nemesi,13,5,7,5,0,6,"Breach,Raze,Cypher,Brimstone,Skye","Breach,Cypher,Reyna,KAY/O,Clove"
Lotus,Axolotl PinkDevils,ENIGMA GC,13,5,9,3,2,4,"Breach,Raze,Killjoy,Omen,Gekko","Breach,Raze,Killjoy,Gekko,Clove"
Breeze,Sopa du Macaco,Cobweb eSports,10,13,8,4,9,2,"Cypher,Sova,Viper,Jett,Yoru","Cypher,Sova,Viper,Jett,KAY/O"
Bind,Pingou Esport,Cicadas Gaming,7,13,1,11,2,6,"Raze,Cypher,Brimstone,Skye,Gekko","Breach,Cypher,Sova,Brimstone,Yoru"
Lotus,MadView,ehehxd,11,13,8,4,9,3,"Raze,Killjoy,Viper,Fade,Clove","Breach,Raze,Sova,Killjoy,Omen"
Lotus,MouzKings eSports,Los Bandidos,6,13,4,8,5,2,"Breach,Raze,Killjoy,Omen,Gekko","Breach,Raze,Killjoy,Omen,Gekko"
Breeze,Natus Vincere,FNATIC,6,13,5,7,6,1,"Cypher,Sova,Jett,Yoru,Astra","Cypher,Sova,Viper,Yoru,KAY/O"
Ascent,EKO Esports GC,LuckyGirls,13,7,8,4,3,5,"Raze,Cypher,Sova,Phoenix,Omen","Sova,Killjoy,Omen,Jett,KAY/O"
Lotus,Axolotl PinkDevils,TwentyStars GC,6,13,4,8,5,2,"Breach,Raze,Killjoy,Omen,Gekko","Breach,Raze,Killjoy,Omen,Chamber"
Sunset,ZFT GC 2,Nemesi,4,13,1,11,2,3,"Cypher,Omen,Jett,Fade,Gekko","Cypher,Reyna,Omen,KAY/O,Gekko"
Lotus,Entry Frogs Iris,ENIGMA GC,13,11,8,4,7,5,"Breach,Raze,Killjoy,Omen,Fade","Breach,Raze,Killjoy,Gekko,Clove"
Icebox,Team Vitality,KOI,4,13,3,9,4,1,"Raze,Killjoy,Viper,KAY/O,Gekko","Killjoy,Viper,Jett,KAY/O,Gekko"
Breeze,Team Vitality,KOI,13,7,6,6,1,7,"Cypher,Sova,Viper,Yoru,Astra","Cypher,Sova,Viper,Jett,Yoru"
Split,Team Vitality,KOI,5,13,5,7,6,0,"Raze,Killjoy,Viper,Skye,Astra","Raze,Viper,Omen,Yoru,Fade"
Breeze,Carnival Gaming,Medal Esports,3,13,2,2,11,1,"Sova,Viper,Omen,Jett,Yoru","Cypher,Sova,Viper,Jett,KAY/O"
Ascent,Carnival Gaming,Medal Esports,6,13,2,5,8,4,"Sova,Killjoy,Viper,Phoenix,Omen","Breach,Viper,Phoenix,Omen,KAY/O"
Lotus,Carnival Gaming,Medal Esports,13,8,7,5,3,6,"Raze,Killjoy,Viper,Omen,Fade","Raze,Killjoy,Viper,Omen,Fade"
Lotus,JiJieHao Bonkers,Arena Internet Cafe,13,7,7,5,2,6,"Raze,Omen,KAY/O,Chamber,Gekko","Raze,Killjoy,Viper,Omen,Skye"
Icebox,Reckoning Esports,Grayfox Esports,8,13,1,8,5,7,"Sova,Killjoy,Viper,Yoru,Harbor","Sova,Killjoy,Viper,Sage,Jett"
Breeze,JiJieHao Bonkers,Arena Internet Cafe,7,13,5,3,10,2,"Sova,Viper,Jett,Yoru,Harbor","Cypher,Sova,Viper,Jett,Astra"
Split,Reckoning Esports,Grayfox Esports,7,13,4,4,9,3,"Raze,Cypher,Sage,Omen,Skye","Breach,Raze,Viper,Omen,Skye"
Icebox,JiJieHao Bonkers,Arena Internet Cafe,14,12,8,5,7,6,"Sova,Killjoy,Viper,Jett,Harbor","Sova,Killjoy,Viper,Sage,Jett"
Lotus,Reckoning Esports,Grayfox Esports,13,2,10,2,0,3,"Raze,Killjoy,Viper,Omen,Fade","Raze,Killjoy,Viper,Omen,Fade"
Ascent,ZETA DIVISION GC,FENNEL GC,13,6,10,2,4,3,"Sova,Killjoy,Omen,Jett,KAY/O","Sova,Killjoy,Omen,Jett,KAY/O"
Ascent,JiJieHao Bonkers,Arena Internet Cafe,13,10,6,6,4,7,"Sova,Killjoy,Omen,Jett,KAY/O","Sova,Killjoy,Omen,Jett,KAY/O"
Sunset,ZETA DIVISION GC,FENNEL GC,13,8,7,5,3,6,"Raze,Cypher,Sova,Omen,KAY/O","Breach,Raze,Cypher,Sova,Omen"
Lotus,ZETA DIVISION GC,FENNEL GC,13,2,10,2,0,3,"Raze,Killjoy,Viper,Omen,Fade","Raze,Killjoy,Viper,Omen,Fade"
Split,Bon Bon Bum Contra GC,Kunai Esports FEM,13,0,1,0,0,12,"Raze,Viper,Omen,Jett,Skye","Breach,Raze,Killjoy,Viper,Omen"
Breeze,Event Horizon,Erm what the crap!,10,13,5,6,7,5,"Cypher,Sova,Viper,Jett,Yoru","Cypher,Sova,Viper,Jett,KAY/O"
Ascent,Bon Bon Bum Contra GC,Kunai Esports FEM,13,11,1,11,0,12,"Breach,Raze,Sova,Killjoy,Omen","Sova,Killjoy,Omen,Jett,KAY/O"
Bind,Team Digital,Event Horizon,12,14,8,5,9,4,"Raze,Viper,Brimstone,Skye,Gekko","Raze,Viper,Brimstone,Skye,Yoru"
Lotus,Akron Esports,Team Digital,3,13,0,4,9,3,"Raze,Killjoy,Omen,Jett,Gekko","Raze,Killjoy,Viper,Omen,Fade"
Sunset,Zen eSports GC,OXEN GC,13,7,9,3,4,4,"Breach,Raze,Cypher,Phoenix,Omen","Raze,Cypher,Viper,Omen,Gekko"
Lotus,Event Horizon,Spate Esports,13,9,5,7,2,8,"Breach,Raze,Killjoy,Omen,Gekko","Breach,Raze,Cypher,Omen,Gekko"
Lotus,Something Funny,Team Digital,8,13,2,7,6,6,"Raze,Cypher,Viper,Fade,Clove","Raze,Killjoy,Viper,Omen,Fade"
Lotus,Kent State University,Flare,11,13,6,6,7,5,"Raze,Killjoy,Omen,Neon,Gekko","Raze,Killjoy,Omen,Fade,Deadlock"
Lotus,HYBR,Event Horizon,3,13,3,9,4,0,"Raze,Killjoy,Viper,Omen,Fade","Breach,Raze,Killjoy,Omen,Gekko"
Sunset,Akron Esports,Hale,13,8,4,5,3,9,"Raze,Cypher,Omen,Jett,Skye","Breach,Raze,Cypher,Omen,Gekko"
Sunset,Excane,Adms Awesome Aimers,11,13,6,6,7,5,"Breach,Raze,Cypher,Omen,Gekko","Breach,Raze,Cypher,Omen,Jett"
Ascent,Zen eSports GC,OXEN GC,13,9,7,5,4,6,"Sova,Killjoy,Omen,Jett,KAY/O","Sova,Killjoy,Omen,Jett,KAY/O"
Bind,Spate Esports,YDZ Blue,14,12,10,3,9,4,"Viper,Jett,Yoru,Gekko,Clove","Raze,Viper,Brimstone,Skye,Gekko"
Icebox,Team Digital,GOON DUDES,13,8,6,3,5,7,"Sova,Killjoy,Viper,Jett,Harbor","Sova,Killjoy,Viper,Sage,Jett"
Lotus,LC,Flare,12,14,8,5,9,4,"Raze,Killjoy,Omen,Jett,Fade","Raze,Killjoy,Omen,Fade,Deadlock"
Ascent,STARFIRE,Hale,3,13,0,4,9,3,"Sova,Killjoy,Omen,Jett,KAY/O","Sova,Killjoy,Omen,Jett,KAY/O"
Split,Adms Awesome Aimers,BERNARDS,13,2,10,2,0,3,"Raze,Cypher,Omen,Jett,Skye","Breach,Raze,Sage,Jett,Astra"
Ascent,Erm what the crap!,Akron Esports,13,6,8,4,2,5,"Sova,Killjoy,Omen,Jett,KAY/O","Sova,Killjoy,Omen,Jett,KAY/O"
Lotus,AQUA Nation,Event Horizon,9,13,7,3,10,2,"Raze,Killjoy,Viper,Omen,Skye","Breach,Raze,Killjoy,Omen,Gekko"
Icebox,Zen eSports GC,OXEN GC,8,13,6,6,7,2,"Sova,Killjoy,Viper,Jett,KAY/O","Sova,Killjoy,Viper,Reyna,Jett"
Lotus,2Game Esports,Hero Base,3,13,1,3,10,2,"Raze,Killjoy,Viper,Omen,Fade","Killjoy,Viper,Omen,Neon,Gekko"
Ascent,Pingou Esport,Siko Esports,13,7,5,3,4,8,"Sova,Killjoy,Omen,Jett,KAY/O","Sova,Killjoy,Omen,Jett,KAY/O"
Ascent,2Game Esports,Hero Base,4,13,1,4,9,3,"Sova,Killjoy,Omen,Jett,KAY/O","Breach,Viper,Omen,Jett,KAY/O"
Lotus,idk and idc,minikid & amigos,9,13,3,7,6,6,"Breach,Raze,Killjoy,Omen,Jett","Breach,Sova,Killjoy,Omen,Neon"
Bind,Karmine Corp,Team Heretics,9,13,8,4,9,1,"Raze,Viper,Omen,Skye,Gekko","Sova,Viper,Omen,Skye,Yoru"
Bind,Pingou Esport,Siko Esports,12,14,6,7,7,6,"Raze,Cypher,Brimstone,Skye,Gekko","Raze,Viper,Brimstone,Skye,Gekko"
Icebox,idk and idc,minikid & amigos,13,10,9,3,7,4,"Sova,Killjoy,Viper,Reyna,Jett","Sova,Killjoy,Viper,Jett,Gekko"
Lotus,Karmine Corp,Team Heretics,13,5,10,2,3,3,"Raze,Cypher,Viper,Omen,Fade","Killjoy,Viper,Omen,Neon,Gekko"
Icebox,Zzz,Los Bandidos,8,13,3,6,7,5,"Sova,Killjoy,Viper,Reyna,Jett","Sova,Killjoy,Viper,Reyna,Jett"
Lotus,Pingou Esport,Siko Esports,13,4,10,2,2,3,"Breach,Killjoy,Omen,Jett,Gekko","Raze,Killjoy,Viper,Omen,Fade"
Sunset,idk and idc,minikid & amigos,10,13,4,7,6,6,"Breach,Cypher,Reyna,Omen,Jett","Breach,Raze,Cypher,Omen,Gekko"
Ascent,Zzz,Los Bandidos,5,13,3,3,10,2,"Sova,Killjoy,Phoenix,Omen,Jett","Sova,Killjoy,Omen,Jett,KAY/O"
Breeze,Cicadas Gaming,Fish N Chips,13,9,7,3,6,6,"Cypher,Sova,Viper,Jett,Skye","Cypher,Sova,Viper,Jett,Yoru"
Icebox,Karmine Corp,Team Heretics,12,14,6,7,7,6,"Killjoy,Viper,Sage,Jett,Gekko","Sova,Killjoy,Viper,Reyna,Jett"
Breeze,Mix123,idk and idc,2,13,0,3,10,2,"Cypher,Sova,Jett,Skye,Harbor","Cypher,Sova,Viper,Reyna,Jett"
Breeze,Sopa du Macaco,Zzz,13,6,9,3,3,4,"Cypher,Sova,Viper,Jett,Yoru","Cypher,Sova,Viper,Jett,Yoru"
Sunset,Cicadas Gaming,Fish N Chips,13,8,8,4,4,5,"Breach,Raze,Cypher,Omen,Yoru","Breach,Raze,Cypher,Reyna,Omen"
Ascent,Flame Hard,Los Bandidos,4,13,0,5,8,4,"Sova,Killjoy,Omen,Jett,KAY/O","Sova,Killjoy,Omen,Jett,KAY/O"
Sunset,BBL Esports,GIANTX,11,13,5,7,6,6,"Raze,Cypher,Omen,KAY/O,Gekko","Breach,Raze,Cypher,Omen,Gekko"
Icebox,MadView,minikid & amigos,13,1,2,0,1,11,"Sova,Killjoy,Viper,Reyna,Jett","Sova,Killjoy,Viper,Jett,Gekko"
Lotus,Sopa du Macaco,Zzz,13,7,9,3,4,4,"Breach,Raze,Killjoy,Omen,Gekko","Breach,Raze,Killjoy,Omen,Neon"
Lotus,Cuban Raft Raiders,Flame Hard,3,13,1,3,10,2,"Raze,Killjoy,Viper,Omen,Fade","Breach,Raze,Killjoy,Omen,Fade"
Sunset,Mix123,SO PA CAROLA,13,9,8,2,7,5,"Breach,Raze,Cypher,Omen,Gekko","Raze,Cypher,Omen,Jett,Gekko"
Lotus,MadView,minikid & amigos,13,3,9,3,0,4,"Raze,Killjoy,Viper,Fade,Clove","Breach,Sova,Killjoy,Omen,Neon"
Bind,BBL Esports,GIANTX,6,13,1,6,7,5,"Breach,Raze,Viper,Brimstone,Skye","Raze,Viper,Omen,Skye,Yoru"
Sunset,A 300,idk and idc,10,13,3,8,5,7,"Raze,Cypher,Omen,Jett,Gekko","Breach,Cypher,Reyna,Omen,Jett"
Ascent,MLT Esports,Revenant Esports,10,13,5,7,6,5,"Sova,Killjoy,Omen,Jett,KAY/O","Sova,Killjoy,Omen,Jett,KAY/O"
Lotus,MLT Esports,Revenant Esports,13,15,7,7,8,6,"Raze,Killjoy,Viper,Omen,Fade","Raze,Killjoy,Viper,Omen,Fade"
Sunset,DRX Changers,FENNEL GC,4,13,4,8,5,0,"Breach,Raze,Cypher,Omen,Gekko","Breach,Raze,Cypher,Sova,Omen"
Icebox,Carnival Gaming,True Rippers,4,13,0,5,8,4,"Killjoy,Viper,Sage,Harbor,Gekko","Sova,Killjoy,Viper,Jett,Gekko"
Split,DRX Changers,FENNEL GC,6,13,3,9,4,3,"Breach,Raze,Viper,Omen,Fade","Raze,Cypher,Viper,Omen,Skye"
Ascent,Carnival Gaming,True Rippers,2,13,2,10,3,0,"Raze,Sova,Killjoy,Viper,Omen","Sova,Killjoy,Omen,Jett,KAY/O"
Lotus,Arena Internet Cafe,Justice For Tomorrow,13,10,7,4,6,6,"Raze,Killjoy,Viper,Omen,Skye","Raze,Killjoy,Viper,Omen,Fade"
Bind,FENNEL GC,Meteor GC,13,10,7,5,5,6,"Raze,Viper,Brimstone,Skye,Gekko","Breach,Raze,Brimstone,Sage,Gekko"
Icebox,Arena Internet Cafe,Justice For Tomorrow,13,4,8,4,0,5,"Sova,Killjoy,Viper,Sage,Jett","Sova,Killjoy,Viper,Sage,Jett"
Lotus,FENNEL GC,Meteor GC,13,7,6,6,1,7,"Raze,Killjoy,Viper,Omen,Fade","Raze,Astra,KAY/O,Chamber,Gekko"
Ascent,ZETA DIVISION GC,DRX Changers,13,10,8,4,6,5,"Sova,Killjoy,Omen,Jett,KAY/O","Sova,Killjoy,Omen,Jett,KAY/O"
Split,ZETA DIVISION GC,DRX Changers,13,10,9,3,7,4,"Raze,Cypher,Viper,Omen,Skye","Breach,Raze,Viper,Omen,Fade"
Sunset,Border Monsters Chile,XSOUL,11,13,8,4,9,3,"Raze,Cypher,Omen,KAY/O,Gekko","Breach,Raze,Reyna,Astra,Gekko"
Lotus,ZETA DIVISION GC,DRX Changers,10,13,4,8,5,6,"Raze,Killjoy,Viper,Omen,Fade","Raze,Killjoy,Viper,Omen,Gekko"
Ascent,Mango Slices,Dissonance Esports,4,13,1,4,9,3,"Cypher,Sova,Omen,Jett,KAY/O","Sova,Killjoy,Omen,Jett,KAY/O"
Lotus,Border Monsters Chile,XSOUL,9,13,5,7,6,4,"Raze,Killjoy,Viper,Omen,Fade","Breach,Raze,Killjoy,Omen,Gekko"
Icebox,Mango Slices,Dissonance Esports,5,13,3,9,4,2,"Killjoy,Viper,KAY/O,Gekko,Deadlock","Sova,Killjoy,Viper,Jett,Gekko"
Lotus,OXEN BULL BEATS,Maze Gaming,13,6,9,3,3,4,"Raze,Killjoy,Viper,Omen,Fade","Breach,Raze,Killjoy,Omen,Fade"
Lotus,Predator X Gaming,Mango Slices,2,13,2,10,3,0,"Raze,Killjoy,Viper,Fade,Clove","Raze,Killjoy,Viper,Omen,Fade"
Split,Hale,Dissonance Esports,12,14,9,4,10,3,"Raze,Viper,Omen,Jett,Skye","Raze,Cypher,Viper,Omen,Skye"
Split,2Game Esports,RED Canids,6,13,2,5,8,4,"Viper,Jett,Astra,Fade,Gekko","Raze,Killjoy,Viper,Skye,Astra"
Icebox,OXEN BULL BEATS,Maze Gaming,13,8,6,3,5,7,"Killjoy,Viper,Jett,KAY/O,Gekko","Sova,Killjoy,Viper,Jett,Gekko"
Bind,Akave Esports Black,FUSION X,13,10,7,5,5,6,"Raze,Cypher,Viper,Brimstone,Skye","Raze,Cypher,Viper,Brimstone,Skye"
Lotus,Mango Slices,Event Horizon Red,13,7,6,6,1,7,"Raze,Killjoy,Viper,Omen,Fade","Breach,Raze,Killjoy,Omen,Gekko"
Ascent,CKnights,Dissonance Esports,7,13,3,9,4,4,"Sova,Killjoy,Omen,Jett,KAY/O","Sova,Killjoy,Omen,Jett,KAY/O"
Sunset,Predator X Gaming,Cooli & Company,13,3,9,3,0,4,"Breach,Raze,Cypher,Sova,Omen","Breach,Raze,Cypher,Omen,Gekko"
Lotus,Hale,Adms Awesome Aimers,13,10,7,5,5,6,"Raze,Killjoy,Viper,Omen,Fade","Raze,Sova,Brimstone,Neon,Gekko"
Lotus,Akave Esports Black,FUSION X,13,0,12,0,0,1,"Raze,Viper,Omen,Chamber,Fade","Raze,Killjoy,Viper,Omen,Fade"
Bind,2Game Esports,RED Canids,13,8,7,5,3,6,"Raze,Viper,Brimstone,Skye,Gekko","Raze,Cypher,Viper,Brimstone,Skye"
Split,Event Horizon Red,LC,13,9,5,7,2,8,"Breach,Raze,Viper,Omen,Skye","Breach,Raze,Cypher,Omen,Skye"
Sunset,Grafton BlackHawks,Adms Awesome Aimers,0,13,0,12,1,0,"Sova,Killjoy,Jett,Skye,Clove","Raze,Cypher,Fade,Gekko,Clove"
Bind,CKnights,92' Dream Team,13,11,5,7,4,8,"Raze,Brimstone,Skye,Harbor,Gekko","Raze,Cypher,Brimstone,Jett,Skye"
Lotus,Ultralight,Cooli & Company,7,13,2,6,7,5,"Raze,Killjoy,Viper,Omen,Gekko","Raze,Killjoy,Omen,Fade,Gekko"
Split,Dreadnoughts,Mango Slices,4,13,2,3,10,2,"Raze,Cypher,Viper,Omen,Skye","Breach,Raze,Cypher,Viper,Omen"
Ascent,Hale,Team ROAR,13,7,6,6,1,7,"Sova,Killjoy,Omen,Jett,KAY/O","Sova,Killjoy,Omen,Jett,KAY/O"
Icebox,9z Team GC,KRÜ BLAZE,5,13,2,4,9,3,"Sova,Killjoy,Viper,Sage,Jett","Sova,Killjoy,Viper,Jett,Harbor"
Lotus,2Game Esports,RED Canids,9,13,6,6,7,3,"Raze,Killjoy,Viper,Omen,Fade","Raze,Killjoy,Viper,Omen,Skye"
Lotus,9z Team GC,KRÜ BLAZE,1,13,0,2,11,1,"Killjoy,Omen,Jett,KAY/O,Gekko","Raze,Killjoy,Viper,Omen,Fade"
Ascent,Legacy,Hero Base,8,13,4,5,8,4,"Cypher,Sova,Omen,Jett,KAY/O","Breach,Viper,Omen,Jett,KAY/O"
Icebox,A 300,Sopa du Macaco,11,13,5,7,6,6,"Sova,Killjoy,Viper,Jett,KAY/O","Sova,Killjoy,Viper,Jett,Chamber"
Breeze,Mix123,Zzz,11,13,6,6,7,5,"Cypher,Sova,Viper,Jett,Skye","Cypher,Sova,Viper,Jett,Yoru"
Ascent,MadView,ZaraG Verde,13,7,7,1,6,6,"Sova,Killjoy,Phoenix,Omen,Jett","Breach,Sova,Killjoy,Jett,Clove"
Lotus,Cuban Raft Raiders,minikid & amigos,0,13,0,1,12,0,"Raze,Killjoy,Viper,Omen,Fade","Breach,Killjoy,Omen,Neon,Gekko"
Breeze,Legacy,Hero Base,12,14,6,7,7,6,"Cypher,Sova,Viper,Jett,KAY/O","Cypher,Sova,Viper,Jett,KAY/O"
Breeze,c0rattix party,R8 Esports,14,16,6,9,7,8,"Cypher,Sova,Viper,Jett,KAY/O","Cypher,Sova,Viper,Omen,Yoru"
Sunset,c0rattix party,R8 Esports,13,7,4,4,3,9,"Raze,Cypher,Omen,KAY/O,Gekko","Breach,Raze,Cypher,Sova,Omen"
Icebox,c0rattix party,R8 Esports,10,13,6,6,7,4,"Sova,Killjoy,Viper,Sage,Jett","Sova,Killjoy,Viper,Sage,Jett"
Ascent,osliki,Team hz,13,6,3,4,2,10,"Sova,Killjoy,Omen,Jett,KAY/O","Raze,Sova,Killjoy,Omen,Jett"
Icebox,Team Falcons Vega,Twisted Minds Orchid,13,10,7,5,5,6,"Sova,Killjoy,Viper,Jett,Gekko","Sova,Killjoy,Viper,Reyna,Jett"
Split,R8 Esports,Team hz,13,9,6,6,3,7,"Raze,Cypher,Viper,Omen,Skye","Raze,Cypher,Omen,Jett,Skye"
Breeze,Team Falcons Vega,Twisted Minds Orchid,13,11,5,7,4,8,"Sova,Viper,Jett,Yoru,Astra","Cypher,Sova,Viper,Jett,Yoru"
Ascent,c0rattix party,osliki,13,8,4,5,3,9,"Sova,Killjoy,Omen,Jett,KAY/O","Cypher,Sova,Phoenix,Omen,Jett"
Sunset,Team Falcons Vega,Twisted Minds Orchid,13,11,6,6,5,7,"Breach,Raze,Cypher,Omen,Fade","Breach,Raze,Cypher,Omen,Gekko"
Lotus,Orangutan,Grayfox Esports,5,13,4,8,5,1,"Breach,Raze,Sova,Killjoy,Omen","Raze,Killjoy,Viper,Omen,Fade"
Ascent,Justice For Tomorrow,BOBO,13,6,6,6,0,7,"Sova,Killjoy,Reyna,Omen,Jett","Sova,Killjoy,Omen,Jett,KAY/O"
Icebox,Orangutan,Grayfox Esports,1,13,1,11,2,0,"Sova,Killjoy,Viper,Jett,Harbor","Sova,Killjoy,Viper,Sage,Jett"
Icebox,Justice For Tomorrow,BOBO,13,4,8,4,0,5,"Sova,Killjoy,Viper,Reyna,Jett","Sova,Killjoy,Viper,Jett,KAY/O"
Lotus,Justice For Tomorrow,BOBO,4,13,0,5,8,4,"Raze,Viper,Omen,Chamber,Gekko","Raze,Killjoy,Viper,Omen,Fade"
Lotus,MLT Esports,Reckoning Esports,13,11,9,3,8,4,"Raze,Killjoy,Viper,Omen,Fade","Raze,Killjoy,Viper,Omen,Fade"
Ascent,Meteor GC,DRX Changers,8,13,4,5,8,4,"Sova,Killjoy,Omen,Jett,KAY/O","Sova,Killjoy,Omen,Jett,KAY/O"
Breeze,Arena Internet Cafe,JiJieHao Bonkers,10,13,4,8,5,6,"Cypher,Sova,Viper,Yoru,Astra","Sova,Viper,Jett,Yoru,Harbor"
Ascent,MLT Esports,Reckoning Esports,13,7,8,4,3,5,"Sova,Killjoy,Omen,Jett,KAY/O","Cypher,Sova,Omen,Jett,KAY/O"
Lotus,Meteor GC,DRX Changers,6,13,3,9,4,3,"Raze,Astra,KAY/O,Chamber,Gekko","Raze,Killjoy,Viper,Omen,Gekko"
Icebox,Arena Internet Cafe,JiJieHao Bonkers,9,13,7,5,8,2,"Sova,Killjoy,Viper,Sage,Jett","Sova,Killjoy,Viper,Jett,Harbor"
Bind,FENNEL GC,ZETA DIVISION GC,7,13,5,7,6,2,"Raze,Viper,Brimstone,Skye,Gekko","Raze,Cypher,Viper,Brimstone,Skye"
Split,FENNEL GC,ZETA DIVISION GC,13,10,3,9,1,10,"Raze,Cypher,Viper,Omen,Skye","Raze,Cypher,Viper,Omen,Skye"
Icebox,FENNEL GC,ZETA DIVISION GC,4,13,4,8,5,0,"Sova,Killjoy,Viper,Jett,KAY/O","Killjoy,Viper,Omen,KAY/O,Gekko"
Split,Ball State,Mizzou Esports,8,13,3,6,7,5,"Raze,Cypher,Viper,Omen,Skye","Breach,Raze,Reyna,Jett,Astra"
Sunset,Fisher Falcons,Fisher College Tea Party,13,9,4,6,3,9,"Breach,Sova,Viper,Phoenix,Omen","Breach,Raze,Cypher,Omen,Gekko"
Icebox,Ball State,Mizzou Esports,12,14,6,7,7,6,"Killjoy,Viper,Sage,Jett,Gekko","Killjoy,Viper,Sage,Reyna,Jett"
Ascent,Fisher Falcons,Fisher College Tea Party,13,9,6,6,3,7,"Sova,Killjoy,Omen,Jett,KAY/O","Sova,Killjoy,Omen,Jett,KAY/O"
Split,Fisher Falcons,Fisher College Tea Party,13,8,4,5,3,9,"Raze,Cypher,Viper,Omen,Skye","Raze,Cypher,Viper,Omen,Skye"
Split,KRÜ Esports,100 Thieves,13,8,6,6,2,7,"Raze,Cypher,Viper,Omen,Skye","Raze,Viper,Astra,Fade,Gekko"
Breeze,KRÜ Esports,100 Thieves,11,13,4,8,5,7,"Cypher,Sova,Viper,Jett,KAY/O","Cypher,Sova,Viper,Jett,KAY/O"
Sunset,KRÜ Esports,100 Thieves,13,7,7,5,2,6,"Breach,Raze,Cypher,Omen,Gekko","Raze,Cypher,Sova,Omen,Gekko"
Sunset,Twisted Minds Orchid,The Ultimates Odyssey,14,12,5,8,4,9,"Breach,Raze,Cypher,Omen,Gekko","Raze,Cypher,Viper,Omen,Fade"
Ascent,Capacitanes,Lotus Knights,9,13,2,8,5,7,"Cypher,Viper,Omen,Jett,KAY/O","Cypher,Sova,Omen,Jett,KAY/O"
Bind,VexOficiaal,Dimonis,5,13,2,4,9,3,"Raze,Viper,Brimstone,Skye,Deadlock","Raze,Cypher,Viper,Skye,Clove"
Bind,Twisted Minds Orchid,The Ultimates Odyssey,13,10,7,4,6,6,"Raze,Viper,Brimstone,Skye,Gekko","Raze,Viper,Sage,Omen,Skye"
Bind,Capacitanes,Lotus Knights,9,13,7,5,8,2,"Viper,Brimstone,Skye,Yoru,Clove","Raze,Brimstone,Skye,Gekko,Clove"
Sunset,VexOficiaal,Dimonis,10,13,7,5,8,3,"Breach,Raze,Cypher,Sova,Omen","Raze,Cypher,Omen,KAY/O,Gekko"
Lotus,Twisted Minds Orchid,The Ultimates Odyssey,8,13,6,3,10,2,"Killjoy,Viper,Omen,Neon,Gekko","Breach,Raze,Cypher,Omen,Skye"
Lotus,Team Falcons Vega,Twisted Minds Orchid,15,13,9,5,8,6,"Raze,Killjoy,Viper,Omen,Fade","Killjoy,Viper,Omen,Neon,Gekko"
Sunset,Team Falcons Vega,Twisted Minds Orchid,16,14,6,9,5,10,"Breach,Raze,Cypher,Omen,Fade","Breach,Raze,Cypher,Omen,Gekko"
Split,Gen.G Esports,Rex Regum Qeon,10,13,5,7,6,5,"Raze,Viper,Omen,Jett,Skye","Raze,Cypher,Viper,Omen,Skye"
Ascent,Gen.G Esports,Rex Regum Qeon,11,13,5,7,6,6,"Sova,Killjoy,Omen,Jett,KAY/O","Sova,Killjoy,Omen,Jett,KAY/O"
Breeze,Gen.G Esports,Rex Regum Qeon,13,3,2,2,1,11,"Sova,Viper,Jett,Yoru,Astra","Cypher,Sova,Viper,Jett,Yoru"
Breeze,Bleed Esports,DRX,4,13,2,3,10,2,"Cypher,Sova,Viper,Jett,Yoru","Cypher,Sova,Viper,Jett,Astra"
Bind,Bleed Esports,DRX,9,13,5,7,6,4,"Raze,Viper,Brimstone,Skye,Gekko","Raze,Cypher,Viper,Brimstone,KAY/O"
Sunset,VSPO!,Team ex-Pro,9,13,4,6,7,5,"Raze,Cypher,Sova,Phoenix,Omen","Raze,Cypher,Sova,Neon,Clove"
Split,VSPO!,Team Streamer,13,9,4,6,3,9,"Breach,Raze,Cypher,Omen,Yoru","Raze,Cypher,Sage,Omen,Skye"
Bind,VSPO!,Team Casters,13,3,9,3,0,4,"Raze,Cypher,Brimstone,Skye,Yoru","Raze,Viper,Sage,Omen,Skye"
Ascent,Jade Orchid,TEAM POOM,13,9,6,6,3,7,"Cypher,Sova,Phoenix,Omen,Jett","Sova,Killjoy,Reyna,Omen,Jett"
Bind,Resonate,Bunbunbun,13,11,5,7,4,8,"Raze,Cypher,Viper,Brimstone,Skye","Breach,Raze,Cypher,Brimstone,Skye"
Lotus,Baguette,Sexy Gang,13,11,5,7,4,8,"Raze,Viper,Omen,Fade,Gekko","Raze,Killjoy,Viper,Omen,KAY/O"
Breeze,Flowstate,Resonate,5,13,4,8,5,1,"Cypher,Sova,Viper,Jett,KAY/O","Cypher,Sova,Viper,Jett,KAY/O"
Sunset,BAO BUNS,Jade Orchid,12,14,8,5,9,4,"Breach,Raze,Cypher,Omen,Gekko","Raze,Cypher,Omen,KAY/O,Gekko"
Ascent,AmazingOnliners,Sexy Gang,4,13,1,11,2,3,"Sova,Killjoy,Omen,Jett,KAY/O","Sova,Killjoy,Omen,Jett,KAY/O"
Ascent,Baguette,CALI GAMERS,13,9,5,5,4,8,"Cypher,Sova,Omen,Jett,KAY/O","Breach,Raze,Sova,Killjoy,Omen"
Ascent,TEAM POOM,UCD Blue GOld,13,7,4,4,3,9,"Sova,Killjoy,Reyna,Omen,Jett","Sova,Killjoy,Omen,Jett,KAY/O"
Split,OK Gaming,Kunai Esports FEM,8,13,3,9,4,5,"Breach,Raze,Cypher,Viper,Clove","Breach,Raze,Killjoy,Viper,Omen"
Lotus,BRUCE BANNER,Bunbunbun,14,16,8,7,9,6,"Raze,Killjoy,Viper,Omen,Skye","Breach,Jett,Astra,Chamber,Gekko"
Ascent,HAZordouS,Flowstate,13,15,7,7,8,6,"Sova,Killjoy,Omen,Jett,KAY/O","Sova,Killjoy,Omen,Jett,KAY/O"
Bind,AmazingOnliners,Donoobs,13,7,6,2,5,7,"Raze,Viper,Brimstone,Fade,Gekko","Raze,Viper,Brimstone,Skye,Gekko"
Ascent,THE SPECTRUM,Baguette,7,13,4,4,9,3,"Sova,Killjoy,Omen,Jett,KAY/O","Cypher,Sova,Omen,Jett,KAY/O"
Bind,Esports at UCD Gold,BAO BUNS,11,13,6,6,7,5,"Raze,Cypher,Skye,Deadlock,Clove","Raze,Cypher,Yoru,Astra,Gekko"
Lotus,Monsters Uni,TEAM POOM,8,13,2,10,3,6,"Raze,Killjoy,Viper,Skye,Clove","Raze,Killjoy,Jett,Gekko,Clove"
Sunset,NRG Esports,Evil Geniuses,11,13,6,6,7,5,"Raze,Cypher,Omen,KAY/O,Gekko","Breach,Raze,Cypher,Omen,Fade"
Icebox,OK Gaming,Kunai Esports FEM,13,9,8,4,5,5,"Killjoy,Viper,Reyna,Jett,Gekko","Sova,Killjoy,Viper,Jett,Gekko"
Ascent,Shopify Rebellion,UCF Gold,13,11,6,6,5,7,"Sova,Killjoy,Omen,Jett,KAY/O","Sova,Killjoy,Omen,Jett,KAY/O"
Ascent,Predator X Gaming,Van Lyn,3,13,0,4,9,3,"Breach,Raze,Sova,Killjoy,Omen","Sova,Killjoy,Omen,Jett,KAY/O"
Ascent,OK Gaming,Kunai Esports FEM,7,13,6,6,7,1,"Sova,Killjoy,Omen,Jett,KAY/O","Sova,Killjoy,Omen,Jett,KAY/O"
Bind,Awaken,Zero MarksMen Black,1,13,0,2,11,1,"Raze,Viper,Brimstone,Skye,Gekko","Breach,Viper,Phoenix,Brimstone,KAY/O"
Sunset,Six Figures,Lemonade Stand,8,13,2,7,6,6,"Raze,Cypher,Omen,KAY/O,Gekko","Raze,Cypher,Omen,KAY/O,Gekko"
Ascent,Blinn Esports,ECHO8,13,2,10,2,0,3,"Sova,Killjoy,Omen,Jett,KAY/O","Sova,Killjoy,Omen,Jett,KAY/O"
Sunset,Kats Squad,Burger Boyz 2.0,8,13,5,7,6,3,"Raze,Cypher,Omen,KAY/O,Gekko","Raze,Cypher,Omen,KAY/O,Gekko"
Sunset,ROSE,St. Clair Saints,13,15,7,7,8,6,"Raze,Viper,Omen,KAY/O,Gekko","Breach,Raze,Cypher,Omen,Fade"
Lotus,NRG Esports,Evil Geniuses,16,14,7,8,6,9,"Breach,Raze,Cypher,Brimstone,Gekko","Raze,Cypher,Viper,Omen,Fade"
Sunset,LAG,Predator X Gaming,2,13,0,3,10,2,"Raze,Cypher,Omen,KAY/O,Gekko","Breach,Cypher,Sova,Omen,Jett"
Icebox,Shopify Rebellion,les piments,15,13,7,7,6,8,"Killjoy,Viper,KAY/O,Harbor,Gekko","Sova,Killjoy,Viper,Reyna,Jett"
Ascent,Mindcontrol,Kats Squad,6,13,1,6,7,5,"Sova,Killjoy,Omen,Jett,KAY/O","Sova,Killjoy,Omen,Jett,KAY/O"
Lotus,St. Clair Saints,TMU Blue,13,7,9,3,4,4,"Raze,Cypher,Viper,Omen,Skye","Breach,Raze,Killjoy,Omen,Gekko"
Sunset,nice2me,Van Lyn,9,13,6,4,9,3,"Breach,Raze,Cypher,Omen,Gekko","Breach,Raze,Cypher,Sova,Omen"
Ascent,F1 Black,Blinn Esports,4,13,1,4,9,3,"Cypher,Sova,Omen,Jett,KAY/O","Sova,Killjoy,Omen,Jett,KAY/O"
Bind,Defiant Gaming,ROSE,4,13,1,4,9,3,"Raze,Viper,Brimstone,Skye,Gekko","Raze,Viper,Brimstone,Skye,Gekko"
Lotus,ECHO8,Fractal Gaming,13,10,8,3,7,5,"Breach,Killjoy,Omen,Jett,Gekko","Raze,Killjoy,Viper,Omen,Fade"
Sunset,Roblox Cows,Six Figures,10,13,7,5,8,3,"Breach,Raze,Cypher,Sova,Omen","Raze,Cypher,Omen,KAY/O,Gekko"
Breeze,U4RIA Radiata,Lemonade Stand,4,13,4,8,5,0,"Cypher,Sova,Viper,Reyna,Jett","Cypher,Sova,Viper,Jett,KAY/O"
Lotus,UCF Gold,shanghaisuprise,13,4,3,2,2,10,"Raze,Killjoy,Viper,Omen,Fade","Breach,Raze,Killjoy,Omen,Gekko"
Ascent,Justice for Clear,Zero MarksMen Black,12,14,8,5,9,4,"Cypher,Sova,Jett,KAY/O,Clove","Sova,Killjoy,Omen,Jett,KAY/O"
Ascent,5 Raisins Secs,Burger Boyz 2.0,6,13,3,9,4,3,"Sova,Killjoy,Phoenix,Omen,Jett","Sova,Killjoy,Omen,Jett,KAY/O"
Ascent,Deagle Ravagers,OXEN GC,11,13,6,6,7,5,"Sova,Killjoy,Omen,Jett,KAY/O","Sova,Killjoy,Omen,Jett,KAY/O"
Bind,Shifty505,Awaken,13,15,7,7,8,6,"Raze,Viper,Skye,Gekko,Clove","Raze,Viper,Brimstone,Skye,Gekko"
Ascent,NRG Esports,Evil Geniuses,6,13,2,10,3,4,"Sova,Killjoy,Omen,Jett,KAY/O","Sova,Killjoy,Omen,Jett,KAY/O"
Bind,CSUF Orange,LBR,13,3,4,0,3,9,"Raze,Viper,Brimstone,Reyna,Skye","Raze,Cypher,Viper,Brimstone,Skye"
Lotus,F1 Black,Arkangel Esports,13,7,8,4,3,5,"Cypher,Viper,Jett,Skye,Clove","Raze,Killjoy,Viper,Omen,Fade"
Lotus,Fractal Gaming,DRAKE AND DRIVE,13,7,7,5,2,6,"Raze,Killjoy,Viper,Omen,Fade","Raze,Killjoy,Viper,Omen,Gekko"
Lotus,Roblox Cows,CVNTS,13,8,4,5,3,9,"Raze,Killjoy,Viper,Omen,Fade","Raze,Killjoy,Viper,Omen,Fade"
Ascent,Kats Squad,Red Bull Chumps,13,10,5,7,3,8,"Sova,Killjoy,Omen,Jett,KAY/O","Sova,Killjoy,Omen,Jett,KAY/O"
Icebox,U4RIA Radiata,TAMU White,13,8,9,3,5,4,"Sova,Killjoy,Viper,Sage,Jett","Sova,Killjoy,Viper,Reyna,KAY/O"
Lotus,CCG Esports,Six Figures,5,13,3,3,10,2,"Raze,Killjoy,Viper,Omen,Fade","Breach,Killjoy,Astra,Neon,Gekko"
Lotus,Sussy Players,Lemonade Stand,6,13,2,5,8,4,"Raze,Cypher,Omen,Fade,Gekko","Breach,Raze,Omen,Chamber,Gekko"
Bind,Malicious,Defiant Gaming,10,13,5,7,6,5,"Raze,Viper,Brimstone,Skye,Chamber","Raze,Viper,Brimstone,Skye,Gekko"
Lotus,Cataclysm Gaming,Justice for Clear,4,13,2,3,10,2,"Breach,Raze,Killjoy,Omen,Gekko","Raze,Killjoy,Omen,Fade,Gekko"
Ascent,ECHO8,Bravo Six,13,6,8,4,2,5,"Sova,Killjoy,Omen,Jett,KAY/O","Sova,Killjoy,Omen,Jett,KAY/O"
Sunset,YDZ Esports,Shifty505,2,13,2,10,3,0,"Raze,Cypher,Omen,KAY/O,Gekko","Raze,Cypher,Omen,KAY/O,Gekko"
Sunset,Mindcontrol,Radford University,13,5,11,1,4,2,"Breach,Raze,Cypher,Sova,Omen","Breach,Raze,Cypher,Omen,Gekko"
Sunset,F5 Esports,St. Clair Saints,0,13,0,12,1,0,"Raze,Cypher,Omen,KAY/O,Gekko","Breach,Raze,Cypher,Omen,Fade"
Lotus,Awaken,YDZ Infinity,13,0,12,0,0,1,"Raze,Cypher,Omen,KAY/O,Gekko","Raze,Killjoy,Viper,Omen,Gekko"
Lotus,TMU Blue,caide n em,13,10,9,2,8,4,"Breach,Raze,Killjoy,Omen,Gekko","Raze,Killjoy,Viper,Omen,Fade"
Lotus,Hyperion Gold,Shopify Rebellion,5,13,2,4,9,3,"Raze,Killjoy,Reyna,Omen,Gekko","Raze,Killjoy,Viper,Omen,Fade"
Lotus,Miami Varsity Red,Predator X Gaming,11,13,8,4,9,3,"Killjoy,Viper,Omen,Jett,Fade","Raze,Killjoy,Viper,Fade,Clove"
Sunset,FAWZ Purple,nice2me,10,13,7,5,8,3,"Raze,Cypher,Omen,KAY/O,Gekko","Breach,Raze,Cypher,Omen,Gekko"
Ascent,les piments,50 Percent Final,14,12,5,8,4,9,"Sova,Killjoy,Omen,Jett,KAY/O","Sova,Killjoy,Omen,Jett,KAY/O"
Lotus,UCF Gold,Berzerkers,13,7,4,4,3,9,"Raze,Killjoy,Viper,Omen,Fade","Raze,Killjoy,Viper,Omen,Gekko"
Bind,Trident (NA),5 Raisins Secs,5,13,2,4,9,3,"Raze,Cypher,Brimstone,Skye,Gekko","Raze,Cypher,Brimstone,Skye,Gekko"
Breeze,Awaken RGN,LAG,6,13,2,5,8,4,"Cypher,Sova,Viper,Jett,KAY/O","Cypher,Sova,Viper,Jett,KAY/O"
Sunset,Kunai Esports FEM,New Combat Line GC,13,4,2,3,1,11,"Breach,Raze,Cypher,Gekko,Clove","Raze,Cypher,Omen,KAY/O,Gekko"
Split,Deagle Ravagers,OXEN GC,7,13,6,6,7,1,"Breach,Raze,Cypher,Omen,Skye","Raze,Cypher,Viper,Omen,Skye"
Bind,Cloud9,FURIA,13,8,5,4,4,8,"Raze,Cypher,Viper,Brimstone,Skye","Raze,Cypher,Viper,Brimstone,Skye"
Lotus,CSUF Orange,LBR,13,4,10,2,2,3,"Raze,Killjoy,Viper,Omen,Fade","Raze,Killjoy,Viper,Omen,Fade"
Sunset,Team 7 Esports,Skout Esports,2,13,0,3,10,2,"Raze,Viper,Omen,Yoru,Fade","Breach,Raze,Cypher,Omen,Gekko"
Icebox,Kunai Esports FEM,New Combat Line GC,11,13,6,6,7,5,"Sova,Killjoy,Viper,Jett,Gekko","Sova,Killjoy,Viper,Jett,Gekko"
Icebox,Deagle Ravagers,OXEN GC,13,11,6,6,5,7,"Sova,Killjoy,Viper,Jett,KAY/O","Sova,Killjoy,Viper,Reyna,Jett"
Lotus,Cloud9,FURIA,13,3,4,0,3,9,"Raze,Killjoy,Viper,Omen,Gekko","Raze,Killjoy,Viper,Omen,Fade"
Sunset,CSUF Orange,LBR,9,13,4,6,7,5,"Raze,Cypher,Reyna,Omen,Fade","Breach,Raze,Cypher,Viper,Omen"
Lotus,Team 7 Esports,Skout Esports,7,13,5,3,10,2,"Breach,Sova,Viper,Omen,Neon","Breach,Raze,Killjoy,Omen,Skye"
Sunset,Rebirth Esports,TENGAN MIEDO,13,10,4,7,3,9,"Breach,Raze,Cypher,Omen,KAY/O","Breach,Raze,Cypher,Omen,Gekko"
Icebox,UCF Gold,LG Orange,13,8,11,1,7,2,"Sova,Killjoy,Viper,Jett,Gekko","Sova,Killjoy,Viper,Jett,KAY/O"
Breeze,Fisher College Tea Party,Harrisburg University,14,12,5,8,4,9,"Cypher,Sova,Viper,Reyna,Jett","Cypher,Sova,Viper,Yoru,KAY/O"
Bind,Kunai Esports FEM,New Combat Line GC,13,8,5,4,4,8,"Raze,Cypher,Viper,Skye,Harbor","Raze,Cypher,Brimstone,Skye,Clove"
Ascent,Cloud9,FURIA,2,13,2,1,12,0,"Sova,Killjoy,Omen,Jett,KAY/O","Sova,Killjoy,Omen,Jett,KAY/O"
Bind,Team 7 Esports,Skout Esports,13,5,4,2,3,9,"Raze,Cypher,Phoenix,Brimstone,Gekko","Raze,Viper,Brimstone,Skye,Yoru"
Breeze,Rebirth Esports,TENGAN MIEDO,13,11,9,3,8,4,"Cypher,Sova,Viper,Jett,KAY/O","Cypher,Sova,Viper,Jett,KAY/O"
Lotus,UCF Gold,LG Orange,13,11,6,6,5,7,"Raze,Killjoy,Viper,Omen,Fade","Raze,Killjoy,Viper,Omen,Fade"
Lotus,Fisher College Tea Party,Harrisburg University,12,14,8,5,9,4,"Raze,Killjoy,Viper,Omen,Skye","Killjoy,Viper,Omen,Neon,Gekko"
Lotus,Rebirth Esports,TENGAN MIEDO,13,10,9,2,8,4,"Breach,Raze,Cypher,Omen,Jett","Breach,Raze,Sova,Killjoy,Omen"
Split,Fisher College Tea Party,Harrisburg University,13,6,6,6,0,7,"Raze,Cypher,Viper,Omen,Skye","Raze,Cypher,Viper,Omen,Skye"
Sunset,OXEN GC,TLS Fem,13,5,8,4,1,5,"Raze,Cypher,Viper,Omen,Gekko","Breach,Raze,Cypher,Omen,Gekko"
Lotus,NAMI eSports,Cuban Raft Raiders,12,14,9,4,10,3,"Raze,Viper,Omen,Gekko,Deadlock","Raze,Killjoy,Viper,Omen,Fade"
Icebox,OXEN GC,TLS Fem,13,10,9,2,8,4,"Sova,Killjoy,Viper,Reyna,Jett","Killjoy,Viper,Reyna,KAY/O,Gekko"
Ascent,NAMI eSports,Cuban Raft Raiders,13,8,6,6,2,7,"Cypher,Sova,Omen,Jett,KAY/O","Sova,Killjoy,Omen,Jett,KAY/O"
Bind,Division 7,Neverlanders eSports Baby's,13,9,8,4,5,5,"Raze,Cypher,Brimstone,Sage,Skye","Raze,Viper,Brimstone,Skye,Gekko"
Bind,NAMI eSports,Cuban Raft Raiders,9,13,6,6,7,3,"Raze,Viper,Brimstone,Skye,Gekko","Raze,Killjoy,Viper,Omen,Gekko"
Lotus,Division 7,Neverlanders eSports Baby's,13,3,4,0,3,9,"Breach,Raze,Killjoy,Astra,Gekko","Raze,Killjoy,Viper,Omen,Fade"
Lotus,SOS Affenalarm,A One Man Army,11,13,6,6,7,5,"Breach,Killjoy,Omen,Jett,Gekko","Breach,Raze,Killjoy,Omen,Gekko"
Breeze,Veni eSports,XPERION NXT,13,11,7,5,6,6,"Cypher,Sova,Viper,Jett,Yoru","Sova,Viper,Skye,Neon,Harbor"
Sunset,jdeme si pro vas,DropoutNenjoyers,5,13,2,4,9,3,"Breach,Raze,Cypher,Omen,Gekko","Raze,Cypher,Omen,KAY/O,Gekko"
Icebox,Tani eSports,Capacitanes,9,13,7,5,8,2,"Sova,Killjoy,Viper,Jett,Gekko","Sova,Killjoy,Viper,Jett,KAY/O"
Icebox,Lotus Knights,Ursus Gaming,13,7,2,6,1,11,"Sova,Killjoy,Viper,Sage,Gekko","Sova,Killjoy,Viper,Sage,Jett"
Sunset,SOS Affenalarm,A One Man Army,7,13,1,7,6,6,"Breach,Cypher,Omen,Jett,Gekko","Breach,Raze,Cypher,Omen,Gekko"
Lotus,AEFCT ESPORTS,DIVINE,7,13,3,9,4,4,"Breach,Raze,Viper,Omen,Fade","Breach,Raze,Killjoy,Viper,Omen"
Lotus,Tropadobagaço,POK,13,10,4,8,2,9,"Raze,Killjoy,Viper,Omen,Gekko","Raze,Killjoy,Viper,Omen,Gekko"
Bind,Veni eSports,XPERION NXT,11,13,6,6,7,5,"Viper,Brimstone,Jett,Skye,Gekko","Raze,Viper,Brimstone,Skye,Gekko"
Bind,AXIMZERO,Dimonis,3,13,3,9,4,0,"Breach,Raze,Brimstone,Yoru,Fade","Raze,Cypher,Viper,Skye,Clove"
Lotus,Lootcifer,Babos Gaming,13,8,6,3,5,7,"Raze,Killjoy,Phoenix,Omen,Fade","Breach,Killjoy,Omen,Neon,Gekko"
Sunset,VexOficiaal,Solar Flare,13,3,2,2,1,11,"Breach,Raze,Cypher,Sova,Omen","Raze,Cypher,Sova,Omen,Gekko"
Ascent,SOS Affenalarm,A One Man Army,13,5,4,2,3,9,"Sova,Killjoy,Phoenix,Omen,Jett","Sova,Killjoy,Omen,Jett,KAY/O"
Lotus,jdeme si pro vas,DropoutNenjoyers,11,13,4,8,5,7,"Breach,Raze,Killjoy,Omen,Gekko","Raze,Killjoy,Viper,Omen,Fade"
Lotus,Tani eSports,Capacitanes,13,5,11,1,4,2,"Breach,Raze,Cypher,Omen,Gekko","Breach,Raze,Killjoy,Omen,Gekko"
Bind,R8 Blues,The Ultimates Odyssey,5,13,2,4,9,3,"Viper,Brimstone,Sage,Skye,Neon","Raze,Viper,Sage,Omen,Skye"
Lotus,IRREGULARS,Lord eSports,9,13,2,8,5,7,"Raze,Killjoy,Omen,Fade,Gekko","Breach,Raze,Killjoy,Omen,Gekko"
Lotus,Lotus Knights,Ursus Gaming,7,13,4,4,9,3,"Killjoy,Viper,Omen,Neon,Fade","Breach,Raze,Killjoy,Omen,Gekko"
Icebox,Tropadobagaço,POK,13,7,7,5,2,6,"Sova,Killjoy,Viper,Jett,Gekko","Killjoy,Viper,Jett,KAY/O,Gekko"
Bind,AEFCT ESPORTS,DIVINE,13,7,7,1,6,6,"Raze,Cypher,Viper,Brimstone,Skye","Breach,Raze,Viper,Brimstone,Gekko"
Sunset,Lootcifer,Babos Gaming,13,7,8,4,3,5,"Breach,Raze,Killjoy,Sage,Omen","Breach,Cypher,Omen,Neon,Gekko"
Sunset,AXIMZERO,Dimonis,8,13,8,4,9,0,"Raze,Cypher,Viper,KAY/O,Harbor","Raze,Cypher,Omen,KAY/O,Gekko"
Sunset,Veni eSports,XPERION NXT,15,13,9,5,8,6,"Breach,Cypher,Omen,Jett,Gekko","Breach,Raze,Cypher,Sova,Omen"
Breeze,Lotus Knights,Ursus Gaming,13,4,8,4,0,5,"Cypher,Sova,Viper,Jett,KAY/O","Cypher,Sova,Viper,Jett,KAY/O"
Sunset,Tani eSports,Capacitanes,6,13,5,7,6,1,"Breach,Raze,Cypher,Omen,Fade","Breach,Raze,Cypher,Omen,Gekko"
Bind,VexOficiaal,Solar Flare,13,11,5,7,4,8,"Raze,Viper,Brimstone,Skye,Deadlock","Raze,Cypher,Brimstone,Skye,Gekko"
Ascent,IRREGULARS,Lord eSports,10,13,6,6,7,4,"Sova,Killjoy,Omen,Jett,KAY/O","Cypher,Sova,Omen,Jett,KAY/O"
Bind,Pingu E-Sports,SOS Affenalarm,13,3,4,0,3,9,"Breach,Raze,Cypher,Brimstone,Gekko","Breach,Raze,Cypher,Brimstone,Skye"
Ascent,R8 Blues,The Ultimates Odyssey,9,13,2,10,3,7,"Sova,Killjoy,Jett,Astra,KAY/O","Sova,Killjoy,Omen,Jett,KAY/O"
Sunset,Tropadobagaço,POK,11,13,8,4,9,3,"Breach,Raze,Cypher,Sova,Omen","Breach,Raze,Cypher,Omen,Fade"
Ascent,AEFCT ESPORTS,DIVINE,4,13,3,9,4,1,"Sova,Killjoy,Omen,Jett,KAY/O","Breach,Viper,Phoenix,Omen,KAY/O"
Breeze,Team Secret,Talon Esports,10,13,7,5,8,3,"Cypher,Sova,Viper,Jett,KAY/O","Cypher,Sova,Viper,Jett,Yoru"
Ascent,WSKFiT,Sorbonne University,3,13,0,4,9,3,"Sova,Killjoy,Omen,Jett,KAY/O","Cypher,Sova,Reyna,Omen,Jett"
Split,Riddim,The Retirement Home,13,4,4,1,3,9,"Breach,Cypher,Sage,Jett,Astra","Breach,Raze,Cypher,Omen,Jett"
Icebox,AXELERATE,BLUE BEES.ESP,7,13,4,8,5,3,"Sova,Killjoy,Viper,Reyna,Gekko","Sova,Killjoy,Viper,Reyna,Jett"
Lotus,Veni eSports,Reveal Multigaming,6,13,6,6,7,0,"Breach,Killjoy,Omen,Jett,Gekko","Breach,Sova,Killjoy,Omen,Jett"
Sunset,Pingu E-Sports,SOS Affenalarm,13,11,8,4,7,5,"Breach,Raze,Cypher,Sova,Omen","Breach,Cypher,Omen,Jett,Yoru"
Lotus,Crest Gaming ZST,HIT GAMING CLAN,13,4,4,1,3,9,"Raze,Killjoy,Viper,Omen,Fade","Raze,Killjoy,Viper,Omen,Fade"
Breeze,FAV gaming,BC SWELL,14,16,8,7,9,6,"Cypher,Sova,Viper,Jett,KAY/O","Cypher,Sova,Viper,Omen,Yoru"
Lotus,RIDDLE ORDER,RABILIS BURST,13,0,12,0,0,1,"Raze,Viper,Omen,Chamber,Fade","Raze,Killjoy,Viper,Omen,Fade"
Split,Section 5.1,Lisan al Gaib,13,2,10,2,0,3,"Raze,Cypher,Brimstone,Sage,Skye","Breach,Cypher,Reyna,Omen,Jett"
Lotus,Permitta Unicorns,Lootcifer,17,15,11,5,10,6,"Breach,Raze,Killjoy,Omen,Fade","Breach,Raze,Killjoy,Omen,KAY/O"
Lotus,Delight,NOEZ FOXX,5,13,4,8,5,1,"Raze,Killjoy,Viper,Omen,Fade","Raze,Killjoy,Viper,Omen,Fade"
Ascent,cunnyfuntsss,Dole Lords,13,6,8,4,2,5,"Raze,Sova,Reyna,Deadlock,Clove","Cypher,Sova,Omen,Jett,KAY/O"
Ascent,Orkadia,Pritong Manok,13,5,9,3,2,4,"Sova,Killjoy,Omen,Jett,KAY/O","Sova,Killjoy,Omen,Jett,KAY/O"
Ascent,INFERNUS,IRREGULARS,13,9,6,4,5,7,"Sova,Killjoy,Phoenix,Omen,Jett","Sova,Killjoy,Omen,Jett,KAY/O"
Icebox,esports team αD,AXELERATE,5,13,2,4,9,3,"Cypher,Sova,Viper,Jett,Harbor","Sova,Killjoy,Viper,Reyna,Gekko"
Lotus,BLUE BEES.ESP,昌平君昌文君f0rsaken,13,7,7,1,6,6,"Raze,Killjoy,Viper,Omen,Fade","Raze,Killjoy,Omen,Fade,Gekko"
Lotus,RIDDLE ORDER,TeamDuration,13,1,2,0,1,11,"Raze,Viper,Omen,Chamber,Fade","Breach,Raze,Killjoy,Omen,Fade"
Sunset,Sorbonne University,Turin University,13,7,6,6,1,7,"Breach,Raze,Cypher,Omen,Gekko","Breach,Raze,Cypher,Sova,Omen"
Lotus,Team Secret,Talon Esports,11,13,5,7,6,6,"Raze,Killjoy,Viper,Omen,Fade","Raze,Killjoy,Viper,Omen,Fade"
Lotus,Pingu E-Sports,SOS Affenalarm,10,13,5,7,6,5,"Breach,Raze,Killjoy,Omen,Gekko","Breach,Killjoy,Omen,Jett,Gekko"
Bind,Riddim,The Retirement Home,13,8,8,4,4,5,"Cypher,Viper,Brimstone,Jett,Skye","Breach,Raze,Viper,Brimstone,Fade"
Lotus,Zvietnam,Babos Gaming,10,13,6,6,7,4,"Breach,Killjoy,Omen,Yoru,Neon","Breach,Killjoy,Omen,Neon,Gekko"
Icebox,BUCHCLUB,XPERION NXT,2,13,2,10,3,0,"Sova,Killjoy,Viper,Jett,Gekko","Sova,Killjoy,Viper,Jett,Harbor"
Sunset,SETOUCHI SPARKS,HIT GAMING CLAN,11,13,6,6,7,5,"Breach,Cypher,Sova,Omen,Jett","Breach,Raze,Cypher,Omen,Fade"
Lotus,Crest Gaming ZST,Xenesis e-sports,13,5,6,0,5,7,"Raze,Killjoy,Viper,Omen,Fade","Breach,Cypher,Omen,Yoru,Gekko"
Bind,Orkadia,Pritong Manok,13,3,3,1,2,10,"Raze,Viper,Brimstone,Skye,Gekko","Raze,Cypher,Brimstone,Fade,Gekko"
Lotus,cunnyfuntsss,Dole Lords,13,8,7,2,6,6,"Raze,Viper,Sage,Deadlock,Clove","Raze,Viper,Reyna,Omen,Gekko"
Breeze,Silly Cars,Lord eSports,11,13,9,3,10,2,"Sova,Viper,Jett,Yoru,Chamber","Cypher,Sova,Viper,Jett,KAY/O"
Ascent,Striders,RABILIS BURST,7,13,4,8,5,3,"Raze,Cypher,Viper,Omen,KAY/O","Sova,Killjoy,Omen,Jett,KAY/O"
Lotus,Delight,NTPOJA,13,5,10,2,3,3,"Raze,Killjoy,Viper,Omen,Fade","Raze,Killjoy,Viper,Omen,Fade"
Ascent,Veni eSports,Reveal Multigaming,10,13,8,4,9,2,"Sova,Killjoy,Omen,Jett,KAY/O","Sova,Killjoy,Phoenix,Omen,Jett"
Lotus,Haven Liberty,BC SWELL,11,13,6,6,7,5,"Breach,Raze,Killjoy,Omen,Fade","Raze,Killjoy,Viper,Omen,Fade"
Sunset,Permitta Unicorns,Lootcifer,13,6,10,2,4,3,"Breach,Raze,Cypher,Omen,Fade","Breach,Sova,Killjoy,Omen,Neon"
Bind,NOEZ FOXX,ORB GARDEN GAMING,13,2,10,2,0,3,"Raze,Viper,Brimstone,Yoru,Fade","Raze,Viper,Brimstone,Skye,Yoru"
Lotus,WSKFiT,KIT SC ESPORTS,13,11,8,4,7,5,"Breach,Raze,Sova,Killjoy,Omen","Raze,Killjoy,Omen,Fade,Gekko"
Ascent,Section 5.1,Lisan al Gaib,13,6,5,2,4,8,"Raze,Cypher,Sova,Brimstone,Sage","Sova,Killjoy,Omen,Jett,KAY/O"
Sunset,INFERNUS,IRREGULARS,13,5,5,1,4,8,"Breach,Raze,Cypher,Omen,Gekko","Breach,Raze,Cypher,Omen,Gekko"
Lotus,FAV gaming,DopeNess Esports,13,0,12,0,0,1,"Raze,Killjoy,Viper,Omen,Fade","Raze,Killjoy,Viper,Omen,Fade"
Ascent,Monkey Stars,Fishing Rods Academy,14,16,8,7,9,6,"Sova,Killjoy,Omen,Jett,KAY/O","Sova,Killjoy,Phoenix,Omen,Jett"
Ascent,Xenesis e-sports,TRIDENT,13,7,8,4,3,5,"Breach,Killjoy,Omen,Yoru,Fade","Sova,Killjoy,Omen,Jett,KAY/O"
Ascent,Mirage,HIT GAMING CLAN,7,13,3,9,4,4,"Sova,Killjoy,Omen,Jett,KAY/O","Sova,Killjoy,Omen,Jett,KAY/O"
Sunset,BLUE BEES.ESP,AMORIS Vega,13,10,9,3,7,4,"Raze,Cypher,Phoenix,Omen,Fade","Raze,Omen,KAY/O,Chamber,Gekko"
Bind,ODD PLAN,AXELERATE,14,16,6,9,7,8,"Raze,Viper,Brimstone,Skye,Gekko","Breach,Viper,Phoenix,Brimstone,KAY/O"
Ascent,Striders,ALESTAR,13,6,7,5,1,6,"Raze,Cypher,Viper,Omen,KAY/O","Sova,Killjoy,Omen,Jett,KAY/O"
Lotus,ALBION,NOEZ FOXX,3,13,3,9,4,0,"Raze,Killjoy,Omen,Skye,Clove","Raze,Killjoy,Viper,Omen,Fade"
Lotus,Cloud,RABILIS BURST,5,13,3,9,4,2,"Raze,Killjoy,Viper,Astra,Fade","Raze,Killjoy,Viper,Omen,Fade"
Ascent,Haven Liberty,Acris,13,4,4,1,3,9,"Sova,Killjoy,Omen,Jett,Astra","Sova,Killjoy,Omen,Jett,KAY/O"
Lotus,OCS esports,昌平君昌文君f0rsaken,13,15,7,7,8,6,"Raze,Killjoy,Viper,Omen,Fade","Raze,Killjoy,Omen,Fade,Gekko"
Breeze,SETOUCHI SPARKS,TMRB No1,13,10,8,3,7,5,"Cypher,Sova,Viper,Jett,Yoru","Cypher,Sova,Viper,Jett,Yoru"
Lotus,Crest Gaming ZST,和成天下,13,2,10,2,0,3,"Raze,Killjoy,Viper,Omen,Fade","Breach,Killjoy,Reyna,Omen,Jett"
Breeze,esports team αD,OZE GAMING,13,3,11,1,2,2,"Cypher,Sova,Viper,Jett,Yoru","Sova,Viper,Yoru,Neon,Gekko"
Ascent,TeamDuration,JapanKorea,16,14,10,5,9,6,"Sova,Killjoy,Omen,Jett,KAY/O","Sova,Killjoy,Omen,Jett,KAY/O"
Breeze,Toy's Gaming,ORB GARDEN GAMING,7,13,6,6,7,1,"Cypher,Sova,Viper,Jett,Yoru","Cypher,Sova,Viper,Jett,Yoru"
Lotus,NTPOJA,Shumai Brothers,13,3,9,3,0,4,"Raze,Killjoy,Viper,Omen,Fade","Raze,Killjoy,Viper,Omen,Skye"
Lotus,ASNA,Delight,7,13,7,5,8,0,"Raze,Killjoy,Viper,Omen,Fade","Raze,Killjoy,Viper,Omen,Fade"
Icebox,Vtuber,BC SWELL,7,13,2,6,7,5,"Sova,Killjoy,Viper,Jett,Gekko","Killjoy,Viper,Jett,KAY/O,Gekko"
Breeze,FAV gaming,Slovo Yakuta,13,6,4,3,3,9,"Cypher,Sova,Viper,Jett,KAY/O","Cypher,Sova,Viper,Reyna,Jett"
Ascent,DopeNess Esports,aaaaal,13,4,5,0,4,8,"Sova,Killjoy,Reyna,Omen,Jett","Sova,Killjoy,Omen,Jett,KAY/O"
Lotus,UP Valencia,KIT SC ESPORTS,4,13,2,3,10,2,"Breach,Raze,Killjoy,Omen,Fade","Raze,Killjoy,Omen,Fade,Gekko"
Sunset,Team Secret,Talon Esports,13,11,3,9,2,10,"Breach,Raze,Cypher,Sova,Omen","Breach,Raze,Cypher,Omen,Fade"
Bind,STUBA Esports,Turin University,11,13,7,5,8,4,"Raze,Cypher,Viper,Yoru,Clove","Breach,Raze,Viper,Fade,Clove"
Breeze,Monkey Stars,Fishing Rods Academy,13,5,4,2,3,9,"Cypher,Sova,Viper,Jett,KAY/O","Cypher,Sova,Viper,Reyna,Jett"
Sunset,T1,ZETA DIVISION,13,10,6,6,4,7,"Raze,Cypher,Omen,KAY/O,Gekko","Sova,Viper,Phoenix,Omen,Chamber"
Icebox,Monkey Stars,Fishing Rods Academy,8,13,5,4,9,3,"Sova,Killjoy,Viper,Jett,Gekko","Sova,Killjoy,Viper,Reyna,Jett"
Lotus,T1,ZETA DIVISION,13,9,8,4,5,5,"Raze,Viper,Omen,Chamber,Fade","Viper,Omen,Chamber,Neon,Gekko"
Bind,T1,ZETA DIVISION,11,13,6,6,7,5,"Raze,Viper,Skye,Harbor,Gekko","Raze,Viper,Brimstone,Skye,Gekko"
Icebox,Ragnus Esports,New Combat Line GC,5,13,2,4,9,3,"Viper,Jett,Skye,Harbor,Gekko","Sova,Killjoy,Viper,Jett,Gekko"
Bind,Kunai Esports FEM,Genbu Gaming GC,14,12,6,7,5,8,"Raze,Cypher,Viper,Skye,Harbor","Raze,Cypher,Viper,Brimstone,Skye"
Lotus,OK Gaming,Bon Bon Bum Contra GC,4,13,4,8,5,0,"Raze,Omen,Yoru,Chamber,Clove","Breach,Raze,Killjoy,Omen,Gekko"
Breeze,Ragnus Esports,New Combat Line GC,10,13,5,6,7,5,"Cypher,Viper,Skye,Yoru,KAY/O","Cypher,Sova,Viper,Jett,KAY/O"
Split,Kunai Esports FEM,Genbu Gaming GC,14,12,6,7,5,8,"Breach,Raze,Killjoy,Viper,Omen","Raze,Killjoy,Viper,Skye,Astra"
Icebox,OK Gaming,Bon Bon Bum Contra GC,15,13,9,5,8,6,"Viper,Reyna,Jett,Yoru,Clove","Killjoy,Viper,Jett,Gekko,Clove"
Sunset,Shopify Rebellion,FlyQuest RED,13,8,8,1,7,5,"Breach,Raze,Cypher,Omen,Gekko","Breach,Raze,Cypher,Sova,Omen"
Bind,Ragnus Esports,New Combat Line GC,13,8,9,3,5,4,"Raze,Cypher,Brimstone,Skye,Yoru","Raze,Cypher,Brimstone,Skye,Clove"
Ascent,OK Gaming,Bon Bon Bum Contra GC,3,13,2,10,3,1,"Sova,Killjoy,Omen,Jett,KAY/O","Breach,Raze,Sova,Killjoy,Omen"
Ascent,Kunai Esports FEM,Genbu Gaming GC,7,13,4,4,9,3,"Sova,Killjoy,Omen,Jett,KAY/O","Sova,Killjoy,Omen,Jett,KAY/O"
Lotus,Shopify Rebellion,FlyQuest RED,11,13,3,9,4,8,"Raze,Killjoy,Viper,Omen,Fade","Raze,Killjoy,Viper,Omen,Skye"
Lotus,OXEN GC,Dasein Club GC,13,11,9,3,8,4,"Raze,Killjoy,Viper,Omen,Gekko","Breach,Raze,Sova,Killjoy,Omen"
Icebox,Sentinels,LOUD,8,13,3,6,7,5,"Killjoy,Viper,Jett,KAY/O,Gekko","Sova,Killjoy,Viper,Jett,Harbor"
Bind,Luminescent Sapphire,Timeless Rivals,13,1,2,0,1,11,"Raze,Viper,Brimstone,Skye,Gekko","Raze,Viper,Brimstone,Skye,Gekko"
Sunset,CSUF Orange,CSULB Gold,13,8,5,4,4,8,"Raze,Cypher,Reyna,Omen,Fade","Breach,Raze,Cypher,Sova,Omen"
Split,Status Red,OutGoing Esports,11,13,2,10,3,9,"Raze,Cypher,Viper,Omen,Skye","Raze,Cypher,Viper,Omen,Skye"
Ascent,XSOUL GC,TLS Fem,8,13,3,6,7,5,"Sova,Killjoy,Omen,Jett,KAY/O","Raze,Sova,Killjoy,Omen,KAY/O"
Lotus,SFU Pink,UC Irvine,5,13,4,8,5,1,"Viper,Omen,Chamber,Neon,Fade","Breach,Killjoy,Yoru,Astra,Gekko"
Ascent,TENGAN MIEDO,ONA Family,13,6,8,4,2,5,"Sova,Killjoy,Omen,Jett,KAY/O","Sova,Killjoy,Omen,Jett,KAY/O"
Ascent,Deagle Ravagers,Zen eSports GC,4,13,1,4,9,3,"Sova,Killjoy,Omen,Jett,KAY/O","Sova,Killjoy,Omen,Jett,KAY/O"
Ascent,Shopify Rebellion,FlyQuest RED,13,8,6,3,5,7,"Sova,Killjoy,Omen,Jett,KAY/O","Sova,Killjoy,Omen,Jett,KAY/O"
Split,OXEN GC,Dasein Club GC,11,13,5,7,6,6,"Raze,Cypher,Viper,Omen,Skye","Raze,Cypher,Viper,Omen,Skye"
Sunset,Sya Unity,Baby Goats,6,13,2,5,8,4,"Cypher,Sova,Jett,Yoru,Clove","Breach,Raze,Cypher,Omen,Gekko"
Bind,Luxoria,Lucky 7 Gaming,11,13,3,9,4,8,"Raze,Viper,Brimstone,Skye,Yoru","Raze,Viper,Brimstone,Skye,Gekko"
Icebox,WasTaken,Timeless Rivals,5,13,3,3,10,2,"Killjoy,Viper,Sage,Omen,Gekko","Killjoy,Viper,Jett,KAY/O,Gekko"
Lotus,Sentinels,LOUD,7,13,5,3,10,2,"Raze,Killjoy,Viper,Omen,Fade","Raze,Viper,Omen,Fade,Deadlock"
Lotus,XSOUL GC,TLS Fem,13,6,8,4,2,5,"Raze,Killjoy,Omen,Skye,Gekko","Breach,Raze,Killjoy,Viper,Omen"
Icebox,SFU Pink,UC Irvine,5,13,2,4,9,3,"Sova,Killjoy,Viper,Omen,Jett","Killjoy,Viper,Jett,KAY/O,Gekko"
Lotus,OutGoing Esports,Outlaws X,13,8,4,5,3,9,"Raze,Killjoy,Viper,Omen,Fade","Raze,Cypher,Viper,Astra,Fade"
Bind,CSULB Black,LBR,10,13,7,4,9,3,"Raze,Cypher,Brimstone,Skye,Yoru","Raze,Cypher,Viper,Brimstone,Skye"
Icebox,CSUF Orange,CSULB Gold,13,11,6,6,5,7,"Sova,Killjoy,Viper,Jett,Harbor","Sova,Killjoy,Viper,Sage,Jett"
Lotus,TENGAN MIEDO,ONA Family,13,9,6,4,5,7,"Breach,Raze,Sova,Killjoy,Omen","Raze,Killjoy,Viper,Omen,Fade"
Breeze,Shopify Rebellion,Supernova x Pals,13,6,9,3,3,4,"Cypher,Sova,Viper,Jett,KAY/O","Cypher,Sova,Viper,Jett,KAY/O"
Breeze,Genbu Gaming GC,Legiowon Puff,13,3,4,0,3,9,"Cypher,Sova,Viper,Jett,KAY/O","Cypher,Sova,Viper,Jett,KAY/O"
Icebox,St. Clair Saints,Northwood University,13,8,8,4,4,5,"Sova,Killjoy,Viper,Jett,Harbor","Sova,Killjoy,Viper,Jett,KAY/O"
Bind,FlyQuest RED,floppers,13,11,6,6,5,7,"Raze,Viper,Brimstone,Skye,Yoru","Raze,Cypher,Viper,Skye,Astra"
Split,SFU Pink,UC Irvine,4,13,0,5,8,4,"Raze,Cypher,Reyna,Skye,Astra","Cypher,Sova,Viper,Omen,Iso"
Bind,Luxoria,WasTaken,13,6,4,3,3,9,"Raze,Cypher,Brimstone,Skye,Gekko","Raze,Cypher,Brimstone,Skye,Yoru"
Bind,CSUF Orange,CSULB Gold,5,13,4,8,5,1,"Raze,Viper,Brimstone,Reyna,Skye","Raze,Cypher,Brimstone,Skye,Yoru"
Bind,Deagle Ravagers,Zen eSports GC,13,15,7,7,8,6,"Breach,Raze,Viper,Brimstone,Skye","Breach,Raze,Viper,Brimstone,Gekko"
Icebox,XSOUL GC,TLS Fem,7,13,5,7,6,2,"Killjoy,Viper,Jett,Harbor,Gekko","Killjoy,Viper,Reyna,KAY/O,Gekko"
Lotus,Lucky 7 Gaming,ZETA,13,1,11,1,0,2,"Raze,Killjoy,Viper,Omen,Gekko","Killjoy,Omen,Jett,KAY/O,Gekko"
Bind,ZENITH,Luminescent Sapphire,9,13,6,4,9,3,"Breach,Raze,Viper,Brimstone,Skye","Raze,Viper,Brimstone,Skye,Gekko"
Bind,Timeless Rivals,The Force,13,5,6,0,5,7,"Raze,Viper,Brimstone,Skye,Gekko","Cypher,Brimstone,Jett,Skye,Gekko"
Bind,G2 Esports,MIBR,13,3,11,1,2,2,"Raze,Viper,Brimstone,Skye,Gekko","Raze,Viper,Brimstone,Skye,Gekko"
Bind,Baby Goats,Status Red,13,10,4,7,3,9,"Raze,Viper,Brimstone,Yoru,Gekko","Raze,Viper,Brimstone,Skye,Gekko"
Icebox,OXEN GC,Dasein Club GC,13,10,8,3,7,5,"Sova,Killjoy,Viper,Reyna,Jett","Sova,Killjoy,Viper,Reyna,Jett"
Bind,Celestial Dawn,Sya Unity,1,13,1,11,2,0,"Breach,Raze,Cypher,Brimstone,Skye","Viper,Jett,Yoru,Gekko,Clove"
Ascent,CSULB Black,LBR,8,13,4,5,8,4,"Sova,Killjoy,Omen,Jett,Deadlock","Sova,Killjoy,Sage,Omen,Jett"
Lotus,Shopify Rebellion,Supernova x Pals,13,3,10,2,1,3,"Raze,Killjoy,Viper,Omen,Fade","Raze,Killjoy,Viper,Omen,Fade"
Sunset,TAMU Maroon,UST Esports,13,15,5,9,6,8,"Breach,Raze,Cypher,Omen,Fade","Breach,Raze,Cypher,Omen,Gekko"
Ascent,Infiriumz Gaming GC,New Combat Line GC,4,13,4,1,12,0,"Sova,Killjoy,Omen,Jett,KAY/O","Sova,Killjoy,Omen,Jett,KAY/O"
Breeze,Rebirth Esports,Zen Esports,13,9,3,7,2,10,"Cypher,Sova,Viper,Jett,KAY/O","Sova,Viper,Reyna,KAY/O,Harbor"
Sunset,Mizzou Esports,Indiana Hoosiers,13,7,5,3,4,8,"Breach,Raze,Cypher,Reyna,Omen","Breach,Raze,Cypher,Sova,Omen"
Lotus,CSULB Black,LBR,13,6,3,4,2,10,"Raze,Killjoy,Viper,Omen,Fade","Raze,Killjoy,Viper,Omen,Fade"
Lotus,FlyQuest RED,floppers,14,12,7,6,6,7,"Raze,Killjoy,Viper,Omen,Skye","Raze,Cypher,Omen,KAY/O,Gekko"
Split,WasTaken,Outlaws X,13,9,7,3,6,6,"Raze,Cypher,Viper,Skye,Clove","Raze,Cypher,Viper,Omen,KAY/O"
Ascent,Status Red,The Force,13,1,11,1,0,2,"Sova,Killjoy,Omen,Jett,KAY/O","Cypher,Sova,Omen,Jett,KAY/O"
Ascent,LG Orange,Cumberland Phoenix,13,2,3,0,2,10,"Sova,Killjoy,Omen,Jett,KAY/O","Sova,Killjoy,Omen,Jett,KAY/O"
Split,Luxoria,OutGoing Esports,13,6,7,5,1,6,"Raze,Cypher,Omen,Skye,Gekko","Raze,Viper,Omen,Jett,Skye"
Lotus,GOOBERS,ZETA,6,13,4,8,5,2,"Raze,Killjoy,Omen,Fade,Gekko","Killjoy,Omen,Jett,KAY/O,Gekko"
Bind,Infiriumz Gaming GC,New Combat Line GC,1,13,0,2,11,1,"Raze,Cypher,Viper,Brimstone,Skye","Raze,Cypher,Brimstone,Skye,Clove"
Sunset,Baby Goats,Timeless Rivals,13,3,11,1,2,2,"Breach,Raze,Cypher,Omen,Gekko","Breach,Raze,Sova,Viper,Omen"
Bind,Shopify Rebellion,Supernova x Pals,6,13,3,9,4,3,"Raze,Viper,Brimstone,Skye,Gekko","Raze,Viper,Brimstone,Skye,Gekko"
Split,ZENITH,Celestial Dawn,8,13,6,6,7,2,"Raze,Cypher,Viper,Omen,Skye","Breach,Raze,Sage,Omen,Jett"
Lotus,St. Clair Saints,Northwood University,17,15,8,8,7,9,"Raze,Cypher,Viper,Omen,Skye","Raze,Sova,Killjoy,Viper,Omen"
Icebox,Sya Unity,Luminescent Sapphire,13,11,7,5,6,6,"Raze,Viper,Chamber,Gekko,Clove","Sova,Killjoy,Viper,Jett,KAY/O"
Breeze,TAMU Maroon,UST Esports,9,13,6,4,9,3,"Sova,Viper,Jett,Yoru,Astra","Cypher,Sova,Viper,Jett,KAY/O"
Bind,Mizzou Esports,Indiana Hoosiers,3,13,0,4,9,3,"Breach,Raze,Brimstone,Reyna,Jett","Raze,Viper,Brimstone,Skye,Yoru"
Icebox,G2 Esports,MIBR,13,9,6,4,5,7,"Sova,Killjoy,Viper,Harbor,Gekko","Killjoy,Viper,Sage,KAY/O,Gekko"
Ascent,TLS Fem,Maze Gaming GC,13,7,10,2,5,3,"Raze,Sova,Killjoy,Omen,KAY/O","Sova,Killjoy,Omen,Jett,KAY/O"
Icebox,Rebirth Esports,Zen Esports,13,8,9,0,8,4,"Viper,Reyna,Omen,Jett,Gekko","Killjoy,Viper,Jett,KAY/O,Gekko"
Bind,LG Orange,Cumberland Phoenix,14,12,7,6,6,7,"Raze,Cypher,Viper,Brimstone,Skye","Raze,Viper,Brimstone,Skye,Gekko"
Split,Harrisburg University,TMU Blue,14,12,9,4,8,5,"Raze,Cypher,Viper,Omen,Skye","Breach,Cypher,Omen,Jett,Skye"
Lotus,TAMU Maroon,UST Esports,7,13,6,6,7,1,"Raze,Killjoy,Viper,Omen,Skye","Breach,Raze,Killjoy,Omen,Gekko"
Icebox,Mizzou Esports,Indiana Hoosiers,13,6,9,3,3,4,"Killjoy,Viper,Sage,Reyna,Jett","Sova,Killjoy,Viper,Omen,Jett"
Sunset,St. Clair Saints,Northwood University,13,11,7,5,6,6,"Breach,Raze,Cypher,Omen,Fade","Breach,Raze,Cypher,Sova,Omen"
Lotus,Winthrop University,Fisher Falcons,14,12,7,6,6,7,"Raze,Killjoy,Viper,Omen,Fade","Raze,Killjoy,Viper,Omen,Fade"
Lotus,TLS Fem,Maze Gaming GC,13,10,6,6,4,7,"Breach,Raze,Killjoy,Viper,Omen","Raze,Killjoy,Omen,Skye,Fade"
Bind,Harrisburg University,TMU Blue,13,11,8,4,7,5,"Raze,Viper,Brimstone,Skye,Gekko","Breach,Cypher,Brimstone,Jett,Skye"
Split,Bellakitas,Dasein Club GC,6,13,2,5,8,4,"Breach,Raze,Cypher,Omen,Gekko","Raze,Cypher,Viper,Omen,Skye"
Bind,Winthrop University,Fisher Falcons,14,12,6,7,5,8,"Raze,Viper,Brimstone,Skye,Gekko","Breach,Viper,Phoenix,Brimstone,KAY/O"
Sunset,Winthrop University,Fisher Falcons,13,8,4,5,3,9,"Breach,Raze,Cypher,Omen,Fade","Breach,Sova,Viper,Phoenix,Omen"
Sunset,Bellakitas,Dasein Club GC,6,13,2,5,8,4,"Breach,Raze,Cypher,Omen,Fade","Breach,Raze,Cypher,Sova,Omen"
Icebox,TLS Fem,Maze Gaming GC,10,13,5,6,7,5,"Killjoy,Viper,Reyna,KAY/O,Gekko","Sova,Viper,Sage,Reyna,KAY/O"
Breeze,Sky Esports,MouzKings eSports,4,13,0,5,8,4,"Cypher,Sova,Viper,Jett,KAY/O","Cypher,Sova,Viper,Jett,KAY/O"
Ascent,Staffordshire University,UP Valencia,13,4,8,4,0,5,"Cypher,Viper,Omen,Jett,KAY/O","Sova,Killjoy,Omen,Jett,KAY/O"
Ascent,WSKFiT,Faculty of OI,9,13,5,5,8,4,"Sova,Killjoy,Omen,Jett,KAY/O","Sova,Killjoy,Omen,Jett,KAY/O"
Bind,TUD Apes,NUPESU,6,13,4,8,5,2,"Raze,Cypher,Brimstone,Skye,Yoru","Raze,Cypher,Viper,Sage,Clove"
Bind,Budapest UTE,Turin University,3,13,1,3,10,2,"Raze,Cypher,Brimstone,Fade,Gekko","Breach,Raze,Viper,Fade,Clove"
Ascent,University of Göttingen,Nottingham Trent,7,13,4,4,9,3,"Sova,Killjoy,Omen,Jett,KAY/O","Sova,Killjoy,Omen,Jett,KAY/O"
Bind,LDV Esports,KIT SC ESPORTS,3,13,1,3,10,2,"Cypher,Viper,Brimstone,Reyna,Gekko","Raze,Cypher,Viper,Brimstone,Skye"
Icebox,Hogeschool PXL,VU Amsterdam,3,13,0,4,9,3,"Sova,Killjoy,Viper,Jett,Gekko","Sova,Killjoy,Viper,Jett,Gekko"
Split,STUBA Esports,Owls UPC,2,13,2,10,3,0,"Breach,Raze,Cypher,Viper,Clove","Raze,Cypher,Omen,Jett,Skye"
Ascent,Twisted Minds Orchid,R8 Blues,9,13,3,7,6,6,"Sova,Killjoy,Omen,Jett,KAY/O","Sova,Killjoy,Jett,Astra,KAY/O"
Lotus,Podnik,DropoutNenjoyers,10,13,5,7,6,5,"Breach,Sova,Killjoy,Omen,Jett","Raze,Killjoy,Viper,Omen,Fade"
Ascent,Sky Esports,MouzKings eSports,4,13,4,8,5,0,"Sova,Killjoy,Omen,Jett,KAY/O","Sova,Killjoy,Omen,Jett,KAY/O"
Icebox,Team Falcons Vega,The Ultimates Odyssey,13,3,4,0,3,9,"Sova,Killjoy,Viper,Jett,Gekko","Sova,Killjoy,Viper,Jett,Gekko"
Ascent,NUPESU,WSKFiT,13,5,5,1,4,8,"Sova,Killjoy,Sage,Jett,Clove","Sova,Killjoy,Omen,Jett,KAY/O"
Ascent,University of Göttingen,Owls UPC,13,9,8,4,5,5,"Cypher,Sova,Omen,Jett,KAY/O","Sova,Killjoy,Omen,Jett,KAY/O"
Bind,Nottingham Trent,TUD Apes,13,7,6,6,1,7,"Raze,Cypher,Viper,Brimstone,Skye","Raze,Viper,Brimstone,Skye,Yoru"
Lotus,Twisted Minds Orchid,R8 Blues,13,10,8,4,6,5,"Killjoy,Viper,Omen,Neon,Gekko","Killjoy,Viper,Omen,Skye,Neon"
Lotus,UP Valencia,University of Milan,13,3,11,1,2,2,"Breach,Raze,Killjoy,Omen,Fade","Breach,Raze,Killjoy,Omen,Gekko"
Split,Faculty of OI,Sorbonne University,13,6,7,5,1,6,"Raze,Cypher,Astra,Gekko,Deadlock","Raze,Viper,Omen,Skye,Chamber"
Sunset,Team Falcons Vega,The Ultimates Odyssey,13,1,11,1,0,2,"Breach,Raze,Cypher,Omen,Fade","Raze,Cypher,Viper,Omen,Fade"
Bind,Turin University,Prague UEB,13,9,7,3,6,6,"Breach,Raze,Viper,Fade,Clove","Raze,Cypher,Brimstone,Sage,Skye"
Sunset,KIT SC ESPORTS,STUBA Esports,12,14,5,8,6,7,"Breach,Raze,Cypher,Omen,Gekko","Raze,Cypher,Fade,Gekko,Clove"
Bind,Staffordshire University,Budapest UTE,17,15,12,4,11,5,"Raze,Cypher,Brimstone,Jett,Gekko","Raze,Cypher,Brimstone,Fade,Gekko"
Bind,LDV Esports,VU Amsterdam,13,9,6,4,5,7,"Cypher,Viper,Reyna,Gekko,Clove","Killjoy,Brimstone,Jett,Yoru,Gekko"
Breeze,Podnik,DropoutNenjoyers,15,17,5,11,6,10,"Cypher,Sova,Viper,Jett,KAY/O","Cypher,Sova,Viper,Jett,Yoru"
Lotus,BUCHCLUB,Playing Ducks,13,5,5,1,4,8,"Breach,Raze,Killjoy,Omen,Jett","Breach,Raze,Killjoy,Viper,Omen"
Ascent,IF WE BEING REAL,GJ Omen,6,13,6,6,7,0,"Sova,Killjoy,Phoenix,Omen,Jett","Sova,Killjoy,Omen,Jett,KAY/O"
Icebox,Mix123,A One Man Army,7,13,2,6,7,5,"Sova,Killjoy,Viper,Reyna,Jett","Sova,Killjoy,Viper,Sage,Jett"
Lotus,Bard3,Zvietnam,6,13,3,4,9,3,"Breach,Raze,Killjoy,Omen,Fade","Breach,Killjoy,Omen,Yoru,Neon"
Lotus,Babos Gaming,Novita Esports,13,8,2,7,1,11,"Breach,Killjoy,Omen,Neon,Gekko","Killjoy,Sage,Reyna,Omen,Neon"
Lotus,Permitta Youngstars,Lord eSports,4,13,2,3,10,2,"Breach,Raze,Killjoy,Omen,Gekko","Breach,Raze,Killjoy,Omen,Gekko"
Breeze,DANGER,XPERION NXT,9,13,5,5,8,4,"Cypher,Sova,Viper,Jett,Yoru","Sova,Viper,Skye,Neon,Harbor"
Icebox,INF Esports,Silly Cars,6,13,5,7,6,1,"Sova,Killjoy,Viper,Sage,Jett","Sova,Killjoy,Viper,Jett,Deadlock"
Bind,Podnik,DropoutNenjoyers,13,10,6,6,4,7,"Raze,Cypher,Viper,Brimstone,Skye","Raze,Viper,Brimstone,Skye,Gekko"
Breeze,Budapest UTE,Hogeschool PXL,13,11,8,4,7,5,"Cypher,Sova,Viper,Jett,Gekko","Cypher,Sova,Viper,Jett,Clove"
Bind,6TM ESPORTS,Playing Ducks,8,13,5,4,9,3,"Viper,Reyna,Yoru,Fade,Harbor","Raze,Cypher,Viper,Brimstone,Gekko"
Ascent,Sorbonne University,Nottingham Trent,6,13,2,10,3,4,"Sova,Killjoy,Omen,Jett,KAY/O","Sova,Killjoy,Omen,Jett,KAY/O"
Lotus,Mausi eSports,GJ Omen,6,13,4,8,5,2,"Raze,Cypher,Viper,Reyna,Omen","Raze,Killjoy,Viper,Omen,Fade"
Split,NUPESU,Staffordshire University,13,8,8,4,4,5,"Raze,Cypher,Phoenix,Sage,Clove","Raze,Cypher,Omen,Jett,Skye"
Lotus,TUD Apes,University of Göttingen,13,9,7,5,4,6,"Raze,Viper,Omen,Chamber,Gekko","Breach,Raze,Killjoy,Omen,Skye"
Breeze,WSKFiT,UP Valencia,13,9,5,5,4,8,"Cypher,Sova,Viper,Jett,KAY/O","Cypher,Sova,Viper,Jett,KAY/O"
Ascent,Owls UPC,KIT SC ESPORTS,13,9,5,5,4,8,"Sova,Killjoy,Omen,Jett,KAY/O","Sova,Killjoy,Omen,Jett,KAY/O"
Sunset,ECO Quantum,Novita Esports,4,13,1,4,9,3,"Breach,Raze,Cypher,Omen,Gekko","Raze,Cypher,Omen,Skye,Neon"
Sunset,STUBA Esports,Turin University,13,9,5,7,2,8,"Raze,Cypher,Fade,Gekko,Clove","Raze,Cypher,Omen,Fade,Harbor"
Split,Prague UEB,Faculty of OI,3,13,0,4,9,3,"Raze,Killjoy,Sage,Omen,Skye","Raze,Cypher,Astra,Gekko,Deadlock"
Bind,University of Milan,LDV Esports,13,4,4,1,3,9,"Raze,Viper,Brimstone,Jett,Skye","Raze,Viper,Brimstone,Sage,Skye"
Ascent,Lumina Gaming,A One Man Army,7,13,4,8,5,3,"Sova,Killjoy,Omen,Jett,KAY/O","Sova,Killjoy,Omen,Jett,KAY/O"
Ascent,YĪNJĪNG,Lord eSports,4,13,2,10,3,2,"Sova,Killjoy,Omen,Jett,KAY/O","Cypher,Sova,Omen,Jett,KAY/O"
Bind,Reveal Academy,XPERION NXT,6,13,1,6,7,5,"Raze,Viper,Brimstone,Skye,Chamber","Raze,Viper,Brimstone,Skye,Gekko"
Icebox,Zvietnam,Die Regler Badaboom,13,6,4,3,3,9,"Sova,Killjoy,Viper,Omen,Jett","Sova,Killjoy,Viper,Reyna,Jett"
Icebox,New Origins Esports,evolutionSTARS,3,13,1,3,10,2,"Sova,Killjoy,Viper,Sage,Jett","Sova,Killjoy,Viper,Jett,Gekko"
Icebox,UCAN ESPORTS,Silly Cars,3,13,3,9,4,0,"Sova,Killjoy,Viper,Reyna,Jett","Sova,Killjoy,Viper,Jett,Deadlock"
Ascent,Veni eSports,Babos Gaming,13,7,8,4,3,5,"Sova,Killjoy,Omen,Jett,KAY/O","Sova,Killjoy,Omen,KAY/O,Neon"
Icebox,Bard3,Reveal Multigaming,4,13,2,10,3,2,"Sova,Killjoy,Viper,Sage,Jett","Sova,Killjoy,Viper,Reyna,Jett"
Ascent,A One Man Army,VCGN BRUCHQ,13,2,11,1,1,2,"Sova,Killjoy,Omen,Jett,KAY/O","Sova,Killjoy,Jett,Gekko,Clove"
Lotus,J4,Mausi eSports,6,13,2,5,8,4,"Breach,Raze,Killjoy,Omen,Jett","Raze,Cypher,Viper,Reyna,Omen"
Lotus,Jorge & Filhos Lda.,Star Queens,13,5,4,2,3,9,"Breach,Killjoy,Viper,Omen,Neon","Breach,Raze,Killjoy,Omen,Fade"
Bind,XPERION NXT,FlyingChamps Prophecy,13,2,11,1,1,2,"Raze,Viper,Brimstone,Skye,Gekko","Raze,Viper,Brimstone,Skye,Yoru"
Split,Monkey Stars,HUNTERS,13,8,5,4,4,8,"Breach,Cypher,Sage,Omen,Jett","Raze,Cypher,Viper,Omen,Skye"
Ascent,Lumina Gaming,Nocturnal E-sports,13,4,9,3,1,4,"Sova,Killjoy,Omen,Jett,KAY/O","Sova,Killjoy,Omen,Jett,KAY/O"
Lotus,Playing Ducks,SERENITY,13,7,9,3,4,4,"Breach,Raze,Killjoy,Viper,Omen","Breach,Raze,Killjoy,Omen,Jett"
Ascent,hlavi,jdeme si pro vas,12,14,5,8,6,7,"Sova,Killjoy,Omen,Jett,KAY/O","Sova,Killjoy,Omen,Jett,KAY/O"
Lotus,Lord eSports,True Facts Gaming,13,5,8,4,1,5,"Breach,Raze,Killjoy,Omen,Gekko","Breach,Raze,Cypher,Omen,Skye"
Breeze,INF Esports,SOS Affenalarm,4,13,4,8,5,0,"Cypher,Sova,Viper,Jett,KAY/O","Sova,Viper,Jett,Yoru,Chamber"
Ascent,ECO Quantum,Glacial Guardians,13,10,7,5,5,6,"Sova,Killjoy,Omen,Jett,KAY/O","Sova,Killjoy,Omen,Jett,KAY/O"
Lotus,Pingu E-Sports,Permitta Youngstars,13,4,5,0,4,8,"Breach,Raze,Killjoy,Omen,Gekko","Breach,Raze,Killjoy,Omen,Fade"
Lotus,Lootcifer,BUCHCLUB,13,7,9,3,4,4,"Breach,Raze,Killjoy,Omen,KAY/O","Breach,Raze,Killjoy,Omen,Skye"
Lotus,INFERNUS,IF WE BEING REAL,13,4,4,1,3,9,"Breach,Raze,Killjoy,Omen,Fade","Breach,Raze,Killjoy,Viper,Omen"
Ascent,Fishing Rods Academy,Axolotl milk academy,13,1,2,0,1,11,"Sova,Killjoy,Phoenix,Omen,Jett","Breach,Viper,Phoenix,Omen,Fade"
Bind,Zerenity,Die Regler Badaboom,4,13,4,8,5,0,"Raze,Cypher,Brimstone,Skye,Gekko","Raze,Cypher,Brimstone,Skye,Yoru"
Lotus,Permitta Unicorns,DANGER,13,1,11,1,0,2,"Breach,Raze,Killjoy,Omen,Fade","Breach,Raze,Cypher,Omen,Fade"
Sunset,UP Valencia,Budapest UTE,13,3,4,0,3,9,"Breach,Raze,Cypher,Omen,Gekko","Breach,Raze,Cypher,Omen,Gekko"
Split,Nottingham Trent,Owls UPC,13,9,6,6,3,7,"Breach,Raze,Cypher,Omen,Jett","Raze,Cypher,Omen,Jett,Skye"
Bind,Faculty of OI,NUPESU,9,13,6,4,9,3,"Raze,Cypher,Viper,Brimstone,Gekko","Raze,Cypher,Viper,Brimstone,Sage"
Ascent,KIT SC ESPORTS,University of Milan,13,3,2,2,1,11,"Sova,Killjoy,Omen,Jett,KAY/O","Sova,Killjoy,Omen,Jett,KAY/O"
Lotus,Mix123,IRREGULARS,5,13,1,5,8,4,"Breach,Raze,Killjoy,Omen,Gekko","Raze,Killjoy,Omen,Fade,Gekko"
Icebox,University of Göttingen,WSKFiT,13,7,7,1,6,6,"Sova,Killjoy,Viper,Sage,Jett","Killjoy,Viper,Sage,Jett,Gekko"
Sunset,Turin University,Hogeschool PXL,13,2,3,0,2,10,"Raze,Cypher,Omen,Fade,Harbor","Raze,Cypher,Sova,Omen,Gekko"
Split,Sorbonne University,VU Amsterdam,13,6,9,3,3,4,"Raze,Viper,Omen,Skye,Chamber","Breach,Raze,Cypher,Chamber,Clove"
Split,STUBA Esports,Staffordshire University,11,13,6,6,7,5,"Breach,Raze,Cypher,Viper,Clove","Raze,Cypher,Omen,Jett,Skye"
Bind,Novita Esports,Winable,13,7,9,3,4,4,"Raze,Viper,Brimstone,Reyna,Skye","Raze,Viper,Yoru,Gekko,Clove"
Lotus,Prague UEB,TUD Apes,7,13,4,8,5,3,"Raze,Killjoy,Omen,Skye,Gekko","Raze,Viper,Omen,Chamber,Gekko"
Ascent,6TM ESPORTS,Xenon Esports EU,13,4,9,3,1,4,"Cypher,Sova,Omen,Jett,KAY/O","Killjoy,Viper,Phoenix,Omen,Fade"
Ascent,Zvietnam,6TM ACADEMY,13,5,4,2,3,9,"Sova,Killjoy,Omen,Jett,KAY/O","Sova,Killjoy,Omen,Jett,KAY/O"
Bind,Reveal Academy,TEAM BLINDSPOT,13,10,9,3,7,4,"Raze,Viper,Brimstone,Skye,Chamber","Raze,Viper,Skye,Gekko,Clove"
Bind,Be Gentle,Silly Cars,4,13,3,9,4,1,"Raze,Cypher,Viper,Brimstone,Skye","Raze,Jett,Skye,Chamber,Clove"
Ascent,ROA Zenith,YĪNJĪNG,5,13,2,10,3,3,"Sova,Killjoy,Omen,Jett,KAY/O","Sova,Killjoy,Omen,Jett,KAY/O"
Ascent,Jorge & Filhos Lda.,Star Queens,13,3,11,1,2,2,"Killjoy,Reyna,Jett,KAY/O,Clove","Sova,Killjoy,Omen,Jett,KAY/O"
Lotus,New Origins Esports,evolutionSTARS,7,13,4,4,9,3,"Raze,Killjoy,Viper,Omen,Fade","Breach,Raze,Killjoy,Viper,Omen"
Ascent,GJ Omen,SOS Academy,13,3,9,3,0,4,"Sova,Killjoy,Omen,Jett,KAY/O","Cypher,Sova,Phoenix,Brimstone,Gekko"
Ascent,Babos Gaming,J4,13,5,7,5,0,6,"Sova,Killjoy,Omen,KAY/O,Neon","Cypher,Sova,Omen,Jett,KAY/O"
Sunset,Monkey Stars,HUNTERS,3,13,1,3,10,2,"Breach,Cypher,Sova,Omen,Jett","Raze,Cypher,Omen,KAY/O,Gekko"
Lotus,IF WE BEING REAL,ECO Quantum,13,4,10,2,2,3,"Breach,Raze,Killjoy,Viper,Omen","Breach,Raze,Killjoy,Omen,Gekko"
Lotus,hlavi,jdeme si pro vas,8,13,1,8,5,7,"Breach,Raze,Killjoy,Omen,Gekko","Breach,Raze,Killjoy,Omen,Gekko"
Lotus,Playing Ducks,INF Esports,6,13,3,4,9,3,"Breach,Raze,Killjoy,Viper,Omen","Breach,Killjoy,Omen,Neon,Gekko"
Lotus,Lootcifer,Be Gentle,13,1,2,0,1,11,"Breach,Raze,Killjoy,Omen,KAY/O","Raze,Cypher,Omen,Skye,Fade"
Ascent,DANGER,ROA Zenith,13,3,10,2,1,3,"Sova,Killjoy,Omen,Jett,KAY/O","Sova,Killjoy,Omen,Jett,KAY/O"
Icebox,XPERION NXT,Pingu E-Sports,7,13,4,8,5,3,"Sova,Killjoy,Viper,Jett,Harbor","Sova,Killjoy,Viper,Omen,Gekko"
Sunset,Lumina Gaming,Reveal Multigaming,10,13,3,8,5,7,"Breach,Raze,Cypher,Sova,Omen","Breach,Cypher,Sova,Omen,Jett"
Lotus,Bard3,A One Man Army,13,11,10,2,9,3,"Breach,Raze,Killjoy,Omen,Fade","Breach,Raze,Killjoy,Omen,Gekko"
Ascent,Permitta Youngstars,Reveal Academy,13,1,11,1,0,2,"Sova,Killjoy,Phoenix,Omen,Jett","Sova,Killjoy,Omen,Jett,KAY/O"
Icebox,Permitta Unicorns,Lord eSports,13,8,6,6,2,7,"Sova,Killjoy,Viper,Omen,Chamber","Killjoy,Viper,Jett,KAY/O,Gekko"
Ascent,6TM ESPORTS,SOS Affenalarm,3,13,2,10,3,1,"Cypher,Sova,Omen,Jett,KAY/O","Sova,Killjoy,Phoenix,Omen,Jett"
Ascent,Zvietnam,IRREGULARS,4,13,0,5,8,4,"Sova,Killjoy,Omen,Jett,KAY/O","Sova,Killjoy,Omen,Jett,KAY/O"
Icebox,Zerenity,Mix123,8,13,2,7,6,6,"Sova,Killjoy,Viper,Jett,Gekko","Sova,Killjoy,Viper,Reyna,Jett"
Ascent,UCAN ESPORTS,BUCHCLUB,11,13,6,6,7,5,"Sova,Killjoy,Omen,Jett,KAY/O","Breach,Viper,Phoenix,KAY/O,Clove"
Sunset,Fishing Rods Academy,Axolotl milk academy,13,9,7,3,6,6,"Raze,Cypher,Phoenix,Omen,Gekko","Breach,Sova,Viper,Phoenix,Omen"
Sunset,Novita Esports,INFERNUS,10,13,5,7,6,5,"Cypher,Omen,Jett,Skye,Yoru","Breach,Raze,Cypher,Omen,Gekko"
Lotus,Budapest UTE,University of Göttingen,8,13,2,7,6,6,"Breach,Raze,Killjoy,Omen,Gekko","Breach,Raze,Killjoy,Omen,Gekko"
Ascent,Nottingham Trent,NUPESU,13,11,6,6,5,7,"Sova,Killjoy,Omen,Jett,KAY/O","Sova,Killjoy,Viper,Jett,Clove"
Icebox,Monkey Stars,HUNTERS,13,4,3,2,2,10,"Sova,Killjoy,Viper,Jett,Gekko","Sova,Killjoy,Viper,Reyna,Jett"
Split,Staffordshire University,TUD Apes,9,13,3,9,4,6,"Raze,Cypher,Omen,Jett,Skye","Breach,Raze,Cypher,Omen,Jett"
Lotus,Veni eSports,GJ Omen,13,7,7,5,2,6,"Breach,Killjoy,Omen,Jett,Gekko","Raze,Killjoy,Viper,Omen,Fade"
Ascent,University of Milan,Turin University,13,6,4,3,3,9,"Sova,Killjoy,Omen,Jett,KAY/O","Breach,Raze,Cypher,Sova,Omen"
Bind,LDV Esports,Faculty of OI,6,13,4,3,10,2,"Raze,Viper,Brimstone,Sage,Skye","Raze,Cypher,Viper,Brimstone,Gekko"
Ascent,Hogeschool PXL,Prague UEB,6,13,2,5,8,4,"Sova,Killjoy,Omen,Jett,KAY/O","Sova,Killjoy,Omen,Jett,KAY/O"
Split,Owls UPC,Sorbonne University,13,5,4,2,3,9,"Raze,Cypher,Omen,Jett,Skye","Raze,Viper,Omen,Skye,Chamber"
Bind,VU Amsterdam,STUBA Esports,14,16,4,11,5,10,"Raze,Killjoy,Brimstone,Reyna,Gekko","Raze,Cypher,Viper,Gekko,Clove"
Ascent,Global Esports,DetonatioN FocusMe,13,11,7,5,6,6,"Sova,Killjoy,Omen,Jett,KAY/O","Raze,Cypher,Viper,Omen,KAY/O"
Icebox,UP Valencia,NUPESU,10,13,4,7,6,6,"Sova,Killjoy,Viper,Jett,Gekko","Sova,Killjoy,Viper,Sage,Jett"
Ascent,Owls UPC,Hogeschool PXL,13,5,5,1,4,8,"Sova,Killjoy,Omen,Jett,KAY/O","Sova,Killjoy,Phoenix,Omen,Jett"
Lotus,TUD Apes,STUBA Esports,13,3,11,1,2,2,"Raze,Killjoy,Viper,Omen,Gekko","Breach,Raze,Killjoy,Gekko,Clove"
Split,Staffordshire University,VU Amsterdam,13,3,9,3,0,4,"Raze,Cypher,Omen,Jett,Skye","Breach,Raze,Viper,Reyna,Omen"
Lotus,University of Göttingen,LDV Esports,13,3,9,3,0,4,"Raze,Killjoy,Omen,Skye,Gekko","Raze,Killjoy,Viper,Omen,Fade"
Lotus,Faculty of OI,Budapest UTE,8,13,6,6,7,2,"Breach,Killjoy,Viper,Omen,Neon","Breach,Raze,Killjoy,Omen,Gekko"
Sunset,KIT SC ESPORTS,Turin University,13,8,4,5,3,9,"Breach,Raze,Cypher,Omen,Gekko","Raze,Cypher,Omen,Fade,Harbor"
Split,Sorbonne University,Prague UEB,13,11,6,6,5,7,"Raze,Viper,Omen,Skye,Chamber","Raze,Killjoy,Sage,Omen,Skye"
Lotus,Global Esports,DetonatioN FocusMe,13,5,11,1,4,2,"Raze,Killjoy,Viper,Omen,Fade","Raze,Killjoy,Viper,Omen,Fade"
Ascent,WSKFiT,University of Milan,13,7,7,1,6,6,"Sova,Killjoy,Omen,Jett,KAY/O","Sova,Killjoy,Jett,KAY/O,Clove"
Split,Global Esports,DetonatioN FocusMe,10,13,6,6,7,4,"Raze,Cypher,Viper,Omen,Skye","Raze,Cypher,Viper,Omen,Skye"
Bind,Bleed Esports,Paper Rex,6,13,5,7,6,1,"Raze,Viper,Brimstone,Skye,Gekko","Raze,Brimstone,Skye,Harbor,Gekko"
Ascent,Bleed Esports,Paper Rex,5,13,3,9,4,2,"Sova,Killjoy,Omen,Jett,KAY/O","Sova,Sage,Omen,Jett,KAY/O"
Bind,KTANA,Absolute Gaming,13,6,8,4,2,5,"Breach,Raze,Cypher,Gekko,Clove","Raze,Viper,Brimstone,Skye,Gekko"
Ascent,KTANA,Absolute Gaming,13,2,2,1,1,11,"Breach,Raze,Cypher,Omen,Fade","Sova,Killjoy,Omen,Jett,KAY/O"
Bind,iKU,Hyperion Gaming,13,11,6,6,5,7,"Raze,Cypher,Viper,Brimstone,Gekko","Raze,Viper,Brimstone,Skye,Chamber"
Lotus,iKU,Hyperion Gaming,13,3,4,0,3,9,"Raze,Killjoy,Viper,Omen,Gekko","Raze,Cypher,Omen,Fade,Gekko"
Icebox,Barcelona Sporting X,MYVRA,7,13,2,6,7,5,"Sova,Killjoy,Viper,Reyna,Jett","Sova,Killjoy,Viper,Jett,Harbor"
Ascent,Illicit Gaming,Duality Esports,13,3,4,0,3,9,"Sova,Killjoy,Omen,Jett,KAY/O","Breach,Raze,Sova,Viper,Omen"
Ascent,Barcelona Sporting X,MYVRA,2,13,2,10,3,0,"Sova,Killjoy,Omen,Jett,KAY/O","Sova,Killjoy,Omen,Jett,KAY/O"
Lotus,TBS GC,REVOADA,9,13,4,6,7,5,"Raze,Killjoy,Viper,Omen,Fade","Raze,Killjoy,Viper,Omen,Fade"
Lotus,Illicit Gaming,Duality Esports,13,8,4,5,3,9,"Raze,Killjoy,Viper,Omen,Fade","Raze,Killjoy,Viper,Omen,Fade"
Bind,FlyQuest RED,Reformed GC,15,13,10,4,9,5,"Raze,Viper,Brimstone,Skye,Yoru","Raze,Viper,Brimstone,Skye,Chamber"
Lotus,floppers,Teddy Tactics,13,3,11,1,2,2,"Raze,Cypher,Omen,KAY/O,Gekko","Killjoy,Viper,Omen,Neon,Gekko"
Split,Fisher College Navy,Fisher College Tea Party,3,13,3,9,4,0,"Raze,Cypher,Viper,Omen,Skye","Raze,Cypher,Viper,Omen,Skye"
Lotus,Shopify Rebellion,mesos millionaires,13,6,6,6,0,7,"Raze,Killjoy,Viper,Omen,Fade","Breach,Raze,Killjoy,Omen,Gekko"
Breeze,Supernova x Pals,Solstice GC,13,7,5,7,0,8,"Cypher,Sova,Viper,Jett,KAY/O","Cypher,Sova,Viper,Yoru,Clove"
Ascent,TBS GC,REVOADA,4,13,0,5,8,4,"Breach,Cypher,Omen,Jett,KAY/O","Sova,Killjoy,Omen,Jett,KAY/O"
Sunset,FlyQuest RED,Reformed GC,13,8,8,4,4,5,"Breach,Raze,Cypher,Sova,Omen","Breach,Raze,Cypher,KAY/O,Harbor"
Bind,Elite Gaming,ZAGAS,6,13,6,6,7,0,"Raze,Viper,Brimstone,Skye,Gekko","Raze,Brimstone,Skye,Gekko,Deadlock"
Ascent,Fisher College Navy,Fisher College Tea Party,9,13,1,9,4,8,"Sova,Killjoy,Reyna,Omen,Jett","Sova,Killjoy,Omen,Jett,KAY/O"
Sunset,floppers,Teddy Tactics,13,3,4,0,3,9,"Raze,Cypher,Sova,Viper,Omen","Raze,Cypher,Omen,KAY/O,Gekko"
Bind,Cruzados Esports GC,FiRePOWER GC,3,13,1,3,10,2,"Raze,Viper,Brimstone,Fade,Gekko","Raze,Viper,Omen,Gekko,Deadlock"
Bind,Shopify Rebellion,mesos millionaires,13,9,6,6,3,7,"Raze,Viper,Brimstone,Skye,Gekko","Raze,Viper,Skye,Chamber,Clove"
Sunset,Supernova x Pals,Solstice GC,13,8,6,3,5,7,"Raze,Cypher,Omen,KAY/O,Gekko","Raze,Cypher,Omen,Gekko,Clove"
Sunset,LOUD GC,Team Leveling,12,14,6,7,7,6,"Breach,Raze,Viper,Omen,KAY/O","Breach,Raze,Cypher,Omen,Gekko"
Ascent,Elite Gaming,ZAGAS,11,13,5,7,6,6,"Sova,Killjoy,Omen,Jett,KAY/O","Sova,Killjoy,Omen,Jett,KAY/O"
Breeze,floppers,C4C Flare,13,2,10,2,0,3,"Cypher,Sova,Viper,Yoru,Astra","Cypher,Sova,Viper,Jett,KAY/O"
Bind,mesos millionaires,Silly Squad,13,3,9,3,0,4,"Raze,Viper,Skye,Chamber,Clove","Raze,Viper,Brimstone,KAY/O,Gekko"
Ascent,FlyQuest RED,Cafe Coke,13,6,9,3,3,4,"Sova,Killjoy,Omen,Jett,KAY/O","Sova,Killjoy,Omen,Jett,KAY/O"
Icebox,Teddy Tactics,Prospects Amethyst,13,4,4,1,3,9,"Sova,Killjoy,Viper,Sage,Jett","Sova,Killjoy,Viper,Omen,Gekko"
Breeze,Cruzados Esports GC,FiRePOWER GC,11,13,5,7,6,6,"Cypher,Sova,Viper,Jett,KAY/O","Cypher,Sova,Viper,Omen,Yoru"
Breeze,Supernova x Pals,friends GC,13,6,7,5,1,6,"Cypher,Sova,Viper,Jett,KAY/O","Cypher,Sova,Viper,Jett,KAY/O"
Ascent,Shopify Rebellion,Awaken RED,13,4,5,0,4,8,"Sova,Killjoy,Omen,Jett,KAY/O","Sova,Killjoy,Omen,Jett,KAY/O"
Sunset,Solstice GC,Kirbee Squad,13,4,9,3,1,4,"Raze,Cypher,Omen,Gekko,Clove","Breach,Raze,Cypher,Gekko,Clove"
Split,Kinetic GC,Reformed GC,10,13,6,5,8,4,"Raze,Cypher,Omen,Jett,Skye","Raze,Viper,Omen,Jett,Skye"
Bind,Solstice GC,Kirbee Squad,13,1,2,0,1,11,"Raze,Cypher,Viper,Brimstone,Skye","Raze,Cypher,Viper,Skye,Clove"
Bind,LOUD GC,Team Leveling,9,13,5,5,8,4,"Raze,Viper,Brimstone,Fade,Gekko","Raze,Viper,Brimstone,Skye,Gekko"
Ascent,mesos millionaires,Silly Squad,13,9,6,4,5,7,"Sova,Killjoy,Jett,Astra,KAY/O","Sova,Killjoy,Omen,Jett,KAY/O"
Sunset,floppers,C4C Flare,13,8,5,4,4,8,"Raze,Cypher,Sova,Viper,Omen","Breach,Raze,Cypher,Omen,Fade"
Lotus,Kinetic GC,Reformed GC,2,13,2,10,3,0,"Raze,Killjoy,Viper,Omen,Fade","Raze,Killjoy,Viper,Omen,Gekko"
Bind,FlyQuest RED,Cafe Coke,13,8,8,4,4,5,"Raze,Viper,Brimstone,Skye,Yoru","Raze,Viper,Skye,Gekko,Clove"
Lotus,Teddy Tactics,Prospects Amethyst,13,8,8,4,4,5,"Killjoy,Viper,Omen,Neon,Gekko","Breach,Raze,Viper,Omen,Gekko"
Bind,Shopify Rebellion,Awaken RED,13,5,7,5,0,6,"Raze,Viper,Brimstone,Skye,Gekko","Raze,Cypher,Viper,Brimstone,Skye"
Sunset,Supernova x Pals,friends GC,13,6,6,1,5,7,"Raze,Cypher,Omen,KAY/O,Gekko","Raze,Cypher,Omen,KAY/O,Gekko"
Ascent,Brewton Parker College,UCF Gold,10,13,6,5,8,4,"Killjoy,Viper,Omen,Jett,Skye","Sova,Killjoy,Omen,Jett,KAY/O"
Breeze,Fractious Esports,Tani eSports,5,13,4,8,5,1,"Cypher,Sova,Viper,Reyna,Jett","Cypher,Sova,Viper,Jett,KAY/O"
Sunset,Brewton Parker College,UCF Gold,13,9,7,5,4,6,"Raze,Cypher,Viper,Omen,Gekko","Raze,Cypher,Omen,KAY/O,Gekko"
Bind,Karmine Corp,KOI,15,13,5,9,4,10,"Raze,Viper,Omen,Skye,Gekko","Raze,Viper,Brimstone,KAY/O,Gekko"
Icebox,LOUD GC,Team Leveling,15,13,8,6,7,7,"Sova,Viper,Sage,Jett,KAY/O","Sova,Killjoy,Viper,Jett,Gekko"
Ascent,BEYOND eSports Academy,Fractious Esports,4,13,0,5,8,4,"Sova,Killjoy,Omen,Jett,KAY/O","Sova,Killjoy,Reyna,Omen,Jett"
Lotus,CROW DYNASTY,Lotus Knights,4,13,1,4,9,3,"Breach,Raze,Killjoy,Gekko,Clove","Raze,Killjoy,Viper,Omen,Fade"
Icebox,AXIMZERO,Capacitanes,13,7,8,4,3,5,"Killjoy,Viper,Reyna,Gekko,Clove","Sova,Killjoy,Viper,Jett,Harbor"
Icebox,VexOficiaal,TeamGamingProject,13,9,9,1,8,4,"Sova,Killjoy,Viper,Reyna,Jett","Sova,Killjoy,Viper,Jett,Gekko"
Split,Brewton Parker College,UCF Gold,10,13,3,9,4,7,"Raze,Cypher,Viper,Omen,Skye","Raze,Cypher,Viper,Omen,Skye"
Icebox,Karmine Corp,KOI,7,13,4,4,9,3,"Killjoy,Viper,Sage,Jett,Gekko","Killjoy,Viper,Jett,KAY/O,Gekko"
Icebox,Fractious Esports,UnderDogs SYN,13,4,10,2,2,3,"Sova,Killjoy,Viper,Reyna,Jett","Sova,Killjoy,Viper,Reyna,Jett"
Bind,Ensalada de atun,CROW DYNASTY,8,13,2,7,6,6,"Raze,Brimstone,Yoru,Chamber,Gekko","Raze,Reyna,Gekko,Deadlock,Clove"
Lotus,Stray Wolves,TeamGamingProject,6,13,1,6,7,5,"Raze,Killjoy,Viper,Gekko,Clove","Breach,Raze,Killjoy,Omen,Gekko"
Sunset,AXIMZERO,Zenturions,13,10,6,6,4,7,"Raze,Cypher,Viper,KAY/O,Harbor","Breach,Raze,Cypher,Omen,Fade"
Icebox,Capacitanes,Blood Moon V2,13,3,3,1,2,10,"Sova,Killjoy,Viper,Jett,Harbor","Sova,Killjoy,Viper,Jett,Gekko"
Ascent,VexOficiaal,1000rr club,13,8,4,5,3,9,"Sova,Killjoy,Omen,Jett,KAY/O","Cypher,Sova,Omen,Jett,KAY/O"
Lotus,A decoy,Tani eSports,9,13,6,4,9,3,"Raze,Killjoy,Skye,Gekko,Clove","Breach,Raze,Cypher,Omen,Gekko"
Sunset,Karmine Corp,KOI,13,7,8,4,3,5,"Raze,Cypher,Omen,KAY/O,Gekko","Cypher,Omen,KAY/O,Neon,Gekko"
Lotus,Stray Wolves,THUNDER KNIGHTS ESPORTS GAMING,13,4,4,1,3,9,"Raze,Killjoy,Viper,Gekko,Clove","Breach,Raze,Killjoy,Omen,Gekko"
Icebox,CROW DYNASTY,TLS eSports,13,4,10,2,2,3,"Sova,Killjoy,Viper,Jett,Gekko","Killjoy,Viper,Reyna,Jett,Gekko"
Icebox,Ensalada de atun,eQuizers Academy,13,3,10,2,1,3,"Sova,Killjoy,Viper,Reyna,Jett","Sova,Killjoy,Viper,Yoru,Harbor"
Breeze,Iberian Mix,A decoy,10,13,6,5,8,4,"Cypher,Sova,Viper,Jett,Yoru","Cypher,Sova,Viper,Jett,Gekko"
Breeze,Noname Mix,AXIMZERO,10,13,7,4,9,3,"Sova,Viper,Jett,Yoru,Astra","Cypher,Sova,Viper,Yoru,Gekko"
Sunset,Neko E-Sports,BEYOND eSports Academy,6,13,2,5,8,4,"Breach,Raze,Cypher,Sova,Omen","Breach,Raze,Cypher,Omen,Gekko"
Icebox,BEYOND eSports,VexOficiaal,4,13,3,9,4,1,"Sova,Killjoy,Viper,Reyna,Jett","Sova,Killjoy,Viper,Reyna,Jett"
Split,Ursus Gaming,1000rr club,9,13,6,4,9,3,"Breach,Raze,Cypher,Omen,Skye","Breach,Raze,Cypher,Omen,Skye"
Lotus,Capacitanes,Dimonis,13,3,4,0,3,9,"Breach,Raze,Killjoy,Omen,Gekko","Breach,Raze,Cypher,Omen,Gekko"
Sunset,Team Vitality,GIANTX,13,6,7,5,1,6,"Raze,Viper,Omen,KAY/O,Gekko","Breach,Raze,Cypher,Omen,Gekko"
Lotus,FusyonEC,TeamGamingProject,10,13,5,7,6,5,"Breach,Raze,Killjoy,Omen,Fade","Breach,Raze,Killjoy,Omen,Gekko"
Breeze,Team Vitality,GIANTX,13,7,9,3,4,4,"Cypher,Sova,Viper,Yoru,Astra","Cypher,Sova,Viper,Jett,Yoru"
Lotus,Team Vitality,GIANTX,14,16,8,7,9,6,"Killjoy,Viper,Omen,Neon,Gekko","Raze,Killjoy,Viper,Omen,Fade"
Ascent,Carnival Gaming,Grayfox Esports,4,13,3,9,4,1,"Sova,Killjoy,Omen,Jett,KAY/O","Breach,Raze,Sova,Killjoy,Omen"
Split,Carnival Gaming,Grayfox Esports,8,13,5,4,9,3,"Breach,Raze,Cypher,Omen,Yoru","Breach,Raze,Viper,Omen,Skye"
Lotus,Carnival Gaming,Grayfox Esports,14,12,7,6,6,7,"Raze,Killjoy,Viper,Omen,Fade","Raze,Killjoy,Viper,Omen,Fade"
Ascent,MLT Esports,True Rippers,12,14,8,5,9,4,"Sova,Killjoy,Omen,Jett,KAY/O","Sova,Killjoy,Omen,Jett,KAY/O"
Split,MLT Esports,True Rippers,8,13,3,6,7,5,"Raze,Cypher,Viper,Omen,Skye","Raze,Cypher,Viper,Omen,Skye"
Icebox,Ball State,Maryville University,13,9,7,5,4,6,"Killjoy,Viper,Sage,Jett,Gekko","Killjoy,Viper,Jett,KAY/O,Gekko"
Bind,K7 Esports GC,KS Esports GC,4,13,2,10,3,2,"Raze,Cypher,Viper,Brimstone,Skye","Raze,Viper,Brimstone,Skye,Yoru"
Breeze,Ball State,Maryville University,8,13,3,9,4,5,"Sova,Viper,Jett,Yoru,Astra","Cypher,Sova,Viper,Jett,KAY/O"
Sunset,K7 Esports GC,KS Esports GC,10,13,8,3,10,2,"Raze,Cypher,Viper,Omen,Skye","Raze,Cypher,Omen,KAY/O,Gekko"
Lotus,Ball State,Maryville University,13,4,5,0,4,8,"Raze,Killjoy,Viper,Omen,Skye","Raze,Killjoy,Viper,Omen,Fade"
Lotus,MIBR GC,LOUD GC,13,3,10,2,1,3,"Raze,Killjoy,Viper,Omen,Fade","Raze,Killjoy,Viper,Omen,Fade"
Sunset,University War GC,Leviatán GC,13,3,9,3,0,4,"Breach,Raze,Cypher,Omen,Fade","Raze,Cypher,Omen,KAY/O,Gekko"
Bind,MIBR GC,LOUD GC,13,9,7,5,4,6,"Raze,Viper,Brimstone,Skye,Gekko","Raze,Viper,Brimstone,Fade,Gekko"
Ascent,University War GC,Leviatán GC,13,8,6,3,5,7,"Sova,Killjoy,Omen,Jett,KAY/O","Sova,Killjoy,Omen,Jett,KAY/O"
Bind,Team Liquid Brazil,TBS GC,13,6,7,0,6,6,"Raze,Viper,Brimstone,Skye,Gekko","Raze,Cypher,Viper,Brimstone,Skye"
Ascent,Cobweb eSports,EvolutionSTARS Avis,13,2,2,1,1,11,"Breach,Sova,Killjoy,Omen,Jett","Killjoy,Omen,Jett,KAY/O,Fade"
Lotus,Cobweb eSports,EvolutionSTARS Avis,13,4,10,2,2,3,"Breach,Raze,Killjoy,Omen,Fade","Breach,Raze,Killjoy,Viper,Clove"
Split,Team Liquid Brazil,TBS GC,13,7,8,0,7,5,"Breach,Raze,Viper,Omen,Skye","Breach,Raze,Viper,Omen,Skye"
Split,BBL Esports,Natus Vincere,13,9,6,6,3,7,"Breach,Raze,Viper,Omen,Skye","Breach,Raze,Viper,Omen,Fade"
Sunset,BBL Esports,Natus Vincere,13,8,5,4,4,8,"Raze,Cypher,Omen,KAY/O,Gekko","Sova,Killjoy,Omen,KAY/O,Neon"
Ascent,BBL Esports,Natus Vincere,8,13,3,6,7,5,"Sova,Killjoy,Omen,Jett,KAY/O","Cypher,Sova,Omen,Jett,KAY/O"
Lotus,FNATIC,FUT Esports,13,15,7,7,8,6,"Raze,Killjoy,Viper,Omen,Fade","Cypher,Viper,Sage,Omen,Jett"
Split,FNATIC,FUT Esports,7,13,5,7,6,2,"Breach,Raze,Cypher,Omen,Yoru","Raze,Viper,Omen,Skye,Chamber"
Breeze,Reckoning Esports,Medal Esports,13,4,5,0,4,8,"Cypher,Sova,Viper,Jett,Astra","Cypher,Sova,Viper,Jett,KAY/O"
Split,FOCUSGG,Justice For Tomorrow,9,13,2,8,5,7,"Raze,Viper,Astra,Fade,Gekko","Raze,Viper,Sage,Skye,Astra"
Lotus,Reckoning Esports,Medal Esports,13,9,7,5,4,6,"Raze,Killjoy,Viper,Omen,Fade","Raze,Killjoy,Viper,Omen,Fade"
Split,Reckoning Esports,Medal Esports,3,13,3,9,4,0,"Raze,Cypher,Sage,Omen,Skye","Cypher,Viper,Omen,Jett,Skye"
Ascent,FOCUSGG,Justice For Tomorrow,9,13,2,8,5,7,"Sova,Killjoy,Omen,Jett,KAY/O","Sova,Killjoy,Omen,Jett,KAY/O"
Icebox,EDGE (OCE),BOBO,10,13,3,8,5,7,"Sova,Killjoy,Viper,Reyna,Jett","Sova,Killjoy,Viper,Jett,KAY/O"
Breeze,Orangutan,Revenant Esports,6,13,5,7,6,1,"Sova,Viper,Jett,Yoru,Astra","Cypher,Sova,Viper,Jett,KAY/O"
Lotus,Orangutan,Revenant Esports,5,13,3,9,4,2,"Breach,Raze,Sova,Killjoy,Omen","Raze,Killjoy,Viper,Omen,Fade"
Lotus,EDGE (OCE),BOBO,7,13,4,4,9,3,"Raze,Cypher,Omen,Jett,Fade","Raze,Killjoy,Viper,Omen,Fade"
Ascent,EDGE (OCE),BOBO,13,10,4,8,2,9,"Killjoy,Reyna,Omen,Jett,Fade","Sova,Killjoy,Omen,Jett,KAY/O"
Lotus,Azzy White,New Combat Line GC,4,13,1,4,9,3,"Breach,Raze,Killjoy,Omen,Gekko","Breach,Raze,Killjoy,Viper,Omen"
Bind,Prospects Amethyst,SaD FROST,16,14,8,7,7,8,"Raze,Viper,Brimstone,Skye,Gekko","Viper,Omen,Jett,Skye,Gekko"
Lotus,Converse Purple,CSULB Black,13,8,4,5,3,9,"Raze,Killjoy,Viper,Omen,Fade","Raze,Killjoy,Viper,Omen,Skye"
Ascent,Legión Mapaches Rabiosas,Genbu Gaming GC,6,13,1,6,7,5,"Sova,Killjoy,Omen,Jett,Skye","Sova,Killjoy,Omen,Jett,KAY/O"
Ascent,Azzy White,New Combat Line GC,14,12,6,7,5,8,"Sova,Killjoy,Omen,Jett,KAY/O","Sova,Killjoy,Omen,Jett,KAY/O"
Icebox,Converse Purple,CSULB Black,11,13,5,7,6,6,"Killjoy,Viper,Jett,KAY/O,Gekko","Sova,Killjoy,Viper,Jett,Harbor"
Lotus,Prospects Amethyst,SaD FROST,13,11,7,5,6,6,"Breach,Raze,Viper,Omen,Gekko","Raze,Killjoy,Omen,KAY/O,Gekko"
Icebox,Bon Bon Bum Contra GC,Ragnus Esports,13,6,7,0,6,6,"Killjoy,Viper,Jett,Gekko,Clove","Viper,Jett,Skye,Harbor,Gekko"
Bind,Bumble Bees,Silly Squad,11,13,9,3,10,2,"Raze,Viper,Brimstone,Skye,Yoru","Raze,Viper,Brimstone,KAY/O,Gekko"
Icebox,Awaken RED,Loafing Cats,13,5,7,5,0,6,"Sova,Killjoy,Viper,Jett,KAY/O","Sova,Killjoy,Viper,Jett,KAY/O"
Ascent,Legiowon Puff,Five Stack GC,13,7,5,3,4,8,"Sova,Killjoy,Omen,Jett,KAY/O","Sova,Killjoy,Omen,Jett,KAY/O"
Bind,friends GC,Infinity X,13,7,6,2,5,7,"Raze,Viper,Brimstone,Skye,Yoru","Raze,Viper,Brimstone,Skye,Gekko"
Split,Cafe Coke,Catnappers,13,1,11,1,0,2,"Breach,Raze,Cypher,Omen,Skye","Raze,Cypher,Omen,Skye,Yoru"
Icebox,Kunai Esports FEM,OK Gaming,15,17,7,9,8,8,"Sova,Killjoy,Viper,Jett,Gekko","Killjoy,Viper,Reyna,Jett,Gekko"
Sunset,C4C Flare,Minimum,13,8,7,5,3,6,"Breach,Raze,Cypher,Omen,Fade","Raze,Cypher,Viper,Omen,Skye"
Icebox,Azzy White,New Combat Line GC,5,13,1,5,8,4,"Sova,Killjoy,Viper,Sage,Jett","Sova,Viper,Jett,Chamber,Gekko"
Lotus,Legión Mapaches Rabiosas,Genbu Gaming GC,6,13,4,8,5,2,"Raze,Killjoy,Omen,Fade,Gekko","Raze,Cypher,Viper,Omen,Gekko"
Icebox,Kirbee Squad,Tenax GC,13,7,6,2,5,7,"Sova,Killjoy,Viper,Jett,Clove","Sova,Killjoy,Viper,Jett,Gekko"
Split,Reformed GC,minions united GC,13,5,5,1,4,8,"Raze,Viper,Omen,Jett,Skye","Breach,Raze,Cypher,Skye,Astra"
Ascent,Converse Purple,CSULB Black,13,9,6,6,3,7,"Sova,Killjoy,Omen,Jett,KAY/O","Sova,Killjoy,Omen,Jett,KAY/O"
Ascent,Prospects Amethyst,SaD FROST,9,13,5,5,8,4,"Sova,Killjoy,Omen,Jett,KAY/O","Sova,Killjoy,Omen,Jett,KAY/O"
Bind,Cafe Coke,Catnappers,13,4,8,4,0,5,"Raze,Viper,Skye,Gekko,Clove","Raze,Viper,Brimstone,Skye,Gekko"
Ascent,Kunai Esports FEM,OK Gaming,3,13,1,3,10,2,"Sova,Killjoy,Omen,Jett,KAY/O","Sova,Killjoy,Omen,Jett,KAY/O"
Ascent,KRÜ Esports,LOUD,13,8,6,3,5,7,"Sova,Killjoy,Omen,Jett,KAY/O","Sova,Viper,Omen,Jett,KAY/O"
Sunset,Legión Mapaches Rabiosas,Genbu Gaming GC,13,2,10,2,0,3,"Raze,Cypher,Skye,Gekko,Clove","Breach,Raze,Cypher,Omen,Gekko"
Split,Awaken RED,Loafing Cats,15,13,9,5,8,6,"Breach,Raze,Cypher,Omen,Skye","Breach,Raze,Cypher,Omen,Skye"
Icebox,friends GC,Infinity X,13,9,9,3,6,4,"Killjoy,Viper,Jett,KAY/O,Gekko","Sova,Killjoy,Viper,Jett,Gekko"
Lotus,C4C Flare,Minimum,13,8,6,6,2,7,"Breach,Raze,Killjoy,Omen,Fade","Raze,Killjoy,Omen,Skye,Gekko"
Ascent,Bumble Bees,Silly Squad,13,15,10,4,11,3,"Sova,Killjoy,Omen,Jett,KAY/O","Sova,Killjoy,Omen,Jett,KAY/O"
Icebox,Legiowon Puff,Five Stack GC,13,7,8,4,3,5,"Killjoy,Viper,Omen,KAY/O,Gekko","Viper,Jett,Gekko,Deadlock,Clove"
Lotus,Reformed GC,minions united GC,13,7,7,1,6,6,"Raze,Killjoy,Viper,Omen,Gekko","Breach,Raze,Killjoy,Omen,Gekko"
Bind,Kirbee Squad,Tenax GC,13,6,7,0,6,6,"Raze,Cypher,Viper,Skye,Clove","Raze,Viper,Brimstone,Skye,Yoru"
Bind,Bon Bon Bum Contra GC,Ragnus Esports,13,4,5,0,4,8,"Raze,Viper,Brimstone,Skye,Gekko","Raze,Cypher,Brimstone,Skye,Yoru"
Sunset,St. Clair Saints,Maryville University,13,3,9,3,0,4,"Breach,Raze,Cypher,Omen,Fade","Raze,Cypher,Viper,Omen,Gekko"
Ascent,TOADS,Team Opulence,8,13,5,4,9,3,"Sova,Killjoy,Reyna,Omen,Jett","Raze,Sova,Killjoy,Omen,Jett"
Ascent,TLS Fem,Malecient Parasside,13,2,10,2,0,3,"Raze,Sova,Killjoy,Omen,KAY/O","Breach,Raze,Sova,Killjoy,Clove"
Split,KRÜ Esports,LOUD,13,8,8,1,7,5,"Raze,Cypher,Viper,Omen,Skye","Breach,Raze,Viper,Omen,Skye"
Ascent,wows little pugstars,TOADS,2,13,2,10,3,0,"Sova,Killjoy,Jett,KAY/O,Clove","Sova,Killjoy,Reyna,Omen,Jett"
Ascent,Team Opulence,Shinjitsu,13,7,6,2,5,7,"Breach,Phoenix,Reyna,Omen,Jett","Sova,Killjoy,Omen,Jett,KAY/O"
Lotus,St. Clair Saints,Maryville University,13,4,9,3,1,4,"Raze,Killjoy,Viper,Omen,Skye","Raze,Killjoy,Viper,Omen,Fade"
Bind,Deagle Ravagers,OXEN GC,13,11,6,6,5,7,"Breach,Raze,Cypher,Brimstone,Skye","Raze,Cypher,Viper,Brimstone,Gekko"
Ascent,Infinity X,STARFIRE,13,11,8,4,7,5,"Cypher,Sova,Omen,Jett,KAY/O","Sova,Killjoy,Omen,Jett,KAY/O"
Split,Krows Corax,Dasein Club GC,10,13,2,10,3,8,"Breach,Raze,Cypher,Reyna,Omen","Raze,Cypher,Viper,Omen,Skye"
Ascent,Veggie Basket,wows little pugstars,0,13,0,1,12,0,"Sova,Killjoy,Omen,Jett,Skye","Sova,Killjoy,Jett,KAY/O,Clove"
Lotus,TLS Fem,Malecient Parasside,13,6,8,4,2,5,"Breach,Raze,Killjoy,Viper,Omen","Raze,Killjoy,Viper,Skye,Clove"
Ascent,TOADS,Kent State University,13,8,7,2,6,6,"Sova,Killjoy,Reyna,Omen,Jett","Sova,Killjoy,Omen,Jett,KAY/O"
Bind,St. Clair Saints,Maryville University,9,13,5,7,6,4,"Raze,Viper,Brimstone,Skye,Gekko","Raze,Cypher,Viper,Brimstone,Skye"
Lotus,Deagle Ravagers,OXEN GC,5,13,2,4,9,3,"Breach,Raze,Cypher,Sova,Omen","Raze,Killjoy,Viper,Omen,Gekko"
Ascent,99 do-gooders,Shinjitsu,8,13,2,7,6,6,"Raze,Viper,Reyna,Skye,Harbor","Sova,Killjoy,Omen,Jett,KAY/O"
Bind,SaD FROST,Harmony Opal,13,8,7,2,6,6,"Viper,Brimstone,Jett,Skye,Gekko","Raze,Cypher,Viper,Skye,Clove"
Lotus,XSOUL GC,Zen eSports GC,5,13,4,8,5,1,"Raze,Omen,Skye,Chamber,Gekko","Raze,Killjoy,Viper,Skye,Astra"
Lotus,Silly Squad,Luxoria GC,13,11,5,7,4,8,"Raze,Killjoy,Viper,Omen,Fade","Raze,Killjoy,Viper,Omen,Skye"
Bind,Quantico Angels,Maze Gaming GC,5,13,2,10,3,3,"Breach,Raze,Viper,Skye,Clove","Raze,Cypher,Viper,Brimstone,Skye"
Lotus,G2 Esports,Leviatán,9,13,4,6,7,5,"Raze,Killjoy,Viper,Omen,Fade","Raze,Killjoy,Viper,Omen,Fade"
Ascent,KONVEX,Team Opulence,10,13,4,8,5,6,"Sova,Killjoy,Omen,Yoru,Gekko","Raze,Sova,Killjoy,Omen,Jett"
Ascent,Hyperion Gold,TOADS,7,13,5,7,6,2,"Sova,Killjoy,Reyna,Omen,Jett","Sova,Killjoy,Reyna,Omen,Jett"
Ascent,Status Red,Veggie Basket,10,13,3,9,4,7,"Sova,Killjoy,Omen,Jett,KAY/O","Sova,Killjoy,Omen,Jett,Skye"
Icebox,TLS Fem,Malecient Parasside,10,13,7,4,9,3,"Killjoy,Viper,Reyna,KAY/O,Gekko","Raze,Sova,Killjoy,Viper,Reyna"
Ascent,Kent State University,Theatrics,13,3,10,2,1,3,"Sova,Killjoy,Omen,Jett,KAY/O","Sova,Killjoy,Omen,Jett,KAY/O"
Lotus,Krows Corax,Dasein Club GC,7,13,2,6,7,5,"Breach,Raze,Killjoy,Viper,Clove","Breach,Raze,Sova,Killjoy,Omen"
Bind,Cafe Coke,U4RIA Magnolia,13,2,10,2,0,3,"Raze,Viper,Skye,Gekko,Clove","Raze,Cypher,Viper,Brimstone,Skye"
Ascent,Boy Kissers (NA),Team Opulence,3,13,1,3,10,2,"Sova,Killjoy,Omen,Jett,KAY/O","Sova,Killjoy,Phoenix,Omen,Jett"
Ascent,wows little pugstars,Sizzle Roses,13,2,10,2,0,3,"Sova,Killjoy,Jett,KAY/O,Clove","Raze,Sova,Killjoy,Omen,KAY/O"
Lotus,Quantico Angels,Maze Gaming GC,3,13,2,10,3,1,"Breach,Raze,Viper,Omen,Clove","Raze,Killjoy,Omen,Skye,Fade"
Split,Aspiration Gaming,99 do-gooders,11,13,7,5,8,4,"Raze,Cypher,Viper,Skye,Clove","Raze,Viper,Omen,Skye,Gekko"
Icebox,Alliance Angels,Catnappers,6,13,5,7,6,1,"Sova,Killjoy,Viper,Jett,Clove","Killjoy,Viper,KAY/O,Gekko,Deadlock"
Ascent,Deagle Ravagers,OXEN GC,13,10,7,5,5,6,"Sova,Killjoy,Omen,Jett,KAY/O","Sova,Killjoy,Omen,Jett,KAY/O"
Icebox,C4C Flare,RyZe Eclipsa GC,13,4,5,0,4,8,"Sova,Killjoy,Viper,Reyna,Harbor","Sova,Killjoy,Viper,Jett,Gekko"
Split,Shinjitsu,Hale,13,4,5,0,4,8,"Raze,Viper,Jett,Skye,Clove","Raze,Cypher,Viper,Omen,Skye"
Ascent,XSOUL GC,Zen eSports GC,4,13,4,8,5,0,"Sova,Killjoy,Omen,Jett,KAY/O","Sova,Killjoy,Omen,Jett,KAY/O"
Ascent,Silly Squad,Luxoria GC,10,13,4,8,5,6,"Sova,Killjoy,Omen,Jett,KAY/O","Sova,Killjoy,Omen,Jett,KAY/O"
Ascent,SaD FROST,Harmony Opal,11,13,8,4,9,3,"Sova,Killjoy,Omen,Jett,KAY/O","Sova,Killjoy,Omen,Jett,KAY/O"
Lotus,minions united GC,Take Back Control,13,5,5,1,4,8,"Breach,Raze,Killjoy,Omen,Gekko","Breach,Raze,Cypher,Omen,Gekko"
Bind,Infinity X,STARFIRE,14,16,7,8,8,7,"Raze,Viper,Brimstone,Skye,Gekko","Raze,Cypher,Brimstone,Jett,Skye"
Icebox,G2 Esports,Leviatán,13,8,7,2,6,6,"Sova,Killjoy,Viper,Harbor,Gekko","Sova,Killjoy,Viper,Jett,Harbor"
Icebox,Synergy GC,Loafing Cats,10,13,4,7,6,6,"Sova,Killjoy,Viper,Reyna,Jett","Sova,Killjoy,Viper,Jett,KAY/O"
Split,Awaken RED,Skyline Dreamers GC,13,7,7,5,2,6,"Breach,Raze,Cypher,Omen,Skye","Raze,Cypher,Viper,Omen,Skye"
Lotus,Minimum,Minions United,13,5,6,0,5,7,"Raze,Killjoy,Omen,Skye,Gekko","Breach,Raze,Killjoy,Astra,Fade"
Sunset,Tenax GC,YDZ Rose,13,8,9,3,5,4,"Raze,Cypher,Omen,KAY/O,Gekko","Breach,Raze,Cypher,Omen,Gekko"
Sunset,Cafe Coke,U4RIA Magnolia,13,7,7,1,6,6,"Raze,Cypher,Sova,Viper,Omen","Breach,Raze,Cypher,Omen,Fade"
Sunset,Silly Squad,Luxoria GC,13,8,5,7,1,8,"Raze,Cypher,Omen,KAY/O,Gekko","Raze,Cypher,Omen,KAY/O,Gekko"
Sunset,C4C Flare,RyZe Eclipsa GC,13,8,8,4,4,5,"Breach,Raze,Cypher,Omen,Fade","Breach,Raze,Cypher,Omen,Gekko"
Lotus,Awaken RED,Skyline Dreamers GC,13,5,10,2,3,3,"Breach,Raze,Killjoy,Omen,Skye","Raze,Killjoy,Viper,Omen,Skye"
Bind,Synergy GC,Loafing Cats,4,13,3,9,4,1,"Raze,Cypher,Viper,Brimstone,Skye","Raze,Viper,Brimstone,Reyna,Skye"
Split,Alliance Angels,Catnappers,9,13,4,6,7,5,"Raze,Cypher,Viper,Omen,Skye","Raze,Cypher,Omen,Skye,Yoru"
Lotus,Infinity X,STARFIRE,13,4,10,2,2,3,"Raze,Killjoy,Omen,KAY/O,Gekko","Breach,Raze,Sova,Killjoy,Omen"
Sunset,SaD FROST,Harmony Opal,13,10,7,4,6,6,"Raze,Cypher,Omen,KAY/O,Gekko","Breach,Raze,Cypher,Omen,Fade"
Sunset,Minimum,Minions United,13,5,5,1,4,8,"Raze,Cypher,Viper,Omen,Skye","Breach,Raze,Cypher,Omen,Gekko"
Icebox,Tenax GC,YDZ Rose,13,2,3,0,2,10,"Sova,Killjoy,Viper,Jett,Gekko","Sova,Killjoy,Viper,Astra,Gekko"
Split,minions united GC,Take Back Control,13,11,8,4,7,5,"Breach,Raze,Cypher,Skye,Astra","Breach,Raze,Cypher,Omen,Gekko"
Breeze,G2 Esports,Leviatán,6,13,2,10,3,4,"Cypher,Sova,Viper,Yoru,Harbor","Cypher,Sova,Viper,Jett,KAY/O"
Sunset,Team Vitality,Gentle Mates,5,13,2,10,3,3,"Raze,Viper,Omen,KAY/O,Gekko","Raze,Cypher,Sage,Omen,KAY/O"
Icebox,Team Vitality,Gentle Mates,5,13,4,8,5,1,"Raze,Killjoy,Viper,KAY/O,Gekko","Killjoy,Viper,Sage,KAY/O,Gekko"
Bind,Team Liquid,Team Heretics,7,13,5,7,6,2,"Raze,Viper,KAY/O,Harbor,Gekko","Sova,Viper,Omen,Skye,Yoru"
Sunset,Team Liquid,Team Heretics,2,13,0,3,10,2,"Cypher,Sova,Omen,Yoru,Gekko","Cypher,Sova,Omen,KAY/O,Neon"
Split,iPGN,BOBO,10,13,5,6,7,5,"Cypher,Omen,Jett,Skye,Yoru","Raze,Viper,Omen,Jett,Skye"
Ascent,Orangutan,MLT Esports,8,13,4,5,8,4,"Killjoy,Viper,Omen,Jett,KAY/O","Sova,Killjoy,Omen,Jett,KAY/O"
Ascent,iPGN,BOBO,13,8,6,3,5,7,"Sova,Killjoy,Omen,Jett,KAY/O","Sova,Killjoy,Omen,Jett,KAY/O"
Breeze,Orangutan,MLT Esports,12,14,7,6,8,5,"Sova,Viper,Jett,Yoru,Astra","Cypher,Sova,Viper,Jett,KAY/O"
Icebox,iPGN,BOBO,11,13,6,6,7,5,"Sova,Killjoy,Viper,Jett,Harbor","Sova,Killjoy,Viper,Jett,KAY/O"
Breeze,Carnival Gaming,Reckoning Esports,6,13,5,7,6,1,"Sova,Viper,Omen,Jett,Yoru","Cypher,Sova,Viper,Jett,Astra"
Sunset,Rub n' Pug,Justice For Tomorrow,12,14,9,4,10,3,"Raze,Cypher,Omen,Jett,Gekko","Raze,Cypher,Omen,KAY/O,Gekko"
Split,Carnival Gaming,Reckoning Esports,5,13,1,5,8,4,"Breach,Raze,Viper,Omen,Yoru","Raze,Cypher,Sage,Omen,Skye"
Lotus,Rub n' Pug,Justice For Tomorrow,11,13,4,8,5,7,"Breach,Raze,Omen,Jett,Chamber","Raze,Killjoy,Viper,Omen,Fade"
Bind,Rub n' Pug,Justice For Tomorrow,13,5,8,4,1,5,"Raze,Jett,Astra,KAY/O,Gekko","Raze,Viper,Brimstone,KAY/O,Gekko"
Ascent,Fisher Falcons,Fisher College Navy,13,7,6,6,1,7,"Sova,Killjoy,Omen,Jett,KAY/O","Sova,Killjoy,Omen,Jett,KAY/O"
Sunset,Muskingum University,Ohio Northern University JV,11,13,5,7,6,6,"Raze,Cypher,Omen,Fade,Gekko","Breach,Raze,Cypher,Sova,Omen"
Bind,Fisher Falcons,Fisher College Navy,10,13,9,3,10,1,"Breach,Viper,Phoenix,Brimstone,KAY/O","Raze,Viper,Brimstone,Skye,Gekko"
Icebox,Potomac State College,Randolph-Macon College,4,13,1,4,9,3,"Killjoy,Viper,Jett,Harbor,Gekko","Sova,Killjoy,Viper,Sage,Jett"
Icebox,Legión Mapaches Rabiosas,Ragnus Esports,5,13,2,4,9,3,"Viper,Jett,Chamber,Fade,Gekko","Viper,Jett,Skye,Harbor,Gekko"
Ascent,Azzy White,Kunai Esports FEM,5,13,2,4,9,3,"Sova,Killjoy,Omen,Jett,KAY/O","Sova,Killjoy,Omen,Jett,KAY/O"
Icebox,Muskingum University,Ohio Northern University JV,10,13,8,3,10,2,"Sova,Killjoy,Viper,Reyna,Gekko","Raze,Killjoy,Viper,Harbor,Gekko"
Lotus,Bon Bon Bum Contra GC,Legiowon Puff,13,5,5,1,4,8,"Breach,Raze,Killjoy,Omen,Gekko","Breach,Raze,Omen,Chamber,Gekko"
Split,Fisher Falcons,Fisher College Navy,13,11,5,7,4,8,"Raze,Cypher,Viper,Omen,Skye","Raze,Viper,Omen,Jett,Skye"
Ascent,Legión Mapaches Rabiosas,Ragnus Esports,3,13,1,3,10,2,"Sova,Killjoy,Omen,Jett,Skye","Breach,Raze,Sova,Killjoy,Omen"
Breeze,Castle Esports X,New Combat Line GC,2,13,0,3,10,2,"Cypher,Viper,Astra,Neon,Gekko","Cypher,Sova,Viper,Jett,KAY/O"
Sunset,Potomac State College,Randolph-Macon College,13,15,7,7,8,6,"Raze,Cypher,Omen,Harbor,Gekko","Raze,Cypher,Sova,Omen,Gekko"
Ascent,OK Gaming,Infiriumz Gaming GC,13,3,9,3,0,4,"Sova,Killjoy,Omen,Jett,KAY/O","Sova,Killjoy,Omen,Jett,KAY/O"
Breeze,NRG Esports,MIBR,13,3,4,0,3,9,"Cypher,Sova,Viper,Jett,Yoru","Cypher,Sova,Viper,Jett,KAY/O"
Breeze,Five Stack GC,Polar Squad Esports GC,13,7,5,3,4,8,"Cypher,Sova,Viper,Jett,KAY/O","Cypher,Sova,Viper,Jett,KAY/O"
Lotus,Take Back Control,LazerrFreeks Ivy,13,3,9,3,0,4,"Breach,Raze,Cypher,Omen,Gekko","Raze,Killjoy,Omen,Fade,Gekko"
Bind,Infinity X,Prospects Amethyst,7,13,5,7,6,2,"Raze,Viper,Brimstone,Skye,Gekko","Raze,Viper,Brimstone,Skye,Gekko"
Ascent,Muskingum University,Ohio Northern University JV,13,11,5,7,4,8,"Breach,Viper,Phoenix,Omen,KAY/O","Sova,Killjoy,Omen,Jett,KAY/O"
Icebox,Bon Bon Bum Contra GC,Legiowon Puff,13,9,4,6,3,9,"Killjoy,Viper,Jett,Gekko,Clove","Killjoy,Viper,Omen,KAY/O,Gekko"
Split,Azzy White,Kunai Esports FEM,10,13,3,9,4,7,"Breach,Cypher,Phoenix,Omen,Jett","Breach,Raze,Killjoy,Viper,Omen"
Breeze,Legión Mapaches Rabiosas,Ragnus Esports,13,7,4,4,3,9,"Cypher,Sova,Viper,Jett,Chamber","Cypher,Viper,Skye,Yoru,KAY/O"
Icebox,Teddy Tactics,Tenax GC,13,6,7,5,1,6,"Sova,Killjoy,Viper,Sage,Jett","Sova,Killjoy,Viper,Jett,Yoru"
Bind,Castle Esports X,New Combat Line GC,0,13,0,12,1,0,"Raze,Viper,Skye,Chamber,Clove","Raze,Cypher,Brimstone,Skye,Clove"
Lotus,minions united GC,Bumble Bees,7,13,3,5,8,4,"Breach,Raze,Killjoy,Omen,Gekko","Raze,Killjoy,Viper,Omen,Fade"
Bind,Potomac State College,Randolph-Macon College,5,13,4,8,5,1,"Raze,Viper,Brimstone,Skye,Deadlock","Raze,Viper,Brimstone,Skye,Gekko"
Lotus,OK Gaming,Infiriumz Gaming GC,13,5,9,3,2,4,"Raze,Killjoy,Viper,Omen,Fade","Breach,Raze,Killjoy,Omen,Jett"
Icebox,fish with no eye,YDZ Rose,11,13,8,4,9,3,"Killjoy,Viper,Jett,KAY/O,Gekko","Sova,Killjoy,Viper,Astra,Gekko"
Split,University of Virginia,Fisher College Tea Party,10,13,7,5,8,3,"Raze,Omen,Yoru,Astra,Fade","Raze,Cypher,Viper,Omen,Skye"
Ascent,FlyQuest RED,Minimum,13,2,3,0,2,10,"Sova,Killjoy,Omen,Jett,KAY/O","Sova,Killjoy,Viper,Brimstone,Yoru"
Sunset,Elysium GC,RyZe Eclipsa GC,3,13,1,3,10,2,"Raze,Cypher,Yoru,Fade,Clove","Breach,Raze,Cypher,Gekko,Clove"
Breeze,C4C Flare,Kirbee Squad,13,15,6,8,7,7,"Cypher,Sova,Viper,Jett,KAY/O","Cypher,Sova,Viper,Jett,Clove"
Split,NRG Esports,MIBR,13,9,7,5,4,6,"Raze,Viper,Omen,Jett,Skye","Raze,Viper,Jett,Skye,Astra"
Icebox,Stone Esports,Rebirth Esports,1,13,0,2,11,1,"Sova,Killjoy,Viper,Reyna,Jett","Viper,Reyna,Omen,Jett,Gekko"
Icebox,friends GC,Reformed GC,7,13,2,6,7,5,"Killjoy,Viper,Jett,KAY/O,Gekko","Killjoy,Viper,Sage,Jett,Gekko"
Lotus,Muskingum University,Ohio Northern University JV,9,13,6,4,9,3,"Raze,Cypher,Viper,Omen,Fade","Breach,Raze,Killjoy,Omen,Gekko"
Ascent,University of Virginia,Fisher College Tea Party,4,13,1,4,9,3,"Raze,Cypher,Phoenix,Omen,Fade","Sova,Killjoy,Omen,Jett,KAY/O"
Bind,minions united GC,Bumble Bees,8,13,5,4,9,3,"Raze,Cypher,Viper,Brimstone,Skye","Raze,Viper,Brimstone,Skye,Yoru"
Lotus,Kinetic GC,SaD FROST,13,6,10,2,4,3,"Raze,Killjoy,Viper,Omen,Fade","Raze,Killjoy,Viper,Omen,Gekko"
Sunset,fish with no eye,YDZ Rose,6,13,3,4,9,3,"Breach,Raze,Cypher,Omen,Fade","Breach,Raze,Cypher,Omen,Gekko"
Ascent,XSOUL GC,Bellakitas,14,12,5,8,4,9,"Sova,Killjoy,Omen,Jett,KAY/O","Raze,Cypher,Reyna,Omen,Gekko"
Lotus,CSP Val Blue,Maryville University,12,14,5,8,6,7,"Raze,Killjoy,Viper,Omen,Fade","Raze,Killjoy,Viper,Omen,Fade"
Lotus,Potomac State College,Randolph-Macon College,13,11,6,6,5,7,"Raze,Cypher,Omen,Harbor,Gekko","Raze,Viper,Omen,Chamber,Fade"
Lotus,Teddy Tactics,Tenax GC,14,12,8,5,7,6,"Killjoy,Viper,Omen,Neon,Gekko","Breach,Raze,Cypher,Omen,Gekko"
Lotus,FlyQuest RED,Minimum,13,1,11,1,0,2,"Raze,Killjoy,Viper,Omen,Skye","Raze,Killjoy,Omen,Skye,Gekko"
Ascent,mesos millionaires,Alliance Angels,13,6,8,4,2,5,"Sova,Killjoy,Jett,Astra,KAY/O","Sova,Killjoy,Omen,Jett,KAY/O"
Breeze,Take Back Control,LazerrFreeks Ivy,16,14,6,9,5,10,"Cypher,Sova,Viper,Jett,Yoru","Cypher,Sova,Viper,Jett,KAY/O"
Sunset,Catnappers,SRVR x PERLAS,13,6,4,3,3,9,"Viper,Sage,Omen,KAY/O,Gekko","Cypher,Sage,Reyna,Omen,Fade"
Breeze,floppers,Cafe Coke,13,3,4,0,3,9,"Cypher,Sova,Viper,Yoru,Astra","Cypher,Sova,Viper,Jett,Yoru"
Icebox,Infinity X,Prospects Amethyst,19,17,13,5,12,6,"Sova,Killjoy,Viper,Jett,Gekko","Sova,Killjoy,Viper,Omen,Gekko"
Bind,Solstice GC,Synergy GC,13,4,10,2,2,3,"Raze,Cypher,Viper,Brimstone,Skye","Raze,Cypher,Viper,Brimstone,Skye"
Lotus,Shopify Rebellion,Silly Squad,13,1,2,0,1,11,"Raze,Killjoy,Viper,Omen,Fade","Raze,Killjoy,Viper,Omen,Fade"
Lotus,C4C Flare,Kirbee Squad,12,14,4,9,5,8,"Breach,Raze,Killjoy,Omen,Fade","Raze,Killjoy,Fade,Gekko,Clove"
Sunset,Thrive Vixens,U4RIA Magnolia,8,13,2,7,6,6,"Breach,Raze,Cypher,Omen,Fade","Breach,Raze,Cypher,Omen,Fade"
Lotus,Elysium GC,RyZe Eclipsa GC,4,13,2,3,10,2,"Breach,Raze,Killjoy,Omen,Gekko","Raze,Killjoy,Viper,Omen,Skye"
Lotus,Labyrinth White,STARFIRE,2,13,2,10,3,0,"Raze,Killjoy,Viper,Omen,Fade","Breach,Raze,Sova,Killjoy,Omen"
Lotus,friends GC,Reformed GC,10,13,6,6,7,4,"Raze,Cypher,Omen,KAY/O,Gekko","Raze,Killjoy,Viper,Omen,Gekko"
Ascent,Supernova x Pals,Awaken RED,13,4,4,1,3,9,"Sova,Killjoy,Omen,Jett,KAY/O","Sova,Killjoy,Omen,Jett,KAY/O"
Bind,Stone Esports,Rebirth Esports,13,10,7,5,5,6,"Raze,Viper,Sage,Skye,Astra","Breach,Raze,Cypher,Omen,KAY/O"
Ascent,OXEN GC,Malecient Parasside,13,10,7,5,5,6,"Sova,Killjoy,Omen,Jett,KAY/O","Breach,Raze,Sova,Killjoy,Clove"
Sunset,Sentinels,Evil Geniuses,10,13,6,6,7,4,"Raze,Cypher,Omen,KAY/O,Gekko","Breach,Raze,Cypher,Omen,Fade"
Bind,Kinetic GC,SaD FROST,13,9,4,6,3,9,"Raze,Viper,Brimstone,Skye,Chamber","Viper,Omen,Jett,Skye,Gekko"
Icebox,University of Virginia,Fisher College Tea Party,13,11,10,2,9,3,"Raze,Sova,Killjoy,Viper,Sage","Sova,Killjoy,Viper,Sage,Jett"
Ascent,Shopify Rebellion,Silly Squad,13,1,2,0,1,11,"Sova,Killjoy,Omen,Jett,KAY/O","Sova,Killjoy,Omen,Jett,KAY/O"
Split,Zen eSports GC,Dasein Club GC,13,9,5,7,2,8,"Raze,Cypher,Jett,Skye,Astra","Raze,Cypher,Viper,Omen,Skye"
Breeze,Bumble Bees,LazerrFreeks Ivy,13,4,11,1,3,2,"Sova,Viper,Jett,Yoru,Astra","Cypher,Sova,Viper,Jett,KAY/O"
Bind,CSP Val Blue,Maryville University,9,13,6,6,7,3,"Breach,Raze,Viper,Brimstone,Skye","Raze,Cypher,Viper,Brimstone,Skye"
Bind,Minimum,Minions United,13,5,10,2,3,3,"Raze,Viper,Brimstone,Skye,Gekko","Raze,Viper,Brimstone,Skye,Gekko"
Bind,Tenax GC,YDZ Rose,13,9,5,7,2,8,"Raze,Viper,Brimstone,Skye,Yoru","Raze,Cypher,Viper,Brimstone,Skye"
Icebox,mesos millionaires,Alliance Angels,13,11,7,5,6,6,"Sova,Killjoy,Viper,Jett,Gekko","Sova,Killjoy,Viper,Jett,Clove"
Icebox,XSOUL GC,Bellakitas,14,12,6,7,5,8,"Killjoy,Viper,Jett,Harbor,Gekko","Killjoy,Viper,Reyna,Jett,Gekko"
Breeze,Solstice GC,Synergy GC,13,4,5,0,4,8,"Cypher,Sova,Viper,Yoru,Clove","Cypher,Sova,Viper,Jett,Astra"
Bind,Deagle Ravagers,Maze Gaming GC,13,6,4,3,3,9,"Breach,Raze,Cypher,Brimstone,Skye","Raze,Cypher,Viper,Brimstone,Skye"
Lotus,Thrive Vixens,U4RIA Magnolia,0,13,0,1,12,0,"Raze,Killjoy,Viper,Omen,Fade","Raze,Killjoy,Viper,Omen,Fade"
Icebox,Supernova x Pals,Awaken RED,13,4,4,1,3,9,"Killjoy,Viper,Yoru,KAY/O,Gekko","Sova,Killjoy,Viper,Jett,KAY/O"
Split,floppers,Cafe Coke,13,5,4,2,3,9,"Breach,Raze,Cypher,Omen,Skye","Breach,Raze,Cypher,Omen,Skye"
Sunset,Labyrinth White,STARFIRE,5,13,1,5,8,4,"Breach,Cypher,Sova,Omen,Yoru","Breach,Raze,Cypher,Omen,Gekko"
Lotus,Infinity X,Prospects Amethyst,9,13,3,9,4,6,"Raze,Killjoy,Omen,KAY/O,Gekko","Breach,Raze,Viper,Omen,Gekko"
Sunset,friends GC,Reformed GC,13,6,3,4,2,10,"Raze,Cypher,Omen,KAY/O,Gekko","Breach,Raze,Cypher,KAY/O,Harbor"
Ascent,minions united GC,Take Back Control,13,8,11,1,7,2,"Sova,Killjoy,Omen,Jett,KAY/O","Sova,Killjoy,Omen,Jett,KAY/O"
Lotus,RyZe Eclipsa GC,Kirbee Squad,8,13,6,3,10,2,"Raze,Killjoy,Viper,Omen,Skye","Raze,Killjoy,Fade,Gekko,Clove"
Sunset,OXEN GC,Malecient Parasside,13,3,4,0,3,9,"Raze,Cypher,Viper,Omen,Gekko","Breach,Raze,Cypher,Omen,Fade"
Bind,Sentinels,Evil Geniuses,11,13,10,2,11,1,"Raze,Viper,Brimstone,Skye,Gekko","Raze,Viper,Brimstone,Skye,Gekko"
Lotus,Tenax GC,YDZ Rose,13,7,5,3,4,8,"Breach,Raze,Cypher,Omen,Gekko","Raze,Killjoy,Viper,Omen,Skye"
Ascent,Zen eSports GC,Dasein Club GC,13,8,7,2,6,6,"Sova,Killjoy,Omen,Jett,KAY/O","Sova,Killjoy,Omen,Jett,KAY/O"
Bind,Bumble Bees,LazerrFreeks Ivy,13,7,5,3,4,8,"Raze,Viper,Brimstone,Skye,Yoru","Raze,Viper,Astra,Fade,Gekko"
Sunset,XSOUL GC,Bellakitas,10,13,7,5,8,3,"Breach,Raze,Cypher,Omen,Gekko","Breach,Raze,Cypher,Omen,Fade"
Split,ONA Family,Red Eye,4,13,0,5,8,4,"Breach,Raze,Viper,Omen,Skye","Raze,Cypher,Viper,Omen,Skye"
Sunset,Deagle Ravagers,Maze Gaming GC,13,6,9,3,3,4,"Breach,Raze,Cypher,Omen,Fade","Breach,Raze,Cypher,Omen,Gekko"
Icebox,Alliance Angels,SRVR x PERLAS,13,4,3,2,2,10,"Sova,Killjoy,Viper,Jett,Clove","Sova,Killjoy,Viper,Reyna,Jett"
Lotus,Loafing Cats,Synergy GC,6,13,0,7,6,6,"Breach,Raze,Cypher,Omen,Gekko","Raze,Killjoy,Omen,Skye,Gekko"
Ascent,Silly Squad,Luxoria GC,13,3,3,1,2,10,"Sova,Killjoy,Omen,Jett,KAY/O","Sova,Killjoy,Omen,Jett,KAY/O"
Sunset,SaD FROST,Harmony Opal,13,11,9,3,8,4,"Raze,Cypher,Omen,KAY/O,Gekko","Breach,Raze,Cypher,Omen,Fade"
Icebox,Cafe Coke,U4RIA Magnolia,13,6,7,0,6,6,"Sova,Killjoy,Viper,Sage,Jett","Sova,Killjoy,Viper,Reyna,Omen"
Bind,mesos millionaires,Catnappers,13,7,8,4,3,5,"Raze,Viper,Skye,Chamber,Clove","Raze,Viper,Brimstone,Skye,Gekko"
Breeze,C4C Flare,Elysium GC,13,1,2,0,1,11,"Cypher,Sova,Viper,Jett,KAY/O","Cypher,Sova,Viper,Jett,KAY/O"
Ascent,Awaken RED,Skyline Dreamers GC,13,11,8,4,7,5,"Sova,Killjoy,Omen,Jett,KAY/O","Sova,Killjoy,Omen,Jett,KAY/O"
Bind,Infinity X,Labyrinth White,13,3,3,1,2,10,"Raze,Viper,Brimstone,Skye,Gekko","Raze,Cypher,Viper,Brimstone,Skye"
Lotus,minions united GC,Take Back Control,13,11,6,6,5,7,"Breach,Raze,Killjoy,Omen,Gekko","Breach,Raze,Cypher,Omen,Gekko"
Bind,Prospects Amethyst,STARFIRE,13,10,5,7,3,8,"Raze,Viper,Brimstone,Skye,Gekko","Raze,Cypher,Brimstone,Skye,Gekko"
Sunset,Reformed GC,Endear Moon,13,7,5,3,4,8,"Breach,Raze,Cypher,KAY/O,Harbor","Raze,Cypher,Omen,KAY/O,Gekko"
Sunset,RyZe Eclipsa GC,Kirbee Squad,13,9,8,4,5,5,"Breach,Raze,Cypher,Gekko,Clove","Raze,Cypher,Jett,Gekko,Clove"
Icebox,Teddy Tactics,fish with no eye,13,3,4,0,3,9,"Sova,Killjoy,Viper,Sage,Jett","Sova,Killjoy,Viper,Reyna,Jett"
Ascent,floppers,Thrive Vixens,13,3,9,3,0,4,"Sova,Viper,Sage,Yoru,Astra","Sova,Killjoy,Omen,Jett,KAY/O"
Split,Awaken RED,Skyline Dreamers GC,13,1,11,1,0,2,"Breach,Raze,Cypher,Omen,Skye","Raze,Viper,Omen,Jett,Skye"
Breeze,ONA Family,Red Eye,7,13,2,6,7,5,"Cypher,Sova,Viper,Jett,KAY/O","Cypher,Sova,Viper,Reyna,Jett"
Lotus,Minimum,Minions United,13,11,10,2,9,3,"Raze,Killjoy,Omen,Skye,Gekko","Raze,Killjoy,Viper,Omen,Skye"
Lotus,Alliance Angels,SRVR x PERLAS,13,7,11,1,6,2,"Raze,Viper,Omen,Skye,Chamber","Raze,Viper,Omen,Chamber,Fade"
Split,Reformed GC,Endear Moon,13,1,2,0,1,11,"Raze,Viper,Omen,Jett,Skye","Raze,Cypher,Viper,Omen,Skye"
Sunset,Cafe Coke,U4RIA Magnolia,13,3,2,2,1,11,"Raze,Cypher,Sova,Viper,Omen","Breach,Raze,Cypher,Omen,Fade"
Sunset,mesos millionaires,Catnappers,13,2,3,0,2,10,"Raze,Cypher,Sova,Gekko,Clove","Viper,Sage,Omen,KAY/O,Gekko"
Icebox,Tenax GC,YDZ Rose,11,13,6,6,7,5,"Sova,Killjoy,Viper,Jett,Yoru","Sova,Killjoy,Viper,Astra,Gekko"
Sunset,Silly Squad,Luxoria GC,13,8,7,2,6,6,"Raze,Cypher,Omen,KAY/O,Gekko","Raze,Cypher,Viper,Omen,Gekko"
Icebox,Infinity X,Labyrinth White,13,2,11,1,1,2,"Sova,Killjoy,Viper,Jett,Gekko","Sova,Killjoy,Viper,Jett,Harbor"
Sunset,C4C Flare,Elysium GC,13,6,9,3,3,4,"Breach,Raze,Cypher,Omen,Fade","Raze,Cypher,Omen,Fade,Gekko"
Ascent,SaD FROST,Harmony Opal,13,7,4,4,3,9,"Sova,Killjoy,Omen,Jett,KAY/O","Sova,Killjoy,Omen,Jett,KAY/O"
Bind,RyZe Eclipsa GC,Kirbee Squad,2,13,1,2,11,1,"Breach,Raze,Viper,Brimstone,Fade","Raze,Cypher,Viper,Skye,Clove"
Lotus,Prospects Amethyst,STARFIRE,13,6,9,3,3,4,"Breach,Raze,Viper,Omen,Gekko","Breach,Raze,Sova,Killjoy,Omen"
Breeze,Loafing Cats,Synergy GC,7,13,4,4,9,3,"Cypher,Sova,Viper,Jett,KAY/O","Cypher,Sova,Viper,Jett,Astra"
Lotus,Bumble Bees,LazerrFreeks Ivy,10,13,5,7,6,5,"Raze,Killjoy,Viper,Omen,Fade","Raze,Killjoy,Omen,Fade,Gekko"
Lotus,floppers,Thrive Vixens,13,1,11,1,0,2,"Raze,Cypher,Omen,KAY/O,Gekko","Raze,Killjoy,Viper,Omen,Fade"
Sunset,Teddy Tactics,fish with no eye,13,2,3,0,2,10,"Raze,Cypher,Omen,KAY/O,Gekko","Breach,Raze,Cypher,Omen,Fade"
Split,minions united GC,Take Back Control,7,13,4,4,9,3,"Breach,Raze,Cypher,Skye,Astra","Breach,Raze,Cypher,Omen,Gekko"
Lotus,Sentinels,Evil Geniuses,13,10,10,1,9,3,"Raze,Killjoy,Viper,Omen,Fade","Raze,Cypher,Viper,Omen,Fade"
Lotus,OOT Esports,BLINDOHOLIK,10,13,6,5,8,4,"Raze,Cypher,Viper,Omen,Fade","Breach,Raze,Cypher,Reyna,Omen"
Split,OOT Esports,BLINDOHOLIK,15,13,9,5,8,6,"Raze,Cypher,Omen,Jett,Skye","Raze,Cypher,Viper,Omen,Iso"
Bind,OOT Esports,BLINDOHOLIK,4,13,4,8,5,0,"Raze,Viper,Brimstone,Skye,Yoru","Raze,Brimstone,Reyna,Skye,Chamber"
Icebox,Global Esports,Paper Rex,7,13,2,6,7,5,"Killjoy,Viper,Sage,Jett,Gekko","Killjoy,Viper,Sage,Jett,KAY/O"
Sunset,Global Esports,Paper Rex,4,13,2,3,10,2,"Killjoy,Sage,Omen,KAY/O,Gekko","Breach,Raze,Sage,Omen,Gekko"
Sunset,Team Secret,DetonatioN FocusMe,13,2,1,2,0,12,"Breach,Raze,Cypher,Sova,Omen","Raze,Cypher,Viper,Omen,Gekko"
Breeze,Team Secret,DetonatioN FocusMe,9,13,1,9,4,8,"Cypher,Sova,Viper,Jett,KAY/O","Cypher,Sova,Viper,Omen,Yoru"
Lotus,Team Secret,DetonatioN FocusMe,13,4,10,2,2,3,"Raze,Killjoy,Viper,Omen,Fade","Raze,Killjoy,Viper,Omen,Fade"
Split,University of Oklahoma,UT Austin,7,13,2,6,7,5,"Raze,Cypher,Viper,Omen,Skye","Raze,Cypher,Viper,Omen,Skye"
Ascent,Kunai Esports FEM,Genbu Gaming GC,13,3,2,2,1,11,"Sova,Killjoy,Omen,Jett,KAY/O","Raze,Killjoy,Jett,Skye,Astra"
Ascent,Northwood University,Ball State,13,10,6,6,4,7,"Sova,Killjoy,Omen,Jett,KAY/O","Sova,Killjoy,Omen,Jett,KAY/O"
Breeze,Polar Squad Esports GC,Infiriumz Gaming GC,11,13,5,7,6,6,"Cypher,Sova,Viper,Jett,KAY/O","Cypher,Sova,Viper,Jett,Yoru"
Breeze,University of Oklahoma,UT Austin,9,13,6,4,9,3,"Cypher,Sova,Viper,Omen,Yoru","Cypher,Sova,Viper,Jett,KAY/O"
Icebox,Legión Mapaches Rabiosas,Castle Esports X,14,12,7,6,6,7,"Sova,Viper,Jett,Chamber,Gekko","Killjoy,Viper,Sage,Harbor,Gekko"
Lotus,New Combat Line GC,Ragnus Esports,7,13,5,7,6,2,"Breach,Raze,Killjoy,Viper,Omen","Breach,Raze,Killjoy,Omen,Iso"
Bind,MBU Spartans,Indiana Hoosiers,5,13,1,5,8,4,"Raze,Viper,Brimstone,Skye,Gekko","Raze,Viper,Brimstone,Skye,Yoru"
Icebox,Kunai Esports FEM,Genbu Gaming GC,13,9,6,6,3,7,"Sova,Killjoy,Viper,Jett,Gekko","Sova,Viper,Sage,Reyna,Jett"
Lotus,Northwood University,Ball State,13,10,7,5,5,6,"Raze,Sova,Killjoy,Viper,Omen","Raze,Killjoy,Viper,Omen,Skye"
Lotus,Five Stack GC,OK Gaming,9,13,6,4,9,3,"Breach,Raze,Killjoy,Viper,Omen","Raze,Killjoy,Viper,Omen,Fade"
Lotus,Polar Squad Esports GC,Infiriumz Gaming GC,10,13,7,5,8,3,"Raze,Killjoy,Omen,Skye,Gekko","Breach,Raze,Killjoy,Omen,Jett"
Ascent,University of Oklahoma,UT Austin,13,6,6,1,5,7,"Sova,Killjoy,Omen,Jett,KAY/O","Sova,Killjoy,Omen,Jett,KAY/O"
Ascent,Legión Mapaches Rabiosas,Castle Esports X,13,8,7,5,3,6,"Sova,Killjoy,Omen,Jett,Skye","Sova,Killjoy,Omen,Jett,KAY/O"
Breeze,MBU Spartans,Indiana Hoosiers,14,16,6,9,7,8,"Cypher,Sova,Viper,Jett,KAY/O","Cypher,Sova,Viper,Jett,KAY/O"
Ascent,St. Clair Saints,Mizzou Esports,13,7,7,5,2,6,"Sova,Killjoy,Omen,Jett,KAY/O","Breach,Killjoy,Reyna,Omen,Jett"
Sunset,University of Oklahoma,UT Austin,10,13,8,4,9,2,"Raze,Cypher,Omen,KAY/O,Gekko","Breach,Raze,Cypher,Sova,Omen"
Ascent,Five Stack GC,OK Gaming,6,13,3,4,9,3,"Sova,Killjoy,Omen,Jett,KAY/O","Sova,Killjoy,Omen,Jett,KAY/O"
Icebox,Northwood University,Ball State,12,14,6,7,7,6,"Sova,Killjoy,Viper,Jett,KAY/O","Killjoy,Viper,Sage,Jett,Gekko"
Ascent,New Combat Line GC,Ragnus Esports,12,14,5,8,6,7,"Sova,Killjoy,Omen,Jett,KAY/O","Breach,Raze,Sova,Killjoy,Omen"
Split,Kunai Esports FEM,Genbu Gaming GC,8,13,4,5,8,4,"Breach,Raze,Killjoy,Viper,Omen","Raze,Killjoy,Viper,Skye,Astra"
Bind,Polar Squad Esports GC,Infiriumz Gaming GC,13,9,8,4,5,5,"Breach,Raze,Viper,Brimstone,Gekko","Raze,Cypher,Viper,Brimstone,Skye"
Sunset,St. Clair Saints,Mizzou Esports,13,5,10,2,3,3,"Breach,Raze,Cypher,Omen,Fade","Breach,Raze,Sova,Reyna,Omen"
Lotus,University of Oklahoma,UT Austin,13,9,8,2,7,5,"Raze,Killjoy,Viper,Omen,Fade","Raze,Killjoy,Viper,Omen,Fade"
Ascent,MBU Spartans,Indiana Hoosiers,15,13,5,9,4,10,"Sova,Killjoy,Brimstone,Sage,KAY/O","Sova,Killjoy,Omen,Jett,KAY/O"
Split,St. Clair Saints,Mizzou Esports,5,13,0,6,7,5,"Raze,Cypher,Viper,Omen,Skye","Breach,Raze,Reyna,Omen,Jett"
Ascent,Cloud9,100 Thieves,6,13,1,11,2,5,"Cypher,Sova,Omen,Jett,KAY/O","Sova,Killjoy,Omen,Jett,KAY/O"
Bind,Krows Corax,Maze Gaming GC,13,15,9,5,10,4,"Breach,Raze,Viper,Brimstone,Skye","Raze,Cypher,Viper,Brimstone,Skye"
Bind,Dasein Club GC,Quantico Angels,13,6,8,4,2,5,"Breach,Raze,Cypher,Sova,Brimstone","Breach,Raze,Viper,Skye,Clove"
Bind,Cloud9,100 Thieves,7,13,4,8,5,3,"Raze,Cypher,Viper,Brimstone,Skye","Raze,Viper,Brimstone,Fade,Gekko"
Lotus,Bellakitas,TLS Fem,13,8,6,3,5,7,"Breach,Raze,Cypher,Omen,Gekko","Raze,Killjoy,Viper,Omen,Skye"
Breeze,Krows Corax,Maze Gaming GC,11,13,8,4,9,3,"Sova,Viper,Jett,KAY/O,Chamber","Cypher,Sova,Viper,Jett,KAY/O"
Lotus,Dasein Club GC,Quantico Angels,13,5,7,5,0,6,"Breach,Raze,Sova,Killjoy,Omen","Breach,Raze,Viper,Omen,Clove"
Icebox,Bellakitas,TLS Fem,13,1,2,0,1,11,"Killjoy,Viper,Reyna,Jett,Gekko","Sova,Killjoy,Viper,Jett,KAY/O"
Icebox,G2 Esports,FURIA,13,3,4,0,3,9,"Sova,Killjoy,Viper,Harbor,Gekko","Killjoy,Viper,Omen,KAY/O,Gekko"
Lotus,G2 Esports,FURIA,13,3,9,3,0,4,"Raze,Killjoy,Viper,Omen,Fade","Raze,Killjoy,Viper,Omen,Fade"
Split,NEANLATIYONBOLM,OOT Esports,13,6,4,3,3,9,"Breach,Raze,Cypher,Omen,Skye","Raze,Cypher,Omen,Jett,Skye"
Lotus,NEANLATIYONBOLM,OOT Esports,13,9,7,3,6,6,"Breach,Raze,Killjoy,Omen,Gekko","Raze,Killjoy,Viper,Omen,Fade"
Sunset,Apeks,SweetNsour,13,5,9,3,2,4,"Viper,Sage,Omen,KAY/O,Gekko","Raze,Cypher,Omen,KAY/O,Gekko"
Lotus,Apeks,SweetNsour,13,6,7,5,1,6,"Raze,Killjoy,Viper,Omen,Fade","Raze,Killjoy,Viper,Omen,Fade"
Icebox,Apeks,SweetNsour,13,4,5,0,4,8,"Sova,Killjoy,Viper,Yoru,Harbor","Sova,Killjoy,Viper,Jett,Harbor"
Ascent,Gen.G Esports,ZETA DIVISION,14,12,8,5,7,6,"Sova,Killjoy,Omen,Jett,KAY/O","Sova,Killjoy,Omen,Jett,KAY/O"
Split,Gen.G Esports,ZETA DIVISION,13,8,6,3,5,7,"Raze,Viper,Omen,Jett,Skye","Breach,Viper,Yoru,Astra,Chamber"
Bind,T1,Talon Esports,10,13,5,7,6,5,"Raze,Viper,Skye,Harbor,Gekko","Raze,Viper,Skye,Harbor,Gekko"
Lotus,T1,Talon Esports,11,13,6,6,7,5,"Raze,Viper,Omen,Chamber,Fade","Viper,Omen,Chamber,Neon,Gekko"
Breeze,SaD Purple,Tootsie Pop's,3,13,0,4,9,3,"Cypher,Sova,Viper,Jett,Yoru","Cypher,Sova,Viper,Jett,KAY/O"
Ascent,SaD Purple,Tootsie Pop's,12,14,4,9,5,8,"Sova,Killjoy,Omen,Jett,KAY/O","Sova,Killjoy,Omen,Jett,KAY/O"
Bind,NRG Esports,Leviatán,4,13,1,11,2,3,"Raze,Viper,Brimstone,KAY/O,Gekko","Raze,Viper,Brimstone,Skye,Gekko"
Icebox,SFU Pink,CSULB Black,13,6,3,4,2,10,"Sova,Killjoy,Viper,Omen,Jett","Sova,Killjoy,Viper,Jett,Harbor"
Lotus,ONA Family,OXEN,13,10,8,3,7,5,"Raze,Killjoy,Viper,Omen,Fade","Breach,Sova,Killjoy,Omen,Neon"
Bind,ASU Maroon,CSULB Gold,6,13,5,7,6,1,"Raze,Viper,Skye,Harbor,Gekko","Raze,Cypher,Brimstone,Skye,Yoru"
Breeze,Organization 13,SaD Purple,9,13,6,4,9,3,"Cypher,Sova,Viper,Jett,Yoru","Cypher,Sova,Viper,Reyna,Yoru"
Sunset,NRG Esports,Leviatán,4,13,2,10,3,2,"Raze,Cypher,Omen,KAY/O,Gekko","Breach,Raze,Cypher,Omen,Gekko"
Lotus,CSUF Orange,UC Irvine,5,13,2,4,9,3,"Breach,Raze,Killjoy,Omen,Fade","Breach,Killjoy,Yoru,Astra,Gekko"
Lotus,SFU Pink,CSULB Black,5,13,3,3,10,2,"Raze,Killjoy,Viper,Omen,Fade","Raze,Killjoy,Viper,Omen,Fade"
Ascent,ASU Maroon,CSULB Gold,13,5,9,3,2,4,"Sova,Killjoy,Omen,Jett,KAY/O","Sova,Killjoy,Omen,Jett,KAY/O"
Icebox,ONA Family,OXEN,5,13,3,9,4,2,"Sova,Killjoy,Viper,Reyna,Harbor","Sova,Killjoy,Viper,Sage,Jett"
Lotus,RIT Orange,TMU Blue,10,13,5,6,7,5,"Raze,Killjoy,Omen,Fade,Gekko","Breach,Raze,Killjoy,Omen,Gekko"
Icebox,Tootsie Pop's,RyZe Esports,13,11,7,5,6,6,"Sova,Killjoy,Viper,Jett,KAY/O","Killjoy,Viper,Jett,KAY/O,Gekko"
Icebox,ASU Maroon,CSULB Gold,2,13,0,3,10,2,"Sova,Killjoy,Viper,Reyna,Jett","Sova,Killjoy,Viper,Sage,Jett"
Sunset,CSUF Orange,UC Irvine,6,13,1,6,7,5,"Raze,Cypher,Reyna,Omen,Fade","Raze,Cypher,Omen,KAY/O,Gekko"
Ascent,Organization 13,SaD Purple,13,15,6,8,7,7,"Sova,Killjoy,Omen,Jett,KAY/O","Sova,Killjoy,Omen,Jett,KAY/O"
Breeze,SFU Pink,CSULB Black,13,8,5,4,4,8,"Cypher,Sova,Viper,Jett,KAY/O","Cypher,Sova,Viper,Jett,Yoru"
Breeze,ONA Family,OXEN,13,4,4,1,3,9,"Cypher,Sova,Viper,Jett,KAY/O","Cypher,Sova,Viper,Jett,Yoru"
Breeze,KRÜ Esports,Evil Geniuses,13,9,5,5,4,8,"Cypher,Sova,Viper,Jett,KAY/O","Sova,Viper,Jett,Yoru,Astra"
Split,RIT Orange,TMU Blue,3,13,1,3,10,2,"Raze,Viper,Omen,Jett,Skye","Breach,Cypher,Omen,Jett,Skye"
Ascent,Tootsie Pop's,RyZe Esports,13,6,7,5,1,6,"Sova,Killjoy,Omen,Jett,KAY/O","Sova,Killjoy,Omen,Jett,KAY/O"
Ascent,RIT Orange,TMU Blue,13,5,7,5,0,6,"Sova,Killjoy,Omen,Jett,KAY/O","Breach,Sova,Killjoy,Omen,Jett"
Breeze,UCF Gold,Wichita State Esports,13,9,7,5,4,6,"Cypher,Sova,Viper,Jett,Yoru","Sova,Viper,Yoru,KAY/O,Harbor"
Lotus,UST Esports,Brewton Parker College,13,3,2,2,1,11,"Breach,Raze,Killjoy,Omen,Gekko","Raze,Killjoy,Viper,Omen,Fade"
Ascent,Zen Esports,Border Monsters Chile,13,5,4,2,3,9,"Sova,Killjoy,Omen,Jett,KAY/O","Sova,Killjoy,Omen,Jett,KAY/O"
Bind,TAMU Maroon,LG Orange,13,9,5,7,2,8,"Raze,Viper,Brimstone,Skye,Deadlock","Raze,Cypher,Viper,Brimstone,Skye"
Lotus,KRÜ Esports,Evil Geniuses,13,5,10,2,3,3,"Raze,Killjoy,Viper,Omen,Fade","Raze,Cypher,Viper,Omen,Fade"
Breeze,Cumberland Phoenix,Columbia College,13,7,7,5,2,6,"Cypher,Sova,Viper,Jett,KAY/O","Cypher,Sova,Viper,Jett,Yoru"
Split,Zero MarksMen Black,SaD Purple,12,14,7,6,8,5,"Raze,Cypher,Viper,Omen,Skye","Raze,Viper,Jett,Skye,Astra"
Breeze,RyZe Esports,Lemonade Stand,13,9,8,4,5,5,"Cypher,Sova,Viper,Jett,KAY/O","Cypher,Sova,Viper,Jett,KAY/O"
Icebox,LAG,Organization 13,11,13,5,7,6,6,"Sova,Killjoy,Viper,Jett,Gekko","Sova,Killjoy,Viper,Jett,Gekko"
Ascent,UST Esports,Brewton Parker College,13,7,6,2,5,7,"Cypher,Sova,Omen,Jett,KAY/O","Killjoy,Viper,Omen,Jett,Skye"
Sunset,Cumberland Phoenix,Columbia College,13,4,10,2,2,3,"Breach,Raze,Cypher,Omen,Fade","Breach,Raze,Cypher,Sova,Omen"
Lotus,TAMU Maroon,LG Orange,13,5,8,4,1,5,"Raze,Killjoy,Viper,Omen,Skye","Raze,Killjoy,Viper,Omen,Fade"
Lotus,Zen Esports,Border Monsters Chile,13,3,4,0,3,9,"Raze,Killjoy,Viper,Omen,Fade","Raze,Killjoy,Viper,Omen,Fade"
Ascent,UCF Gold,Wichita State Esports,13,10,8,3,7,5,"Sova,Killjoy,Omen,Jett,KAY/O","Sova,Killjoy,Omen,Jett,KAY/O"
Ascent,Van Lyn,Tootsie Pop's,8,13,1,8,5,7,"Sova,Killjoy,Omen,Jett,KAY/O","Sova,Killjoy,Omen,Jett,KAY/O"
Ascent,LBR,SDSU Black,13,10,9,2,8,4,"Sova,Killjoy,Sage,Omen,Jett","Raze,Sova,Killjoy,Omen,KAY/O"
Breeze,Winthrop University,Harrisburg University,13,7,3,5,2,10,"Cypher,Sova,Viper,Reyna,Jett","Cypher,Sova,Viper,Yoru,KAY/O"
Lotus,Lemonade Stand,Flaming Dragons,13,10,8,3,7,5,"Breach,Raze,Omen,Chamber,Gekko","Raze,Killjoy,Omen,Jett,Skye"
Bind,SaD Purple,Van Lyn Black,14,12,8,5,7,6,"Cypher,Viper,Brimstone,Reyna,Skye","Raze,Viper,Brimstone,Fade,Gekko"
Sunset,DOOMSDAY,Organization 13,5,13,3,9,4,2,"Breach,Raze,Cypher,Omen,Gekko","Breach,Raze,Cypher,Omen,Fade"
Icebox,RyZe Esports,The GRID,13,7,5,7,0,8,"Killjoy,Viper,Jett,KAY/O,Gekko","Raze,Sova,Killjoy,Viper,Reyna"
Sunset,Van Lyn,1Millisecond,13,2,3,0,2,10,"Breach,Raze,Cypher,Sova,Omen","Raze,Cypher,Omen,Gekko,Clove"
Lotus,Winthrop University,Harrisburg University,13,5,9,3,2,4,"Raze,Killjoy,Viper,Omen,Fade","Killjoy,Viper,Omen,Neon,Gekko"
Bind,LBR,SDSU Black,13,11,5,7,4,8,"Raze,Cypher,Viper,Brimstone,Skye","Raze,Cypher,Viper,Brimstone,Skye"
Lotus,Tootsie Pop's,St. Clair Saints,13,8,6,3,5,7,"Raze,Sova,Killjoy,Viper,Omen","Raze,Sova,Killjoy,Viper,Omen"
Sunset,Blinn Esports,LAG,11,13,4,8,5,7,"Raze,Cypher,Omen,KAY/O,Gekko","Raze,Cypher,Omen,KAY/O,Gekko"
Ascent,Zero MarksMen Black,Mindcontrol,18,16,8,9,7,10,"Sova,Killjoy,Omen,Jett,KAY/O","Sova,Killjoy,Omen,Jett,KAY/O"
Ascent,RyZe Esports,Prospects,13,3,4,0,3,9,"Sova,Killjoy,Omen,Jett,KAY/O","Cypher,Sova,Phoenix,Omen,Jett"
Ascent,Organization 13,Good Luck,13,7,7,5,2,6,"Sova,Killjoy,Omen,Jett,KAY/O","Sova,Killjoy,Omen,Jett,KAY/O"
Lotus,Team Mystake,Flaming Dragons,12,14,8,5,9,4,"Raze,Killjoy,Viper,Omen,Gekko","Raze,Killjoy,Omen,Jett,Skye"
Ascent,Thug Shakers,Van Lyn Black,5,13,1,5,8,4,"Sova,Killjoy,Omen,Jett,KAY/O","Sova,Killjoy,Omen,Jett,KAY/O"
Ascent,Van Lyn,Riches2Rags,13,9,5,5,4,8,"Sova,Killjoy,Omen,Jett,KAY/O","Breach,Sova,Omen,Jett,KAY/O"
Bind,Zero MarksMen Black,West Virginia University,13,8,6,6,2,7,"Breach,Viper,Phoenix,Brimstone,KAY/O","Raze,Viper,Brimstone,Skye,Yoru"
Sunset,1337 (NA),DOOMSDAY,8,13,1,8,5,7,"Breach,Raze,Cypher,Sova,Omen","Breach,Raze,Cypher,Omen,Gekko"
Breeze,LAG,ST x WTP,13,7,5,7,0,8,"Cypher,Sova,Viper,Jett,KAY/O","Cypher,Sova,Viper,Reyna,Jett"
Sunset,SaD Purple,Demigods At UCSD,13,6,5,2,4,8,"Breach,Raze,Cypher,Omen,Gekko","Breach,Raze,Cypher,Omen,Gekko"
Ascent,Tootsie Pop's,eRa (NA),13,7,7,5,2,6,"Sova,Killjoy,Omen,Jett,KAY/O","Sova,Killjoy,Omen,Jett,KAY/O"
Ascent,Mindcontrol,Dan's Minions,13,4,3,2,2,10,"Sova,Killjoy,Omen,Jett,KAY/O","Reyna,Jett,Gekko,Deadlock,Clove"
Lotus,Lemonade Stand,Goth Girl Sanctuary,13,4,4,1,3,9,"Breach,Raze,Omen,Chamber,Gekko","Raze,Killjoy,Viper,Omen,Gekko"
Sunset,St. Clair Saints,Edamotic Fall,13,2,11,1,1,2,"Breach,Raze,Cypher,Omen,Fade","Breach,Raze,Cypher,Omen,Gekko"
Bind,Blinn Esports,Sussy Players,13,4,9,3,1,4,"Raze,Viper,Brimstone,KAY/O,Gekko","Raze,Viper,Brimstone,Skye,Yoru"
Icebox,Nightblood Gaming,The GRID,2,13,0,3,10,2,"Killjoy,Viper,Jett,KAY/O,Gekko","Raze,Sova,Killjoy,Viper,Reyna"
Sunset,Team Equinox,1Millisecond,6,13,4,3,10,2,"Raze,Cypher,Omen,KAY/O,Gekko","Raze,Cypher,Omen,Gekko,Clove"
Split,DSQ Esports,BLINDOHOLIK,13,15,8,6,9,5,"Raze,Cypher,Omen,Skye,Deadlock","Breach,Raze,Cypher,Sage,Omen"
Icebox,Shopify Rebellion,G2 Gozen,5,13,4,8,5,1,"Killjoy,Viper,Phoenix,Reyna,Jett","Killjoy,Viper,Phoenix,Reyna,Jett"
Icebox,LBR,SDSU Black,18,20,9,10,10,9,"Sova,Killjoy,Viper,Jett,Harbor","Raze,Sova,Killjoy,Viper,Gekko"
Bind,Free Orbs,Lumina Gaming,13,6,5,2,4,8,"Raze,Viper,Omen,Skye,Gekko","Raze,Viper,Brimstone,Skye,Yoru"
Split,SK Gaming,DIVIZON,13,7,7,5,2,6,"Cypher,Viper,Omen,Jett,Skye","Breach,Sova,Viper,Omen,Jett"
Bind,LAG,Predator X Gaming,13,2,3,0,2,10,"Raze,Viper,Astra,Fade,Gekko","Raze,Viper,KAY/O,Gekko,Clove"
Sunset,Mindcontrol,Slept On,13,2,10,2,0,3,"Breach,Raze,Cypher,Sova,Omen","Breach,Raze,Cypher,Omen,Fade"
Lotus,Van Lyn Black,YDZ Esports,13,7,6,2,5,7,"Raze,Killjoy,Viper,Omen,Fade","Breach,Raze,Killjoy,Omen,Gekko"
Lotus,Goth Girl Sanctuary,C4C Flare,13,5,2,4,1,11,"Raze,Killjoy,Viper,Omen,Gekko","Breach,Raze,Killjoy,Omen,Fade"
Icebox,Boise State University,Demigods At UCSD,7,13,3,5,8,4,"Sova,Killjoy,Viper,Jett,Harbor","Sova,Killjoy,Viper,Reyna,Jett"
Split,West Virginia University,YDZ Infinity,13,9,6,4,5,7,"Breach,Raze,Viper,Omen,Skye","Raze,Cypher,Jett,Skye,Clove"
Sunset,Blinn Esports,Fractal Gaming,13,2,3,0,2,10,"Raze,Cypher,Omen,KAY/O,Gekko","Breach,Raze,Cypher,Omen,Fade"
Sunset,eRa (NA),Flowstate,13,3,11,1,2,2,"Raze,Cypher,Sova,Gekko,Clove","Raze,Cypher,Sova,Omen,Gekko"
Bind,Riches2Rags,1MSA,13,8,6,6,2,7,"Breach,Raze,Viper,Brimstone,Skye","Raze,Viper,Brimstone,Skye,Gekko"
Sunset,Organization 13,Project 01,13,0,1,0,0,12,"Breach,Raze,Cypher,Omen,Fade","Raze,Cypher,Omen,Gekko"
Split,duke of arrakis,DOOMSDAY,9,13,3,7,6,6,"Raze,Cypher,Viper,Omen,Skye","Raze,Cypher,Viper,Omen,Skye"
Ascent,ST x WTP,Kingship,13,4,4,1,3,9,"Sova,Killjoy,Omen,Jett,KAY/O","Sova,Killjoy,Omen,Jett,KAY/O"
Lotus,Defiant Gaming,Good Luck,10,13,7,5,8,3,"Breach,Raze,Killjoy,Gekko,Clove","Breach,Raze,Killjoy,Omen,Gekko"
Lotus,Prospects,Toads,13,9,4,6,3,9,"Raze,Killjoy,Viper,Omen,Fade","Raze,Killjoy,Viper,Omen,Fade"
Bind,Team Mystake,Lionheart eSports,13,9,6,6,3,7,"Raze,Viper,Brimstone,Skye,Chamber","Raze,Viper,Omen,Skye,Gekko"
Ascent,Van Lyn,COUNTRY SIDE,13,5,5,1,4,8,"Sova,Killjoy,Omen,Jett,KAY/O","Raze,Sova,Killjoy,Omen,Jett"
Lotus,RyZe Esports,Team Digital,13,11,7,5,6,6,"Raze,Killjoy,Viper,Omen,KAY/O","Raze,Killjoy,Viper,Omen,Fade"
Ascent,4 Coaches and a Bum,Dan's Minions,0,13,0,12,1,0,"Cypher,Sova,Omen,Jett,KAY/O","Sova,Killjoy,Omen,Jett,KAY/O"
Bind,SaD Purple,Luxoria,14,12,11,2,10,3,"Raze,Brimstone,Reyna,Skye,Gekko","Raze,Viper,Brimstone,Skye,Yoru"
Lotus,1Millisecond,Endear Gaming,2,13,2,10,3,0,"Raze,Killjoy,Omen,Fade,Gekko","Raze,Killjoy,Viper,Omen,Fade"
Bind,Veer's Kittens,Thug Shakers,10,13,5,7,6,5,"Raze,Viper,Brimstone,Skye,Yoru","Raze,Viper,Brimstone,Skye,Gekko"
Ascent,Zero MarksMen Black,SaD FROST,13,3,9,3,0,4,"Sova,Killjoy,Omen,Jett,KAY/O","Sova,Killjoy,Omen,Jett,KAY/O"
Sunset,Head Down Bag Up,Team Equinox,5,13,4,8,5,1,"Raze,Viper,KAY/O,Gekko,Clove","Raze,Cypher,Omen,KAY/O,Gekko"
Breeze,1337 (NA),Carne Asadas,13,9,5,5,4,8,"Cypher,Sova,Viper,Omen,KAY/O","Cypher,Sova,Viper,Yoru,Chamber"
Lotus,The GRID,FRAUD WATCH,13,2,10,2,0,3,"Raze,Killjoy,Reyna,Gekko,Clove","Raze,Killjoy,Viper,Omen,Skye"
Split,Tootsie Pop's,Void,13,9,3,7,2,10,"Raze,Viper,Jett,Skye,Astra","Raze,Cypher,Viper,Skye,Astra"
Bind,Flaming Dragons,CHURCH OF CHAEWON KIM,15,13,5,9,4,10,"Raze,Viper,Brimstone,Skye,Chamber","Raze,Viper,Brimstone,Skye,Gekko"
Bind,DSQ Esports,BLINDOHOLIK,11,13,4,8,5,7,"Raze,Viper,Omen,Yoru,Gekko","Raze,Cypher,Omen,Skye,Yoru"
Icebox,Nightblood Gaming,Imperial Titans,13,9,4,6,3,9,"Killjoy,Viper,Jett,KAY/O,Gekko","Sova,Killjoy,Viper,Reyna,Jett"
Lotus,St. Clair Saints,Fire Nation,13,6,8,4,2,5,"Raze,Sova,Killjoy,Viper,Omen","Breach,Sova,Killjoy,Omen,Neon"
Lotus,Lemonade Stand,Hyperion Gold,13,2,12,0,2,1,"Breach,Raze,Omen,Chamber,Gekko","Raze,Killjoy,Viper,Omen,Gekko"
Sunset,Flare,Sussy Players,7,13,4,8,5,3,"Breach,Raze,Cypher,Omen,Gekko","Raze,Cypher,Omen,KAY/O,Gekko"
Lotus,Free Orbs,Lumina Gaming,13,3,11,1,2,2,"Raze,Killjoy,Viper,Omen,Fade","Killjoy,Viper,Omen,Neon,Gekko"
Lotus,Edamotic Fall,PSU Black,13,6,6,1,5,7,"Raze,Killjoy,Viper,Omen,Fade","Raze,Killjoy,Viper,Omen,Gekko"
Lotus,Shopify Rebellion,G2 Gozen,7,13,2,6,7,5,"Raze,Reyna,Omen,Neon,Fade","Raze,Phoenix,Omen,Jett,Fade"
Sunset,SK Gaming,DIVIZON,13,8,5,7,1,8,"Cypher,Viper,Omen,Jett,Gekko","Breach,Cypher,Phoenix,Omen,Fade"
Sunset,NOMAD GC,DRAKAINAS,13,9,5,5,4,8,"Cypher,Sova,Omen,Jett,Gekko","Breach,Raze,Cypher,Omen,Fade"
Bind,Bakim Corp,Colors Esport,13,8,7,5,3,6,"Raze,Cypher,Viper,Brimstone,Skye","Breach,Raze,Sova,Viper,Astra"
Breeze,Shopify Rebellion,G2 Gozen,8,13,5,7,6,3,"Sova,Viper,Reyna,Jett,Yoru","Cypher,Viper,Reyna,Jett,Yoru"
Bind,Absolute Cinema,DRAKAINAS,13,4,5,0,4,8,"Raze,Cypher,Brimstone,Skye,Yoru","Breach,Raze,Viper,Brimstone,Yoru"
Ascent,Bakim Corp,Colors Esport,13,5,4,2,3,9,"Sova,Killjoy,Omen,Jett,KAY/O","Sova,Killjoy,Omen,Jett,KAY/O"
Lotus,NOMAD GC,Sa Kour'A,10,13,5,6,7,5,"Raze,Killjoy,Omen,Fade,Gekko","Breach,Raze,Killjoy,Omen,Gekko"
Lotus,CGN Esports,FOKUS,13,10,9,2,8,4,"Raze,Sova,Killjoy,Omen,Gekko","Viper,Yoru,Astra,Neon,Fade"
Sunset,EntryFrogs,Axolotl milk academy,13,9,4,6,3,9,"Breach,Raze,Cypher,Sova,Clove","Sage,Omen,KAY/O,Gekko,Clove"
Bind,CGN Esports,FOKUS,13,6,5,2,4,8,"Raze,Viper,Brimstone,Sage,Gekko","Raze,Viper,Brimstone,Yoru,Gekko"
Sunset,Scald eSport GC,DRAKAINAS,14,16,8,7,9,6,"Breach,Raze,Cypher,Omen,Harbor","Breach,Raze,Cypher,Omen,Fade"
Lotus,Team Yazoukew,Sa Kour'A,10,13,6,5,8,4,"Raze,Killjoy,Viper,Omen,Fade","Breach,Raze,Killjoy,Omen,Gekko"
Ascent,Axolotl milk academy,Monkey Stars,13,9,10,2,7,3,"Breach,Viper,Phoenix,Omen,Fade","Sova,Killjoy,Omen,Jett,KAY/O"
Ascent,Colors Esport,Cicadas Gaming,13,7,6,6,1,7,"Sova,Killjoy,Omen,Jett,KAY/O","Sova,Killjoy,Omen,Jett,KAY/O"
Ascent,Absolute Cinema,F9 Wonders,7,13,4,4,9,3,"Sova,Killjoy,Reyna,Omen,Jett","Sova,Killjoy,Phoenix,Omen,Jett"
Lotus,charbon,NOMAD GC,13,3,9,3,0,4,"Breach,Raze,Killjoy,Omen,Gekko","Raze,Killjoy,Omen,Fade,Gekko"
Sunset,NIGHTMARES team,EntryFrogs,4,13,3,9,4,1,"Breach,Raze,Cypher,Omen,Gekko","Breach,Raze,Cypher,Sova,Clove"
Bind,DIVIZON,Ovation eSports,13,7,5,3,4,8,"Raze,Sova,Viper,Omen,Yoru","Raze,Viper,Omen,Skye,Yoru"
Icebox,DRAKAINAS,NUXERIA GC,13,6,10,2,4,3,"Killjoy,Viper,Jett,KAY/O,Gekko","Sova,Killjoy,Viper,Jett,Gekko"
Sunset,GIANTX GC,G2 Gozen,10,13,5,6,7,5,"Raze,Cypher,Viper,Phoenix,Neon","Raze,Cypher,Phoenix,Reyna,Omen"
Lotus,Colors Esport,Cicadas Gaming,13,6,9,3,3,4,"Raze,Killjoy,Viper,Omen,Fade","Raze,Killjoy,Viper,Omen,Skye"
Ascent,Sa Kour'A,Prototype,13,9,9,3,6,4,"Sova,Killjoy,Omen,Jett,KAY/O","Sova,Killjoy,Omen,Jett,KAY/O"
Bind,Scald eSport GC,ARTORIAS GAMING,13,3,11,1,2,2,"Raze,Cypher,Viper,Brimstone,Skye","Raze,Cypher,Jett,Skye,Clove"
Sunset,all cooked,Team Yazoukew,7,13,4,4,9,3,"Breach,Cypher,Sova,Omen,Jett","Breach,Raze,Cypher,Omen,Gekko"
Breeze,DIVIZON,Ovation eSports,13,10,6,5,5,7,"Cypher,Sova,Viper,Omen,Yoru","Cypher,Sova,Viper,Jett,Yoru"
Icebox,GIANTX GC,G2 Gozen,10,13,5,7,6,5,"Raze,Viper,Reyna,Yoru,Gekko","Killjoy,Viper,Phoenix,Reyna,Jett"
Sunset,Team Secret,Paper Rex,13,8,7,5,3,6,"Breach,Raze,Cypher,Sova,Omen","Raze,Viper,Omen,KAY/O,Gekko"
Icebox,Team Secret,Paper Rex,13,9,5,5,4,8,"Sova,Killjoy,Viper,Jett,KAY/O","Killjoy,Viper,Sage,Jett,KAY/O"
Icebox,Global Esports,Rex Regum Qeon,13,4,8,4,0,5,"Killjoy,Viper,Sage,Jett,Gekko","Sova,Killjoy,Viper,Jett,Gekko"
Lotus,Global Esports,Rex Regum Qeon,13,10,7,5,5,6,"Raze,Killjoy,Viper,Omen,Fade","Raze,Killjoy,Viper,Omen,Fade"
Bind,Predator X Gaming,Imperial,13,8,6,6,2,7,"Raze,Viper,KAY/O,Gekko,Clove","Viper,Brimstone,Skye,Yoru,Gekko"
Lotus,Cloud9,LOUD,13,9,6,6,3,7,"Raze,Killjoy,Viper,Omen,Gekko","Raze,Viper,Omen,Fade,Deadlock"
Sunset,Predator X Gaming,Imperial,13,7,8,4,3,5,"Breach,Cypher,Sova,Omen,Jett","Raze,Cypher,Sova,Gekko,Clove"
Bind,Cumberland Phoenix,UST Esports,13,15,7,7,8,6,"Raze,Viper,Brimstone,Skye,Gekko","Raze,Viper,Brimstone,Skye,Gekko"
Icebox,Cloud9,LOUD,13,4,9,3,1,4,"Sova,Killjoy,Viper,Sage,Jett","Sova,Killjoy,Viper,Jett,Harbor"
Split,SFU Pink,ASU Maroon,13,5,9,3,2,4,"Raze,Cypher,Jett,Skye,Astra","Raze,Cypher,Skye,Astra,Deadlock"
Sunset,blueming,Imperial,5,13,3,9,4,2,"Cypher,Sova,Reyna,Omen,Gekko","Raze,Cypher,Sova,Gekko,Clove"
Lotus,Predator X Gaming,SRVR RED,13,7,6,6,1,7,"Raze,Killjoy,Viper,Fade,Clove","Raze,Killjoy,Viper,Omen,Fade"
Breeze,Cumberland Phoenix,UST Esports,10,13,6,5,8,4,"Cypher,Sova,Viper,Jett,KAY/O","Cypher,Sova,Viper,Jett,KAY/O"
Ascent,Indiana Hoosiers,Ball State,5,13,3,9,4,2,"Sova,Killjoy,Omen,Jett,KAY/O","Sova,Killjoy,Omen,Jett,KAY/O"
Lotus,UC Irvine,SDSU Black,13,9,4,6,3,9,"Breach,Killjoy,Yoru,Astra,Gekko","Raze,Killjoy,Omen,Skye,Gekko"
Icebox,SFU Pink,ASU Maroon,13,5,10,2,3,3,"Sova,Killjoy,Viper,Omen,Jett","Sova,Killjoy,Viper,Reyna,Jett"
Sunset,UTD Orange,Imperial,8,13,7,5,8,1,"Breach,Raze,Cypher,Omen,Fade","Raze,Cypher,Sova,Gekko,Clove"
Lotus,Indiana Hoosiers,Ball State,1,13,1,11,2,0,"Killjoy,Omen,Neon,Fade,Gekko","Raze,Killjoy,Viper,Omen,Skye"
Sunset,Predator X Gaming,Lucky 7 Gaming,13,8,9,3,5,4,"Breach,Cypher,Sova,Omen,Jett","Raze,Cypher,Sova,Omen,Gekko"
Bind,Cloud9,LOUD,11,13,5,7,6,6,"Raze,Cypher,Viper,Brimstone,Skye","Breach,Raze,Viper,Brimstone,KAY/O"
Lotus,Cumberland Phoenix,UST Esports,13,9,7,5,4,6,"Killjoy,Viper,Omen,Jett,Skye","Breach,Raze,Killjoy,Omen,Gekko"
Split,UC Irvine,SDSU Black,13,5,9,3,2,4,"Cypher,Sova,Viper,Omen,Iso","Raze,Cypher,Omen,Skye,Gekko"
Ascent,SFU Pink,ASU Maroon,7,13,2,6,7,5,"Sova,Killjoy,Omen,Jett,KAY/O","Sova,Killjoy,Omen,Jett,KAY/O"
Split,Wooper Warriors,SRVR RED,11,13,4,8,5,7,"Raze,Cypher,Viper,Omen,Skye","Raze,Viper,Omen,Jett,Skye"
Sunset,blueming,LC,13,4,8,4,0,5,"Cypher,Sova,Reyna,Omen,Gekko","Breach,Raze,Cypher,Omen,Gekko"
Sunset,CSUF Orange,LBR,13,2,3,0,2,10,"Raze,Cypher,Reyna,Omen,Fade","Breach,Cypher,Sova,Omen,Jett"
Sunset,Astane Anarchy,Predator X Gaming,3,13,3,9,4,0,"Raze,Cypher,Omen,KAY/O,Gekko","Breach,Cypher,Sova,Omen,Jett"
Bind,SRVR RED,Rollie not a Stopwatch,13,6,4,3,3,9,"Raze,Viper,Brimstone,Skye,Yoru","Raze,Cypher,Brimstone,Jett,Skye"
Lotus,Team Disrupt,UTD Orange,3,13,3,9,4,0,"Raze,Killjoy,Viper,Omen,Fade","Raze,Killjoy,Viper,Omen,Skye"
Lotus,Imperial,Arete,13,10,7,5,5,6,"Breach,Raze,Killjoy,Omen,Gekko","Raze,Killjoy,Viper,Omen,Fade"
Bind,Sentinels,MIBR,13,7,9,3,4,4,"Raze,Viper,Brimstone,Skye,Gekko","Raze,Viper,Brimstone,Skye,KAY/O"
Ascent,UC Irvine,SDSU Black,13,15,3,11,4,10,"Sova,Killjoy,Omen,Jett,KAY/O","Raze,Sova,Killjoy,Omen,KAY/O"
Bind,Harmony,Lucky 7 Gaming,5,13,1,5,8,4,"Breach,Raze,Viper,Brimstone,Gekko","Breach,Raze,Brimstone,Jett,Gekko"
Sunset,Team Basilix,blueming,10,13,3,8,5,7,"Raze,Cypher,Omen,KAY/O,Gekko","Cypher,Sova,Reyna,Omen,Gekko"
Split,LC,Moochachos,14,12,7,6,6,7,"Raze,Cypher,Viper,Omen,Skye","Breach,Raze,Cypher,Omen,Jett"
Ascent,MERC CLAN,Wooper Warriors,7,13,3,5,8,4,"Sova,Killjoy,Omen,Jett,KAY/O","Sova,Killjoy,Omen,Jett,KAY/O"
Icebox,CSUF Orange,LBR,13,11,4,8,3,9,"Sova,Killjoy,Viper,Jett,Harbor","Sova,Killjoy,Viper,Jett,Harbor"
Sunset,GIANTX GC,Shopify Rebellion,8,13,6,6,7,2,"Raze,Cypher,Viper,Phoenix,Neon","Breach,Raze,Reyna,Omen,Jett"
Bind,CSULB Black,CSULB Gold,5,13,3,9,4,2,"Raze,Cypher,Viper,Brimstone,Skye","Raze,Cypher,Brimstone,Skye,Yoru"
Split,Brewton Parker College,Columbia College,13,5,3,3,2,10,"Raze,Cypher,Viper,Omen,Skye","Raze,Cypher,Omen,Jett,Skye"
Bind,Predator X Gaming,NO PRAC,13,1,11,1,0,2,"Raze,Viper,KAY/O,Gekko,Clove","Raze,Brimstone,Skye,Gekko,Clove"
Ascent,Phoenix Esports,LC,0,13,0,1,12,0,"Sova,Reyna,Omen,Jett,Skye","Sova,Killjoy,Omen,Jett,KAY/O"
Lotus,Arete,NEU Aqua,13,3,2,2,1,11,"Raze,Killjoy,Viper,Omen,Fade","Raze,Killjoy,Viper,Skye,Astra"
Sunset,Astane Anarchy,Amphibium,13,10,8,3,7,5,"Raze,Cypher,Omen,KAY/O,Gekko","Raze,Cypher,Omen,KAY/O,Gekko"
Lotus,SRVR RED,We ARE PARTY CODE,13,11,7,5,6,6,"Raze,Killjoy,Viper,Omen,Fade","Raze,Killjoy,Viper,Omen,Gekko"
Sunset,Kent State University,UTD Orange,11,13,4,8,5,7,"Viper,Omen,Jett,KAY/O,Gekko","Breach,Raze,Cypher,Omen,Fade"
Icebox,Hiraeth Ruby,blueming,6,13,4,8,5,2,"Sova,Killjoy,Viper,Jett,Harbor","Sova,Killjoy,Viper,Reyna,Jett"
Lotus,CSUF Orange,LBR,4,13,2,3,10,2,"Breach,Raze,Killjoy,Omen,Fade","Raze,Killjoy,Viper,Omen,Fade"
Ascent,The Barn Animals,MERC CLAN,0,13,0,12,1,0,"Killjoy,Brimstone,Jett,KAY/O,Fade","Sova,Killjoy,Reyna,Omen,Jett"
Bind,Rollie not a Stopwatch,Astral Vision Epic,13,9,6,6,3,7,"Cypher,Viper,Brimstone,Jett,Skye","Raze,Viper,Brimstone,Skye,Gekko"
Lotus,Team Basilix,Sya Unity,13,6,3,4,2,10,"Raze,Killjoy,Omen,Yoru,Fade","Killjoy,Jett,Fade,Gekko,Clove"
Breeze,Fractal Gaming,Lucky 7 Gaming,11,13,6,6,7,5,"Cypher,Sova,Viper,Jett,Yoru","Cypher,Sova,Viper,Jett,KAY/O"
Split,Maryville University,Mizzou Esports,5,13,2,4,9,3,"Raze,Cypher,Viper,Omen,Skye","Breach,Raze,Reyna,Jett,Astra"
Sunset,Scarlet Death Esports,Moochachos,5,13,4,2,11,1,"Raze,Cypher,Omen,KAY/O,Gekko","Breach,Cypher,Jett,Gekko,Clove"
Lotus,Imperial,NVU Violet Phantoms,13,6,9,3,3,4,"Breach,Raze,Killjoy,Omen,Gekko","Raze,Killjoy,Omen,Gekko,Clove"
Ascent,Team Falcons Vega,Gamax Lite,13,11,4,8,3,9,"Sova,Killjoy,Omen,Jett,KAY/O","Sova,Killjoy,Omen,Jett,KAY/O"
Icebox,Wichita State Esports,LG Orange,3,13,1,3,10,2,"Sova,Killjoy,Viper,Jett,Harbor","Sova,Killjoy,Viper,Jett,KAY/O"
Lotus,Sentinels,MIBR,13,3,4,0,3,9,"Raze,Killjoy,Viper,Omen,Fade","Raze,Killjoy,Viper,Omen,Skye"
Ascent,NMSU Black,Harmony,1,13,1,11,2,0,"Sova,Killjoy,Omen,Jett,KAY/O","Sova,Killjoy,Omen,Jett,KAY/O"
Split,Cincinnati Spartans Bravo,Wooper Warriors,9,13,6,6,7,3,"Raze,Cypher,Viper,Omen,Skye","Raze,Cypher,Viper,Omen,Skye"
Sunset,St. Clair Saints,CSP Val Blue,13,6,8,4,2,5,"Breach,Raze,Cypher,Omen,Fade","Breach,Raze,Cypher,Omen,Fade"
Lotus,GIANTX GC,Shopify Rebellion,10,13,6,5,8,4,"Raze,Cypher,Phoenix,Reyna,Neon","Raze,Reyna,Omen,Jett,Fade"
Sunset,Brewton Parker College,Columbia College,8,13,5,7,6,3,"Raze,Cypher,Viper,Omen,Gekko","Raze,Cypher,Sova,Omen,Jett"
Lotus,Triton Esports,LC,7,13,5,7,6,2,"Raze,Killjoy,Omen,Fade,Gekko","Breach,Raze,Killjoy,Omen,Gekko"
Lotus,CSULB Black,CSULB Gold,14,12,10,3,9,4,"Raze,Killjoy,Viper,Omen,Skye","Raze,Killjoy,Viper,Omen,Gekko"
Lotus,Big Brim Gamers,We ARE PARTY CODE,6,13,3,4,9,3,"Raze,Killjoy,Viper,Skye,Clove","Raze,Killjoy,Viper,Omen,Gekko"
Split,DooDooFart,Team Disrupt,1,13,0,2,11,1,"Breach,Raze,Cypher,Viper,Omen","Raze,Cypher,Viper,Omen,Skye"
Breeze,NEU Aqua,WasTaken,13,11,8,4,7,5,"Cypher,Sova,Viper,Jett,KAY/O","Raze,Cypher,Sova,Viper,Jett"
Lotus,UCLA Academy,MERC CLAN,8,13,2,7,6,6,"Raze,Killjoy,Viper,Omen,Fade","Killjoy,Omen,Jett,KAY/O,Gekko"
Lotus,Team Falcons Vega,Gamax Lite,13,4,8,4,0,5,"Raze,Killjoy,Viper,Omen,Fade","Breach,Raze,Killjoy,Omen,Gekko"
Sunset,Borner Sitting Bucks,blueming,7,13,3,5,8,4,"Raze,Cypher,Omen,Gekko,Clove","Cypher,Sova,Reyna,Omen,Gekko"
Lotus,Sya Unity,Shibuya Squad,13,8,9,3,5,4,"Killjoy,Jett,Fade,Gekko,Clove","Breach,Raze,Cypher,Viper,Clove"
Sunset,Maryville University,Mizzou Esports,8,13,6,6,7,2,"Raze,Cypher,Viper,Omen,Gekko","Breach,Raze,Cypher,Reyna,Omen"
Bind,Radianite Reaperz,Lucky 7 Gaming,4,13,1,4,9,3,"Cypher,Brimstone,Sage,Reyna,Gekko","Breach,Raze,Brimstone,Jett,Gekko"
Ascent,Colin Bush's Team,NVU Violet Phantoms,7,13,2,10,3,5,"Sova,Killjoy,Omen,Jett,Gekko","Cypher,Sova,Phoenix,Omen,Jett"
Ascent,Moochachos,Bird Watchers,13,8,8,4,4,5,"Sova,Killjoy,Omen,Jett,KAY/O","Sova,Killjoy,Omen,Jett,KAY/O"
Sunset,UTD Green,Harmony,1,13,0,2,11,1,"Breach,Raze,Cypher,Omen,Fade","Breach,Raze,Cypher,Omen,Gekko"
Ascent,NO PRAC,Team ROAR,18,16,11,6,10,7,"Cypher,Sova,Jett,Astra,KAY/O","Cypher,Sova,Omen,Jett,KAY/O"
Sunset,Amphibium,Status Red,13,11,9,3,8,4,"Raze,Cypher,Omen,KAY/O,Gekko","Raze,Viper,Omen,KAY/O,Gekko"
Icebox,Kent State University,SJ6 AND TRIMADOL,19,17,11,7,10,8,"Sova,Killjoy,Viper,Jett,Harbor","Sova,Killjoy,Viper,Reyna,Clove"
Ascent,Brewton Parker College,Columbia College,13,2,10,2,0,3,"Killjoy,Viper,Omen,Jett,Skye","Sova,Killjoy,Omen,Jett,KAY/O"
Lotus,Good Gamers,Predator X Gaming,5,13,2,4,9,3,"Raze,Yoru,Fade,Gekko,Clove","Cypher,Reyna,KAY/O,Deadlock,Clove"
Ascent,Velocity 5 Esports,Wooper Warriors,0,13,0,1,12,0,"Sova,Killjoy,Omen,Jett,KAY/O","Sova,Killjoy,Omen,Jett,KAY/O"
Ascent,Astral Vision Epic,RAMPAGE Esports BLK,13,5,8,4,1,5,"Sova,Killjoy,Omen,Jett,KAY/O","Sova,Killjoy,Omen,Jett,KAY/O"
Sunset,UTD Orange,RBX,13,4,10,2,2,3,"Breach,Raze,Cypher,Omen,Fade","Breach,Raze,Cypher,Omen,Gekko"
Lotus,Wichita State Esports,LG Orange,8,13,7,5,8,1,"Raze,Killjoy,Viper,Omen,Skye","Raze,Killjoy,Viper,Omen,Fade"
Bind,St. Clair Saints,CSP Val Blue,13,6,9,3,3,4,"Raze,Viper,Brimstone,Skye,Gekko","Breach,Raze,Viper,Brimstone,Skye"
Lotus,Harrisburg University,Fisher College Tea Party,13,2,2,1,1,11,"Killjoy,Viper,Omen,Neon,Gekko","Breach,Killjoy,Omen,Neon,Gekko"
Lotus,Fisher Falcons,RIT Orange,13,0,12,0,0,1,"Raze,Killjoy,Viper,Omen,KAY/O","Raze,Killjoy,Omen,Fade,Gekko"
Icebox,Winthrop University,University of Virginia,13,3,3,1,2,10,"Sova,Killjoy,Viper,Reyna,Jett","Raze,Sova,Killjoy,Viper,Sage"
Sunset,NOMAD,Cicadas Gaming,8,13,3,6,7,5,"Breach,Cypher,Sova,Omen,Neon","Breach,Raze,Cypher,Omen,Yoru"
Split,Fisher College Navy,TMU Blue,13,3,4,0,3,9,"Raze,Viper,Omen,Jett,Skye","Breach,Cypher,Omen,Jett,Skye"
Sunset,KPI Gaming,Case Esports,13,6,4,3,3,9,"Breach,Raze,Cypher,Omen,Gekko","Raze,Viper,Omen,KAY/O,Gekko"
Sunset,G2 Gozen,Karmine Corp GC,13,8,8,4,4,5,"Raze,Cypher,Phoenix,Omen,Jett","Raze,Cypher,Reyna,Omen,Jett"
Ascent,Fisher Falcons,RIT Orange,13,7,2,6,1,11,"Sova,Killjoy,Omen,Jett,KAY/O","Sova,Killjoy,Omen,Jett,KAY/O"
Sunset,Winthrop University,University of Virginia,13,6,4,3,3,9,"Breach,Raze,Cypher,Omen,Fade","Cypher,Sova,Viper,Omen,Yoru"
Sunset,Team Falcons Vega,The Ultimates Odyssey,13,5,4,2,3,9,"Breach,Raze,Cypher,Omen,Fade","Raze,Cypher,Viper,Omen,Fade"
Icebox,CSULB Black,CSULB Gold,9,13,9,3,10,0,"Sova,Killjoy,Viper,Jett,Harbor","Sova,Killjoy,Viper,Sage,Jett"
Split,Harrisburg University,Fisher College Tea Party,13,5,2,4,1,11,"Raze,Cypher,Viper,Omen,Skye","Raze,Cypher,Viper,Omen,Skye"
Lotus,NOMAD,Cicadas Gaming,13,6,7,5,1,6,"Breach,Killjoy,Omen,Neon,Gekko","Raze,Killjoy,Viper,Omen,Skye"
Bind,FOKUS,SK Gaming,13,11,7,5,6,6,"Raze,Viper,Brimstone,Yoru,Gekko","Viper,Brimstone,Jett,Skye,Gekko"
Lotus,R8 Blues,Dragons Esports GC,14,12,5,8,4,9,"Killjoy,Viper,Omen,Skye,Neon","Raze,Killjoy,Viper,Omen,Fade"
Breeze,KPI Gaming,Case Esports,8,13,5,7,6,3,"Cypher,Sova,Viper,Jett,Yoru","Sova,Viper,Jett,Yoru,Astra"
Sunset,XO Nova,Gamax Lite,9,13,5,5,8,4,"Breach,Raze,Cypher,Omen,Gekko","Breach,Raze,Cypher,Omen,Gekko"
Bind,Team Falcons Vega,The Ultimates Odyssey,5,13,1,5,8,4,"Raze,Brimstone,Reyna,Skye,Harbor","Raze,Viper,Sage,Omen,Skye"
Breeze,G2 Gozen,Karmine Corp GC,13,9,8,4,5,5,"Cypher,Viper,Reyna,Jett,Yoru","Sova,Viper,Reyna,Jett,Yoru"
Breeze,NOMAD,Cicadas Gaming,4,13,1,11,2,3,"Viper,Phoenix,Brimstone,Harbor,Gekko","Cypher,Sova,Viper,Jett,Skye"
Split,FOKUS,SK Gaming,13,5,9,3,2,4,"Raze,Omen,Yoru,Astra,Fade","Cypher,Viper,Omen,Jett,Skye"
Lotus,CTRL Esports,Andromeda Gaming,13,9,10,0,9,3,"Raze,Killjoy,Viper,Omen,Fade","Breach,Raze,Killjoy,Omen,Fade"
Icebox,R8 Blues,Dragons Esports GC,13,3,4,0,3,9,"Sova,Killjoy,Viper,Sage,Neon","Killjoy,Viper,Jett,KAY/O,Gekko"
Split,KPI Gaming,Case Esports,13,4,5,0,4,8,"Breach,Raze,Cypher,Omen,Skye","Raze,Viper,Omen,Skye,Yoru"
Breeze,XO Nova,Gamax Lite,5,13,1,11,2,4,"Cypher,Sova,Viper,Jett,Chamber","Cypher,Sova,Viper,Reyna,Jett"
Lotus,Team Falcons Vega,The Ultimates Odyssey,13,8,10,2,6,3,"Raze,Killjoy,Viper,Omen,Fade","Breach,Raze,Killjoy,Omen,Skye"
Ascent,G2 Gozen,Karmine Corp GC,9,13,5,7,6,4,"Raze,Cypher,Phoenix,Omen,Jett","Cypher,Phoenix,Reyna,Omen,Jett"
Breeze,Colors Esport,Bakim Corp,3,13,3,9,4,0,"Cypher,Sova,Viper,Jett,KAY/O","Cypher,Sova,Viper,Reyna,Jett"
Bind,CTRL Esports,Andromeda Gaming,13,8,7,5,3,6,"Raze,Cypher,Viper,Brimstone,Skye","Raze,Viper,Brimstone,Skye,Fade"
Icebox,KPI Gaming,Case Esports,13,11,8,4,7,5,"Sova,Killjoy,Viper,Sage,Jett","Killjoy,Viper,Jett,KAY/O,Gekko"
Split,OnlyFins,SweetNsour,5,13,2,10,3,3,"Killjoy,Viper,Omen,Jett,KAY/O","Raze,Cypher,Viper,Omen,Skye"
Bind,MOUZ,CGN Esports,13,10,7,5,5,6,"Breach,Raze,Viper,Brimstone,Gekko","Raze,Viper,Brimstone,Sage,Gekko"
Lotus,NUXERIA GC,TDSwordys,14,12,6,7,5,8,"Breach,Raze,Killjoy,Omen,Skye","Breach,Raze,Cypher,Omen,Gekko"
Lotus,ARTORIAS GAMING,Cervo Porte,13,10,4,7,3,9,"Breach,Raze,Killjoy,Reyna,Clove","Breach,Raze,Killjoy,Omen,Fade"
Ascent,Prototype,Les oubliées,13,6,7,0,6,6,"Sova,Killjoy,Omen,Jett,KAY/O","Sova,Killjoy,Phoenix,Omen,Jett"
Lotus,Team Yazoukew,ROAW,14,12,9,4,8,5,"Raze,Killjoy,Viper,Omen,Fade","Breach,Raze,Cypher,Omen,Gekko"
Sunset,Virtual eSports,NIGHTMARES team,4,13,0,5,8,4,"Breach,Cypher,Omen,Jett,Fade","Breach,Raze,Cypher,Omen,Gekko"
Lotus,Colors Esport,Bakim Corp,14,12,8,5,7,6,"Raze,Killjoy,Viper,Omen,Fade","Raze,Killjoy,Viper,Omen,Skye"
Bind,KPI Gaming,Case Esports,6,13,3,4,9,3,"Raze,Cypher,Viper,Brimstone,Skye","Viper,Brimstone,Skye,Yoru,Gekko"
Sunset,OnlyFins,SweetNsour,4,13,2,3,10,2,"Raze,Cypher,Omen,KAY/O,Gekko","Raze,Cypher,Omen,KAY/O,Gekko"
Sunset,MOUZ,CGN Esports,13,2,3,0,2,10,"Raze,Cypher,Viper,Omen,Gekko","Raze,Cypher,Sova,Omen,Clove"
Ascent,Shopify Rebellion,Karmine Corp GC,13,7,5,7,0,8,"Sova,Phoenix,Reyna,Jett,Clove","Cypher,Phoenix,Reyna,Omen,Jett"
Bind,TDSwordys,Projet Améthyste,13,2,3,0,2,10,"Raze,Cypher,Brimstone,Skye,Gekko","Breach,Raze,Cypher,Brimstone,Skye"
Ascent,ROAW,TOTALLY SPIKE,13,3,4,0,3,9,"Sova,Killjoy,Omen,Jett,KAY/O","Breach,Cypher,Jett,Skye,Clove"
Split,ARTORIAS GAMING,ValkyRizz,13,3,4,0,3,9,"Raze,Cypher,Reyna,Skye,Clove","Cypher,Viper,Jett,Skye,Clove"
Split,Rizzlers,Les oubliées,2,13,0,3,10,2,"Breach,Raze,Cypher,Omen,Jett","Raze,Cypher,Skye,Yoru,Clove"
Lotus,L'Olympique des Merveilles,NUXERIA GC,6,13,5,7,6,1,"Breach,Raze,Killjoy,Omen,Gekko","Breach,Raze,Killjoy,Omen,Skye"
Lotus,Prototype,les retraitées,13,8,7,2,6,6,"Breach,Raze,Killjoy,Omen,Gekko","Breach,Killjoy,Omen,Jett,Gekko"
Sunset,Cervo Porte,Team PALM GC,13,4,10,2,2,3,"Breach,Raze,Cypher,Omen,Gekko","Cypher,Sage,Reyna,KAY/O,Clove"
Ascent,Pamplepouffs,Team Yazoukew,7,13,4,4,9,3,"Sova,Killjoy,Omen,Jett,KAY/O","Sova,Killjoy,Omen,Jett,KAY/O"
Ascent,Lumens Zero,Monkey Stars,1,13,1,11,2,0,"Sova,Killjoy,Omen,Jett,KAY/O","Sova,Killjoy,Omen,Jett,KAY/O"
Lotus,MOUZ,CGN Esports,7,13,4,8,5,3,"Breach,Raze,Viper,Omen,Fade","Raze,Sova,Killjoy,Omen,Gekko"
Icebox,Colors Esport,Bakim Corp,11,13,7,5,8,4,"Sova,Killjoy,Viper,Jett,Harbor","Sova,Killjoy,Viper,Sage,Jett"
Sunset,NIGHTMARES team,ARANCINI,13,2,10,2,0,3,"Breach,Raze,Cypher,Omen,Gekko","Cypher,Sova,Omen,Jett,Gekko"
Sunset,HUNTERS,EntryFrogs,11,13,7,5,8,4,"Raze,Cypher,Omen,KAY/O,Gekko","Breach,Raze,Cypher,Sova,Clove"
Ascent,Axolotl milk academy,Au Revoir Academy,13,8,7,2,6,6,"Breach,Viper,Phoenix,Omen,Fade","Killjoy,Viper,Omen,Jett,Gekko"
Breeze,Shopify Rebellion,Karmine Corp GC,15,13,8,6,7,7,"Sova,Viper,Reyna,Jett,Yoru","Sova,Viper,Reyna,Jett,Yoru"
Lotus,charbon,DRAKAINAS,13,4,10,2,2,3,"Breach,Raze,Killjoy,Omen,Gekko","Breach,Raze,Killjoy,Omen,Fade"
Ascent,Absolute Cinema,Sa Kour'A,13,2,2,1,1,11,"Sova,Killjoy,Reyna,Omen,Jett","Sova,Killjoy,Omen,Jett,KAY/O"
Sunset,Virtual eSports,ERA,13,6,5,2,4,8,"Breach,Cypher,Omen,Jett,Fade","Breach,Raze,Cypher,Omen,Deadlock"
Icebox,all cooked,F9 Wonders,1,13,1,11,2,0,"Sova,Killjoy,Viper,Jett,Gekko","Sova,Killjoy,Viper,Jett,Gekko"
Sunset,Scald eSport GC,NOMAD GC,11,13,10,2,11,1,"Breach,Raze,Cypher,Omen,Harbor","Cypher,Sova,Omen,Jett,Gekko"
Ascent,Merguez bien guez,TOTALLY SPIKE,1,13,0,2,11,1,"Killjoy,Sage,KAY/O,Fade,Clove","Breach,Cypher,Jett,Skye,Clove"
Ascent,Pisel1,Lumens Zero,7,13,1,7,6,6,"Cypher,Sova,Omen,Jett,KAY/O","Sova,Killjoy,Omen,Jett,KAY/O"
Split,ValkyRizz,SIPAKELY,13,0,1,0,0,12,"Cypher,Viper,Jett,Skye,Clove","Sage,Reyna,Jett,Skye,Clove"
Icebox,Projet Améthyste,KawaiiKittens,13,10,6,5,5,7,"Sova,Killjoy,Viper,Reyna,Jett","Killjoy,Viper,Reyna,Omen,Fade"
Lotus,MAZE Academy,HUNTERS,5,13,2,4,9,3,"Breach,Raze,Killjoy,Viper,Omen","Raze,Killjoy,Viper,Omen,Fade"
Sunset,Au Revoir Academy,I TARALLINI,13,7,10,2,5,3,"Raze,Cypher,Omen,Yoru,Gekko","Raze,Cypher,Omen,KAY/O,Gekko"
Lotus,WinX GC,Team PALM GC,11,13,8,4,9,3,"Cypher,Viper,Brimstone,Reyna,Gekko","Cypher,Phoenix,Sage,Gekko,Clove"
Ascent,TUSCAN TITANS,Axolotl milk academy,5,13,3,9,4,2,"Killjoy,Phoenix,Omen,Jett,Gekko","Breach,Viper,Phoenix,Omen,Fade"
Icebox,Monkey Stars,Faithful,13,5,6,0,5,7,"Sova,Killjoy,Viper,Jett,Gekko","Killjoy,Viper,Sage,KAY/O,Gekko"
Bind,Jenhstars,les retraitées,5,13,4,2,11,1,"Cypher,Reyna,Omen,Neon,Gekko","Breach,Raze,Viper,Brimstone,Skye"
Lotus,Team Yazoukew,Irregulars GC,13,3,4,0,3,9,"Raze,Killjoy,Viper,Omen,Fade","Killjoy,Omen,Jett,Fade,Gekko"
Lotus,charbon,Rizzlers,13,1,11,1,0,2,"Breach,Raze,Killjoy,Omen,Gekko","Breach,Raze,Killjoy,Omen,Fade"
Split,Five Fingers of the Hand,KawaiiKittens,1,13,0,2,11,1,"Raze,Cypher,Sage,Fade,Clove","Cypher,Sage,Reyna,Omen,Fade"
Sunset,DRAKAINAS,Prototype,13,11,6,6,5,7,"Breach,Raze,Cypher,Omen,Fade","Breach,Raze,Cypher,Omen,Gekko"
Lotus,Absolute Cinema,TDSwordys,13,11,6,6,5,7,"Raze,Killjoy,Omen,Skye,Neon","Breach,Raze,Cypher,Omen,Gekko"
Bind,Cicadas Gaming,Bakim Corp,9,13,8,4,9,1,"Raze,Cypher,Brimstone,Jett,Skye","Raze,Cypher,Viper,Brimstone,Skye"
Ascent,F9 Wonders,ARTORIAS GAMING,13,4,5,0,4,8,"Sova,Killjoy,Phoenix,Omen,Jett","Raze,Killjoy,Jett,Skye,Clove"
Bind,ROAW,Scald eSport GC,6,13,3,4,9,3,"Breach,Raze,Cypher,Brimstone,Fade","Raze,Cypher,Viper,Brimstone,Skye"
Lotus,NOMAD GC,Pamplepouffs,13,5,3,3,2,10,"Raze,Killjoy,Omen,Fade,Gekko","Breach,Raze,Cypher,Omen,Gekko"
Ascent,Cervo Porte,all cooked,10,13,7,4,9,3,"Sova,Killjoy,Omen,Jett,KAY/O","Sova,Killjoy,Omen,Jett,KAY/O"
Lotus,L'Olympique des Merveilles,Sa Kour'A,7,13,4,8,5,3,"Breach,Raze,Killjoy,Omen,Gekko","Breach,Raze,Cypher,Omen,Gekko"
Ascent,TOTALLY SPIKE,Spice Girls,13,3,2,2,1,11,"Breach,Cypher,Jett,Skye,Clove","Raze,Killjoy,Viper,Omen,Fade"
Split,NIGHTMARES team,Reviant,13,5,8,4,1,5,"Breach,Raze,Cypher,Omen,Skye","Breach,Raze,Cypher,Sage,Omen"
Ascent,Bleed Esports,DetonatioN FocusMe,13,4,3,2,2,10,"Sova,Killjoy,Omen,Jett,KAY/O","Raze,Cypher,Viper,Omen,KAY/O"
Lotus,Axolotl Pink,Axolotl milk academy,2,13,0,3,10,2,"Breach,Raze,Killjoy,Omen,Gekko","Breach,Raze,Viper,Omen,Chamber"
Ascent,team sul momento,Lumens Zero,12,14,7,6,8,5,"Sova,Killjoy,Omen,Jett,KAY/O","Sova,Killjoy,Omen,Jett,KAY/O"
Split,MAZE Academy,HGE Academy,13,5,6,0,5,7,"Breach,Raze,Cypher,Omen,Fade","Raze,Cypher,Reyna,Omen,Skye"
Ascent,NOMAD,Colors Esport,9,13,6,6,7,3,"Cypher,Sova,Phoenix,Omen,Chamber","Sova,Killjoy,Omen,Jett,KAY/O"
Split,Strangers,EntryFrogs,7,13,5,7,6,2,"Breach,Raze,Cypher,Omen,Jett","Breach,Raze,Cypher,Viper,Omen"
Lotus,Ensemble eSports,I TARALLINI,9,13,4,6,7,5,"Raze,Killjoy,Viper,Omen,Fade","Raze,Cypher,Omen,Jett,Skye"
Icebox,G2 Gozen,GIANTX GC,13,15,7,7,8,6,"Viper,Phoenix,Sage,Jett,Yoru","Raze,Viper,Reyna,Yoru,Gekko"
Lotus,Five Fingers of the Hand,charbon,1,13,1,11,2,0,"Raze,Killjoy,Sage,Gekko,Clove","Raze,Cypher,Phoenix,Omen,Gekko"
Bind,ROAW,Team PALM GC,13,8,9,0,8,4,"Breach,Raze,Cypher,Brimstone,Fade","Cypher,Phoenix,Brimstone,Sage,Gekko"
Ascent,G2 Gozen,GIANTX GC,13,2,12,0,2,1,"Raze,Cypher,Phoenix,Omen,Jett","Raze,Cypher,Omen,Jett,Yoru"
Split,Bleed Esports,DetonatioN FocusMe,13,7,10,2,5,3,"Raze,Viper,Omen,Jett,Skye","Raze,Cypher,Viper,Omen,Skye"
Lotus,Prototype,NUXERIA GC,13,11,6,6,5,7,"Breach,Raze,Killjoy,Omen,Gekko","Breach,Raze,Killjoy,Omen,Skye"
Split,Cicadas Gaming,Bakim Corp,3,13,0,4,9,3,"Raze,Reyna,Skye,Astra,Chamber","Raze,Cypher,Viper,Omen,Skye"
Split,NOMAD,Colors Esport,9,13,5,5,8,4,"Breach,Raze,Cypher,Omen,Fade","Breach,Raze,Viper,Omen,Skye"
Bind,charbon,VICE CORP,13,1,2,0,1,11,"Raze,Viper,Skye,Gekko,Clove","Raze,Cypher,Brimstone,Skye,Gekko"
Bind,F9 Wonders,Irregulars GC,13,0,12,0,0,1,"Raze,Viper,Brimstone,Skye,Gekko","Raze,Cypher,Viper,Skye,Clove"
Ascent,Pamplepouffs,ValkyRizz,13,3,2,2,1,11,"Sova,Killjoy,Omen,Jett,KAY/O","Sova,Killjoy,Jett,KAY/O,Clove"
Split,Merguez bien guez,all cooked,1,13,1,1,12,0,"Raze,Killjoy,Sage,Skye,Clove","Breach,Cypher,Omen,Jett,Skye"
Bind,ICY E-SPORT,DRAKAINAS,8,13,2,7,6,6,"Raze,Cypher,Viper,Brimstone,Skye","Breach,Raze,Viper,Brimstone,Yoru"
Ascent,Sa Kour'A,Jenhstars,13,0,12,0,0,1,"Sova,Killjoy,Omen,Jett,KAY/O","Cypher,Sage,Skye,Neon,Clove"
Lotus,L'Olympique des Merveilles,les retraitées,15,13,10,4,9,5,"Breach,Raze,Killjoy,Omen,Gekko","Killjoy,Viper,Omen,Jett,Skye"
Bind,SIPAKELY,NOMAD GC,1,13,1,11,2,0,"Killjoy,Reyna,Jett,Skye,Clove","Raze,Killjoy,Omen,Skye,Fade"
Bind,ARTORIAS GAMING,Team Yazoukew,13,7,9,3,4,4,"Raze,Cypher,Jett,Skye,Clove","Raze,Viper,Brimstone,Skye,Gekko"
Sunset,Scald eSport GC,WinX GC,13,0,12,0,0,1,"Breach,Raze,Cypher,Omen,Harbor","Cypher,Viper,Gekko,Iso,Clove"
Sunset,Les oubliées,TDSwordys,8,13,5,7,6,3,"Raze,Cypher,Sova,Phoenix,Omen","Breach,Raze,Cypher,Omen,Fade"
Sunset,Projet Améthyste,Rizzlers,5,13,3,3,10,2,"Breach,Raze,Cypher,Sova,Omen","Breach,Raze,Cypher,Omen,Jett"
Bind,Spice Girls,Team PALM GC,1,13,0,2,11,1,"Raze,Killjoy,Brimstone,Gekko,Deadlock","Cypher,Phoenix,Brimstone,Sage,Gekko"
Bind,KawaiiKittens,Absolute Cinema,2,13,1,11,2,1,"Killjoy,Viper,Omen,Jett,Fade","Raze,Cypher,Brimstone,Skye,Yoru"
Ascent,TOTALLY SPIKE,Cervo Porte,11,13,7,5,8,4,"Breach,Cypher,Jett,Skye,Clove","Sova,Killjoy,Omen,Jett,KAY/O"
Bind,G2 Gozen,GIANTX GC,11,13,4,8,5,7,"Raze,Brimstone,Reyna,Yoru,Gekko","Raze,Viper,Reyna,Yoru,Harbor"
Lotus,Bleed Esports,DetonatioN FocusMe,9,13,2,8,5,7,"Raze,Killjoy,Viper,Omen,Fade","Raze,Killjoy,Viper,Omen,Fade"
Sunset,Owls UPC,chuvisexuales edicom lovers,13,8,8,4,4,5,"Cypher,Sova,Omen,Jett,Gekko","Breach,Raze,Cypher,Omen,Gekko"
Split,Gen.G Esports,DRX,7,13,6,6,7,1,"Raze,Viper,Omen,Jett,Skye","Raze,Cypher,Viper,Omen,Skye"
Icebox,Owls UPC,chuvisexuales edicom lovers,13,10,5,7,3,8,"Sova,Killjoy,Viper,Reyna,Jett","Sova,Killjoy,Viper,Jett,Gekko"
Ascent,Gen.G Esports,DRX,13,9,8,2,7,5,"Sova,Killjoy,Omen,Jett,KAY/O","Sova,Killjoy,Omen,Jett,KAY/O"
Breeze,Owls UPC,chuvisexuales edicom lovers,6,13,2,5,8,4,"Cypher,Sova,Viper,Jett,KAY/O","Cypher,Sova,Viper,Jett,KAY/O"
Ascent,Owls UPC,chuvisexuales edicom lovers,13,0,1,0,0,12,"Sova,Killjoy,Omen,Jett,KAY/O","Cypher,Sova,Omen,Jett,KAY/O"
Bind,Gen.G Esports,DRX,10,13,6,5,8,4,"Raze,Cypher,Viper,Brimstone,Skye","Raze,Cypher,Viper,Brimstone,KAY/O"
Sunset,Infiriumz Gaming,One Bullet Gaming,13,3,9,3,0,4,"Raze,Cypher,Omen,KAY/O,Gekko","Breach,Raze,Cypher,Omen,KAY/O"
Lotus,Infiriumz Gaming,One Bullet Gaming,7,13,1,7,6,6,"Raze,Killjoy,Viper,Omen,Fade","Breach,Raze,Sova,Chamber,Clove"
Split,Ragnus Esports,Duality Esports,2,13,2,10,3,0,"Cypher,Sage,Yoru,Iso,Clove","Skye,Yoru,Harbor,Iso,Clove"
Sunset,Ragnus Esports,Duality Esports,3,13,1,11,2,2,"Cypher,Sova,Omen,Neon,Gekko","Raze,Viper,Omen,KAY/O,Gekko"
Bind,Barcelona Sporting X,KS Esports GC,9,13,8,4,9,1,"Raze,Viper,Jett,Skye,Astra","Raze,Viper,Brimstone,Skye,Yoru"
Bind,Northwood University,MBU Spartans,13,10,5,6,4,8,"Breach,Raze,Cypher,Sova,Brimstone","Raze,Viper,Brimstone,Skye,Gekko"
Sunset,Dough Bros,Winthrop University,5,13,3,9,4,2,"Raze,Cypher,Omen,KAY/O,Gekko","Breach,Raze,Cypher,Omen,Fade"
Breeze,DreamMax GC,REVOADA,3,13,0,4,9,3,"Cypher,Sova,Viper,Jett,KAY/O","Cypher,Sova,Viper,Jett,KAY/O"
Lotus,Barcelona Sporting X,KS Esports GC,6,13,2,5,8,4,"Raze,Killjoy,Omen,Skye,Fade","Breach,Raze,Cypher,Omen,Gekko"
Sunset,SJF Valorant Black,Trine University,5,13,2,4,9,3,"Cypher,Viper,Omen,KAY/O,Gekko","Cypher,Reyna,Omen,Jett,Gekko"
Lotus,Northwood University,MBU Spartans,13,7,7,1,6,6,"Raze,Sova,Killjoy,Viper,Omen","Breach,Raze,Omen,Chamber,Gekko"
Ascent,Malecient,Overkill Gaming Clan,10,13,6,6,7,4,"Sova,Killjoy,Omen,Jett,KAY/O","Sova,Killjoy,Omen,Jett,KAY/O"
Icebox,Dough Bros,Winthrop University,7,13,4,8,5,3,"Killjoy,Viper,Jett,KAY/O,Gekko","Sova,Killjoy,Viper,Reyna,Jett"
Split,SJF Valorant Black,Trine University,7,13,3,5,8,4,"Raze,Cypher,Viper,Omen,Skye","Cypher,Reyna,Omen,Jett,Gekko"
Breeze,9z Team GC,FiRePOWER GC,8,13,2,7,6,6,"Cypher,Sova,Viper,Jett,KAY/O","Cypher,Sova,Viper,Omen,Yoru"
Lotus,Malecient,Overkill Gaming Clan,13,2,11,1,1,2,"Raze,Killjoy,Omen,Chamber,Gekko","Raze,Killjoy,Viper,Omen,Gekko"
Icebox,DreamMax GC,REVOADA,13,10,8,3,7,5,"Sova,Killjoy,Viper,Sage,Jett","Sova,Killjoy,Viper,Jett,KAY/O"
Breeze,TAMU Maroon,UCF Gold,13,11,8,4,7,5,"Sova,Viper,Jett,Yoru,Astra","Cypher,Sova,Viper,Jett,Yoru"
Split,Unity Brasil,Stellae Gaming Academy,13,6,10,2,4,3,"Breach,Raze,Viper,Omen,Gekko","Raze,Cypher,Omen,Skye,Gekko"
Lotus,Dough Bros,Winthrop University,13,11,8,4,7,5,"Raze,Killjoy,Viper,Omen,Fade","Raze,Killjoy,Viper,Omen,Fade"
Ascent,SJF Valorant Black,Trine University,10,13,6,6,7,4,"Sova,Killjoy,Omen,Jett,KAY/O","Cypher,Sova,Phoenix,Omen,Jett"
Ascent,The Ultimates Odyssey,R8 Blues,10,13,5,6,7,5,"Sova,Killjoy,Omen,Jett,KAY/O","Sova,Killjoy,Jett,Astra,KAY/O"
Split,TAMU Maroon,UCF Gold,13,2,3,0,2,10,"Raze,Cypher,Viper,Omen,Skye","Raze,Cypher,Viper,Omen,Skye"
Icebox,9z Team GC,FiRePOWER GC,15,13,4,10,3,11,"Sova,Killjoy,Viper,Sage,Jett","Killjoy,Viper,Jett,KAY/O,Gekko"
Lotus,DreamMax GC,REVOADA,7,13,4,4,9,3,"Raze,Killjoy,Viper,Omen,Skye","Raze,Killjoy,Viper,Omen,Fade"
Bind,Unity Brasil,Stellae Gaming Academy,13,5,8,4,1,5,"Raze,Viper,Brimstone,Skye,Gekko","Raze,Viper,Skye,Chamber,Clove"
Sunset,Dragons Esports GC,Gamax Lite,5,13,2,4,9,3,"Breach,Raze,Cypher,Omen,Gekko","Breach,Raze,Cypher,Omen,Gekko"
Lotus,M80,DarkZero Esports,5,13,0,6,7,5,"Raze,Killjoy,Viper,Omen,Fade","Breach,Raze,Cypher,Omen,Fade"
Icebox,The Ultimates Odyssey,R8 Blues,15,13,9,5,8,6,"Sova,Killjoy,Viper,Sage,Jett","Sova,Killjoy,Viper,Sage,Neon"
Lotus,Unity Brasil,Stellae Gaming Academy,8,13,4,8,5,4,"Raze,Killjoy,Viper,Omen,Fade","Raze,Killjoy,Viper,Omen,Skye"
Icebox,donas da bala,Team Leveling,4,13,2,3,10,2,"Sova,Killjoy,Viper,Jett,Gekko","Sova,Killjoy,Viper,Jett,Gekko"
Split,9z Team GC,FiRePOWER GC,6,13,3,9,4,3,"Raze,Viper,Sage,Skye,Astra","Raze,Cypher,Viper,Omen,Skye"
Ascent,Dragons Esports GC,Gamax Lite,7,13,3,5,8,4,"Sova,Killjoy,Omen,Jett,KAY/O","Sova,Killjoy,Omen,Jett,KAY/O"
Ascent,M80,DarkZero Esports,5,13,1,5,8,4,"Sova,Killjoy,Omen,Jett,KAY/O","Cypher,Sova,Omen,Jett,Deadlock"
Lotus,The Ultimates Odyssey,R8 Blues,10,13,8,4,9,2,"Breach,Raze,Killjoy,Omen,Skye","Killjoy,Viper,Omen,Skye,Neon"
Sunset,donas da bala,Team Leveling,13,11,4,8,3,9,"Raze,Cypher,Omen,KAY/O,Gekko","Breach,Raze,Cypher,Omen,Fade"
Lotus,Dragons Esports GC,Gamax Lite,13,11,9,3,8,4,"Raze,Killjoy,Viper,Omen,Fade","Breach,Raze,Killjoy,Omen,Gekko"
Icebox,M80,DarkZero Esports,13,5,5,1,4,8,"Killjoy,Viper,Omen,KAY/O,Gekko","Cypher,Sova,Viper,Omen,KAY/O"
Split,Twisted Minds Orchid,Team Falcons Vega,10,13,3,8,5,7,"Breach,Raze,Cypher,Viper,Omen","Breach,Raze,Cypher,Omen,Skye"
Icebox,FNATIC,KOI,13,4,8,4,0,5,"Sova,Killjoy,Viper,Sage,Jett","Killjoy,Viper,Omen,KAY/O,Gekko"
Breeze,donas da bala,Team Leveling,6,13,5,7,6,1,"Cypher,Sova,Viper,Jett,KAY/O","Cypher,Sova,Viper,Jett,Yoru"
Lotus,Twisted Minds Orchid,Team Falcons Vega,4,13,0,5,8,4,"Killjoy,Viper,Omen,Neon,Gekko","Raze,Killjoy,Viper,Omen,Fade"
Ascent,Gamax Lite,The Ultimates Odyssey,9,13,2,8,5,7,"Sova,Killjoy,Omen,Jett,KAY/O","Sova,Killjoy,Omen,Jett,KAY/O"
Sunset,Lumina Gaming,Elysian Esports,13,4,3,2,2,10,"Breach,Raze,Cypher,Sova,Omen","Breach,Raze,Cypher,Omen,Fade"
Lotus,DSQ Esports,wasted Potential,13,9,7,5,4,6,"Raze,Cypher,Phoenix,Omen,Gekko","Raze,Killjoy,Viper,Omen,Fade"
Bind,Team Falcons Vega,R8 Blues,13,3,3,1,2,10,"Raze,Brimstone,Reyna,Skye,Harbor","Viper,Brimstone,Sage,Skye,Neon"
Bind,FNATIC,KOI,13,11,10,2,9,3,"Raze,Viper,Brimstone,Skye,Gekko","Raze,Viper,Brimstone,KAY/O,Gekko"
Bind,Lumina Gaming,Elysian Esports,13,3,10,2,1,3,"Raze,Viper,Brimstone,Skye,Yoru","Raze,Viper,Brimstone,Skye,Gekko"
Sunset,Gamax Lite,The Ultimates Odyssey,15,13,8,6,7,7,"Breach,Raze,Cypher,Omen,Gekko","Raze,Cypher,Viper,Omen,Fade"
Sunset,DSQ Esports,wasted Potential,5,13,3,9,4,2,"Breach,Viper,Omen,Yoru,Gekko","Breach,Cypher,Viper,Omen,KAY/O"
Split,Free Orbs,Vision Esports (EU),13,6,10,2,4,3,"Raze,Cypher,Viper,Omen,Skye","Raze,Cypher,Viper,Omen,Skye"
Ascent,BLINDOHOLIK,Akira Esports,13,4,4,1,3,9,"Sova,Killjoy,Omen,Jett,Yoru","Sova,Killjoy,Omen,Jett,KAY/O"
Lotus,Team Falcons Vega,R8 Blues,13,4,9,3,1,4,"Raze,Killjoy,Viper,Omen,Fade","Killjoy,Viper,Omen,Skye,Neon"
Ascent,Team Liquid,GIANTX,13,11,4,8,3,9,"Cypher,Sova,Viper,Omen,Yoru","Cypher,Sova,Omen,Jett,KAY/O"
Lotus,Gamax Lite,The Ultimates Odyssey,5,13,4,8,5,1,"Breach,Raze,Killjoy,Omen,Chamber","Breach,Raze,Killjoy,Omen,Skye"
Icebox,Lumina Gaming,Elysian Esports,11,13,7,5,8,4,"Killjoy,Viper,Reyna,KAY/O,Gekko","Sova,Killjoy,Viper,Sage,Jett"
Breeze,Free Orbs,Vision Esports (EU),13,9,7,5,4,6,"Cypher,Viper,Omen,Yoru,KAY/O","Cypher,Sova,Viper,Yoru,Astra"
Breeze,BLINDOHOLIK,Akira Esports,13,4,10,2,2,3,"Cypher,Sova,Viper,Jett,Astra","Cypher,Sova,Viper,Jett,Skye"
Bind,DSQ Esports,wasted Potential,15,13,8,6,7,7,"Raze,Viper,Omen,Yoru,Gekko","Breach,Viper,Yoru,Astra,Gekko"
Icebox,Team Liquid,GIANTX,13,7,9,3,4,4,"Sova,Killjoy,Viper,Jett,Harbor","Killjoy,Viper,KAY/O,Chamber,Gekko"
Lotus,Team Liquid,GIANTX,14,16,8,7,9,6,"Breach,Raze,Cypher,Sova,Omen","Raze,Killjoy,Viper,Omen,Fade"
Icebox,True Rippers,Medal Esports,13,5,8,4,1,5,"Sova,Killjoy,Viper,Jett,Gekko","Sova,Killjoy,Viper,Sage,Jett"
Ascent,True Rippers,Medal Esports,13,9,4,6,3,9,"Sova,Killjoy,Omen,Jett,KAY/O","Breach,Viper,Phoenix,Omen,KAY/O"
Split,FearX,SLT Seongam,13,11,3,9,2,10,"Raze,Cypher,Viper,Omen,KAY/O","Breach,Raze,Cypher,Skye,Astra"
Lotus,FearX,SLT Seongam,13,2,10,2,0,3,"Raze,Killjoy,Viper,Omen,Fade","Breach,Raze,Killjoy,Omen,Gekko"
Bind,Revenant Esports,Grayfox Esports,13,1,2,0,1,11,"Raze,Cypher,Viper,Brimstone,Skye","Breach,Raze,Cypher,Brimstone,Skye"
Breeze,FearX,SLT Seongam,13,3,3,1,2,10,"Cypher,Sova,Viper,Jett,KAY/O","Cypher,Sova,Viper,Jett,Yoru"
Lotus,Revenant Esports,Grayfox Esports,13,3,9,3,0,4,"Raze,Killjoy,Viper,Omen,Fade","Raze,Killjoy,Viper,Omen,Fade"
Icebox,FearX,SLT Seongam,10,13,5,6,7,5,"Sova,Killjoy,Viper,Reyna,Jett","Viper,Reyna,Omen,Jett,Gekko"
Icebox,K7 Esports GC,FUSION X,10,13,2,9,4,8,"Sova,Killjoy,Viper,Sage,Jett","Sova,Killjoy,Viper,Reyna,Gekko"
Lotus,K7 Esports GC,FUSION X,4,13,1,4,9,3,"Raze,Killjoy,Viper,Omen,Skye","Raze,Killjoy,Viper,Omen,Fade"
Breeze,FLUFFY AIMERS,Thinking Men,12,14,7,6,8,5,"Cypher,Viper,Jett,Astra,KAY/O","Sova,Viper,Jett,Yoru,Astra"
Bind,University War GC,KRÜ BLAZE,5,13,2,4,9,3,"Raze,Viper,Brimstone,Skye,Chamber","Raze,Viper,Brimstone,Skye,Gekko"
Bind,FLUFFY AIMERS,Thinking Men,13,15,7,7,8,6,"Raze,Viper,Astra,Fade,Gekko","Raze,Viper,Omen,Skye,Gekko"
Icebox,LOUD GC,REVOADA,13,6,8,4,2,5,"Sova,Viper,Sage,Jett,KAY/O","Sova,Killjoy,Viper,Jett,KAY/O"
Lotus,FLUFFY AIMERS,Thinking Men,13,9,9,3,6,4,"Raze,Killjoy,Viper,Omen,Fade","Raze,Cypher,Omen,Jett,Skye"
Sunset,University War GC,KRÜ BLAZE,10,13,3,8,5,7,"Breach,Raze,Cypher,Omen,Fade","Breach,Raze,Cypher,Omen,Fade"
Bind,LOUD GC,REVOADA,13,10,6,5,5,7,"Raze,Viper,Brimstone,Fade,Gekko","Raze,Viper,Brimstone,Skye,Chamber"
Split,YFP Gaming,Moist x Shopify,4,13,4,8,5,0,"Raze,Viper,Omen,Jett,Skye","Raze,Cypher,Viper,Skye,Astra"
Breeze,MIBR GC,DreamMax GC,13,1,11,1,0,2,"Cypher,Sova,Viper,Jett,KAY/O","Cypher,Sova,Viper,Jett,KAY/O"
Sunset,Dragons Esports GC,Team Falcons Vega,1,13,0,2,11,1,"Raze,Cypher,Viper,Omen,Skye","Breach,Raze,Cypher,Omen,Fade"
Lotus,YFP Gaming,Moist x Shopify,8,13,6,6,7,2,"Raze,Killjoy,Viper,Omen,Fade","Breach,Raze,Cypher,Brimstone,Gekko"
Lotus,MIBR GC,DreamMax GC,13,5,9,3,2,4,"Raze,Killjoy,Viper,Omen,Fade","Raze,Killjoy,Viper,Omen,Skye"
Lotus,Dragons Esports GC,Team Falcons Vega,5,13,1,5,8,4,"Raze,Killjoy,Viper,Omen,Fade","Raze,Killjoy,Viper,Omen,Fade"
Split,R8 Blues,Gamax Lite,13,8,3,6,2,10,"Raze,Killjoy,Viper,Omen,Skye","Cypher,Sage,Omen,Jett,Skye"
Sunset,Team Vitality,FUT Esports,13,9,6,6,3,7,"Raze,Viper,Omen,KAY/O,Gekko","Raze,Cypher,Omen,Gekko,Deadlock"
Lotus,Twisted Minds Orchid,Dragons Esports GC,13,4,4,1,3,9,"Killjoy,Viper,Omen,Neon,Gekko","Raze,Killjoy,Viper,Omen,Fade"
Icebox,Team Vitality,FUT Esports,13,9,7,3,6,6,"Raze,Killjoy,Viper,KAY/O,Gekko","Sova,Viper,Sage,Jett,KAY/O"
Icebox,R8 Blues,Gamax Lite,13,10,8,4,6,5,"Sova,Killjoy,Viper,Sage,Neon","Sova,Killjoy,Viper,Jett,Gekko"
Sunset,Twisted Minds Orchid,Dragons Esports GC,13,7,5,3,4,8,"Breach,Raze,Cypher,Omen,Gekko","Raze,Cypher,Viper,Omen,Skye"
Ascent,Team Vitality,FUT Esports,7,13,3,5,8,4,"Sova,Killjoy,Omen,Jett,KAY/O","Sova,Killjoy,Omen,Jett,KAY/O"
Sunset,BBL Esports,Team Heretics,13,10,7,4,6,6,"Raze,Cypher,Omen,KAY/O,Gekko","Cypher,Sova,Omen,KAY/O,Neon"
Split,BBL Esports,Team Heretics,13,7,7,5,2,6,"Breach,Raze,Viper,Omen,Skye","Raze,Cypher,Brimstone,Omen,Skye"
Sunset,Revenant Esports,Medal Esports,13,1,11,1,0,2,"Viper,Sage,Omen,KAY/O,Gekko","Raze,Cypher,Omen,KAY/O,Gekko"
Ascent,Revenant Esports,Medal Esports,13,10,5,6,4,8,"Sova,Killjoy,Omen,Jett,KAY/O","Breach,Viper,Phoenix,Omen,KAY/O"
Lotus,Revenant Esports,Medal Esports,11,13,3,9,4,8,"Raze,Killjoy,Viper,Omen,Fade","Raze,Killjoy,Viper,Omen,Fade"
Lotus,Reckoning Esports,True Rippers,3,13,3,9,4,0,"Raze,Killjoy,Viper,Omen,Fade","Raze,Killjoy,Viper,Omen,Fade"
Split,Reckoning Esports,True Rippers,10,13,5,7,6,5,"Raze,Cypher,Sage,Omen,Skye","Raze,Cypher,Viper,Omen,Skye"
Bind,FinalFormHQ,Sussy Players,13,5,9,3,2,4,"Raze,Cypher,Brimstone,Skye,Gekko","Raze,Viper,Brimstone,Skye,Yoru"
Icebox,Zen Esports,OXEN,13,2,2,1,1,11,"Killjoy,Viper,Jett,KAY/O,Gekko","Killjoy,Viper,Reyna,KAY/O,Gekko"
Ascent,UT Austin,WKU Hilltoppers RED,13,8,10,2,6,3,"Sova,Killjoy,Omen,Jett,KAY/O","Sova,Killjoy,Jett,KAY/O,Clove"
Breeze,Harrisburg University,Maryville University,6,13,3,9,4,3,"Cypher,Sova,Viper,Yoru,KAY/O","Cypher,Sova,Viper,Jett,KAY/O"
Breeze,Converse Purple,University of Virginia,13,8,5,4,4,8,"Cypher,Sova,Viper,Jett,KAY/O","Cypher,Sova,Viper,Jett,Yoru"
Bind,Huskies,FinalFormHQ,1,13,0,2,11,1,"Raze,Cypher,Viper,Brimstone,Skye","Raze,Cypher,Brimstone,Skye,Gekko"
Lotus,Akave Esports Black,MYVRA,14,12,7,6,6,7,"Raze,Viper,Omen,Chamber,Fade","Breach,Raze,Cypher,Omen,Gekko"
Lotus,Sussy Players,Akron Esports,16,14,10,5,9,6,"Raze,Cypher,Omen,Fade,Gekko","Raze,Viper,Omen,Chamber,Gekko"
Ascent,Oxygen Esports,QoR,7,13,4,8,5,3,"Sova,Killjoy,Omen,Jett,KAY/O","Cypher,Omen,Jett,KAY/O,Fade"
Breeze,Kent State University,Quanna Team,7,13,5,7,6,2,"Cypher,Sova,Viper,Yoru,KAY/O","Cypher,Sova,Viper,Jett,KAY/O"
Split,UT Austin,WKU Hilltoppers RED,5,13,4,8,5,1,"Raze,Viper,Omen,Yoru,Fade","Cypher,Viper,Reyna,Skye,Clove"
Ascent,Zen Esports,OXEN,11,13,5,7,6,6,"Sova,Killjoy,Omen,Jett,KAY/O","Sova,Killjoy,Omen,Yoru,KAY/O"
Split,Converse Purple,University of Virginia,13,7,6,2,5,7,"Breach,Raze,Cypher,Viper,Omen","Raze,Omen,Yoru,Astra,Fade"
Ascent,Huskies,Dhap's Daycare,13,5,8,4,1,5,"Sova,Killjoy,Omen,Jett,KAY/O","Sova,Killjoy,Omen,Jett,KAY/O"
Lotus,Harrisburg University,Maryville University,10,13,4,7,6,6,"Killjoy,Viper,Omen,Neon,Gekko","Raze,Killjoy,Viper,Omen,Fade"
Split,Akave Esports Black,MYVRA,13,5,6,0,5,7,"Breach,Raze,Cypher,Omen,Skye","Raze,Cypher,Viper,Omen,Skye"
Bind,Shinjitsu,FinalFormHQ,5,13,1,5,8,4,"Raze,Viper,Jett,Skye,Clove","Raze,Cypher,Brimstone,Skye,Gekko"
Sunset,Sussy Players,Astane Anarchy,13,10,5,6,4,8,"Raze,Cypher,Omen,KAY/O,Gekko","Raze,Cypher,Omen,KAY/O,Gekko"
Lotus,UT Austin,WKU Hilltoppers RED,13,7,5,3,4,8,"Raze,Killjoy,Omen,Skye,Yoru","Breach,Raze,Killjoy,Omen,Skye"
Breeze,greatest to ever do it,Quanna Team,11,13,5,7,6,6,"Cypher,Sova,Viper,Reyna,Jett","Cypher,Sova,Viper,Jett,KAY/O"
Sunset,Oxygen Esports,QoR,13,10,7,5,5,6,"Breach,Raze,Cypher,Omen,KAY/O","Breach,Raze,Cypher,Sova,Omen"
Ascent,Cruzados Esports,ONA Family,10,13,5,7,6,5,"Cypher,Sova,Omen,Jett,KAY/O","Sova,Killjoy,Omen,Jett,KAY/O"
Ascent,UNLP Esports,KRÜ BLAZE,1,13,1,11,2,0,"Sova,Killjoy,Omen,Jett,KAY/O","Sova,Killjoy,Omen,Jett,KAY/O"
Split,STARFIRE,Huskies,4,13,4,8,5,0,"Raze,Cypher,Viper,Omen,Skye","Cypher,Viper,Omen,Jett,Skye"
Sunset,Rebirth Esports,Border Monsters Chile,13,11,4,8,3,9,"Breach,Raze,Cypher,Omen,KAY/O","Raze,Cypher,Omen,KAY/O,Gekko"
Ascent,TENGAN MIEDO,LRV Esports,13,8,8,1,7,5,"Sova,Killjoy,Omen,Jett,KAY/O","Sova,Killjoy,Omen,Jett,KAY/O"
Lotus,L2CREW,Sussy Players,3,13,0,4,9,3,"Raze,Killjoy,Omen,Skye,Gekko","Raze,Cypher,Omen,Fade,Gekko"
Breeze,Kent State University,Hyperion Gold,13,6,9,3,3,4,"Cypher,Sova,Viper,Yoru,KAY/O","Cypher,Sova,Viper,Jett,KAY/O"
Sunset,Outlast Gaming,Akron Esports,5,13,4,8,5,1,"Raze,Cypher,Omen,KAY/O,Gekko","Breach,Raze,Cypher,Sova,Omen"
Bind,Cruzados Esports,ONA Family,7,13,4,4,9,3,"Cypher,Brimstone,Reyna,Jett,Skye","Raze,Viper,Skye,Harbor,Gekko"
Lotus,UNLP Esports,KRÜ BLAZE,2,13,0,3,10,2,"Raze,Killjoy,Viper,Skye,Clove","Raze,Killjoy,Viper,Omen,Fade"
Bind,TENGAN MIEDO,LRV Esports,13,4,5,0,4,8,"Raze,Viper,Brimstone,Skye,Chamber","Raze,Viper,Brimstone,Fade,Gekko"
Sunset,Cruzados Esports GC,Leviatán GC,7,13,6,6,7,1,"Breach,Raze,Cypher,Omen,Fade","Raze,Cypher,Omen,KAY/O,Gekko"
Lotus,Rebirth Esports,Border Monsters Chile,13,11,8,4,7,5,"Breach,Raze,Cypher,Omen,Jett","Raze,Killjoy,Viper,Omen,Fade"
Lotus,TBS GC,Team Leveling,13,3,4,0,3,9,"Raze,Killjoy,Viper,Omen,Fade","Raze,Killjoy,Viper,Omen,Fade"
Lotus,Oxygen Esports,QoR,8,13,4,8,5,4,"Raze,Killjoy,Viper,Omen,Skye","Raze,Sova,Killjoy,Viper,Omen"
Ascent,FinalFormHQ,LC,15,13,7,7,6,8,"Sova,Killjoy,Omen,Jett,KAY/O","Sova,Killjoy,Jett,Astra,KAY/O"
Breeze,greatest to ever do it,The Barn Animals,13,0,12,0,0,1,"Cypher,Sova,Viper,Jett,Yoru","Cypher,Viper,Jett,KAY/O,Fade"
Breeze,Hale,Quanna Team,13,15,5,9,6,8,"Sova,Viper,Jett,Yoru,Astra","Cypher,Sova,Viper,Jett,KAY/O"
Ascent,Final Form Black,Dhap's Daycare,2,13,2,10,3,0,"Sova,Killjoy,Omen,Jett,KAY/O","Sova,Killjoy,Omen,Jett,KAY/O"
Sunset,blueming,Akron Esports,5,13,4,8,5,1,"Cypher,Sova,Reyna,Omen,Gekko","Breach,Raze,Cypher,Sova,Omen"
Ascent,SMU Valorant,Shinjitsu,7,13,2,6,7,5,"Sova,Killjoy,Jett,Astra,KAY/O","Sova,Killjoy,Omen,Jett,KAY/O"
Breeze,Hyperion Gold,No Scrims No Problem,13,11,10,2,9,3,"Cypher,Sova,Viper,Jett,KAY/O","Cypher,Sova,Viper,Jett,Yoru"
Breeze,Cool Guys,No Scrims No Problem,4,13,0,5,8,4,"Cypher,Sova,Viper,Jett,KAY/O","Cypher,Sova,Viper,Jett,Yoru"
Breeze,Good Gamers,The Barn Animals,8,13,5,7,6,3,"Cypher,Sova,Viper,Yoru,Harbor","Cypher,Sova,Viper,Reyna,Gekko"
Breeze,Hyperion Gold,Escrow Zero,13,1,2,0,1,11,"Cypher,Sova,Viper,Jett,KAY/O","Sova,Viper,Jett,Yoru,Astra"
Breeze,Quanna Team,99 do-gooders,13,2,10,2,0,3,"Cypher,Sova,Viper,Jett,KAY/O","Cypher,Sova,Viper,Jett,KAY/O"
Bind,Cruzados Esports GC,Leviatán GC,11,13,3,9,4,8,"Raze,Viper,Brimstone,Fade,Gekko","Raze,Viper,Brimstone,Skye,Yoru"
Icebox,TBS GC,Team Leveling,14,12,5,8,4,9,"Sova,Killjoy,Viper,Jett,Gekko","Sova,Killjoy,Viper,Jett,Gekko"
Ascent,TSM,SaD Esports,9,13,4,8,5,5,"Cypher,Viper,Omen,Jett,KAY/O","Sova,Killjoy,Omen,Jett,KAY/O"
Ascent,Team Liquid Brazil,donas da bala,13,5,9,3,2,4,"Sova,Killjoy,Omen,Jett,KAY/O","Sova,Killjoy,Omen,Jett,KAY/O"
Breeze,TSM,SaD Esports,13,6,10,2,4,3,"Sova,Viper,Jett,Yoru,Astra","Cypher,Sova,Viper,Jett,KAY/O"
Lotus,The Ultimates Odyssey,Twisted Minds Orchid,11,13,6,6,7,5,"Breach,Raze,Killjoy,Omen,Skye","Killjoy,Viper,Omen,Neon,Gekko"
Split,TSM,SaD Esports,5,13,0,6,7,5,"Raze,Cypher,Viper,Omen,Skye","Raze,Cypher,Viper,Omen,Skye"
Breeze,Dragons Esports GC,XO Nova,9,13,7,5,8,2,"Sova,Viper,Reyna,Jett,Gekko","Cypher,Sova,Viper,Jett,Chamber"
Bind,Team Liquid Brazil,donas da bala,13,4,10,2,2,3,"Raze,Viper,Brimstone,Skye,Gekko","Breach,Viper,Phoenix,Brimstone,Gekko"
Bind,The Ultimates Odyssey,Twisted Minds Orchid,6,13,6,6,7,0,"Raze,Viper,Sage,Omen,Skye","Raze,Cypher,Viper,Brimstone,Skye"
Sunset,OOT Esports,Free Orbs,13,6,7,5,1,6,"Breach,Raze,Cypher,Omen,Jett","Raze,Cypher,Omen,KAY/O,Gekko"
Split,wasted Potential,Dipsy & Co,13,5,8,4,1,5,"Breach,Raze,Viper,Omen,Skye","Raze,Cypher,Viper,Omen,Skye"
Split,Dragons Esports GC,XO Nova,7,13,4,8,5,3,"Breach,Raze,Cypher,Omen,Skye","Breach,Raze,Cypher,Omen,Skye"
Icebox,DSQ Esports,Andromeda Gaming,3,13,1,3,10,2,"Viper,Yoru,Chamber,Harbor,Gekko","Sova,Killjoy,Viper,Jett,Harbor"
Split,Karmine Corp,Natus Vincere,6,13,3,9,4,3,"Raze,Viper,Omen,Yoru,Fade","Breach,Raze,Viper,Omen,Fade"
Split,OOT Esports,Free Orbs,9,13,6,6,7,3,"Raze,Cypher,Omen,Jett,Skye","Raze,Cypher,Viper,Omen,Skye"
Lotus,wasted Potential,Dipsy & Co,13,10,6,5,5,7,"Raze,Killjoy,Viper,Omen,Fade","Raze,Killjoy,Viper,Omen,Fade"
Breeze,Team Calamity,Vision Esports (EU),5,13,5,7,6,0,"Cypher,Sova,Viper,Jett,KAY/O","Cypher,Sova,Viper,Yoru,Astra"
Sunset,DSQ Esports,Andromeda Gaming,2,13,0,3,10,2,"Raze,Cypher,Omen,KAY/O,Gekko","Breach,Raze,Cypher,Omen,Fade"
Lotus,INF Esports,Elysian Esports,10,13,5,7,6,5,"Raze,Killjoy,Viper,Omen,Gekko","Raze,Killjoy,Viper,Omen,Fade"
Sunset,Karmine Corp,Natus Vincere,7,13,2,6,7,5,"Raze,Cypher,Omen,KAY/O,Gekko","Sova,Killjoy,Omen,KAY/O,Neon"
Icebox,NEANLATIYONBOLM,Lumina Gaming,13,2,1,2,0,12,"Killjoy,Viper,Sage,Jett,Gekko","Killjoy,Viper,Reyna,KAY/O,Gekko"
Sunset,wasted Potential,Dipsy & Co,11,13,10,2,11,1,"Breach,Cypher,Viper,Omen,KAY/O","Breach,Raze,Cypher,Omen,Gekko"
Lotus,OOT Esports,Free Orbs,18,16,10,7,9,8,"Raze,Killjoy,Viper,Omen,Fade","Raze,Killjoy,Omen,KAY/O,Gekko"
Bind,Team Calamity,Vision Esports (EU),9,13,4,6,7,5,"Raze,Viper,Brimstone,Skye,Yoru","Raze,Viper,Brimstone,Skye,Gekko"
Breeze,INF Esports,Elysian Esports,7,13,2,6,7,5,"Cypher,Sova,Viper,Jett,KAY/O","Cypher,Sova,Viper,Yoru,KAY/O"
Ascent,NEANLATIYONBOLM,Lumina Gaming,13,3,10,2,1,3,"Sova,Killjoy,Omen,Jett,KAY/O","Sova,Killjoy,Omen,Jett,KAY/O"
Bind,Karmine Corp,Natus Vincere,13,7,8,4,3,5,"Raze,Viper,Omen,Skye,Gekko","Raze,Viper,Brimstone,KAY/O,Gekko"
Lotus,Gentle Mates,FNATIC,4,13,4,8,5,0,"Breach,Raze,Cypher,Phoenix,Omen","Raze,Killjoy,Viper,Omen,Fade"
Breeze,Gentle Mates,FNATIC,6,13,3,9,4,3,"Cypher,Sova,Viper,Phoenix,Yoru","Cypher,Sova,Viper,Yoru,KAY/O"
Lotus,CSULB Black,Demigods At UCSD,13,8,8,4,4,5,"Raze,Killjoy,Viper,Omen,Skye","Raze,Killjoy,Viper,Omen,Fade"
Lotus,Akron Esports,Eternal Focus Crimson,10,13,5,6,7,5,"Raze,Viper,Omen,Chamber,Gekko","Raze,Killjoy,Viper,Omen,Gekko"
Breeze,Potomac State College,Muskingum University,13,11,8,4,7,5,"Cypher,Sova,Omen,Jett,Harbor","Cypher,Sova,Viper,Yoru,KAY/O"
Sunset,BlanK,Akron Esports,2,13,0,3,10,2,"Breach,Raze,Cypher,Omen,Fade","Breach,Raze,Cypher,Sova,Omen"
Icebox,CSULB Black,Demigods At UCSD,13,8,8,1,7,5,"Sova,Killjoy,Viper,Jett,Harbor","Sova,Killjoy,Viper,Reyna,Jett"
Split,Potomac State College,Muskingum University,4,13,3,9,4,1,"Raze,Cypher,Viper,Omen,Skye","Raze,Cypher,Viper,Omen,Skye"
Icebox,NEIT Tigers White,Gallaudet University,6,13,3,4,9,3,"Sova,Killjoy,Viper,Jett,Gekko","Viper,Sage,Jett,KAY/O,Gekko"
Sunset,University of Oklahoma,UT Austin,13,8,6,6,2,7,"Raze,Cypher,Omen,KAY/O,Gekko","Breach,Raze,Cypher,Sova,Omen"
Bind,Columbia College,Brewton Parker College,5,13,3,9,4,2,"Raze,Cypher,Viper,Brimstone,Skye","Raze,Viper,Brimstone,Skye,Yoru"
Lotus,Radford University,Akron Esports,8,13,3,6,7,5,"Raze,Killjoy,Viper,Omen,Fade","Raze,Viper,Omen,Chamber,Gekko"
Bind,Ohio Northern University JV,Randolph-Macon College,6,13,2,5,8,4,"Raze,Cypher,Viper,Brimstone,Skye","Viper,Brimstone,Reyna,Skye,Yoru"
Split,Eternal Focus Crimson,Bionic,13,3,11,1,2,2,"Raze,Cypher,Viper,Omen,Skye","Breach,Raze,Cypher,Omen,Skye"
Icebox,University of Oklahoma,UT Austin,13,9,6,4,5,7,"Killjoy,Viper,Jett,KAY/O,Gekko","Sova,Killjoy,Viper,Jett,KAY/O"
Split,Wichita State Esports,Farmingdale State College,13,3,2,2,1,11,"Raze,Cypher,Viper,Omen,Skye","Breach,Raze,Cypher,Omen,Jett"
Bind,NEIT Tigers White,Gallaudet University,9,13,5,7,6,4,"Raze,Cypher,Viper,Brimstone,Gekko","Cypher,Viper,Brimstone,Yoru,Fade"
Sunset,Potomac State College,Muskingum University,14,12,7,6,6,7,"Raze,Cypher,Omen,Harbor,Gekko","Raze,Cypher,Omen,Fade,Gekko"
Lotus,Columbia College,Brewton Parker College,7,13,6,2,11,1,"Raze,Killjoy,Viper,Fade,Harbor","Raze,Killjoy,Viper,Omen,Fade"
Ascent,Ohio Northern University JV,Randolph-Macon College,5,13,4,8,5,1,"Sova,Killjoy,Omen,Jett,KAY/O","Sova,Killjoy,Omen,Jett,KAY/O"
Breeze,Wichita State Esports,Farmingdale State College,13,2,10,2,0,3,"Sova,Viper,Yoru,KAY/O,Harbor","Cypher,Sova,Viper,Yoru,Neon"
Sunset,Columbia College,Brewton Parker College,10,13,6,6,7,4,"Breach,Raze,Cypher,Sova,Omen","Raze,Cypher,Viper,Omen,Gekko"
Split,Eternal Focus Crimson,SRVR RED,14,12,8,5,7,6,"Raze,Cypher,Viper,Omen,Skye","Raze,Viper,Omen,Jett,Skye"
Lotus,Ohio Northern University JV,Randolph-Macon College,3,13,0,4,9,3,"Breach,Raze,Killjoy,Omen,Gekko","Raze,Viper,Omen,Chamber,Fade"
Sunset,Radford University,Kent State University,15,13,9,5,8,6,"Breach,Raze,Cypher,Omen,Gekko","Viper,Omen,Jett,KAY/O,Gekko"
Icebox,Wichita State Esports,Farmingdale State College,13,2,11,1,1,2,"Sova,Killjoy,Viper,Jett,Harbor","Sova,Killjoy,Viper,Jett,Gekko"
Split,Team Disrupt,LazerrFreeks8,13,10,5,6,4,8,"Raze,Cypher,Viper,Omen,Skye","Raze,Viper,Omen,Jett,Skye"
Lotus,Mizzou Esports,Michigan State University,15,13,5,9,4,10,"Breach,Reyna,Omen,Jett,Chamber","Raze,Killjoy,Viper,Omen,Skye"
Split,NEIT Tigers White,Gallaudet University,13,15,5,9,6,8,"Raze,Cypher,Sage,Omen,Gekko","Breach,Cypher,Viper,Omen,Yoru"
Lotus,Potomac State College,Muskingum University,14,12,11,2,10,3,"Raze,Cypher,Omen,Harbor,Gekko","Raze,Killjoy,Viper,Omen,Fade"
Ascent,Leviatán Academy,Maze Gaming,13,3,4,0,3,9,"Cypher,Sova,Omen,Jett,KAY/O","Sova,Killjoy,Omen,Jett,KAY/O"
Ascent,BlanK,THOTIS MUNCHKINS,13,5,5,1,4,8,"Sova,Killjoy,Omen,Jett,KAY/O","Sova,Killjoy,Omen,Jett,KAY/O"
Sunset,Eternal Focus Crimson,Cooli & Company,13,3,9,3,0,4,"Raze,Cypher,Omen,KAY/O,Gekko","Raze,Cypher,Omen,KAY/O,Gekko"
Lotus,Neglected,Bionic,12,14,9,4,10,3,"Raze,Killjoy,Viper,Omen,Fade","Breach,Raze,Killjoy,Omen,Gekko"
Lotus,CKnights,SRVR RED,1,13,1,11,2,0,"Raze,Killjoy,Viper,Omen,Skye","Raze,Killjoy,Viper,Omen,Fade"
Lotus,LazerrFreeks8,Kent State University,8,13,5,4,9,3,"Raze,Cypher,Omen,Jett,Skye","Raze,Killjoy,Viper,Omen,Fade"
Split,Mizzou Esports,Michigan State University,13,8,7,2,6,6,"Breach,Raze,Reyna,Jett,Astra","Raze,Viper,Jett,Skye,Astra"
Sunset,NVU Violet Phantoms,Akron Esports,3,13,1,11,2,2,"Raze,Cypher,Sova,Gekko,Clove","Breach,Raze,Cypher,Sova,Omen"
Lotus,Radford University,Team Disrupt,13,4,2,3,1,11,"Raze,Killjoy,Viper,Omen,Fade","Raze,Killjoy,Viper,Omen,Fade"
Bind,Leviatán Academy,Maze Gaming,13,4,8,4,0,5,"Raze,Viper,Brimstone,Skye,Gekko","Raze,Viper,Skye,Harbor,Gekko"
Split,BlanK,pure genetic phenomenons,16,14,7,8,6,9,"Raze,Cypher,Viper,Omen,Skye","Raze,Viper,Omen,Jett,Skye"
Ascent,Akron Esports,LC,13,10,7,5,5,6,"Sova,Killjoy,Omen,Jett,KAY/O","Sova,Killjoy,Omen,Jett,KAY/O"
Lotus,Bionic,Amphibioum @ Apple Store,13,5,9,3,2,4,"Breach,Raze,Killjoy,Omen,Gekko","Raze,Killjoy,Omen,Fade,Gekko"
Sunset,Eternal Focus Crimson,CKnights,13,10,6,6,4,7,"Raze,Cypher,Omen,KAY/O,Gekko","Raze,Cypher,Omen,KAY/O,Gekko"
Lotus,SRVR RED,Cooli & Company,13,6,9,3,3,4,"Raze,Killjoy,Viper,Omen,Fade","Raze,Killjoy,Viper,Omen,Skye"
Split,Radford University,LazerrFreeks8,13,4,2,3,1,11,"Raze,Cypher,Viper,Omen,Skye","Raze,Viper,Omen,Jett,Skye"
Sunset,Kent State University,Team Disrupt,14,12,8,5,7,6,"Viper,Omen,Jett,KAY/O,Gekko","Raze,Cypher,Omen,KAY/O,Gekko"
Sunset,Rebirth Esports,LRV Esports,13,7,6,2,5,7,"Breach,Raze,Cypher,Omen,KAY/O","Raze,Viper,Omen,KAY/O,Gekko"
Bind,Rebirth Esports,LRV Esports,8,13,4,5,8,4,"Breach,Raze,Cypher,Omen,KAY/O","Raze,Viper,Brimstone,Fade,Gekko"
Icebox,R8 Blues,Twisted Minds Orchid,11,13,5,7,6,6,"Sova,Killjoy,Viper,Sage,Neon","Sova,Killjoy,Viper,Reyna,Jett"
Lotus,R8 Blues,Twisted Minds Orchid,2,13,1,11,2,1,"Killjoy,Viper,Omen,Skye,Neon","Killjoy,Viper,Omen,Neon,Gekko"
Icebox,XO Nova,The Ultimates Odyssey,6,13,3,4,9,3,"Sova,Killjoy,Viper,Jett,Yoru","Sova,Killjoy,Viper,Sage,Jett"
Sunset,CTRL Esports,BLINDOHOLIK,13,11,7,5,6,6,"Raze,Cypher,Omen,KAY/O,Gekko","Raze,Cypher,Omen,KAY/O,Gekko"
Sunset,XO Nova,The Ultimates Odyssey,3,13,3,9,4,0,"Breach,Raze,Cypher,Sova,Omen","Raze,Cypher,Viper,Omen,Fade"
Split,CTRL Esports,BLINDOHOLIK,13,4,5,0,4,8,"Raze,Cypher,Viper,Omen,Skye","Raze,Cypher,Viper,Omen,Skye"
Lotus,Bleed Esports,ZETA DIVISION,8,13,3,9,4,5,"Raze,Killjoy,Viper,Omen,Fade","Viper,Omen,Chamber,Neon,Gekko"
Ascent,Bleed Esports,ZETA DIVISION,13,9,6,4,5,7,"Sova,Killjoy,Omen,Jett,KAY/O","Sova,Killjoy,Omen,Jett,KAY/O"
Sunset,Bleed Esports,ZETA DIVISION,9,13,3,7,6,6,"Raze,Cypher,Omen,KAY/O,Gekko","Sova,Viper,Phoenix,Omen,Chamber"
Lotus,T1,Rex Regum Qeon,13,8,7,2,6,6,"Raze,Viper,Omen,Chamber,Fade","Raze,Killjoy,Viper,Omen,Fade"
Ascent,T1,Rex Regum Qeon,13,6,7,0,6,6,"Sova,Killjoy,Omen,Jett,KAY/O","Sova,Killjoy,Omen,Jett,KAY/O"
Icebox,Cumberland Phoenix,Converse Purple,13,5,5,1,4,8,"Sova,Killjoy,Viper,Omen,Jett","Killjoy,Viper,Jett,KAY/O,Gekko"
Ascent,OXEN,XSOUL,14,12,7,6,6,7,"Sova,Killjoy,Omen,Yoru,KAY/O","Breach,Raze,Killjoy,Reyna,Omen"
Icebox,OXEN,XSOUL,13,3,2,2,1,11,"Killjoy,Viper,Reyna,KAY/O,Gekko","Sova,Killjoy,Viper,Jett,KAY/O"
Lotus,Mizzou Esports,Purdue Gold,16,14,9,6,8,7,"Reyna,Jett,Harbor,Deadlock,Iso","Cypher,Viper,Omen,Jett,Gekko"
Ascent,Cumberland Phoenix,Converse Purple,13,9,7,3,6,6,"Sova,Killjoy,Omen,Jett,KAY/O","Sova,Killjoy,Omen,Jett,KAY/O"
Bind,Border Monsters Chile,KRÜ BLAZE,13,4,8,4,0,5,"Raze,Viper,Brimstone,Sage,Skye","Raze,Viper,Brimstone,Skye,Gekko"
Split,Mizzou Esports,Purdue Gold,13,3,3,1,2,10,"Breach,Raze,Reyna,Jett,Astra","Cypher,Viper,Omen,Jett,Gekko"
Split,Cloud9,Evil Geniuses,13,4,3,2,2,10,"Raze,Cypher,Viper,Omen,Skye","Raze,Cypher,Viper,Omen,Skye"
Lotus,Border Monsters Chile,KRÜ BLAZE,13,9,9,3,6,4,"Raze,Killjoy,Viper,Omen,Fade","Raze,Killjoy,Viper,Omen,Fade"
Sunset,Cloud9,Evil Geniuses,13,8,8,4,4,5,"Raze,Cypher,Viper,Omen,Skye","Breach,Raze,Cypher,Omen,Fade"
Lotus,Cloud9,Evil Geniuses,9,13,2,8,5,7,"Raze,Killjoy,Viper,Omen,Gekko","Raze,Cypher,Viper,Omen,Fade"
Split,R8 Blues,XO Nova,13,5,4,2,3,9,"Raze,Killjoy,Viper,Omen,Skye","Breach,Raze,Cypher,Omen,Skye"
Breeze,R8 Blues,XO Nova,13,7,6,2,5,7,"Sova,Viper,Jett,KAY/O,Chamber","Cypher,Sova,Viper,Jett,Chamber"
Split,Twisted Minds Orchid,Gamax Lite,13,10,8,3,7,5,"Breach,Raze,Cypher,Viper,Omen","Raze,Cypher,Omen,Skye,Deadlock"
Lotus,INF Esports,DSQ Esports,8,13,4,8,5,4,"Breach,Killjoy,Omen,Neon,Gekko","Raze,Cypher,Phoenix,Omen,Gekko"
Lotus,Dipsy & Co,Lumina Gaming,9,13,4,6,7,5,"Raze,Killjoy,Viper,Omen,Fade","Killjoy,Viper,Omen,Neon,Gekko"
Lotus,The Ultimates Odyssey,Dragons Esports GC,13,7,3,5,2,10,"Breach,Raze,Killjoy,Omen,Skye","Raze,Killjoy,Viper,Omen,Fade"
Sunset,INF Esports,DSQ Esports,8,13,5,7,6,3,"Breach,Cypher,Sova,Omen,Jett","Breach,Viper,Omen,Yoru,Gekko"
Sunset,OOT Esports,Sissi State Punks,13,10,5,6,4,8,"Breach,Raze,Cypher,Omen,Jett","Breach,Cypher,Omen,Jett,Yoru"
Bind,Andromeda Gaming,Elysian Esports,13,11,10,2,9,3,"Raze,Viper,Brimstone,Skye,Fade","Raze,Viper,Brimstone,Skye,Gekko"
Icebox,Dipsy & Co,Lumina Gaming,11,13,6,6,7,5,"Sova,Killjoy,Viper,Jett,KAY/O","Killjoy,Viper,Reyna,KAY/O,Gekko"
Lotus,Twisted Minds Orchid,Gamax Lite,14,12,6,7,5,8,"Killjoy,Viper,Omen,Neon,Gekko","Breach,Raze,Cypher,Omen,Chamber"
Ascent,NEANLATIYONBOLM,wasted Potential,13,2,3,0,2,10,"Sova,Killjoy,Omen,Jett,KAY/O","Sova,Killjoy,Omen,Jett,KAY/O"
Sunset,The Ultimates Odyssey,Dragons Esports GC,13,0,12,0,0,1,"Raze,Cypher,Viper,Omen,Fade","Breach,Raze,Cypher,Omen,Skye"
Icebox,BLINDOHOLIK,Vision Esports (EU),13,10,7,5,5,6,"Killjoy,Viper,Phoenix,Jett,Gekko","Sova,Killjoy,Viper,Reyna,Harbor"
Breeze,Free Orbs,Akira Esports,13,8,3,6,2,10,"Cypher,Viper,Omen,Yoru,Harbor","Cypher,Sova,Viper,Jett,Skye"
Sunset,CTRL Esports,Team Calamity,13,3,3,1,2,10,"Raze,Cypher,Omen,KAY/O,Gekko","Raze,Cypher,Omen,KAY/O,Gekko"
Sunset,BLINDOHOLIK,Vision Esports (EU),13,6,9,3,3,4,"Raze,Cypher,Omen,KAY/O,Gekko","Raze,Cypher,Omen,KAY/O,Gekko"
Icebox,INF Esports,DSQ Esports,13,9,8,2,7,5,"Sova,Killjoy,Viper,Sage,Jett","Killjoy,Viper,Yoru,Harbor,Gekko"
Lotus,Free Orbs,Akira Esports,13,3,2,2,1,11,"Raze,Killjoy,Omen,KAY/O,Gekko","Sova,Killjoy,Viper,Omen,Jett"
Split,OOT Esports,Sissi State Punks,13,10,6,6,4,7,"Raze,Cypher,Omen,Jett,Skye","Cypher,Omen,Yoru,Fade,Gekko"
Sunset,Dipsy & Co,Lumina Gaming,13,6,5,2,4,8,"Breach,Raze,Cypher,Omen,Gekko","Breach,Raze,Cypher,Sova,Omen"
Lotus,Andromeda Gaming,Elysian Esports,13,11,7,5,6,6,"Breach,Raze,Killjoy,Omen,Fade","Raze,Killjoy,Viper,Omen,Fade"
Bind,CTRL Esports,Team Calamity,13,1,11,1,0,2,"Raze,Cypher,Viper,Brimstone,Skye","Raze,Viper,Brimstone,Skye,Yoru"
Split,NEANLATIYONBOLM,wasted Potential,13,8,4,5,3,9,"Raze,Viper,Omen,Skye,Chamber","Breach,Raze,Viper,Omen,Skye"
Lotus,Global Esports,Talon Esports,6,13,1,6,7,5,"Raze,Killjoy,Viper,Omen,Fade","Raze,Killjoy,Viper,Omen,Fade"
Breeze,Global Esports,Talon Esports,12,14,6,7,7,6,"Cypher,Sova,Viper,Jett,KAY/O","Cypher,Sova,Viper,Jett,Yoru"
Icebox,Global Esports,Talon Esports,13,4,9,3,1,4,"Killjoy,Viper,Sage,Jett,Gekko","Killjoy,Viper,Jett,KAY/O,Gekko"
Lotus,Gen.G Esports,DetonatioN FocusMe,13,7,7,1,6,6,"Raze,Killjoy,Viper,Omen,Fade","Raze,Killjoy,Viper,Omen,Fade"
Split,Gen.G Esports,DetonatioN FocusMe,13,8,7,2,6,6,"Raze,Viper,Omen,Jett,Skye","Raze,Cypher,Viper,Omen,Skye"
Icebox,Van Lyn Black,TMU Blue,13,8,8,1,7,5,"Killjoy,Viper,Jett,KAY/O,Gekko","Sova,Killjoy,Viper,Sage,Jett"
Lotus,Van Lyn Black,TMU Blue,13,5,8,4,1,5,"Raze,Killjoy,Viper,Omen,Fade","Raze,Killjoy,Viper,Omen,Fade"
Bind,Van Lyn Black,TMU Blue,15,17,6,10,7,9,"Raze,Viper,Brimstone,Fade,Gekko","Breach,Cypher,Brimstone,Jett,Skye"
Lotus,Brewton Parker College,UTD Esports,13,11,9,3,8,4,"Raze,Killjoy,Viper,Omen,Fade","Breach,Raze,Killjoy,Omen,Gekko"
Ascent,ASU Maroon,DAC Gold,13,8,7,5,3,6,"Sova,Killjoy,Omen,Jett,KAY/O","Breach,Sova,Killjoy,Omen,Jett"
Ascent,north american west coast,TMU Blue,3,13,0,4,9,3,"Sova,Killjoy,Omen,Jett,KAY/O","Breach,Sova,Killjoy,Omen,Jett"
Icebox,Brewton Parker College,UTD Esports,7,13,1,11,2,6,"Sova,Killjoy,Viper,Jett,Harbor","Sova,Killjoy,Viper,Chamber,Deadlock"
Split,IVC Blue,UC Irvine,11,13,7,5,8,4,"Raze,Cypher,Viper,Skye,Astra","Cypher,Sova,Viper,Omen,Iso"
Bind,north american west coast,TMU Blue,5,13,1,5,8,4,"Raze,Cypher,Viper,Brimstone,Skye","Breach,Cypher,Brimstone,Jett,Skye"
Bind,ASU Maroon,DAC Gold,13,11,7,5,6,6,"Raze,Viper,Skye,Harbor,Gekko","Raze,Cypher,Viper,Brimstone,Skye"
Sunset,Brewton Parker College,UTD Esports,13,5,6,0,5,7,"Raze,Cypher,Viper,Omen,Gekko","Raze,Cypher,Omen,KAY/O,Gekko"
Breeze,NRG Esports,FURIA,13,8,7,2,6,6,"Cypher,Sova,Viper,Jett,Yoru","Cypher,Sova,Viper,Jett,Yoru"
Ascent,PSU Black,RIT Orange,0,13,0,1,12,0,"Sova,Killjoy,Omen,Jett,KAY/O","Sova,Killjoy,Omen,Jett,KAY/O"
Sunset,CSUF Orange,SJSU Blue,13,11,6,6,5,7,"Raze,Cypher,Reyna,Omen,Fade","Cypher,Viper,Omen,Jett,Skye"
Lotus,Northwood University,UW-Stout Blue Devils,13,3,10,2,1,3,"Raze,Sova,Killjoy,Viper,Omen","Raze,Killjoy,Viper,Omen,Fade"
Breeze,Boise State University,CSULB Black,6,13,3,9,4,3,"Sova,Viper,Jett,Yoru,Astra","Cypher,Sova,Viper,Jett,Yoru"
Ascent,Seattle University,CSULB Gold,17,19,7,11,8,10,"Sova,Killjoy,Omen,Jett,KAY/O","Sova,Killjoy,Reyna,Omen,KAY/O"
Lotus,PSU Black,RIT Orange,4,13,2,10,3,2,"Breach,Raze,Killjoy,Omen,Gekko","Raze,Killjoy,Omen,Fade,Gekko"
Sunset,IVC Blue,UC Irvine,13,4,4,1,3,9,"Raze,Cypher,Omen,KAY/O,Gekko","Raze,Cypher,Omen,KAY/O,Gekko"
Split,NRG Esports,FURIA,13,2,10,2,0,3,"Raze,Viper,Omen,Jett,Skye","Raze,Viper,Omen,Skye,Yoru"
Sunset,Toji lickers,Van Lyn Black,6,13,4,8,5,2,"Breach,Raze,Cypher,Omen,Fade","Raze,Cypher,Omen,KAY/O,Gekko"
Ascent,Northwood University,UW-Stout Blue Devils,13,4,5,0,4,8,"Sova,Killjoy,Omen,Jett,KAY/O","Cypher,Sova,Omen,Jett,Deadlock"
Icebox,LBR,UCSB Gold,13,9,4,6,3,9,"Sova,Killjoy,Viper,Jett,Harbor","Killjoy,Viper,Jett,KAY/O,Gekko"
Split,CSUF Orange,SJSU Blue,13,7,8,0,7,5,"Raze,Viper,Jett,Skye,Astra","Raze,Cypher,Omen,Jett,Skye"
Icebox,SFU Pink,Esports at UCD Gold,13,6,4,3,3,9,"Sova,Killjoy,Viper,Omen,Jett","Sova,Killjoy,Viper,Jett,KAY/O"
Lotus,UO Green,SDSU Black,10,13,9,3,10,1,"Raze,Killjoy,Omen,Yoru,Gekko","Raze,Cypher,Skye,Astra,Gekko"
Sunset,Seattle University,CSULB Gold,3,13,3,9,4,0,"Breach,Raze,Cypher,Omen,Skye","Raze,Cypher,Sova,Reyna,Omen"
Bind,Boise State University,CSULB Black,9,13,7,5,8,2,"Raze,Viper,Brimstone,Skye,Gekko","Raze,Cypher,Viper,Brimstone,Skye"
Split,UWaterloo Gold,Maryville University,10,13,2,10,3,8,"Raze,Cypher,Omen,Jett,Skye","Raze,Cypher,Viper,Omen,Skye"
Icebox,Toji lickers,Van Lyn Black,7,13,1,7,6,6,"Sova,Killjoy,Viper,Jett,Harbor","Killjoy,Viper,Jett,KAY/O,Gekko"
Lotus,north american west coast,TMU Blue,23,21,10,9,10,10,"Raze,Killjoy,Viper,Omen,Skye","Raze,Killjoy,Viper,Omen,Fade"
Icebox,IVC Blue,UC Irvine,12,14,4,9,5,8,"Sova,Killjoy,Viper,Jett,Gekko","Killjoy,Viper,Jett,KAY/O,Gekko"
Sunset,LBR,UCSB Gold,13,10,7,4,6,6,"Breach,Cypher,Sova,Omen,Jett","Raze,Cypher,Omen,KAY/O,Gekko"
Bind,CSUF Orange,SJSU Blue,7,13,4,4,9,3,"Raze,Viper,Brimstone,Reyna,Skye","Raze,Viper,Brimstone,Reyna,Skye"
Bind,SFU Pink,Esports at UCD Gold,13,9,6,4,5,7,"Raze,Viper,Brimstone,Jett,Gekko","Raze,Cypher,Brimstone,Skye,Deadlock"
Bind,UO Green,SDSU Black,8,13,4,5,8,4,"Raze,Viper,Brimstone,Skye,Gekko","Raze,Cypher,Viper,Brimstone,Skye"
Icebox,Boise State University,CSULB Black,13,6,6,1,5,7,"Sova,Killjoy,Viper,Jett,Harbor","Killjoy,Viper,Jett,KAY/O,Gekko"
Lotus,Seattle University,CSULB Gold,13,6,7,5,1,6,"Raze,Killjoy,Viper,Omen,Skye","Raze,Killjoy,Viper,Omen,Gekko"
Sunset,KRÜ Esports,MIBR,13,8,6,3,5,7,"Breach,Raze,Cypher,Omen,Gekko","Raze,Cypher,Viper,Omen,Skye"
Lotus,Illinois Tech Esports,MBU Spartans,8,13,7,2,11,1,"Omen,Jett,Chamber,Fade,Gekko","Breach,Raze,Omen,Chamber,Gekko"
Breeze,CSP Val Blue,Illini Esports Orange,13,6,7,5,1,6,"Sova,Viper,Jett,Yoru,Harbor","Cypher,Sova,Viper,Jett,KAY/O"
Icebox,Wichita State Esports,Niner Esports,13,6,7,5,1,6,"Sova,Killjoy,Viper,Jett,Harbor","Sova,Killjoy,Viper,Jett,Harbor"
Icebox,UWaterloo Gold,Maryville University,13,11,7,5,6,6,"Sova,Killjoy,Viper,Reyna,Jett","Sova,Killjoy,Viper,Reyna,Jett"
Lotus,Carleton Ravens,Indiana Hoosiers,3,13,2,2,11,1,"Raze,Killjoy,Viper,Omen,Gekko","Raze,Viper,Omen,Skye,Chamber"
Ascent,Illinois Tech Esports,MBU Spartans,1,13,1,11,2,0,"Sova,Killjoy,Omen,Jett,KAY/O","Sova,Killjoy,Brimstone,Sage,KAY/O"
Split,Fisher College Navy,West Virginia University,13,5,9,3,2,4,"Raze,Viper,Omen,Jett,Skye","Breach,Raze,Viper,Skye,Astra"
Icebox,Rochester University Esports,University of Virginia,6,13,2,5,8,4,"Sova,Killjoy,Viper,Sage,Jett","Raze,Sova,Killjoy,Viper,Sage"
Sunset,St. Clair Saints,uOttawa Garnet,13,6,7,5,1,6,"Breach,Raze,Cypher,Omen,Fade","Cypher,Sova,Phoenix,Astra,Gekko"
Icebox,KRÜ Esports,MIBR,13,6,7,5,1,6,"Killjoy,Viper,Reyna,KAY/O,Gekko","Sova,Killjoy,Viper,Jett,Harbor"
Lotus,LG Orange,UF Blue,13,2,3,0,2,10,"Raze,Killjoy,Viper,Omen,Skye","Raze,Killjoy,Viper,Omen,Gekko"
Breeze,TAMU Maroon,UAFS Digital Lions,13,8,7,2,6,6,"Sova,Viper,Jett,Yoru,Astra","Cypher,Sova,Viper,Reyna,Jett"
Split,NC State Red,Columbia College,4,13,3,9,4,1,"Raze,Cypher,Omen,Jett,Skye","Raze,Cypher,Omen,Jett,Skye"
Lotus,Concordia University,Ball State,2,13,0,3,10,2,"Raze,Killjoy,Omen,Skye,Gekko","Raze,Killjoy,Viper,Omen,Skye"
Split,KU Esports,UCF Gold,3,13,1,3,10,2,"Breach,Raze,Cypher,Omen,Skye","Raze,Cypher,Viper,Omen,Skye"
Sunset,UST Esports,TAMU White,13,1,11,1,0,2,"Breach,Raze,Cypher,Omen,Gekko","Breach,Raze,Cypher,Omen,Fade"
Bind,Carleton Ravens,Indiana Hoosiers,2,13,0,3,10,2,"Raze,Cypher,Viper,Brimstone,Skye","Raze,Viper,Brimstone,Skye,Yoru"
Breeze,Wichita State Esports,Niner Esports,13,10,7,5,5,6,"Sova,Viper,Yoru,KAY/O,Harbor","Cypher,Sova,Viper,Jett,KAY/O"
Breeze,Fisher College Navy,West Virginia University,13,6,9,3,3,4,"Sova,Viper,Jett,Yoru,Astra","Cypher,Sova,Viper,Jett,KAY/O"
Lotus,UWaterloo Gold,Maryville University,11,13,8,4,9,3,"Raze,Killjoy,Viper,Omen,Fade","Raze,Killjoy,Viper,Omen,Fade"
Sunset,NC State Red,Columbia College,3,13,0,4,9,3,"Raze,Cypher,Omen,KAY/O,Gekko","Breach,Raze,Cypher,Sova,Omen"
Bind,CSP Val Blue,Illini Esports Orange,13,11,7,5,6,6,"Breach,Raze,Viper,Brimstone,Skye","Raze,Viper,Brimstone,Skye,Chamber"
Icebox,TAMU Maroon,UAFS Digital Lions,13,7,5,3,4,8,"Sova,Killjoy,Viper,Jett,Gekko","Sova,Killjoy,Viper,Reyna,Jett"
Ascent,Concordia University,Ball State,2,13,2,10,3,0,"Cypher,Sova,Omen,Jett,KAY/O","Sova,Killjoy,Omen,Jett,KAY/O"
Bind,St. Clair Saints,uOttawa Garnet,13,9,4,8,1,9,"Raze,Brimstone,Reyna,Skye,Chamber","Raze,Viper,Brimstone,Gekko,Deadlock"
Split,Rochester University Esports,University of Virginia,8,13,5,4,9,3,"Raze,Killjoy,Viper,Omen,Skye","Raze,Omen,Yoru,Astra,Fade"
Breeze,Harrisburg University,Northeastern Varsity,13,8,5,7,1,8,"Cypher,Sova,Viper,Yoru,KAY/O","Cypher,Sova,Viper,Jett,Yoru"
Bind,LG Orange,UF Blue,13,10,7,4,6,6,"Raze,Viper,Brimstone,Reyna,Skye","Raze,Cypher,Viper,Brimstone,Skye"
Icebox,KU Esports,UCF Gold,3,13,0,4,9,3,"Sova,Killjoy,Viper,KAY/O,Harbor","Sova,Killjoy,Viper,Jett,Gekko"
Lotus,Fisher College Tea Party,York University Red,13,2,2,1,1,11,"Raze,Killjoy,Viper,Omen,Skye","Killjoy,Jett,Astra,Harbor,Gekko"
Lotus,UST Esports,TAMU White,13,3,9,3,0,4,"Breach,Raze,Killjoy,Omen,Gekko","Breach,Raze,Sova,Killjoy,Omen"
Bind,TMU Blue,FIU Varsity,13,4,9,3,1,4,"Breach,Cypher,Brimstone,Jett,Skye","Raze,Viper,Brimstone,Skye,Chamber"
Icebox,Fisher Falcons,Tiffin University,13,7,6,6,1,7,"Sova,Killjoy,Viper,Reyna,Jett","Sova,Killjoy,Viper,Jett,KAY/O"
Split,Winthrop University,Fisher Rising,13,7,6,2,5,7,"Raze,Viper,Skye,Astra,KAY/O","Raze,Cypher,Viper,Omen,Skye"
Split,Fisher College Tea Party,York University Red,13,3,9,3,0,4,"Raze,Cypher,Viper,Omen,Skye","Raze,Cypher,Omen,Jett,Skye"
Bind,Fisher College Navy,West Virginia University,9,13,5,5,8,4,"Raze,Viper,Brimstone,KAY/O,Gekko","Raze,Viper,Brimstone,Skye,Yoru"
Lotus,Fisher Falcons,Tiffin University,13,2,3,0,2,10,"Raze,Killjoy,Viper,Omen,Fade","Raze,Viper,Omen,Chamber,Gekko"
Icebox,TMU Blue,FIU Varsity,13,6,9,3,3,4,"Sova,Killjoy,Viper,Sage,Jett","Raze,Sova,Killjoy,Viper,Omen"
Split,DSYRE,NOVO Esports,13,3,3,1,2,10,"Raze,Viper,Omen,Yoru,Fade","Raze,Cypher,Omen,Skye,Deadlock"
Lotus,Harrisburg University,Northeastern Varsity,13,8,6,3,5,7,"Killjoy,Viper,Omen,Neon,Gekko","Raze,Killjoy,Viper,Omen,Fade"
Sunset,Rochester University Esports,University of Virginia,13,10,8,3,7,5,"Raze,Cypher,Sova,Omen,Gekko","Cypher,Sova,Viper,Omen,Yoru"
Lotus,Winthrop University,Fisher Rising,13,4,10,2,2,3,"Raze,Killjoy,Viper,Omen,Fade","Raze,Killjoy,Viper,Omen,Skye"
Split,Hero Base,Stellae Gaming,13,8,6,3,5,7,"Breach,Raze,Viper,Omen,Skye","Raze,Cypher,Viper,Omen,Skye"
Split,Fire Flux Esports,Galakticos,14,12,7,6,6,7,"Raze,Cypher,Viper,Omen,Skye","Raze,Cypher,Viper,Omen,Skye"
Breeze,DSYRE,NOVO Esports,13,4,8,4,0,5,"Cypher,Sova,Viper,Omen,Yoru","Cypher,Sova,Viper,Jett,Yoru"
Breeze,Hero Base,Stellae Gaming,13,8,9,3,5,4,"Cypher,Sova,Viper,Jett,KAY/O","Cypher,Sova,Viper,Jett,KAY/O"
Bind,DSYRE,NOVO Esports,13,11,7,5,6,6,"Raze,Viper,Brimstone,KAY/O,Gekko","Breach,Raze,Brimstone,Yoru,Fade"
Sunset,Apeks,OnlyFins,13,2,11,1,1,2,"Viper,Sage,Omen,KAY/O,Gekko","Breach,Raze,Cypher,Sova,Omen"
Sunset,Hero Base,Stellae Gaming,11,13,3,9,4,8,"Breach,Raze,Viper,Omen,KAY/O","Raze,Cypher,Viper,Omen,Gekko"
Bind,Fire Flux Esports,Galakticos,14,12,3,10,2,11,"Raze,Viper,Sage,Omen,Gekko","Raze,Viper,Omen,KAY/O,Gekko"
Sunset,DSYRE,NOVO Esports,3,13,3,9,4,0,"Breach,Raze,Cypher,Omen,Fade","Breach,Raze,Cypher,Omen,Deadlock"
Breeze,Apeks,OnlyFins,13,6,3,4,2,10,"Cypher,Sova,Viper,Yoru,KAY/O","Cypher,Sova,Viper,Jett,KAY/O"
Lotus,NoodleSoupWarriors,CTRL x YARI Esports,7,13,2,10,3,5,"Raze,Sova,Killjoy,Viper,Omen","Raze,Killjoy,Viper,Omen,Fade"
Lotus,Galorys,Legacy,10,13,6,5,8,4,"Raze,Killjoy,Viper,Omen,Fade","Raze,Killjoy,Viper,Omen,Fade"
Split,Metizport,SweetNsour,7,13,2,6,7,5,"Raze,Killjoy,Viper,Skye,Astra","Raze,Cypher,Viper,Omen,Skye"
Lotus,Fire Flux Esports,Galakticos,13,10,6,5,5,7,"Killjoy,Viper,Omen,Neon,Gekko","Viper,Omen,Neon,Fade,Gekko"
Split,NoodleSoupWarriors,CTRL x YARI Esports,6,13,6,6,7,0,"Raze,Cypher,Omen,Jett,Skye","Raze,Cypher,Omen,Skye,Deadlock"
Split,Reignite Lily,FENNEL GC,7,13,1,7,6,6,"Raze,Viper,Omen,Jett,Skye","Raze,Cypher,Viper,Omen,Skye"
Ascent,Galorys,Legacy,10,13,3,8,5,7,"Sova,Killjoy,Omen,Jett,KAY/O","Sova,Killjoy,Omen,Jett,KAY/O"
Lotus,Metizport,SweetNsour,10,13,7,5,8,3,"Raze,Killjoy,Viper,Omen,Fade","Raze,Killjoy,Viper,Omen,Fade"
Breeze,Reignite Lily,FENNEL GC,4,13,1,4,9,3,"Cypher,Sova,Viper,Yoru,KAY/O","Cypher,Sova,Viper,Jett,KAY/O"
Sunset,Requiem,CTRL x YARI Esports,10,13,3,8,5,7,"Breach,Raze,Cypher,Omen,Yoru","Breach,Raze,Cypher,Omen,Gekko"
Breeze,SCARZ GC,Meteor GC,1,13,1,11,2,0,"Sova,Viper,Yoru,Chamber,Harbor","Cypher,Sova,Viper,Yoru,KAY/O"
Icebox,Metizport,SweetNsour,13,6,4,3,3,9,"Sova,Killjoy,Viper,Sage,Jett","Sova,Killjoy,Viper,Jett,Harbor"
Lotus,FATE Flare,Divergentes GC,9,13,4,6,7,5,"Breach,Raze,Killjoy,Omen,Gekko","Breach,Raze,Cypher,Omen,Gekko"
Ascent,DRX Changers,DetonatioN FocusMe GC,13,9,7,5,4,6,"Sova,Killjoy,Omen,Jett,KAY/O","Sova,Killjoy,Omen,Jett,KAY/O"
Lotus,Reignite Lily,FENNEL GC,13,11,8,4,7,5,"Raze,Viper,Omen,Chamber,Fade","Raze,Killjoy,Viper,Omen,Fade"
Split,ZETA DIVISION GC,Cyber Geek,13,1,2,0,1,11,"Raze,Cypher,Viper,Omen,Skye","Raze,Viper,Omen,Jett,Skye"
Icebox,Requiem,CTRL x YARI Esports,13,10,5,6,4,8,"Sova,Killjoy,Viper,Jett,Deadlock","Killjoy,Viper,Reyna,KAY/O,Gekko"
Bind,SCARZ GC,Meteor GC,9,13,7,5,8,2,"Raze,Cypher,Viper,Brimstone,Skye","Breach,Raze,Brimstone,Chamber,Gekko"
Split,FATE Flare,Divergentes GC,13,10,4,8,2,9,"Breach,Raze,Cypher,Sage,Omen","Breach,Raze,Cypher,Omen,Jett"
Icebox,Bleed Esports,Rex Regum Qeon,5,13,4,8,5,1,"Killjoy,Viper,Jett,KAY/O,Gekko","Sova,Killjoy,Viper,Jett,Gekko"
Ascent,ZETA DIVISION GC,Cyber Geek,13,11,6,6,5,7,"Sova,Killjoy,Omen,Jett,KAY/O","Sova,Killjoy,Omen,Jett,KAY/O"
Split,DRX Changers,DetonatioN FocusMe GC,14,12,6,7,5,8,"Breach,Raze,Cypher,Viper,Omen","Breach,Raze,Cypher,Omen,Deadlock"
Ascent,SCARZ GC,Meteor GC,13,8,5,4,4,8,"Sova,Killjoy,Omen,Jett,KAY/O","Sova,Killjoy,Omen,Jett,KAY/O"
Split,FENNEL GC,Sasanqua,13,5,6,0,5,7,"Raze,Cypher,Viper,Omen,Skye","Cypher,Sage,Omen,Jett,Skye"
Icebox,FATE Flare,Divergentes GC,8,13,2,7,6,6,"Sova,Killjoy,Viper,Reyna,Gekko","Killjoy,Viper,Jett,Skye,Chamber"
Lotus,Requiem,CTRL x YARI Esports,9,13,5,7,6,4,"Raze,Killjoy,Viper,Omen,Fade","Raze,Killjoy,Viper,Omen,Fade"
Lotus,Bleed Esports,Rex Regum Qeon,2,13,0,3,10,2,"Raze,Killjoy,Viper,Omen,Fade","Raze,Killjoy,Viper,Omen,Fade"
Lotus,Focus e-Sports Female,DetonatioN FocusMe GC,8,13,4,5,8,4,"Raze,Killjoy,Omen,Fade,Gekko","Raze,Killjoy,Viper,Omen,Fade"
Ascent,FENNEL GC,Sasanqua,11,13,7,5,8,4,"Sova,Killjoy,Omen,Jett,KAY/O","Sova,Killjoy,Omen,Jett,KAY/O"
Ascent,Meteor GC,BANDAL,13,3,4,0,3,9,"Sova,Killjoy,Omen,Jett,KAY/O","Sova,Killjoy,Omen,Jett,KAY/O"
Breeze,Cyber Geek,Insomnia GC,13,10,8,3,7,5,"Cypher,Sova,Viper,Jett,KAY/O","Cypher,Sova,Omen,Yoru,Harbor"
Sunset,Team Secret,ZETA DIVISION,13,7,9,3,4,4,"Breach,Raze,Cypher,Sova,Omen","Sova,Viper,Phoenix,Omen,Chamber"
Lotus,FENNEL GC,Sasanqua,13,7,7,1,6,6,"Raze,Killjoy,Viper,Omen,Fade","Breach,Killjoy,Omen,Jett,Fade"
Ascent,Focus e-Sports Female,DetonatioN FocusMe GC,11,13,2,10,3,9,"Sova,Killjoy,Phoenix,Omen,Jett","Sova,Killjoy,Omen,Jett,KAY/O"
Split,Cyber Geek,Insomnia GC,13,9,8,2,7,5,"Raze,Viper,Omen,Jett,Skye","Breach,Raze,Cypher,Sage,Omen"
Sunset,Meteor GC,BANDAL,14,12,9,4,8,5,"Raze,Cypher,Omen,KAY/O,Gekko","Breach,Raze,Cypher,Omen,Fade"
Lotus,Team Secret,ZETA DIVISION,6,13,5,7,6,1,"Raze,Killjoy,Viper,Omen,Fade","Viper,Omen,Chamber,Neon,Gekko"
Icebox,Team Secret,ZETA DIVISION,13,8,6,3,5,7,"Sova,Killjoy,Viper,Jett,KAY/O","Killjoy,Viper,Jett,KAY/O,Gekko"
Sunset,Esports at UCD Gold,USC Cardinal,13,9,6,4,5,7,"Raze,Cypher,Sova,Phoenix,Omen","Breach,Raze,Cypher,Sova,Omen"
Icebox,ASU Maroon,UCSD Gold,13,7,9,3,4,4,"Sova,Killjoy,Viper,Reyna,Jett","Killjoy,Viper,Jett,KAY/O,Gekko"
Ascent,ASU Maroon,UCSD Gold,13,9,7,3,6,6,"Sova,Killjoy,Omen,Jett,KAY/O","Sova,Killjoy,Omen,Jett,KAY/O"
Icebox,Sentinels,Leviatán,11,13,6,6,7,5,"Killjoy,Viper,Jett,KAY/O,Gekko","Sova,Killjoy,Viper,Jett,Harbor"
Split,TMU Blue,Stony Brook,13,1,11,1,0,2,"Breach,Cypher,Omen,Jett,Skye","Raze,Cypher,Viper,Omen,Skye"
Ascent,TMU Blue,Stony Brook,13,6,8,4,2,5,"Breach,Sova,Killjoy,Omen,Jett","Sova,Killjoy,Omen,Jett,KAY/O"
Icebox,Utica Blue,SNHU Esports,13,7,7,1,6,6,"Killjoy,Viper,Jett,Harbor,Gekko","Sova,Killjoy,Viper,Harbor,Deadlock"
Bind,CSUN Black,SDSU Black,4,13,0,5,8,4,"Raze,Viper,Brimstone,Skye,Yoru","Raze,Cypher,Viper,Brimstone,Skye"
Ascent,CSULB Gold,Cal Blue,13,9,6,4,5,7,"Sova,Killjoy,Omen,Jett,KAY/O","Sova,Killjoy,Omen,Jett,KAY/O"
Icebox,Scarlet Knights Black,Tiffin University,12,14,9,4,10,3,"Sova,Killjoy,Viper,Sage,Jett","Sova,Killjoy,Viper,Jett,KAY/O"
Split,DAC Gold,OSU Varsity,13,3,9,3,0,4,"Raze,Cypher,Viper,Omen,Skye","Raze,Cypher,Viper,Omen,Skye"
Breeze,Demigods At UCSD,CSULB Black,10,13,3,9,4,7,"Cypher,Sova,Viper,Reyna,Jett","Cypher,Sova,Viper,Jett,Yoru"
Lotus,Sentinels,Leviatán,17,19,13,5,14,4,"Raze,Killjoy,Viper,Omen,Fade","Raze,Killjoy,Viper,Omen,Fade"
Ascent,Utica Blue,SNHU Esports,6,13,3,9,4,3,"Sova,Killjoy,Omen,Jett,KAY/O","Sova,Killjoy,Omen,Jett,KAY/O"
Lotus,Scarlet Knights Black,Tiffin University,10,13,6,6,7,4,"Raze,Killjoy,Viper,Omen,Skye","Raze,Viper,Omen,Chamber,Gekko"
Split,CSUN Black,SDSU Black,13,8,8,4,4,5,"Raze,Cypher,Viper,Omen,Skye","Raze,Cypher,Viper,Omen,Skye"
Bind,DAC Gold,OSU Varsity,8,13,5,7,6,3,"Raze,Cypher,Viper,Brimstone,Skye","Raze,Cypher,Viper,Brimstone,Skye"
Bind,Concordia University,Kent State University,13,9,8,2,7,5,"Raze,Cypher,Viper,Brimstone,Skye","Raze,Cypher,Viper,Omen,Fade"
Split,GCU Esports,UC Irvine,6,13,3,9,4,3,"Raze,Cypher,Viper,Omen,Skye","Cypher,Sova,Viper,Omen,Iso"
Bind,UCO Varsity,KU Esports,11,13,5,7,6,6,"Raze,Cypher,Viper,Brimstone,Skye","Raze,Sova,Viper,Brimstone,Skye"
Bind,CSULB Gold,Cal Blue,10,13,7,4,9,3,"Raze,Cypher,Brimstone,Skye,Yoru","Raze,Viper,Brimstone,Skye,Yoru"
Sunset,Demigods At UCSD,CSULB Black,13,6,9,3,3,4,"Breach,Raze,Cypher,Omen,Gekko","Breach,Raze,Cypher,Sova,Omen"
Bind,SJSU Blue,UBC Black,13,2,3,0,2,10,"Raze,Viper,Brimstone,Reyna,Skye","Raze,Cypher,Viper,Brimstone,Skye"
Lotus,CSUF Orange,EaUCD Blue,13,5,9,3,2,4,"Breach,Raze,Killjoy,Omen,Fade","Raze,Killjoy,Viper,Omen,Skye"
Bind,Boise State University,University of Utah,13,6,10,2,4,3,"Raze,Viper,Brimstone,Skye,Gekko","Raze,Cypher,Omen,KAY/O,Gekko"
Bind,AntHeaters,UCSB Gold,10,13,7,5,8,3,"Raze,Viper,Brimstone,Skye,Yoru","Raze,Viper,Brimstone,Skye,Gekko"
Lotus,Utica Blue,SNHU Esports,13,6,6,1,5,7,"Breach,Raze,Viper,Omen,Gekko","Viper,Omen,Yoru,Gekko,Deadlock"
Sunset,Toji lickers,Team Disrupt,13,7,7,5,2,6,"Breach,Raze,Cypher,Omen,Fade","Raze,Cypher,Omen,KAY/O,Gekko"
Ascent,NOVA Nighthawks,RIT Orange,7,13,2,6,7,5,"Breach,Cypher,Sova,Omen,Jett","Sova,Killjoy,Omen,Jett,KAY/O"
Icebox,Demigods At UCSD,CSULB Black,6,13,2,5,8,4,"Sova,Killjoy,Viper,Reyna,Jett","Killjoy,Viper,Jett,KAY/O,Gekko"
Sunset,GCU Esports,UC Irvine,8,13,7,5,8,1,"Raze,Cypher,Omen,KAY/O,Gekko","Raze,Cypher,Omen,KAY/O,Gekko"
Sunset,Concordia University,Kent State University,13,10,7,4,6,6,"Breach,Raze,Cypher,Omen,Gekko","Viper,Omen,Jett,KAY/O,Gekko"
Lotus,CSUN Black,SDSU Black,11,13,7,5,8,4,"Raze,Killjoy,Viper,Omen,Fade","Raze,Cypher,Skye,Astra,Gekko"
Lotus,UCO Varsity,KU Esports,10,13,6,5,8,4,"Raze,Killjoy,Viper,Omen,Fade","Raze,Killjoy,Viper,Omen,Skye"
Icebox,DAC Gold,OSU Varsity,14,12,6,7,5,8,"Killjoy,Viper,Jett,KAY/O,Gekko","Sova,Killjoy,Viper,Jett,Gekko"
Lotus,CSULB Gold,Cal Blue,13,8,6,6,2,7,"Raze,Killjoy,Viper,Omen,Gekko","Raze,Killjoy,Viper,Omen,Skye"
Ascent,SJSU Blue,UBC Black,13,9,4,6,3,9,"Sova,Killjoy,Omen,Jett,KAY/O","Sova,Killjoy,Omen,Jett,KAY/O"
Split,G2 Esports,100 Thieves,8,13,4,8,5,4,"Breach,Raze,Cypher,Viper,Omen","Raze,Viper,Astra,Fade,Gekko"
Lotus,AntHeaters,UCSB Gold,3,13,0,4,9,3,"Breach,Raze,Killjoy,Omen,Gekko","Breach,Raze,Cypher,Omen,Gekko"
Icebox,Boise State University,University of Utah,13,3,4,0,3,9,"Sova,Killjoy,Viper,Jett,Harbor","Sova,Killjoy,Viper,Jett,Gekko"
Lotus,Maryville University,Davenport University,13,8,6,3,5,7,"Raze,Killjoy,Viper,Omen,Fade","Raze,Killjoy,Reyna,Omen,Gekko"
Bind,TMU Blue,F5 Esports,13,2,10,2,0,3,"Breach,Cypher,Brimstone,Jett,Skye","Raze,Viper,Brimstone,Skye,Gekko"
Split,CSUF Orange,EaUCD Blue,13,8,4,5,3,9,"Raze,Viper,Jett,Skye,Astra","Raze,Cypher,Omen,Jett,Skye"
Icebox,NC State Red,NEO Esports,13,6,9,3,3,4,"Sova,Killjoy,Viper,Sage,Jett","Sova,Killjoy,Viper,Jett,Harbor"
Icebox,Predator X Gaming,Van Lyn Black,8,13,6,6,7,2,"Raze,Sova,Killjoy,Viper,Yoru","Killjoy,Viper,Jett,KAY/O,Gekko"
Split,Ball State,WKU Hilltoppers RED,13,6,9,3,3,4,"Raze,Cypher,Viper,Omen,Skye","Breach,Raze,Cypher,Skye,Astra"
Split,NOVA Nighthawks,RIT Orange,5,13,5,7,6,0,"Raze,Cypher,Viper,Omen,Skye","Raze,Viper,Omen,Jett,Skye"
Icebox,SFU Pink,Sac State Green,14,12,9,4,8,5,"Sova,Killjoy,Viper,Reyna,Jett","Viper,Reyna,Jett,Chamber,Gekko"
Icebox,Toji lickers,Team Disrupt,13,7,4,4,3,9,"Sova,Killjoy,Viper,Jett,Harbor","Killjoy,Viper,Omen,KAY/O,Gekko"
Sunset,Utica Blue,SNHU Esports,13,9,7,5,4,6,"Breach,Raze,Cypher,Omen,Gekko","Raze,Cypher,Omen,KAY/O,Gekko"
Icebox,Niner Esports,BSC Bobcats VA,13,10,5,7,3,8,"Sova,Killjoy,Viper,Jett,Harbor","Killjoy,Viper,Sage,Reyna,Gekko"
Split,University of Virginia,UMBC Black,13,4,10,2,2,3,"Raze,Omen,Yoru,Astra,Fade","Raze,Cypher,Viper,Omen,Skye"
Sunset,TAMU White,RRG Orange,13,5,5,1,4,8,"Breach,Raze,Cypher,Omen,Fade","Breach,Raze,Cypher,Sova,Omen"
Lotus,NC State Red,NEO Esports,13,6,7,5,1,6,"Raze,Killjoy,Viper,Omen,Fade","Raze,Killjoy,Viper,Omen,Skye"
Ascent,TMU Blue,F5 Esports,13,8,9,3,5,4,"Breach,Sova,Killjoy,Omen,Jett","Sova,Killjoy,Omen,Jett,KAY/O"
Split,uOttawa Garnet,OTSU Esports,13,6,3,4,2,10,"Raze,Cypher,Viper,Omen,Skye","Raze,Viper,Omen,Jett,Skye"
Lotus,SFU Pink,Sac State Green,13,2,11,1,1,2,"Raze,Killjoy,Viper,Omen,Fade","Breach,Raze,Killjoy,Omen,Gekko"
Sunset,north american west coast,Six Figures,13,9,3,7,2,10,"Raze,Cypher,Omen,KAY/O,Gekko","Raze,Cypher,Omen,KAY/O,Gekko"
Lotus,Ball State,WKU Hilltoppers RED,13,4,8,4,0,5,"Raze,Killjoy,Viper,Omen,Skye","Breach,Raze,Killjoy,Omen,Skye"
Ascent,Seattle University,BCIT Black,13,5,9,3,2,4,"Sova,Killjoy,Omen,Jett,KAY/O","Sova,Viper,Omen,Jett,KAY/O"
Split,Maryville University,Davenport University,13,10,6,5,5,7,"Raze,Cypher,Viper,Omen,Skye","Raze,Cypher,Viper,Reyna,Astra"
Lotus,St. Clair Saints,Conestoga Condors,13,1,11,1,0,2,"Raze,Killjoy,Viper,Omen,Fade","Breach,Raze,Killjoy,Omen,Gekko"
Lotus,Predator X Gaming,Van Lyn Black,9,13,4,6,7,5,"Raze,Killjoy,Viper,Fade,Clove","Raze,Killjoy,Viper,Omen,Fade"
Split,Fisher College Tea Party,PACE Gold,13,5,11,1,4,2,"Raze,Cypher,Viper,Omen,Skye","Raze,Viper,Omen,Jett,Skye"
Ascent,Brewton Parker College,UTD Orange,13,5,9,3,2,4,"Killjoy,Viper,Omen,Jett,Skye","Sova,Killjoy,Omen,Jett,KAY/O"
Ascent,GMU Patriots,Fisher Rising,2,13,2,10,3,0,"Cypher,Sova,Omen,Jett,KAY/O","Sova,Killjoy,Omen,Jett,KAY/O"
Lotus,Wichita State Esports,TXST Esports,13,5,10,2,3,3,"Raze,Killjoy,Viper,Omen,Skye","Raze,Killjoy,Viper,Omen,Fade"
Sunset,UST Esports,Northwest Vista College,13,4,9,3,1,4,"Breach,Raze,Cypher,Omen,Gekko","Cypher,Viper,Omen,Yoru,Gekko"
Bind,Niner Esports,BSC Bobcats VA,9,13,6,6,7,3,"Raze,Viper,Brimstone,Skye,Gekko","Cypher,Viper,Brimstone,Reyna,Skye"
Bind,G2 Esports,100 Thieves,9,13,5,5,8,4,"Viper,Brimstone,Yoru,KAY/O,Fade","Raze,Viper,Brimstone,Fade,Gekko"
Lotus,Converse NBG,Columbia College,10,13,6,6,7,4,"Raze,Killjoy,Viper,Omen,Skye","Raze,Killjoy,Viper,Fade,Harbor"
Split,Illini Esports Orange,UofG Gold,13,6,4,3,3,9,"Raze,Cypher,Viper,Omen,Skye","Breach,Raze,Cypher,Omen,Skye"
Bind,Northwood University,Miami Varsity Red,13,10,7,5,5,6,"Breach,Raze,Cypher,Sova,Brimstone","Raze,Brimstone,Skye,Chamber,Deadlock"
Sunset,Seneca Ruby,Carleton Ravens,6,13,4,8,5,2,"Breach,Raze,Cypher,Omen,Gekko","Raze,Cypher,Omen,KAY/O,Gekko"
Lotus,OKState Varsity,UAFS Digital Lions,10,13,3,8,5,7,"Raze,Killjoy,Viper,Omen,Gekko","Raze,Killjoy,Omen,Jett,Gekko"
Split,TAMU White,RRG Orange,4,13,0,5,8,4,"Raze,Cypher,Viper,Omen,Skye","Raze,Cypher,Viper,Omen,Skye"
Bind,Stockton Varsity,PSU Black,6,13,2,5,8,4,"Raze,Viper,Brimstone,Skye,Gekko","Raze,Viper,Omen,Yoru,Fade"
Bind,SJSU Gold,UO Green,8,13,2,7,6,6,"Raze,Viper,Brimstone,Skye,Gekko","Raze,Viper,Brimstone,Skye,Gekko"
Ascent,Toji lickers,Goth Girl Sanctuary,15,13,8,6,7,7,"Sova,Killjoy,Omen,Jett,KAY/O","Sova,Killjoy,Omen,Jett,KAY/O"
Lotus,TMU Blue,F5 Esports,9,13,6,6,7,3,"Raze,Killjoy,Viper,Omen,Fade","Raze,Killjoy,Viper,Omen,Skye"
Split,north american west coast,Six Figures,4,13,2,3,10,2,"Raze,Cypher,Viper,Omen,Skye","Raze,Cypher,Omen,Jett,Deadlock"
Icebox,University of Virginia,UMBC Black,11,13,7,5,8,4,"Raze,Sova,Killjoy,Viper,Sage","Sova,Killjoy,Viper,Reyna,Jett"
Ascent,Niner Esports,BSC Bobcats VA,13,5,1,5,0,12,"Sova,Killjoy,Omen,Jett,KAY/O","Sova,Killjoy,Omen,Jett,KAY/O"
Breeze,Wichita State Esports,TXST Esports,13,1,11,1,0,2,"Sova,Viper,Yoru,KAY/O,Harbor","Cypher,Sova,Viper,Reyna,Jett"
Icebox,Ball State,WKU Hilltoppers RED,11,13,8,4,9,3,"Killjoy,Viper,Sage,Jett,Gekko","Sova,Killjoy,Viper,Sage,Gekko"
Lotus,UST Esports,Northwest Vista College,13,8,5,4,4,8,"Breach,Raze,Killjoy,Omen,Gekko","Raze,Viper,Omen,Chamber,Gekko"
Icebox,Seattle University,BCIT Black,13,10,6,5,5,7,"Sova,Killjoy,Viper,Jett,Harbor","Sova,Killjoy,Viper,Jett,Gekko"
Bind,Illini Esports Orange,UofG Gold,13,6,10,2,4,3,"Raze,Viper,Brimstone,Skye,Chamber","Raze,Viper,Brimstone,Skye,Gekko"
Sunset,Converse NBG,Columbia College,5,13,2,4,9,3,"Cypher,Viper,Omen,Jett,Skye","Breach,Raze,Cypher,Sova,Omen"
Bind,uOttawa Garnet,OTSU Esports,14,12,8,5,7,6,"Raze,Viper,Brimstone,Gekko,Deadlock","Raze,Sova,Viper,Brimstone,Skye"
Lotus,Seneca Ruby,Carleton Ravens,4,13,1,4,9,3,"Raze,Killjoy,Omen,Jett,Skye","Raze,Killjoy,Viper,Omen,Gekko"
Lotus,Predator X Gaming,Radford University,13,8,6,3,5,7,"Raze,Killjoy,Viper,Fade,Clove","Raze,Killjoy,Viper,Omen,Fade"
Ascent,OKState Varsity,UAFS Digital Lions,2,13,1,11,2,1,"Sova,Killjoy,Omen,Jett,KAY/O","Sova,Killjoy,Omen,Jett,KAY/O"
Bind,St. Clair Saints,Conestoga Condors,13,11,10,2,9,3,"Breach,Raze,Viper,Skye,Astra","Raze,Cypher,Viper,Brimstone,Skye"
Ascent,TAMU White,RRG Orange,13,7,6,2,5,7,"Sova,Killjoy,Omen,Jett,KAY/O","Sova,Killjoy,Omen,Jett,KAY/O"
Lotus,Brewton Parker College,UTD Orange,13,8,8,1,7,5,"Raze,Killjoy,Viper,Omen,Fade","Raze,Killjoy,Viper,Omen,Skye"
Lotus,Northwood University,Miami Varsity Red,13,6,3,4,2,10,"Raze,Sova,Killjoy,Viper,Omen","Killjoy,Viper,Omen,Jett,Skye"
Lotus,Fisher College Tea Party,PACE Gold,11,13,5,7,6,6,"Raze,Killjoy,Viper,Omen,Skye","Raze,Killjoy,Viper,Omen,Fade"
Lotus,SJSU Gold,UO Green,5,13,1,5,8,4,"Breach,Raze,Killjoy,Omen,Gekko","Raze,Killjoy,Omen,Yoru,Gekko"
Ascent,Northeastern Varsity,Syracuse University,13,3,4,0,3,9,"Sova,Killjoy,Omen,Jett,KAY/O","Sova,Killjoy,Omen,Jett,KAY/O"
Split,Fisher College Navy,James Madison University,13,9,4,6,3,9,"Raze,Viper,Omen,Jett,Skye","Raze,Viper,Omen,Jett,Skye"
Icebox,Fisher Falcons,FGCU Thunderbirds,13,0,12,0,0,1,"Sova,Killjoy,Viper,Reyna,Jett","Sova,Killjoy,Viper,Reyna,KAY/O"
Bind,Rochester University Esports,NJIT Highlanders Red,13,6,5,2,4,8,"Raze,Cypher,Viper,Brimstone,Skye","Raze,Viper,Brimstone,Skye,Yoru"
Lotus,Harrisburg University,Boston University Red,13,1,11,1,0,2,"Killjoy,Viper,Omen,Neon,Gekko","Breach,Raze,Killjoy,Omen,Fade"
Sunset,GMU Patriots,Fisher Rising,16,14,8,7,7,8,"Breach,Raze,Cypher,Sova,Omen","Breach,Raze,Cypher,Sova,Omen"
Bind,West Virginia University,McGill Red,13,4,8,4,0,5,"Raze,Viper,Brimstone,Skye,Yoru","Raze,Viper,Brimstone,Skye,Gekko"
Bind,Winthrop University,SNHU Esports,13,10,8,3,7,5,"Raze,Viper,Brimstone,Skye,Gekko","Sova,Viper,Phoenix,Omen,Deadlock"
Lotus,north american west coast,Six Figures,13,5,4,2,3,9,"Raze,Killjoy,Viper,Omen,Skye","Breach,Astra,Chamber,Neon,Gekko"
Lotus,Toji lickers,Goth Girl Sanctuary,9,13,4,8,5,5,"Raze,Killjoy,Viper,Omen,Fade","Raze,Killjoy,Viper,Omen,Gekko"
Breeze,Permitta Unicorns,Novita Esports,5,13,2,4,9,3,"Cypher,Sova,Viper,Jett,Gekko","Cypher,Sova,Viper,Jett,Yoru"
Ascent,Fisher College Tea Party,PACE Gold,13,9,9,3,6,4,"Sova,Killjoy,Omen,Jett,KAY/O","Cypher,Sova,Omen,Jett,KAY/O"
Icebox,Fisher College Navy,James Madison University,13,5,8,4,1,5,"Killjoy,Viper,Jett,KAY/O,Gekko","Sova,Killjoy,Viper,Sage,Jett"
Lotus,University of Virginia,UMBC Black,14,12,9,4,8,5,"Raze,Sova,Viper,Omen,KAY/O","Raze,Omen,Chamber,Neon,Gekko"
Split,Fisher Falcons,FGCU Thunderbirds,13,5,2,4,1,11,"Raze,Cypher,Viper,Omen,Skye","Breach,Raze,Killjoy,Skye,Astra"
Sunset,Predator X Gaming,Radford University,13,10,6,6,4,7,"Breach,Cypher,Sova,Jett,Clove","Breach,Raze,Cypher,Omen,Gekko"
Sunset,Harrisburg University,Boston University Red,13,5,6,0,5,7,"Breach,Raze,Cypher,Omen,Gekko","Breach,Raze,Cypher,Omen,Gekko"
Ascent,Stockton Varsity,PSU Black,12,14,8,5,9,4,"Sova,Killjoy,Omen,Jett,KAY/O","Sova,Killjoy,Omen,Jett,KAY/O"
Ascent,TMU Blue,Alphaware Olympians,13,5,6,0,5,7,"Breach,Sova,Killjoy,Omen,Jett","Cypher,Sova,Omen,Jett,KAY/O"
Ascent,West Virginia University,McGill Red,13,4,5,0,4,8,"Sova,Killjoy,Omen,Jett,KAY/O","Sova,Killjoy,Omen,Jett,KAY/O"
Sunset,Winthrop University,SNHU Esports,13,4,9,3,1,4,"Breach,Raze,Cypher,Omen,Fade","Raze,Cypher,Omen,KAY/O,Gekko"
Split,GMU Patriots,Fisher Rising,6,13,4,8,5,2,"Raze,Cypher,Omen,Jett,Skye","Raze,Cypher,Viper,Omen,Skye"
Lotus,Northeastern Varsity,Syracuse University,13,6,7,5,1,6,"Raze,Killjoy,Viper,Omen,Fade","Raze,Killjoy,Viper,Omen,Fade"
Sunset,Rochester University Esports,NJIT Highlanders Red,13,9,4,6,3,9,"Raze,Cypher,Sova,Omen,Gekko","Breach,Raze,Cypher,Omen,KAY/O"
Icebox,Van Lyn Black,U4RIA Radiata,13,8,6,3,5,7,"Killjoy,Viper,Jett,KAY/O,Gekko","Sova,Killjoy,Viper,Sage,Jett"
Lotus,F5 Esports,LazerrFreeks8,13,10,5,7,3,8,"Raze,Killjoy,Viper,Omen,Skye","Raze,Killjoy,Omen,Fade,Gekko"
Ascent,Sushi Bois,north american west coast,0,13,0,1,12,0,"Sova,Killjoy,Omen,Jett,KAY/O","Cypher,Sova,Reyna,Jett,Clove"
Breeze,Cumberland Phoenix,University of Oklahoma,13,7,8,4,3,5,"Cypher,Sova,Viper,Jett,KAY/O","Cypher,Sova,Viper,Omen,Yoru"
Split,Reveal Multigaming,XPERION NXT,3,13,3,9,4,0,"Breach,Raze,Cypher,Omen,Skye","Raze,Cypher,Viper,Omen,Skye"
Split,Team Disrupt,Scarlet Death Esports,13,6,8,4,2,5,"Raze,Cypher,Viper,Omen,Skye","Raze,Cypher,Viper,Omen,Skye"
Icebox,Toji lickers,Goth Girl Sanctuary,13,9,8,2,7,5,"Sova,Killjoy,Viper,Jett,Harbor","Raze,Killjoy,Viper,Gekko,Clove"
Icebox,Permitta Unicorns,Novita Esports,11,13,2,10,3,9,"Sova,Killjoy,Viper,Omen,Jett","Killjoy,Viper,Reyna,Jett,Gekko"
Bind,Van Lyn Black,U4RIA Radiata,13,4,12,0,4,1,"Raze,Viper,Brimstone,Fade,Gekko","Raze,Cypher,Viper,Brimstone,Skye"
Split,TMU Blue,Alphaware Olympians,13,10,6,6,4,7,"Breach,Cypher,Omen,Jett,Skye","Raze,Cypher,Omen,Skye,Deadlock"
Bind,Sushi Bois,north american west coast,4,13,4,8,5,0,"Raze,Viper,Brimstone,Yoru,Gekko","Raze,Viper,Brimstone,Skye,Gekko"
Lotus,Cumberland Phoenix,University of Oklahoma,13,6,9,3,3,4,"Killjoy,Viper,Omen,Jett,Skye","Raze,Killjoy,Viper,Omen,Fade"
Icebox,Predator X Gaming,Radford University,9,13,2,8,5,7,"Raze,Sova,Killjoy,Viper,Yoru","Killjoy,Viper,Sage,KAY/O,Gekko"
Split,F5 Esports,LazerrFreeks8,13,6,4,3,3,9,"Raze,Cypher,Viper,Omen,Skye","Raze,Cypher,Viper,Omen,Skye"
Lotus,Team Disrupt,Scarlet Death Esports,13,4,3,2,2,10,"Raze,Killjoy,Viper,Omen,Fade","Raze,Killjoy,Viper,Omen,Fade"
Split,2Game Esports,Hero Base,13,11,7,5,6,6,"Viper,Jett,Astra,Fade,Gekko","Breach,Raze,Viper,Omen,Skye"
Icebox,Reveal Multigaming,XPERION NXT,10,13,7,5,8,3,"Sova,Killjoy,Viper,Reyna,Jett","Sova,Killjoy,Viper,Jett,Harbor"
Sunset,Permitta Unicorns,Novita Esports,13,6,9,3,3,4,"Breach,Raze,Cypher,Omen,Fade","Breach,Cypher,Omen,Yoru,Gekko"
Split,OnlyFins,SweetNsour,13,11,6,6,5,7,"Killjoy,Viper,Omen,Jett,KAY/O","Raze,Cypher,Viper,Omen,Skye"
Ascent,SAW,Elevate,14,12,6,7,5,8,"Sova,Killjoy,Omen,Jett,KAY/O","Breach,Reyna,Astra,Neon,Gekko"
Breeze,AKA HERO,Novita Esports,6,13,2,10,3,4,"Cypher,Sova,Viper,Jett,Yoru","Cypher,Sova,Viper,Jett,Yoru"
Breeze,2Game Esports,Hero Base,13,11,8,4,7,5,"Sova,Viper,Jett,Yoru,Astra","Cypher,Sova,Viper,Jett,KAY/O"
Bind,CSP Val Blue,Clarke Pride,13,1,11,1,0,2,"Breach,Raze,Viper,Brimstone,Skye","Raze,Viper,Brimstone,Reyna,Skye"
Breeze,XPERION NXT,SOS Affenalarm,13,5,10,2,3,3,"Sova,Viper,Skye,Neon,Harbor","Cypher,Sova,Viper,Reyna,Jett"
Icebox,OnlyFins,SweetNsour,13,6,9,3,3,4,"Sova,Killjoy,Viper,Sage,Jett","Sova,Killjoy,Viper,Jett,Harbor"
Bind,SAW,Elevate,13,6,5,2,4,8,"Raze,Viper,Brimstone,Skye,Gekko","Viper,Omen,KAY/O,Neon,Gekko"
Breeze,CSP Val Blue,Clarke Pride,13,2,2,1,1,11,"Sova,Viper,Jett,Yoru,Harbor","Sova,Viper,Jett,Astra,KAY/O"
Bind,Vennegjengen,CTRL x YARI Esports,1,13,1,11,2,0,"Raze,Cypher,Viper,Brimstone,Skye","Raze,Cypher,Viper,Brimstone,Skye"
Split,AKA HERO,Novita Esports,13,8,8,4,4,5,"Raze,Cypher,Viper,Omen,Skye","Raze,Cypher,Viper,Omen,Skye"
Sunset,Reveal Multigaming,Veni eSports,14,12,5,8,4,9,"Breach,Cypher,Sova,Omen,Jett","Breach,Cypher,Sova,Omen,Jett"
Split,XPERION NXT,SOS Affenalarm,13,1,11,1,0,2,"Raze,Cypher,Viper,Omen,Skye","Breach,Raze,Cypher,Omen,Jett"
Ascent,Permitta Unicorns,BUCHCLUB,13,4,5,0,4,8,"Sova,Killjoy,Omen,Jett,KAY/O","Sova,Killjoy,Omen,Jett,KAY/O"
Sunset,OnlyFins,SweetNsour,10,13,3,8,5,7,"Breach,Raze,Cypher,Sova,Omen","Raze,Cypher,Omen,KAY/O,Gekko"
Ascent,XPERION NXT,SOS Affenalarm,5,13,2,10,3,3,"Sova,Killjoy,Omen,Jett,KAY/O","Sova,Killjoy,Phoenix,Omen,Jett"
Icebox,RED Canids,Galorys,13,11,6,6,5,7,"Sova,Killjoy,Viper,Sage,Jett","Sova,Killjoy,Viper,Sage,Jett"
Lotus,AKA HERO,Novita Esports,9,13,7,5,8,2,"Raze,Killjoy,Viper,Omen,Fade","Killjoy,Omen,Jett,Yoru,Gekko"
Sunset,Permitta Unicorns,BUCHCLUB,13,5,8,4,1,5,"Breach,Raze,Cypher,Omen,Fade","Breach,Raze,Cypher,Omen,Gekko"
Lotus,Vennegjengen,CTRL x YARI Esports,13,10,4,8,2,9,"Breach,Raze,Cypher,Harbor,Deadlock","Breach,Raze,Sage,Astra,Deadlock"
Split,SAW,Elevate,12,14,8,5,9,4,"Raze,Viper,Jett,Skye,Astra","Raze,Viper,Omen,Yoru,Fade"
Lotus,Reveal Multigaming,Veni eSports,13,11,8,4,7,5,"Breach,Sova,Killjoy,Omen,Jett","Breach,Killjoy,Omen,Jett,Gekko"
Ascent,Absolute Cinema,Divergentes GC,8,13,1,8,5,7,"Sova,Killjoy,Reyna,Omen,Neon","Killjoy,Omen,Jett,KAY/O,Gekko"
Breeze,Vennegjengen,CTRL x YARI Esports,5,13,4,8,5,1,"Cypher,Sova,Viper,Yoru,Harbor","Cypher,Sova,Viper,Omen,Yoru"
Icebox,Absolute Cinema,FATE Flare,0,13,0,12,1,0,"Sova,Viper,Jett,Chamber,Gekko","Sova,Killjoy,Viper,Reyna,Gekko"
Icebox,SAW,Elevate,13,3,11,1,2,2,"Sova,Killjoy,Viper,Sage,Jett","Killjoy,Viper,Jett,KAY/O,Gekko"
Ascent,RED Canids,Galorys,14,12,5,8,4,9,"Sova,Killjoy,Omen,Jett,KAY/O","Sova,Killjoy,Omen,Jett,KAY/O"
Lotus,TDSwordys,Divergentes GC,3,13,1,3,10,2,"Breach,Killjoy,Omen,Neon,Gekko","Breach,Raze,Cypher,Omen,Gekko"
Icebox,Apeks,Metizport,13,9,7,3,6,6,"Sova,Killjoy,Viper,Yoru,Harbor","Sova,Killjoy,Viper,Sage,Jett"
Split,DetonatioN FocusMe GC,Eternity GC,13,6,7,5,1,6,"Breach,Raze,Cypher,Omen,Deadlock","Breach,Raze,Cypher,Omen,Fade"
Bind,Sasanqua,Soleil Gaming,13,2,3,0,2,10,"Cypher,Brimstone,Jett,Skye,Gekko","Breach,Raze,Brimstone,Jett,Gekko"
Split,Absolute Cinema,FATE Flare,9,13,7,5,8,2,"Raze,Cypher,Omen,Jett,Skye","Breach,Raze,Cypher,Sage,Omen"
Icebox,BANDAL,shade yoja,13,6,11,1,5,2,"Killjoy,Viper,Jett,KAY/O,Gekko","Sova,Killjoy,Viper,Reyna,Jett"
Ascent,METU VALKYRIES,TDSwordys,2,13,0,3,10,2,"Breach,Cypher,Sage,Jett,Astra","Breach,Raze,Sova,Killjoy,Omen"
Bind,EXO Clan,Vennegjengen,3,13,3,9,4,0,"Raze,Cypher,Viper,Omen,Skye","Raze,Cypher,Viper,Brimstone,Skye"
Ascent,DRAKAINAS,Divergentes GC,5,13,3,9,4,2,"Sova,Killjoy,Omen,Jett,KAY/O","Killjoy,Omen,Jett,KAY/O,Gekko"
Ascent,Apeks,Metizport,13,3,4,0,3,9,"Sova,Killjoy,Omen,Jett,KAY/O","Sova,Killjoy,Viper,Omen,Jett"
Bind,T1,DRX,6,13,3,9,4,3,"Raze,Viper,Skye,Harbor,Gekko","Raze,Cypher,Viper,Brimstone,KAY/O"
Lotus,DetonatioN FocusMe GC,Eternity GC,13,8,5,4,4,8,"Raze,Killjoy,Viper,Omen,Fade","Breach,Raze,Cypher,Omen,Fade"
Lotus,Sasanqua,Soleil Gaming,5,13,3,3,10,2,"Killjoy,Omen,Jett,Skye,Chamber","Breach,Raze,Killjoy,Omen,Gekko"
Bind,Erah Esport GC,TDSwordys,3,13,0,4,9,3,"Breach,Raze,Cypher,Brimstone,Skye","Raze,Cypher,Brimstone,Skye,Gekko"
Ascent,EXO Clan,Vennegjengen,13,6,9,3,3,4,"Breach,Cypher,Sova,Omen,Jett","Sova,Killjoy,Omen,Jett,KAY/O"
Bind,BANDAL,shade yoja,13,10,5,7,3,8,"Breach,Raze,Cypher,Brimstone,Skye","Raze,Cypher,Viper,Brimstone,Skye"
Ascent,Absolute Cinema,DRAKAINAS,13,7,6,2,5,7,"Sova,Killjoy,Omen,Jett,Yoru","Sova,Killjoy,Omen,Jett,KAY/O"
Bind,CTRL Esports,CTRL x YARI Esports,8,13,4,8,5,4,"Raze,Cypher,Viper,Brimstone,Skye","Raze,Cypher,Viper,Brimstone,Skye"
Lotus,METU VALKYRIES,FATE Flare,6,13,2,10,3,4,"Raze,Killjoy,Viper,Omen,Gekko","Breach,Raze,Killjoy,Omen,Gekko"
Split,T1,DRX,5,13,2,10,3,3,"Raze,Viper,Omen,Jett,Skye","Raze,Cypher,Viper,Omen,Skye"
Lotus,Divergentes GC,AURORA,13,1,11,1,0,2,"Breach,Raze,Cypher,Omen,Gekko","Breach,Raze,Killjoy,Omen,Gekko"
Split,O2esports,Insomnia GC,3,13,3,9,4,0,"Raze,Viper,Omen,KAY/O,Gekko","Breach,Raze,Cypher,Sage,Omen"
Sunset,Sasanqua,Soleil Gaming,13,5,8,4,1,5,"Cypher,Sova,Omen,Jett,Gekko","Raze,Cypher,Omen,KAY/O,Gekko"
Lotus,EXO Clan,Vennegjengen,8,13,6,3,10,2,"Breach,Raze,Sova,Killjoy,Omen","Breach,Raze,Cypher,Harbor,Deadlock"
Lotus,CTRL Esports,CTRL x YARI Esports,9,13,6,4,9,3,"Raze,Killjoy,Viper,Omen,Fade","Raze,Killjoy,Viper,Omen,Fade"
Lotus,Divergentes GC,FATE Flare,9,13,4,6,7,5,"Breach,Raze,Cypher,Omen,Gekko","Breach,Raze,Killjoy,Omen,Gekko"
Bind,Erah Esport GC,DRAKAINAS,11,13,5,7,6,6,"Breach,Raze,Cypher,Brimstone,Skye","Breach,Raze,Viper,Brimstone,Yoru"
Split,BANDAL,shade yoja,9,13,7,3,10,2,"Breach,Raze,Cypher,Omen,Skye","Raze,Cypher,Viper,Omen,Skye"
Split,Eternity GC,DOPENESS SELENE,13,11,8,4,7,5,"Breach,Raze,Cypher,Omen,Fade","Breach,Raze,Cypher,Omen,Skye"
Sunset,Absolute Cinema,TDSwordys,13,6,10,2,4,3,"Raze,Cypher,Sova,Omen,Yoru","Breach,Raze,Cypher,Omen,Fade"
Breeze,T1,DRX,13,9,8,2,7,5,"Sova,Viper,Jett,Yoru,Harbor","Cypher,Sova,Viper,Jett,Yoru"
Icebox,FENNEL GC,Reignite Lily,10,13,6,6,7,4,"Sova,Killjoy,Viper,Jett,KAY/O","Sova,Killjoy,Viper,Jett,Deadlock"
Ascent,METU VALKYRIES,AURORA,13,5,4,2,3,9,"Breach,Cypher,Sage,Jett,Astra","Sova,Killjoy,Omen,Jett,KAY/O"
Ascent,O2esports,Insomnia GC,2,13,2,10,3,0,"Sova,Killjoy,Omen,Jett,KAY/O","Breach,Sova,Killjoy,Omen,Astra"
Icebox,Soleil Gaming,AMORIS Lykos,13,7,6,2,5,7,"Sova,Killjoy,Viper,Jett,Gekko","Killjoy,Viper,Jett,KAY/O,Gekko"
Ascent,Eternity GC,DOPENESS SELENE,11,13,5,7,6,6,"Sova,Killjoy,Omen,Jett,KAY/O","Sova,Killjoy,Omen,Jett,KAY/O"
Bind,Gen.G Esports,Paper Rex,6,13,2,10,3,4,"Raze,Cypher,Viper,Brimstone,Skye","Raze,Brimstone,Skye,Harbor,Gekko"
Lotus,Meteor GC,SCARZ GC,10,13,6,6,7,4,"Raze,Astra,KAY/O,Chamber,Gekko","Cypher,Sova,Omen,Jett,KAY/O"
Lotus,FENNEL GC,Reignite Lily,13,10,5,6,4,8,"Raze,Killjoy,Viper,Omen,Fade","Raze,Viper,Omen,Chamber,Fade"
Bind,Insomnia GC,TRO Gaming Lumirize,13,6,10,2,4,3,"Raze,Cypher,Brimstone,Reyna,Skye","Raze,Cypher,Brimstone,Reyna,Skye"
Split,NIX_North,shade yoja,8,13,5,7,6,3,"Raze,Cypher,Viper,Omen,Skye","Raze,Cypher,Viper,Omen,Skye"
Lotus,DRX Changers,Focus e-Sports Female,13,4,3,2,2,10,"Raze,Killjoy,Viper,Omen,Gekko","Raze,Killjoy,Omen,Fade,Gekko"
Sunset,BANDAL,GEM DIANA,13,1,11,1,0,2,"Raze,Cypher,Sova,Phoenix,Omen","Breach,Raze,Cypher,Omen,Fade"
Split,ZETA DIVISION GC,Cyber Geek,13,8,5,4,4,8,"Raze,Cypher,Viper,Omen,Skye","Raze,Viper,Omen,Jett,Skye"
Icebox,O2esports,NoNameRabbit,13,4,10,2,2,3,"Sova,Killjoy,Viper,Omen,Jett","Sova,Killjoy,Viper,KAY/O,Harbor"
Split,DetonatioN FocusMe GC,EAGER GC,13,4,4,1,3,9,"Breach,Raze,Cypher,Omen,Deadlock","Breach,Raze,Cypher,Omen,Skye"
Lotus,Soleil Gaming,AMORIS Lykos,13,10,4,7,3,9,"Breach,Raze,Killjoy,Omen,Gekko","Raze,Killjoy,Viper,Skye,Astra"
Ascent,FENNEL GC,Reignite Lily,6,13,5,7,6,1,"Sova,Killjoy,Omen,Jett,KAY/O","Sova,Killjoy,Omen,Jett,KAY/O"
Lotus,Eternity GC,DOPENESS SELENE,13,11,7,5,6,6,"Breach,Raze,Cypher,Omen,Fade","Raze,Killjoy,Viper,Omen,Fade"
Lotus,BANDAL,GEM DIANA,13,5,10,2,3,3,"Raze,Killjoy,Omen,Jett,Skye","Breach,Raze,Killjoy,Omen,Fade"
Icebox,Gen.G Esports,Paper Rex,11,13,3,9,4,8,"Killjoy,Viper,Omen,KAY/O,Gekko","Killjoy,Viper,Sage,Jett,KAY/O"
Icebox,NIX_North,shade yoja,4,13,1,4,9,3,"Sova,Killjoy,Viper,Jett,KAY/O","Sova,Killjoy,Viper,Reyna,Jett"
Icebox,Insomnia GC,TRO Gaming Lumirize,13,4,11,1,3,2,"Raze,Sova,Killjoy,Viper,Harbor","Killjoy,Viper,Jett,KAY/O,Gekko"
Ascent,ZETA DIVISION GC,Cyber Geek,13,6,11,1,5,2,"Sova,Killjoy,Omen,Jett,KAY/O","Sova,Killjoy,Omen,Jett,KAY/O"
Ascent,DRX Changers,Focus e-Sports Female,13,5,4,2,3,9,"Sova,Killjoy,Omen,Jett,KAY/O","Sova,Killjoy,Phoenix,Omen,Jett"
Bind,DetonatioN FocusMe GC,EAGER GC,13,0,1,0,0,12,"Breach,Raze,Cypher,Brimstone,Fade","Breach,Raze,Brimstone,Jett,Skye"
Lotus,O2esports,NoNameRabbit,13,2,1,2,0,12,"Breach,Raze,Killjoy,Omen,Fade","Raze,Killjoy,Viper,Omen,Skye"
Ascent,Meteor GC,SCARZ GC,13,15,5,9,6,8,"Sova,Killjoy,Omen,Jett,KAY/O","Sova,Killjoy,Omen,Jett,KAY/O"
Lotus,Gen.G Esports,Paper Rex,13,11,9,3,8,4,"Raze,Killjoy,Viper,Omen,Fade","Raze,Cypher,Omen,Jett,Skye"
Lotus,Absolute Gaming,Hyperion Gaming,13,2,3,0,2,10,"Breach,Raze,Killjoy,Gekko,Clove","Raze,Killjoy,Viper,Omen,Gekko"
Bind,Absolute Gaming,Hyperion Gaming,13,3,9,3,0,4,"Raze,Cypher,Brimstone,Reyna,Skye","Raze,Viper,Brimstone,Skye,Yoru"
Sunset,Reactor 9,We are Groot,4,13,3,9,4,1,"Raze,Cypher,Omen,KAY/O,Gekko","Raze,Cypher,Viper,Omen,Gekko"
Ascent,Reactor 9,The Okiezis,13,0,1,0,0,12,"Sova,Killjoy,Omen,Jett,KAY/O","Sova,Killjoy,Omen,Jett,KAY/O"
Sunset,KTANA,Duality Esports,13,11,7,5,6,6,"Breach,Raze,Cypher,Omen,Gekko","Raze,Cypher,Omen,KAY/O,Gekko"
Ascent,We are Groot,Defiant Gaming,13,10,6,6,4,7,"Sova,Killjoy,Viper,Jett,Clove","Sova,Killjoy,Omen,Jett,KAY/O"
Breeze,Clemson Esports,WKU Hilltoppers RED,5,13,4,8,5,1,"Cypher,Sova,Viper,Omen,Jett","Cypher,Sova,Viper,Jett,KAY/O"
Icebox,K7 Esports GC,Barcelona Sporting X,14,12,10,3,9,4,"Sova,Killjoy,Viper,Sage,Jett","Sova,Killjoy,Viper,Omen,Jett"
Sunset,Reactor 9,Predator X Gaming,13,11,6,6,5,7,"Raze,Cypher,Omen,KAY/O,Gekko","Breach,Cypher,Sova,Jett,Clove"
Lotus,KTANA,Duality Esports,13,8,8,1,7,5,"Breach,Cypher,Omen,Neon,Gekko","Breach,Raze,Viper,Omen,Gekko"
Bind,Akron Esports,Indiana Hoosiers,11,13,3,9,4,8,"Raze,Viper,Brimstone,Skye,Gekko","Raze,Viper,Brimstone,Skye,Yoru"
Split,Harmony Black,The Okiezis,11,13,5,7,6,6,"Raze,Cypher,Viper,Omen,Skye","Raze,Cypher,Omen,Skye,Gekko"
Ascent,We are Groot,Crack Babies,13,2,3,0,2,10,"Sova,Killjoy,Viper,Jett,Clove","Cypher,Sova,Omen,Jett,KAY/O"
Sunset,FIU Varsity,Sheridan Bruins,13,5,8,4,1,5,"Raze,Cypher,Viper,Omen,Gekko","Raze,Cypher,Omen,KAY/O,Gekko"
Sunset,Defiant Gaming,Supernova Nebula,13,9,5,7,2,8,"Raze,Cypher,Sova,Omen,Gekko","Raze,Cypher,Omen,KAY/O,Gekko"
Ascent,Clemson Esports,WKU Hilltoppers RED,11,13,4,8,5,7,"Sova,Killjoy,Omen,Jett,KAY/O","Breach,Sova,Killjoy,Omen,Jett"
Lotus,Reactor 9,NoNonSense,13,6,4,3,3,9,"Raze,Killjoy,Viper,Omen,Fade","Raze,Killjoy,Viper,Omen,Fade"
Sunset,K7 Esports GC,Barcelona Sporting X,13,9,6,4,5,7,"Raze,Cypher,Viper,Omen,Skye","Raze,Cypher,Omen,KAY/O,Gekko"
Ascent,Harmony Black,FDR,13,3,9,3,0,4,"Viper,Jett,Skye,Fade,Clove","Cypher,Sova,Omen,Jett,KAY/O"
Ascent,Akron Esports,Indiana Hoosiers,8,13,3,9,4,5,"Sova,Killjoy,Omen,Jett,KAY/O","Sova,Killjoy,Omen,Jett,KAY/O"
Breeze,iKU,Illicit Gaming,10,13,5,7,6,5,"Cypher,Sova,Viper,Jett,Yoru","Cypher,Sova,Viper,Jett,KAY/O"
Lotus,UCF Gold,USF Gold,13,3,3,1,2,10,"Breach,Raze,Omen,Chamber,Gekko","Raze,Killjoy,Viper,Omen,Fade"
Bind,Player1Fitness,Crack Babies,11,13,3,9,4,8,"Raze,Viper,Brimstone,Jett,Skye","Raze,Viper,Brimstone,Skye,Yoru"
Ascent,Vulcan Rising,Predator X Gaming,6,13,3,4,9,3,"Sova,Killjoy,Omen,Jett,KAY/O","Breach,Viper,Jett,KAY/O,Clove"
Lotus,FIU Varsity,Sheridan Bruins,13,9,7,5,4,6,"Raze,Killjoy,Viper,Omen,Fade","Raze,Sova,Killjoy,Omen,Skye"
Icebox,pugstars,The Okiezis,7,13,1,7,6,6,"Sova,Killjoy,Viper,Reyna,Jett","Killjoy,Viper,Jett,KAY/O,Gekko"
Bind,St. Clair Saints Academy,MBU Spartans,13,15,7,7,8,6,"Raze,Cypher,Viper,Brimstone,Skye","Raze,Viper,Brimstone,Skye,Gekko"
Icebox,Supernova Nebula,HYBR,13,8,9,3,5,4,"Killjoy,Viper,Reyna,KAY/O,Gekko","Sova,Killjoy,Viper,Jett,Chamber"
Sunset,Radford University,Defiant Gaming,7,13,4,4,9,3,"Breach,Raze,Cypher,Omen,Gekko","Raze,Cypher,Sova,Omen,Gekko"
Icebox,University War GC,Cruzados Esports GC,13,2,3,0,2,10,"Sova,Killjoy,Viper,Sage,Chamber","Killjoy,Viper,Jett,KAY/O,Gekko"
Icebox,Clemson Esports,WKU Hilltoppers RED,13,11,9,3,8,4,"Sova,Killjoy,Viper,Jett,Harbor","Sova,Killjoy,Viper,Sage,Gekko"
Sunset,Cataclysm Gaming,We are Groot,8,13,3,6,7,5,"Breach,Cypher,Omen,Yoru,Neon","Raze,Cypher,Viper,Omen,Gekko"
Split,Harmony Black,SYNTAX.FF,13,6,10,2,4,3,"Raze,Cypher,Viper,Omen,Skye","Raze,Omen,Yoru,Astra,Fade"
Bind,NoNonSense,Oxidized Esports,17,15,8,8,7,9,"Raze,Viper,Brimstone,Skye,Yoru","Raze,Viper,Brimstone,Fade,Gekko"
Split,UCF Gold,USF Gold,13,4,5,0,4,8,"Raze,Cypher,Viper,Omen,Skye","Raze,Viper,Omen,Skye,Iso"
Lotus,iKU,Illicit Gaming,4,13,1,4,9,3,"Raze,Killjoy,Viper,Omen,Gekko","Raze,Killjoy,Viper,Omen,Fade"
Split,XD Gaming,Player1Fitness,5,13,3,3,10,2,"Breach,Raze,Cypher,Yoru,Clove","Raze,Cypher,Viper,Omen,Skye"
Lotus,St. Clair Saints Academy,MBU Spartans,8,13,3,9,4,5,"Raze,Killjoy,Viper,Omen,Skye","Breach,Raze,Omen,Chamber,Gekko"
Lotus,Vulcan Rising,Boomerz and Zoomers,13,5,8,4,1,5,"Raze,Killjoy,Viper,Omen,Fade","Killjoy,Phoenix,Astra,Gekko,Clove"
Bind,Purpose Gaming,HYBR,1,13,0,2,11,1,"Raze,Viper,Brimstone,Skye,Gekko","Raze,Viper,Brimstone,Skye,Yoru"
Lotus,Rowan Brown,Predator X Gaming,0,13,0,1,12,0,"Breach,Raze,Cypher,Fade,Clove","Raze,Killjoy,Viper,Fade,Clove"
Lotus,mentally chill,pugstars,10,13,6,6,7,4,"Raze,Killjoy,Viper,Gekko,Clove","Raze,Cypher,Viper,Omen,Fade"
Lotus,Radford University,Erm what the crap!,13,6,3,4,2,10,"Raze,Killjoy,Viper,Omen,Fade","Raze,Killjoy,Omen,Fade,Gekko"
Lotus,Dhap's Daycare,Reactor 9,0,13,0,1,12,0,"Breach,Raze,Killjoy,Omen,Gekko","Raze,Killjoy,Viper,Omen,Fade"
Lotus,Crack Babies,Team Virtuosity,13,11,4,8,3,9,"Raze,Killjoy,Viper,Omen,Fade","Raze,Killjoy,Viper,Omen,Skye"
Sunset,QoR,Thinking Men,13,11,8,4,7,5,"Breach,Raze,Cypher,Sova,Omen","Breach,Raze,Cypher,Omen,Fade"
Lotus,Hyperion Gold,We are Groot,8,13,1,8,5,7,"Raze,Killjoy,Viper,Omen,Gekko","Raze,Killjoy,Viper,Omen,Gekko"
Ascent,UNCW Varsity,The Okiezis,3,13,2,2,11,1,"Sova,Killjoy,Omen,Jett,KAY/O","Cypher,Sova,Reyna,Jett,Clove"
Ascent,Wall Rats,FDR,3,13,0,4,9,3,"Cypher,Omen,Jett,Skye,KAY/O","Cypher,Sova,Omen,Jett,KAY/O"
Icebox,Amphibium GC,Cataclysm Gaming,2,13,2,10,3,0,"Sova,Killjoy,Viper,Jett,KAY/O","Sova,Killjoy,Viper,Chamber,Harbor"
Bind,A1 ESports,Defiant Gaming,1,13,1,11,2,0,"Raze,Cypher,Viper,Brimstone,Gekko","Raze,Viper,Brimstone,Skye,Gekko"
Sunset,Spartans Academy,Predator X Gaming,2,13,0,3,10,2,"Raze,Cypher,Viper,Omen,Gekko","Breach,Cypher,Sova,Jett,Clove"
Sunset,SYNTAX.FF,Destined2Rise,15,13,9,5,8,6,"Breach,Raze,Cypher,Omen,Gekko","Raze,Cypher,Omen,KAY/O,Gekko"
Sunset,Reactor 9,Nerve Esports Onyx,13,0,12,0,0,1,"Raze,Cypher,Omen,KAY/O,Gekko","Raze,Cypher,Sova,Omen,Gekko"
Split,Player1Fitness,Raven Esports,13,8,5,7,1,8,"Raze,Cypher,Viper,Omen,Skye","Raze,Cypher,Viper,Skye,Astra"
Sunset,Scarlet Death Esports,pugstars,1,13,0,2,11,1,"Raze,Cypher,Omen,KAY/O,Gekko","Raze,Cypher,Viper,Omen,Gekko"
Bind,HYBR,Fallen Angels Orias,13,4,9,3,1,4,"Raze,Viper,Brimstone,Skye,Yoru","Raze,Viper,Brimstone,Skye,Gekko"
Sunset,99 do-gooders,Team Virtuosity,1,13,0,2,11,1,"Raze,Omen,KAY/O,Neon,Fade","Raze,Cypher,Viper,Omen,Fade"
Sunset,Destro,Oxidized Esports,13,15,6,8,7,7,"Breach,Raze,Harbor,Gekko,Clove","Breach,Raze,Cypher,Omen,Fade"
Ascent,UW Esports,Boomerz and Zoomers,5,13,2,4,9,3,"Cypher,Sova,Omen,Jett,KAY/O","Sova,Killjoy,Phoenix,Astra,Clove"
Ascent,Erm what the crap!,WasTaken,13,1,2,0,1,11,"Sova,Killjoy,Omen,Jett,KAY/O","Sova,Killjoy,Omen,Jett,KAY/O"
Split,University War GC,Cruzados Esports GC,16,14,9,6,8,7,"Raze,Cypher,Viper,Omen,Skye","Viper,Jett,Skye,Astra,KAY/O"
Lotus,Advogatos,Stellae Gaming Academy,13,11,9,3,8,4,"Raze,Killjoy,Viper,Omen,Gekko","Raze,Killjoy,Viper,Omen,Skye"
Ascent,QoR,Thinking Men,13,11,3,9,2,10,"Sova,Killjoy,Omen,Jett,KAY/O","Cypher,Viper,Omen,Jett,Skye"
Sunset,University War GC,Cruzados Esports GC,10,13,7,5,8,3,"Breach,Raze,Cypher,Omen,Fade","Breach,Raze,Cypher,Omen,Fade"
Icebox,Advogatos,Stellae Gaming Academy,13,6,4,3,3,9,"Sova,Killjoy,Viper,Jett,Gekko","Sova,Killjoy,Viper,Jett,Gekko"
Lotus,M80,Winthrop University,13,11,7,5,6,6,"Raze,Killjoy,Viper,Omen,Fade","Raze,Killjoy,Viper,Omen,Fade"
Bind,UF Blue,UCF Black,13,10,6,6,4,7,"Raze,Cypher,Viper,Brimstone,Skye","Raze,Cypher,Viper,Brimstone,Gekko"
Ascent,UF Blue,UCF Black,13,3,4,0,3,9,"Sova,Killjoy,Omen,Jett,KAY/O","Sova,Killjoy,Omen,Jett,KAY/O"
Sunset,M80,Winthrop University,13,1,2,0,1,11,"Raze,Cypher,Omen,KAY/O,Gekko","Breach,Raze,Cypher,Omen,Fade"
Sunset,Hero Base,Legacy,13,6,2,5,1,11,"Breach,Raze,Viper,Omen,KAY/O","Raze,Cypher,Omen,KAY/O,Gekko"
Icebox,Karmine Corp,Gentle Mates,13,6,3,4,2,10,"Killjoy,Viper,Sage,Jett,Gekko","Sova,Killjoy,Viper,Sage,Jett"
Lotus,Hero Base,Legacy,13,8,8,4,4,5,"Killjoy,Viper,Omen,Neon,Gekko","Raze,Killjoy,Viper,Omen,Fade"
Split,Karmine Corp,Gentle Mates,13,6,4,3,3,9,"Raze,Viper,Omen,Yoru,Fade","Viper,Phoenix,Omen,Jett,Skye"
Icebox,Galorys,Stellae Gaming,13,9,6,6,3,7,"Sova,Killjoy,Viper,Sage,Jett","Breach,Sova,Killjoy,Viper,Phoenix"
Split,FNATIC,GIANTX,13,7,9,3,4,4,"Breach,Raze,Cypher,Omen,Yoru","Breach,Raze,Viper,Omen,Skye"
Lotus,Galorys,Stellae Gaming,13,7,9,3,4,4,"Raze,Killjoy,Viper,Omen,Fade","Raze,Killjoy,Viper,Omen,Fade"
Breeze,FNATIC,GIANTX,5,13,4,8,5,1,"Cypher,Sova,Viper,Yoru,KAY/O","Cypher,Sova,Viper,Jett,Yoru"
Bind,FNATIC,GIANTX,13,5,7,5,0,6,"Raze,Viper,Brimstone,Skye,Gekko","Raze,Viper,Omen,Skye,Yoru"
Breeze,Revenant Esports,Reckoning Esports,15,13,7,7,6,8,"Cypher,Sova,Viper,Jett,KAY/O","Sova,Viper,Jett,Yoru,Astra"
Split,JiJieHao Bonkers,EDGE (OCE),13,8,7,5,3,6,"Raze,Cypher,Viper,Omen,Skye","Raze,Cypher,Omen,Jett,Skye"
Ascent,Revenant Esports,Reckoning Esports,13,8,7,2,6,6,"Sova,Killjoy,Omen,Jett,KAY/O","Sova,Killjoy,Omen,Jett,KAY/O"
Lotus,DetonatioN FocusMe GC,Focus e-Sports Female,9,13,6,6,7,3,"Raze,Killjoy,Viper,Omen,Fade","Raze,Killjoy,Omen,Fade,Gekko"
Sunset,FENNEL GC,Sasanqua,13,10,6,5,5,7,"Breach,Raze,Cypher,Sova,Omen","Cypher,Sova,Omen,Jett,Gekko"
Ascent,Meteor GC,NIX_North,13,1,2,0,1,11,"Sova,Killjoy,Omen,Jett,KAY/O","Sova,Killjoy,Omen,Jett,KAY/O"
Split,Cyber Geek,O2esports,13,3,11,1,2,2,"Raze,Viper,Omen,Jett,Skye","Raze,Viper,Omen,KAY/O,Gekko"
Sunset,SCARZ GC,BANDAL,13,7,8,4,3,5,"Raze,Cypher,Sova,Viper,Omen","Breach,Raze,Cypher,Omen,Fade"
Ascent,JiJieHao Bonkers,EDGE (OCE),13,9,7,3,6,6,"Sova,Killjoy,Omen,Jett,KAY/O","Killjoy,Reyna,Omen,Jett,Fade"
Lotus,Revenant Esports,Reckoning Esports,11,13,6,6,7,5,"Raze,Killjoy,Viper,Omen,Fade","Raze,Killjoy,Viper,Omen,Fade"
Split,DetonatioN FocusMe GC,Focus e-Sports Female,10,13,7,5,8,3,"Breach,Raze,Cypher,Omen,Deadlock","Raze,Viper,Jett,Skye,Astra"
Split,ZETA DIVISION GC,Insomnia GC,15,13,10,4,9,5,"Raze,Cypher,Viper,Omen,Skye","Breach,Raze,Cypher,Sage,Omen"
Breeze,Meteor GC,NIX_North,13,2,3,0,2,10,"Cypher,Sova,Viper,Yoru,KAY/O","Cypher,Sova,Viper,Jett,Yoru"
Split,FENNEL GC,Sasanqua,14,12,9,4,8,5,"Raze,Cypher,Viper,Omen,Skye","Cypher,Sage,Omen,Jett,Skye"
Ascent,DRX Changers,Eternity GC,13,7,6,6,1,7,"Sova,Killjoy,Omen,Jett,KAY/O","Sova,Killjoy,Omen,Jett,KAY/O"
Bind,Cyber Geek,O2esports,13,1,2,0,1,11,"Raze,Viper,Brimstone,Skye,Chamber","Viper,Brimstone,Skye,Yoru,Neon"
Lotus,ZETA DIVISION GC,Insomnia GC,13,2,3,0,2,10,"Raze,Killjoy,Viper,Omen,Fade","Breach,Raze,Killjoy,Omen,Jett"
Icebox,SCARZ GC,BANDAL,13,3,4,0,3,9,"Sova,Killjoy,Viper,Jett,Harbor","Killjoy,Viper,Jett,KAY/O,Gekko"
Ascent,DetonatioN FocusMe GC,Focus e-Sports Female,13,6,7,5,1,6,"Sova,Killjoy,Omen,Jett,KAY/O","Sova,Killjoy,Phoenix,Omen,Jett"
Sunset,DRX Changers,Eternity GC,13,3,2,2,1,11,"Breach,Raze,Cypher,Omen,Gekko","Sova,Viper,Omen,Yoru,Gekko"
Lotus,FOCUSGG,Arena Internet Cafe,11,13,5,7,6,6,"Raze,Killjoy,Viper,Omen,Fade","Raze,Killjoy,Viper,Omen,Skye"
Ascent,MLT Esports,Grayfox Esports,13,9,6,6,3,7,"Sova,Killjoy,Omen,Jett,KAY/O","Sova,Killjoy,Viper,Omen,Jett"
Icebox,GEM DIANA,NIX_North,10,13,5,6,7,5,"Sova,Killjoy,Viper,Sage,Jett","Sova,Killjoy,Viper,Jett,KAY/O"
Ascent,O2esports,TRO Gaming Lumirize,13,2,3,0,2,10,"Sova,Killjoy,Omen,Jett,KAY/O","Sova,Killjoy,Omen,Jett,KAY/O"
Icebox,Insomnia GC,NoNameRabbit,13,7,7,1,6,6,"Raze,Sova,Killjoy,Viper,Harbor","Sova,Killjoy,Viper,KAY/O,Harbor"
Sunset,BANDAL,shade yoja,13,5,6,0,5,7,"Breach,Raze,Cypher,Omen,Fade","Breach,Raze,Cypher,Sova,Omen"
Lotus,Focus e-Sports Female,DOPENESS SELENE,13,7,7,1,6,6,"Raze,Killjoy,Omen,Fade,Gekko","Raze,Killjoy,Viper,Omen,Fade"
Icebox,Reignite Lily,Soleil Gaming,13,4,9,3,1,4,"Sova,Killjoy,Viper,Jett,Deadlock","Sova,Killjoy,Viper,Jett,KAY/O"
Split,Sasanqua,AMORIS Lykos,13,4,4,1,3,9,"Cypher,Sage,Omen,Jett,Skye","Cypher,Jett,Skye,Yoru,Astra"
Bind,Eternity GC,EAGER GC,13,3,3,1,2,10,"Raze,Viper,Skye,Astra,Gekko","Raze,Cypher,Brimstone,Jett,Skye"
Bind,MLT Esports,Grayfox Esports,13,8,4,5,3,9,"Raze,Viper,Brimstone,Skye,Gekko","Breach,Raze,Cypher,Brimstone,Skye"
Ascent,GEM DIANA,NIX_North,4,13,1,4,9,3,"Sova,Killjoy,Omen,Jett,KAY/O","Sova,Killjoy,Omen,Jett,KAY/O"
Split,FOCUSGG,Arena Internet Cafe,16,18,11,6,12,5,"Raze,Viper,Astra,Fade,Gekko","Breach,Raze,Cypher,Skye,Astra"
Breeze,Insomnia GC,NoNameRabbit,13,4,10,2,2,3,"Cypher,Sova,Omen,Yoru,Harbor","Cypher,Sova,Viper,Jett,Harbor"
Lotus,O2esports,TRO Gaming Lumirize,13,10,5,6,4,8,"Breach,Raze,Killjoy,Omen,Fade","Raze,Killjoy,Viper,Omen,Fade"
Split,BANDAL,shade yoja,13,8,10,2,6,3,"Breach,Raze,Cypher,Omen,Skye","Raze,Cypher,Viper,Omen,Skye"
Lotus,Reignite Lily,Soleil Gaming,13,8,7,2,6,6,"Raze,Viper,Omen,Chamber,Fade","Breach,Raze,Killjoy,Omen,Gekko"
Lotus,Sasanqua,AMORIS Lykos,13,5,6,0,5,7,"Killjoy,Omen,Jett,Skye,Chamber","Raze,Killjoy,Viper,Skye,Astra"
Ascent,Focus e-Sports Female,DOPENESS SELENE,13,9,9,3,6,4,"Sova,Killjoy,Phoenix,Omen,Jett","Sova,Killjoy,Omen,Jett,KAY/O"
Lotus,Eternity GC,EAGER GC,13,7,5,3,4,8,"Breach,Raze,Cypher,Omen,Fade","Breach,Raze,Killjoy,Omen,Fade"
Lotus,GEM DIANA,NIX_North,13,3,4,0,3,9,"Breach,Raze,Killjoy,Omen,Fade","Breach,Raze,Killjoy,Omen,Gekko"
Icebox,FOCUSGG,Arena Internet Cafe,13,9,6,4,5,7,"Sova,Killjoy,Viper,Sage,Jett","Sova,Killjoy,Viper,Jett,Harbor"
Bind,LBR,IVC Gray,13,5,5,1,4,8,"Raze,Cypher,Viper,Brimstone,Skye","Raze,Viper,Brimstone,Skye,Deadlock"
Lotus,LBR,IVC Gray,6,13,4,8,5,2,"Raze,Killjoy,Viper,Omen,Skye","Raze,Viper,Omen,Chamber,Fade"
Ascent,LBR,IVC Gray,13,2,10,2,0,3,"Sova,Killjoy,Sage,Omen,Jett","Cypher,Sova,Reyna,Omen,Jett"
Sunset,UTD Esports,LA Tech Blue,13,8,10,2,6,3,"Raze,Cypher,Omen,KAY/O,Gekko","Breach,Raze,Cypher,Omen,Gekko"
Split,IVC Blue,Bronco Esports Black,13,9,5,5,4,8,"Raze,Cypher,Viper,Skye,Astra","Breach,Raze,Cypher,Omen,Skye"
Sunset,University of Saskatchewan,Illinois Tech Esports,2,13,2,10,3,0,"Breach,Raze,Cypher,Omen,Gekko","Raze,Cypher,Reyna,Omen,Gekko"
Icebox,IVC Blue,Bronco Esports Black,13,2,10,2,0,3,"Sova,Killjoy,Viper,Jett,Gekko","Killjoy,Viper,Jett,KAY/O,Gekko"
Lotus,UTD Esports,LA Tech Blue,13,10,8,3,7,5,"Breach,Raze,Killjoy,Omen,Gekko","Breach,Raze,Cypher,Astra,Gekko"
Lotus,University of Saskatchewan,Illinois Tech Esports,3,13,2,10,3,1,"Raze,Viper,Omen,Fade,Gekko","Reyna,Omen,Jett,Chamber,Gekko"
Lotus,KS Esports GC,Akave Esports Black,9,13,4,6,7,5,"Breach,Raze,Cypher,Omen,Gekko","Raze,Viper,Omen,Chamber,Fade"
Sunset,TBK Esports,Legacy,10,13,7,5,8,3,"Raze,Cypher,Omen,KAY/O,Gekko","Raze,Cypher,Omen,KAY/O,Gekko"
Split,KS Esports GC,Akave Esports Black,4,13,0,5,8,4,"Raze,Cypher,Viper,Omen,Skye","Breach,Raze,Cypher,Omen,Skye"
Split,Elite Gaming,DASKAR,13,4,10,2,2,3,"Raze,Viper,Omen,Jett,Skye","Breach,Raze,Viper,Omen,Skye"
Sunset,Oxygen Esports,YFP Gaming,13,8,6,6,2,7,"Breach,Raze,Cypher,Omen,KAY/O","Raze,Cypher,Omen,KAY/O,Neon"
Breeze,TBK Esports,Legacy,11,13,6,6,7,5,"Cypher,Sova,Viper,Jett,KAY/O","Cypher,Sova,Viper,Jett,KAY/O"
Icebox,Elite Gaming,DASKAR,13,7,9,3,4,4,"Sova,Killjoy,Viper,Jett,Gekko","Killjoy,Viper,Jett,KAY/O,Gekko"
Icebox,Leviatán GC,9z Team GC,9,13,3,7,6,6,"Sova,Killjoy,Viper,Harbor,Gekko","Sova,Killjoy,Viper,Sage,Jett"
Split,Oxygen Esports,YFP Gaming,15,13,7,7,6,8,"Raze,Killjoy,Viper,Skye,Astra","Raze,Viper,Reyna,Omen,Skye"
Bind,Elite Gaming,DASKAR,10,13,6,5,8,4,"Viper,Phoenix,Brimstone,Skye,Fade","Raze,Cypher,Viper,Brimstone,Skye"
Ascent,TBK Esports,Legacy,9,13,4,6,7,5,"Sova,Killjoy,Omen,Jett,KAY/O","Sova,Killjoy,Omen,Jett,KAY/O"
Bind,Leviatán GC,9z Team GC,10,13,6,6,7,4,"Raze,Viper,Brimstone,Skye,Yoru","Breach,Raze,Cypher,Brimstone,Fade"
Lotus,FLUFFY AIMERS,Moist x Shopify,7,13,1,7,6,6,"Raze,Killjoy,Viper,Omen,Fade","Breach,Raze,Cypher,Brimstone,Gekko"
Icebox,TBK Esports,Legacy,13,6,7,0,6,6,"Sova,Killjoy,Viper,Sage,Jett","Killjoy,Viper,Jett,KAY/O,Gekko"
Bind,SISSI STΛTΞ PUNKS Kaizen,Permitta Unicorns GC,15,13,9,5,8,6,"Raze,Cypher,Viper,Skye,Clove","Raze,Brimstone,Reyna,Jett,Deadlock"
Breeze,FLUFFY AIMERS,Moist x Shopify,9,13,6,6,7,3,"Cypher,Viper,Jett,Astra,KAY/O","Cypher,Sova,Viper,Jett,KAY/O"
Ascent,Royal Family eSports,A One Man Army,7,13,1,7,6,6,"Reyna,Jett,Chamber,Harbor,Gekko","Sova,Killjoy,Omen,Jett,KAY/O"
Split,TBK Esports,Legacy,13,8,8,1,7,5,"Raze,Viper,Omen,Jett,Skye","Raze,Viper,Omen,Jett,Skye"
Bind,Dortmund Esports Safire,aNc Outplayed GC,8,13,3,6,7,5,"Raze,Viper,Skye,Fade,Clove","Raze,Viper,Brimstone,Fade,Gekko"
Sunset,SISSI STΛTΞ PUNKS Kaizen,Permitta Unicorns GC,13,11,8,4,7,5,"Raze,Cypher,Sova,Astra,Gekko","Cypher,Sage,Reyna,Jett,Clove"
Icebox,BBL Esports,KOI,13,3,4,0,3,9,"Sova,Killjoy,Viper,Sage,Omen","Sova,Killjoy,Viper,Yoru,Harbor"
Bind,SNOOZE Esports,Esports Team Twente,13,11,7,5,6,6,"Raze,Omen,Skye,Chamber,Gekko","Raze,Viper,Brimstone,Skye,Deadlock"
Lotus,IRON COMPANY,eSports Cologne,3,13,0,4,9,3,"Raze,Viper,Omen,Chamber,Fade","Raze,Killjoy,Viper,Astra,Fade"
Ascent,Dortmund Esports Safire,aNc Outplayed GC,13,7,7,1,6,6,"Sova,Killjoy,Omen,Jett,KAY/O","Breach,Cypher,Sova,Omen,Jett"
Bind,TOG Kitsune,ALTERNATE aTTaX Ruby,11,13,6,6,7,5,"Breach,Raze,Cypher,Sova,Brimstone","Breach,Raze,Viper,Brimstone,Fade"
Breeze,IRON COMPANY,eSports Cologne,6,13,2,10,3,4,"Cypher,Sova,Viper,Jett,Yoru","Cypher,Sova,Viper,Jett,Chamber"
Breeze,BBL Esports,KOI,13,4,4,1,3,9,"Cypher,Sova,Viper,Omen,Yoru","Cypher,Sova,Viper,Omen,Yoru"
Ascent,SISSI STΛTΞ PUNKS Kaizen,Permitta Unicorns GC,12,14,5,8,6,7,"Breach,Sova,Killjoy,Omen,Jett","Raze,Sova,Omen,Gekko,Deadlock"
Bind,BLX CORP X BCG,Siko Esports,7,13,1,7,6,6,"Raze,Omen,Chamber,Fade,Deadlock","Raze,Viper,Brimstone,Skye,Gekko"
Lotus,Dortmund Esports Safire,aNc Outplayed GC,4,13,2,3,10,2,"Breach,Raze,Killjoy,Reyna,Omen","Breach,Raze,Killjoy,Omen,Gekko"
Lotus,RIZON Sugar,HEROIC Valkyries,4,13,2,3,10,2,"Breach,Raze,Killjoy,Omen,Deadlock","Raze,Viper,Sage,Omen,Skye"
Lotus,TOG Kitsune,ALTERNATE aTTaX Ruby,13,8,5,4,4,8,"Breach,Raze,Sova,Killjoy,Omen","Breach,Raze,Cypher,Omen,Fade"
Ascent,Team Liquid,Natus Vincere,5,13,2,4,9,3,"Cypher,Sova,Viper,Omen,Yoru","Cypher,Sova,Omen,Jett,KAY/O"
Sunset,SNOOZE Esports,Royal Family eSports,5,13,1,5,8,4,"Cypher,Omen,Yoru,Chamber,Fade","Raze,Cypher,Sova,Omen,KAY/O"
Split,TOG Kitsune,ALTERNATE aTTaX Ruby,4,13,1,4,9,3,"Breach,Raze,Cypher,Omen,Skye","Breach,Raze,Cypher,Omen,Skye"
Sunset,RIZON Sugar,HEROIC Valkyries,7,13,6,6,7,1,"Breach,Raze,Cypher,Sova,Omen","Raze,Cypher,Omen,KAY/O,Gekko"
Split,Team Liquid,Natus Vincere,11,13,10,2,11,1,"Raze,Cypher,Viper,Omen,Skye","Breach,Raze,Viper,Omen,Fade"
Lotus,Team Liquid,Natus Vincere,13,10,5,6,4,8,"Breach,Raze,Cypher,Sova,Omen","Breach,Raze,Killjoy,Brimstone,Gekko"
Sunset,Medal Esports,Grayfox Esports,10,13,5,6,7,5,"Raze,Cypher,Omen,KAY/O,Gekko","Breach,Raze,Cypher,Sova,Omen"
Breeze,Medal Esports,Grayfox Esports,12,14,4,9,5,8,"Cypher,Sova,Viper,Jett,KAY/O","Sova,Viper,Jett,Astra,Gekko"
Icebox,BOBO,EDGE (OCE),11,13,3,9,4,8,"Sova,Viper,Sage,Reyna,Jett","Sova,Killjoy,Viper,Reyna,Jett"
Ascent,BOBO,EDGE (OCE),3,13,3,9,4,0,"Sova,Killjoy,Omen,Jett,KAY/O","Killjoy,Reyna,Omen,Jett,Fade"
Icebox,Orangutan,Reckoning Esports,11,13,8,4,9,3,"Sova,Killjoy,Viper,Jett,Harbor","Sova,Killjoy,Viper,Yoru,Harbor"
Lotus,BOBO,EDGE (OCE),13,10,7,5,5,6,"Raze,Killjoy,Viper,Omen,Fade","Raze,Cypher,Omen,Jett,Skye"
Lotus,Orangutan,Reckoning Esports,13,10,10,2,8,3,"Breach,Raze,Sova,Killjoy,Omen","Raze,Killjoy,Viper,Omen,Fade"
Sunset,JiJieHao Bonkers,iPGN,13,6,8,4,2,5,"Raze,Cypher,Omen,KAY/O,Gekko","Raze,Cypher,Omen,KAY/O,Gekko"
Ascent,Orangutan,Reckoning Esports,10,13,3,8,5,7,"Sova,Killjoy,Omen,Jett,KAY/O","Sova,Killjoy,Omen,Jett,KAY/O"
Ascent,JiJieHao Bonkers,iPGN,13,11,5,7,4,8,"Sova,Killjoy,Omen,Jett,KAY/O","Sova,Killjoy,Omen,Jett,KAY/O"
Icebox,UW-Stout Blue Devils,Humber College Esports,13,11,9,3,8,4,"Killjoy,Viper,KAY/O,Gekko,Deadlock","Killjoy,Viper,Jett,KAY/O,Gekko"
Ascent,Ball State,University of Virginia,11,13,7,5,8,4,"Sova,Killjoy,Omen,Jett,KAY/O","Raze,Cypher,Phoenix,Omen,Fade"
Sunset,UW-Stout Blue Devils,Humber College Esports,13,11,8,4,7,5,"Raze,Cypher,Omen,KAY/O,Gekko","Raze,Cypher,Omen,KAY/O,Gekko"
Sunset,Predator X Gaming,Astane Anarchy,13,5,10,2,3,3,"Breach,Cypher,Sova,Jett,Clove","Raze,Cypher,Omen,KAY/O,Gekko"
Sunset,University of Oklahoma,Clemson Esports,13,8,5,4,4,8,"Raze,Cypher,Omen,KAY/O,Gekko","Breach,Raze,Cypher,Omen,Gekko"
Lotus,Rebirth Esports,ONA Family,13,6,6,1,5,7,"Breach,Raze,Cypher,Omen,Jett","Raze,Killjoy,Viper,Omen,Fade"
Sunset,UT Austin,WKU Hilltoppers RED,13,9,9,3,6,4,"Breach,Raze,Cypher,Sova,Omen","Raze,Cypher,Omen,Skye,Clove"
Split,Maryville University,Brewton Parker College,13,7,5,3,4,8,"Raze,Cypher,Viper,Omen,Skye","Breach,Raze,Cypher,Omen,Skye"
Sunset,Ball State,University of Virginia,12,14,5,8,6,7,"Raze,Viper,KAY/O,Gekko,Clove","Cypher,Sova,Viper,Omen,Yoru"
Icebox,NC State Red,Rochester University Esports,6,13,5,7,6,1,"Sova,Killjoy,Viper,Sage,Jett","Sova,Killjoy,Viper,Sage,Jett"
Breeze,Harrisburg University,Michigan State University,13,8,5,7,1,8,"Cypher,Sova,Viper,Yoru,KAY/O","Cypher,Sova,Viper,Jett,KAY/O"
Breeze,MYVRA,FUSION X,13,11,10,2,9,3,"Cypher,Sova,Viper,Jett,Yoru","Cypher,Sova,Viper,KAY/O,Chamber"
Lotus,Astane Anarchy,Huskies,13,6,7,5,1,6,"Raze,Killjoy,Viper,Omen,Gekko","Killjoy,Viper,Omen,Jett,Fade"
Split,Demigods At UCSD,UofT,13,5,6,0,5,7,"Raze,Cypher,Viper,Omen,Skye","Breach,Raze,Cypher,Omen,Skye"
Lotus,Boy Kissers (NA),Predator X Gaming,8,13,4,8,5,4,"Breach,Raze,Killjoy,Omen,Gekko","Raze,Killjoy,Viper,Fade,Clove"
Ascent,University of Oklahoma,Clemson Esports,13,6,6,1,5,7,"Sova,Killjoy,Omen,Jett,KAY/O","Sova,Killjoy,Omen,Jett,KAY/O"
Lotus,UT Austin,WKU Hilltoppers RED,13,6,8,4,2,5,"Raze,Killjoy,Viper,Omen,Skye","Breach,Raze,Killjoy,Omen,Skye"
Ascent,UWaterloo Gold,Redbird Varsity,13,9,8,4,5,5,"Sova,Killjoy,Phoenix,Omen,Jett","Sova,Killjoy,Omen,Jett,KAY/O"
Bind,UW-Stout Blue Devils,Humber College Esports,13,15,9,5,10,4,"Raze,Viper,Brimstone,Skye,Gekko","Raze,Viper,Brimstone,Skye,Gekko"
Icebox,Rebirth Esports,ONA Family,13,9,8,4,5,5,"Viper,Reyna,Omen,Jett,Gekko","Sova,Killjoy,Viper,Reyna,Harbor"
Icebox,Demigods At UCSD,UofT,13,4,10,2,2,3,"Sova,Killjoy,Viper,Reyna,Jett","Sova,Viper,Jett,KAY/O,Gekko"
Lotus,St. Clair Saints,Mizzou Esports,13,3,3,1,2,10,"Raze,Sova,Killjoy,Viper,Omen","Breach,Raze,Omen,Chamber,Gekko"
Icebox,Ball State,University of Virginia,13,11,6,6,5,7,"Killjoy,Viper,Sage,Jett,Gekko","Sova,Killjoy,Viper,Sage,Jett"
Sunset,NC State Red,Rochester University Esports,11,13,6,6,7,5,"Raze,Cypher,Omen,KAY/O,Gekko","Raze,Cypher,Sova,Omen,Gekko"
Lotus,Harrisburg University,Michigan State University,13,9,7,3,6,6,"Killjoy,Viper,Omen,Neon,Gekko","Raze,Killjoy,Viper,Omen,Skye"
Lotus,Maryville University,Brewton Parker College,15,13,9,5,8,6,"Raze,Killjoy,Viper,Omen,Fade","Raze,Killjoy,Viper,Omen,Fade"
Sunset,Astane Anarchy,pugstars,13,9,7,3,6,6,"Raze,Cypher,Omen,KAY/O,Gekko","Raze,Cypher,Omen,Jett,Gekko"
Icebox,ST MOB,Boy Kissers (NA),11,13,8,4,9,3,"Sova,Killjoy,Viper,Reyna,Jett","Sova,Killjoy,Viper,Jett,Gekko"
Icebox,Washed,Predator X Gaming,7,13,2,10,3,5,"Sova,Killjoy,Viper,Reyna,Jett","Raze,Sova,Killjoy,Viper,Yoru"
Lotus,Amphibium Academy,Huskies,4,13,3,2,11,1,"Raze,Killjoy,Viper,Omen,Skye","Killjoy,Viper,Omen,Jett,Fade"
Bind,University of Oklahoma,Clemson Esports,9,13,7,3,10,2,"Raze,Viper,Brimstone,KAY/O,Fade","Raze,Viper,Brimstone,Skye,Yoru"
Lotus,UWaterloo Gold,Redbird Varsity,13,10,5,6,4,8,"Raze,Killjoy,Viper,Omen,Fade","Raze,Killjoy,Viper,Omen,Fade"
Ascent,MYVRA,FUSION X,13,11,7,5,6,6,"Sova,Killjoy,Omen,Jett,KAY/O","Breach,Viper,Omen,Yoru,KAY/O"
Sunset,St. Clair Saints,Mizzou Esports,13,2,2,1,1,11,"Breach,Raze,Cypher,Omen,Fade","Breach,Raze,Cypher,Sova,Omen"
Bind,TENGAN MIEDO,Red Eye,13,10,6,5,5,7,"Raze,Viper,Brimstone,Skye,Chamber","Raze,Cypher,Viper,Brimstone,Skye"
Lotus,Huskies,Spandex Warriors,13,5,6,0,5,7,"Killjoy,Viper,Omen,Jett,Fade","Breach,Killjoy,Omen,Neon,Gekko"
Lotus,Washed,Final Form Black,13,7,6,6,1,7,"Raze,Killjoy,Viper,Omen,Gekko","Raze,Killjoy,Omen,Fade,Gekko"
Lotus,Predator X Gaming,SRVR RED,13,9,7,5,4,6,"Raze,Killjoy,Viper,Fade,Clove","Raze,Killjoy,Viper,Omen,Fade"
Lotus,Radford University,ST MOB,8,13,4,5,8,4,"Raze,Killjoy,Viper,Omen,Fade","Raze,Killjoy,Viper,Fade,Clove"
Lotus,DarkZero Esports,TSM,13,8,6,6,2,7,"Breach,Raze,Cypher,Omen,Fade","Raze,Killjoy,Viper,Omen,Skye"
Ascent,Ice Fishers,Astane Anarchy,9,13,5,5,8,4,"Breach,Viper,Omen,Jett,KAY/O","Sova,Killjoy,Omen,Jett,KAY/O"
Lotus,Cruzados Esports,UNLP Esports,13,7,3,5,2,10,"Raze,Cypher,Omen,Jett,Fade","Breach,Raze,Killjoy,Omen,Fade"
Lotus,TENGAN MIEDO,Red Eye,13,6,3,4,2,10,"Breach,Raze,Sova,Killjoy,Omen","Raze,Killjoy,Viper,Omen,Skye"
Breeze,FiRePOWER GC,KRÜ BLAZE,9,13,1,9,4,8,"Cypher,Sova,Viper,Omen,Yoru","Cypher,Sova,Viper,Jett,KAY/O"
Lotus,Boy Kissers (NA),Hyperion Gold,13,9,9,3,6,4,"Breach,Raze,Killjoy,Gekko,Clove","Raze,Killjoy,Viper,Omen,Gekko"
Split,Cruzados Esports,UNLP Esports,13,5,4,2,3,9,"Raze,Cypher,Omen,Jett,Skye","Raze,Viper,Omen,Jett,Skye"
Sunset,DarkZero Esports,TSM,13,11,4,8,3,9,"Raze,Cypher,Omen,KAY/O,Gekko","Raze,Cypher,Viper,Omen,Skye"
Sunset,FiRePOWER GC,KRÜ BLAZE,3,13,3,9,4,0,"Raze,Cypher,Viper,Omen,Gekko","Breach,Raze,Cypher,Omen,Fade"
Breeze,Stellae Gaming,TBK Esports,13,9,6,4,5,7,"Cypher,Sova,Viper,Jett,KAY/O","Cypher,Sova,Viper,Jett,KAY/O"
Sunset,SaD Esports,Dough Bros,13,9,9,3,6,4,"Raze,Cypher,Viper,Omen,Skye","Raze,Cypher,Viper,Omen,Fade"
Ascent,Zen Esports,LRV Esports,13,11,7,5,6,6,"Sova,Killjoy,Omen,Jett,KAY/O","Sova,Killjoy,Omen,Jett,KAY/O"
Sunset,Stellae Gaming,TBK Esports,8,13,2,7,6,6,"Raze,Cypher,Viper,Omen,Gekko","Raze,Cypher,Omen,KAY/O,Gekko"
Icebox,Team Vitality,Team Heretics,13,9,8,4,5,5,"Raze,Killjoy,Viper,KAY/O,Gekko","Killjoy,Viper,Sage,KAY/O,Gekko"
Split,SaD Esports,Dough Bros,13,8,8,4,4,5,"Raze,Cypher,Viper,Omen,Skye","Raze,Cypher,Viper,Omen,Skye"
Bind,Zen Esports,LRV Esports,13,8,7,5,3,6,"Raze,Viper,Brimstone,Skye,Gekko","Raze,Viper,Brimstone,Fade,Gekko"
Bind,Stellae Gaming,TBK Esports,13,8,6,3,5,7,"Raze,Viper,Brimstone,Sage,Skye","Raze,Viper,Brimstone,Sage,Skye"
Sunset,Team Vitality,Team Heretics,11,13,5,7,6,6,"Raze,Viper,Omen,KAY/O,Gekko","Cypher,Sova,Omen,KAY/O,Neon"
Bind,IRON COMPANY,Dortmund Esports,6,13,1,6,7,5,"Raze,Viper,Brimstone,Skye,Yoru","Viper,Omen,Yoru,Fade,Gekko"
Split,Falke Esports,eQuizers,13,8,5,7,1,8,"Raze,Viper,Skye,Astra,Chamber","Raze,Cypher,Viper,Omen,Skye"
Breeze,Team Vitality,Team Heretics,13,9,7,3,6,6,"Cypher,Sova,Viper,Yoru,Astra","Cypher,Sova,Viper,Yoru,KAY/O"
Lotus,IRON COMPANY,Dortmund Esports,5,13,5,7,6,0,"Raze,Viper,Omen,Chamber,Fade","Raze,Viper,Yoru,Harbor,Gekko"
Icebox,Falke Esports,eQuizers,9,13,9,3,10,0,"Sova,Killjoy,Viper,Jett,KAY/O","Killjoy,Viper,Jett,KAY/O,Gekko"
Breeze,Karmine Corp,FUT Esports,7,13,1,7,6,6,"Cypher,Sova,Viper,Jett,KAY/O","Cypher,Sova,Viper,Jett,KAY/O"
Split,LONETEAM,GMBLERS Esports,13,9,6,6,3,7,"Raze,Cypher,Viper,Skye,Astra","Breach,Raze,Cypher,Omen,Skye"
Breeze,Falke Esports,eQuizers,13,9,5,5,4,8,"Cypher,Sova,Viper,Jett,KAY/O","Sova,Viper,Jett,KAY/O,Iso"
Lotus,Karmine Corp,FUT Esports,8,13,5,4,9,3,"Raze,Killjoy,Viper,Omen,Fade","Cypher,Viper,Sage,Omen,Jett"
Icebox,LONETEAM,GMBLERS Esports,13,11,7,5,6,6,"Sova,Killjoy,Viper,Reyna,Jett","Sova,Killjoy,Viper,Sage,Jett"
Ascent,Falke Esports,eQuizers,13,7,6,6,1,7,"Sova,Killjoy,Omen,Jett,KAY/O","Cypher,Sova,Omen,Jett,KAY/O"
Sunset,LONETEAM,GMBLERS Esports,13,5,4,2,3,9,"Breach,Raze,Cypher,Sova,Omen","Breach,Raze,Cypher,Omen,Gekko"
Bind,Karmine Corp,FUT Esports,13,11,7,5,6,6,"Raze,Viper,Omen,Skye,Gekko","Viper,Sage,Omen,KAY/O,Gekko"
Icebox,True Rippers,Grayfox Esports,13,15,7,7,8,6,"Sova,Killjoy,Viper,Jett,Gekko","Sova,Killjoy,Viper,Sage,Jett"
Split,Arena Internet Cafe,Justice For Tomorrow,13,9,8,4,5,5,"Breach,Raze,Cypher,Skye,Astra","Raze,Viper,Jett,Skye,Astra"
Bind,True Rippers,Grayfox Esports,5,13,3,9,4,2,"Raze,Cypher,Viper,Brimstone,Skye","Breach,Raze,Cypher,Brimstone,Skye"
Split,Nongshim RedForce,SLT Seongam,9,13,3,9,4,6,"Raze,Viper,Omen,Jett,Skye","Breach,Raze,Cypher,Skye,Astra"
Sunset,Arena Internet Cafe,Justice For Tomorrow,13,9,9,3,6,4,"Sova,Viper,Omen,Neon,Gekko","Raze,Cypher,Omen,KAY/O,Gekko"
Lotus,Carnival Gaming,Orangutan,3,13,2,10,3,1,"Breach,Raze,Viper,Omen,Fade","Breach,Raze,Sova,Killjoy,Omen"
Bind,Nongshim RedForce,SLT Seongam,5,13,1,5,8,4,"Raze,Viper,Omen,Yoru,Fade","Raze,Viper,Brimstone,Skye,Gekko"
Icebox,FOCUSGG,Rub n' Pug,13,7,6,2,5,7,"Sova,Killjoy,Viper,Sage,Jett","Sova,Killjoy,Viper,Reyna,Jett"
Sunset,Nongshim RedForce,SLT Seongam,13,11,6,6,5,7,"Raze,Viper,Omen,Yoru,Fade","Breach,Raze,Cypher,Sova,Omen"
Ascent,Carnival Gaming,Orangutan,12,14,5,8,6,7,"Breach,Raze,Cypher,Omen,KAY/O","Sova,Killjoy,Omen,Jett,KAY/O"
Split,FOCUSGG,Rub n' Pug,13,7,10,2,5,3,"Raze,Viper,Astra,Fade,Gekko","Raze,Reyna,Omen,Jett,Skye"
Bind,FOCUSGG,Rub n' Pug,9,13,4,6,7,5,"Raze,Viper,Brimstone,Yoru,Fade","Raze,Brimstone,Jett,Skye,Harbor"
Lotus,Nongshim RedForce,SLT Seongam,11,13,6,6,7,5,"Raze,Killjoy,Viper,Omen,Fade","Breach,Raze,Killjoy,Omen,Gekko"
Sunset,WIU Gold,Catholic University,3,13,0,4,9,3,"Breach,Raze,Cypher,Omen,Gekko","Raze,Killjoy,Omen,Fade,Gekko"
Lotus,Columbia College,Wichita State Esports,15,13,9,5,8,6,"Raze,Viper,Chamber,Fade,Harbor","Raze,Killjoy,Viper,Omen,Skye"
Lotus,TENGAN MIEDO,Zen Esports,15,13,8,6,7,7,"Breach,Raze,Sova,Killjoy,Omen","Raze,Viper,Omen,Fade,Deadlock"
Ascent,WIU Gold,Catholic University,6,13,2,5,8,4,"Sova,Killjoy,Omen,Jett,KAY/O","Breach,Raze,Sova,Killjoy,Omen"
Ascent,Columbia College,Wichita State Esports,8,13,3,6,7,5,"Sova,Killjoy,Omen,Jett,KAY/O","Sova,Killjoy,Omen,Jett,KAY/O"
Ascent,Trine University,Gallaudet University,13,5,5,1,4,8,"Cypher,Sova,Phoenix,Omen,Jett","Breach,Cypher,Omen,Jett,KAY/O"
Bind,TENGAN MIEDO,Zen Esports,13,7,8,4,3,5,"Raze,Viper,Brimstone,Skye,Chamber","Raze,Viper,Omen,Skye,Chamber"
Breeze,WIU Gold,Catholic University,13,3,10,2,1,3,"Breach,Cypher,Sova,Viper,Jett","Killjoy,Viper,Reyna,KAY/O,Harbor"
Sunset,Muskingum University,RPI White,13,5,6,0,5,7,"Raze,Cypher,Omen,Fade,Gekko","Breach,Raze,Cypher,Omen,Gekko"
Split,Potomac State College,University of Idaho,13,2,11,1,1,2,"Raze,Cypher,Viper,Omen,Skye","Raze,Cypher,Viper,Omen,Skye"
Bind,Border Monsters Chile,OXEN BULL BEATS,13,4,5,0,4,8,"Raze,Cypher,Viper,Brimstone,Skye","Raze,Viper,Brimstone,Skye,Gekko"
Lotus,Trine University,Gallaudet University,13,5,9,3,2,4,"Raze,Viper,Omen,Jett,Gekko","Breach,Cypher,Omen,Neon,Gekko"
Split,NEIT Tigers White,SJF Valorant Black,8,13,5,7,6,3,"Killjoy,Sage,Omen,Jett,Gekko","Raze,Cypher,Viper,Omen,KAY/O"
Split,Columbia College,Wichita State Esports,13,8,7,5,3,6,"Raze,Cypher,Omen,Jett,Skye","Breach,Raze,Viper,Omen,Skye"
Icebox,Brewton Parker College,Farmingdale State College,13,11,10,2,9,3,"Sova,Killjoy,Viper,Reyna,Harbor","Sova,Killjoy,Viper,Jett,Gekko"
Ascent,Muskingum University,RPI White,5,13,2,4,9,3,"Sova,Killjoy,Omen,Jett,KAY/O","Cypher,Sova,Phoenix,Omen,Jett"
Ascent,Potomac State College,University of Idaho,7,13,3,5,8,4,"Sova,Killjoy,Omen,Jett,KAY/O","Sova,Killjoy,Omen,Jett,KAY/O"
Sunset,Trine University,Gallaudet University,13,5,8,4,1,5,"Cypher,Sova,Reyna,Omen,Jett","Breach,Cypher,Omen,Neon,Gekko"
Breeze,Columbia College,Wichita State Esports,4,13,1,4,9,3,"Cypher,Sova,Viper,Jett,KAY/O","Sova,Viper,Yoru,KAY/O,Harbor"
Lotus,Border Monsters Chile,OXEN BULL BEATS,13,4,3,2,2,10,"Raze,Killjoy,Viper,Omen,Fade","Raze,Killjoy,Viper,Omen,Fade"
Lotus,WIU Gold,Catholic University,13,11,6,6,5,7,"Raze,Killjoy,Omen,Skye,Iso","Raze,Killjoy,Viper,Omen,Skye"
Bind,Randolph-Macon College,Tiffin University JV,13,9,7,5,4,6,"Raze,Viper,Brimstone,Skye,KAY/O","Raze,Cypher,Brimstone,Skye,Deadlock"
Bind,NEIT Tigers White,SJF Valorant Black,7,13,7,5,8,0,"Raze,Cypher,Sova,Brimstone,Gekko","Cypher,Viper,Brimstone,Skye,Yoru"
Split,Brewton Parker College,Farmingdale State College,13,5,8,4,1,5,"Breach,Raze,Cypher,Omen,Skye","Raze,Cypher,Viper,Omen,Skye"
Ascent,SJF Valorant Red,Ohio Northern University JV,10,13,3,8,5,7,"Sova,Killjoy,Jett,Astra,KAY/O","Sova,Killjoy,Omen,Jett,KAY/O"
Split,Muskingum University,RPI White,13,7,7,5,2,6,"Raze,Cypher,Viper,Omen,Skye","Raze,Cypher,Omen,Skye,Gekko"
Ascent,Brewton Parker College,Farmingdale State College,13,2,3,0,2,10,"Killjoy,Viper,Omen,Jett,Skye","Sova,Killjoy,Omen,Jett,KAY/O"
Bind,Columbia College,Wichita State Esports,13,7,4,4,3,9,"Raze,Cypher,Viper,Brimstone,Skye","Breach,Raze,Viper,Brimstone,Gekko"
Lotus,Potomac State College,University of Idaho,13,8,6,3,5,7,"Raze,Cypher,Astra,Harbor,Gekko","Raze,Killjoy,Omen,Fade,Gekko"
Split,Trine University,Gallaudet University,11,13,7,5,8,4,"Cypher,Phoenix,Omen,Jett,Gekko","Breach,Cypher,Viper,Omen,Yoru"
Split,WIU Gold,Catholic University,6,13,4,8,5,2,"Breach,Cypher,Omen,Jett,Skye","Raze,Killjoy,Viper,Omen,KAY/O"
Ascent,Randolph-Macon College,Tiffin University JV,13,11,3,9,2,10,"Sova,Killjoy,Omen,Jett,KAY/O","Killjoy,Reyna,Omen,Jett,KAY/O"
Sunset,NEIT Tigers White,SJF Valorant Black,10,13,5,7,6,5,"Breach,Raze,Cypher,Omen,Gekko","Cypher,Viper,Omen,KAY/O,Gekko"
Icebox,SJF Valorant Red,Ohio Northern University JV,4,13,3,9,4,1,"Sova,Killjoy,Viper,Omen,Jett","Raze,Cypher,Viper,Harbor,Gekko"
Lotus,Stone Esports,Red Eye,13,6,6,1,5,7,"Raze,Killjoy,Viper,Omen,Fade","Breach,Raze,Killjoy,Omen,Gekko"
Sunset,Legacy,TBK Esports,6,13,2,5,8,4,"Breach,Raze,Cypher,Omen,Fade","Raze,Cypher,Omen,KAY/O,Gekko"
Bind,Stone Esports,Red Eye,11,13,4,8,5,7,"Raze,Viper,Sage,Skye,Astra","Raze,Cypher,Viper,Brimstone,Skye"
Breeze,Legacy,TBK Esports,8,13,5,7,6,3,"Cypher,Sova,Viper,Jett,KAY/O","Cypher,Sova,Viper,Jett,KAY/O"
Breeze,Cruzados Esports,ONA Family,1,13,1,11,2,0,"Cypher,Sova,Viper,Jett,KAY/O","Cypher,Sova,Viper,Jett,KAY/O"
Ascent,Permitta Unicorns,SOS Affenalarm,11,13,7,5,8,4,"Sova,Killjoy,Omen,Jett,KAY/O","Sova,Phoenix,Omen,Jett,Deadlock"
Ascent,Cruzados Esports,ONA Family,7,13,1,7,6,6,"Cypher,Sova,Omen,Jett,KAY/O","Sova,Killjoy,Omen,Jett,KAY/O"
Split,Stellae Gaming,XLD Gaming,13,2,3,0,2,10,"Raze,Cypher,Viper,Omen,Skye","Breach,Raze,Viper,Omen,Fade"
Lotus,Permitta Unicorns,SOS Affenalarm,10,13,8,4,9,2,"Breach,Raze,Omen,Chamber,Gekko","Breach,Raze,Killjoy,Omen,Jett"
Lotus,BLX CORP X BCG,A One Man Army,13,7,5,3,4,8,"Breach,Raze,Cypher,Omen,Gekko","Breach,Killjoy,Omen,Neon,Gekko"
Lotus,Stellae Gaming,XLD Gaming,13,10,7,5,5,6,"Raze,Killjoy,Viper,Omen,Fade","Raze,Killjoy,Viper,Omen,Fade"
Sunset,Permitta Unicorns,SOS Affenalarm,14,12,5,8,4,9,"Raze,Viper,Sage,Reyna,Omen","Breach,Cypher,Phoenix,Omen,Jett"
Icebox,Esports Team Twente,Siko Esports,6,13,3,9,4,3,"Killjoy,Viper,Jett,KAY/O,Gekko","Raze,Phoenix,Brimstone,Reyna,Harbor"
Lotus,Ramboot Club,Case Esports,5,13,2,4,9,3,"Raze,Killjoy,Viper,Omen,Fade","Raze,Killjoy,Viper,Omen,Fade"
Sunset,J4,Babos Gaming,3,13,1,3,10,2,"Breach,Raze,Cypher,Omen,Gekko","Breach,Cypher,Omen,Neon,Gekko"
Bind,BLX CORP X BCG,SNOOZE Esports,13,11,8,4,7,5,"Raze,Omen,Chamber,Fade,Deadlock","Raze,Reyna,Omen,Skye,Gekko"
Lotus,Lootcifer,Veni eSports,15,13,7,7,6,8,"Breach,Cypher,Omen,Jett,Skye","Breach,Raze,Killjoy,Omen,Gekko"
Icebox,DREAMED WORLD,Dortmund Esports,13,15,8,6,9,5,"Sova,Killjoy,Viper,Jett,Gekko","Breach,Viper,Reyna,Omen,Neon"
Icebox,Ramboot Club,Case Esports,5,13,5,7,6,0,"Sova,Killjoy,Viper,Jett,Harbor","Sova,Killjoy,Viper,Yoru,Harbor"
Bind,GoNext Esports,Chipi Chapa's,13,2,2,1,1,11,"Raze,Viper,Brimstone,Skye,Gekko","Raze,Viper,Omen,Skye,Gekko"
Bind,DREAMED WORLD,Dortmund Esports,3,13,3,9,4,0,"Raze,Viper,Brimstone,Yoru,Fade","Viper,Omen,Yoru,Fade,Gekko"
Ascent,J4,Babos Gaming,9,13,4,8,5,5,"Sova,Killjoy,Omen,Jett,KAY/O","Sova,Viper,Omen,Jett,KAY/O"
Sunset,Esports Team Twente,Royal Family eSports,9,13,4,6,7,5,"Breach,Raze,Omen,Gekko,Deadlock","Raze,Cypher,Sova,Omen,KAY/O"
Bind,Lootcifer,Veni eSports,13,10,5,7,3,8,"Raze,Viper,Omen,KAY/O,Gekko","Breach,Raze,Cypher,Brimstone,Skye"
Lotus,GoNext Esports,Chipi Chapa's,13,8,5,7,1,8,"Breach,Sova,Killjoy,Omen,Jett","Raze,Cypher,Viper,Omen,Skye"
Bind,Ramboot Club,Case Esports,10,13,3,8,5,7,"Raze,Viper,Brimstone,Skye,Yoru","Viper,Brimstone,Skye,Yoru,Gekko"
Sunset,Ramboot Club,Case Esports,13,9,7,5,4,6,"Breach,Raze,Cypher,Phoenix,Omen","Viper,Sage,Omen,KAY/O,Gekko"
Ascent,GoNext Esports,Chipi Chapa's,14,12,7,6,6,7,"Sova,Killjoy,Omen,Jett,KAY/O","Cypher,Sova,Omen,Jett,Gekko"
Icebox,GoNext Esports,Chipi Chapa's,9,13,6,4,9,3,"Sova,Killjoy,Viper,Sage,Jett","Sova,Killjoy,Viper,Jett,Yoru"
Sunset,T1,DetonatioN FocusMe,11,13,6,6,7,5,"Cypher,Sova,Omen,KAY/O,Neon","Raze,Cypher,Viper,Omen,Gekko"
Lotus,T1,DetonatioN FocusMe,13,5,4,2,3,9,"Raze,Viper,Omen,Chamber,Fade","Raze,Killjoy,Viper,Omen,Fade"
Ascent,T1,DetonatioN FocusMe,10,13,3,8,5,7,"Sova,Killjoy,Omen,Jett,KAY/O","Raze,Cypher,Viper,Omen,KAY/O"
Ascent,Gen.G Esports,Talon Esports,13,8,3,6,2,10,"Sova,Killjoy,Omen,Jett,KAY/O","Sova,Killjoy,Omen,Jett,KAY/O"
Lotus,Gen.G Esports,Talon Esports,13,9,4,6,3,9,"Raze,Killjoy,Viper,Omen,Fade","Raze,Killjoy,Viper,Omen,Fade"
Bind,Redbird Varsity,CSULB Black,2,13,2,10,3,0,"Viper,Brimstone,Skye,Yoru,Gekko","Raze,Cypher,Viper,Brimstone,Skye"
Sunset,Redbird Varsity,CSULB Black,10,13,8,4,9,2,"Raze,Cypher,Omen,KAY/O,Gekko","Raze,Cypher,Viper,Omen,Skye"
Breeze,KRÜ Esports,FURIA,13,7,6,2,5,7,"Cypher,Sova,Viper,Jett,KAY/O","Cypher,Sova,Viper,Jett,KAY/O"
Icebox,KRÜ Esports,FURIA,11,13,7,5,8,4,"Killjoy,Viper,Reyna,KAY/O,Gekko","Killjoy,Viper,Omen,KAY/O,Gekko"
Lotus,KRÜ Esports,FURIA,13,7,10,2,5,3,"Raze,Killjoy,Viper,Omen,Fade","Raze,Killjoy,Viper,Omen,Skye"
Breeze,KPI Gaming,UCAM Esports Club,13,6,5,2,4,8,"Cypher,Sova,Viper,Jett,Yoru","Sova,Viper,Jett,Yoru,Astra"
Lotus,Permitta Unicorns GC,aNc Outplayed GC,4,13,1,4,9,3,"Breach,Raze,Omen,Chamber,Gekko","Breach,Raze,Killjoy,Omen,Gekko"
Bind,Diamant Esports,Chipi Chapa's,16,18,5,12,6,11,"Raze,Viper,Omen,Skye,Fade","Raze,Viper,Omen,Skye,Gekko"
Lotus,KPI Gaming,UCAM Esports Club,13,3,11,1,2,2,"Killjoy,Viper,Omen,Skye,Neon","Raze,Killjoy,Viper,Omen,Fade"
Lotus,eSports Cologne,Dortmund Esports,13,3,10,2,1,3,"Raze,Killjoy,Viper,Astra,Fade","Raze,Viper,Yoru,Harbor,Gekko"
Ascent,Permitta Unicorns GC,aNc Outplayed GC,7,13,0,8,5,7,"Raze,Sova,Omen,Gekko,Deadlock","Breach,Cypher,Sova,Omen,Jett"
Ascent,Diamant Esports,Chipi Chapa's,13,7,4,4,3,9,"Breach,Raze,Cypher,Omen,Fade","Sova,Killjoy,Phoenix,Omen,Jett"
Icebox,KPI Gaming,UCAM Esports Club,13,3,11,1,2,2,"Sova,Killjoy,Viper,Sage,Jett","Sova,Killjoy,Viper,Jett,Harbor"
Ascent,eSports Cologne,Dortmund Esports,13,11,4,8,3,9,"Sova,Killjoy,Omen,Jett,KAY/O","Sova,Viper,Omen,Jett,Yoru"
Icebox,Diamant Esports,Chipi Chapa's,10,13,6,5,8,4,"Raze,Killjoy,Viper,Reyna,Gekko","Sova,Killjoy,Viper,Jett,Yoru"
Bind,KPI Gaming,UCAM Esports Club,17,19,8,10,9,9,"Raze,Cypher,Viper,Brimstone,Skye","Breach,Raze,Brimstone,Yoru,Fade"
Breeze,Diamant Esports,Chipi Chapa's,9,13,7,5,8,2,"Cypher,Sova,Viper,Omen,Yoru","Cypher,Sova,Viper,Jett,Yoru"
Lotus,Diamant Esports,Chipi Chapa's,13,6,7,0,6,6,"Raze,Killjoy,Viper,Omen,Skye","Raze,Cypher,Viper,Omen,Skye"
Lotus,Global Esports,DRX,6,13,3,9,4,3,"Raze,Killjoy,Viper,Omen,Fade","Raze,Killjoy,Viper,Omen,Fade"
Ascent,Global Esports,DRX,8,13,5,4,9,3,"Sova,Killjoy,Omen,Jett,KAY/O","Sova,Killjoy,Omen,Jett,KAY/O"
Icebox,Team Secret,Rex Regum Qeon,12,14,5,8,6,7,"Sova,Killjoy,Viper,Jett,KAY/O","Sova,Killjoy,Viper,Jett,Gekko"
Split,Team Secret,Rex Regum Qeon,13,6,6,6,0,7,"Breach,Raze,Cypher,Omen,Fade","Raze,Cypher,Viper,Omen,Skye"
Breeze,Team Secret,Rex Regum Qeon,10,13,7,4,9,3,"Cypher,Sova,Viper,Jett,KAY/O","Cypher,Sova,Viper,Jett,Yoru"
Sunset,Burger Boyz 2.0,Blinn Esports,6,13,5,7,6,1,"Breach,Raze,Cypher,Omen,Fade","Raze,Cypher,Omen,KAY/O,Gekko"
Ascent,Burger Boyz 2.0,Blinn Esports,12,14,3,10,4,9,"Sova,Killjoy,Omen,Jett,KAY/O","Viper,Omen,Jett,KAY/O,Gekko"
Icebox,Burger Boyz 2.0,Blinn Esports,13,10,8,4,6,5,"Sova,Killjoy,Viper,Jett,Gekko","Killjoy,Viper,KAY/O,Harbor,Gekko"
Icebox,pugstars,Hyperion Gold,11,13,7,5,8,4,"Sova,Killjoy,Viper,Reyna,Jett","Sova,Killjoy,Viper,Reyna,Clove"
Split,1337 (NA),Burger Boyz 2.0,11,13,3,9,4,8,"Raze,Cypher,Viper,Omen,Skye","Raze,Cypher,Viper,Skye,Astra"
Split,Sentinels,100 Thieves,13,6,7,5,1,6,"Raze,Cypher,Viper,Omen,Skye","Raze,Viper,Astra,Fade,Gekko"
Bind,Endear Gaming Sun,Hyperion Gold,4,13,4,8,5,0,"Raze,Viper,Brimstone,Skye,Yoru","Raze,Cypher,Brimstone,Jett,Skye"
Sunset,Big Brim Gamers,pugstars,6,13,1,11,2,5,"Cypher,Sova,Viper,Phoenix,Harbor","Raze,Cypher,Yoru,Gekko,Clove"
Ascent,Blinn Esports,Zero MarksMen Black,13,11,7,5,6,6,"Viper,Omen,Jett,KAY/O,Gekko","Sova,Killjoy,Omen,Jett,KAY/O"
Sunset,1337 (NA),Burger Boyz 2.0,13,10,6,6,4,7,"Breach,Raze,Cypher,Omen,Gekko","Breach,Raze,Cypher,Omen,Fade"
Icebox,pugstars,ecouple & friends,13,7,6,2,5,7,"Sova,Viper,Sage,Reyna,Jett","Sova,Killjoy,Viper,Jett,Clove"
Lotus,Hyperion Gold,SRVR RED,13,4,4,1,3,9,"Raze,Killjoy,Viper,Omen,Gekko","Raze,Killjoy,Viper,Omen,Fade"
Ascent,Big Brim Gamers,The Socialites,13,3,3,1,2,10,"Phoenix,Reyna,Jett,KAY/O,Clove","Raze,Killjoy,Sage,Skye,Astra"
Lotus,Final Form Black,Endear Gaming Sun,9,13,6,4,9,3,"Raze,Killjoy,Viper,Omen,Gekko","Raze,Killjoy,Viper,Omen,Fade"
Icebox,Sentinels,100 Thieves,13,10,8,3,7,5,"Killjoy,Viper,Jett,KAY/O,Gekko","Sova,Killjoy,Viper,Jett,Gekko"
Split,Blinn Esports,Zero MarksMen Black,13,11,5,7,4,8,"Raze,Cypher,Viper,Omen,Skye","Raze,Cypher,Viper,Omen,Skye"
Icebox,1337 (NA),Burger Boyz 2.0,9,13,4,6,7,5,"Sova,Killjoy,Viper,Sage,Chamber","Sova,Killjoy,Viper,Jett,Gekko"
Icebox,G2 Esports,Evil Geniuses,13,3,4,0,3,9,"Sova,Killjoy,Viper,Omen,Gekko","Sova,Killjoy,Viper,Jett,Harbor"
Lotus,G2 Esports,Evil Geniuses,13,8,7,2,6,6,"Raze,Killjoy,Viper,Omen,Fade","Raze,Cypher,Viper,Omen,Fade"
Split,SISSI STΛTΞ PUNKS Kaizen,Morekats Aurora,15,13,6,8,5,9,"Breach,Raze,Cypher,Omen,Skye","Raze,Cypher,Sage,Omen,Gekko"
Split,Gamax Lite,Odd 1 OUT,9,13,3,9,4,6,"Breach,Raze,Cypher,Astra,Deadlock","Breach,Raze,Cypher,Omen,Skye"
Lotus,VX300 Gaming,NOVO Esports,17,19,9,9,10,8,"Raze,Killjoy,Reyna,Omen,Skye","Raze,Killjoy,Viper,Omen,Fade"
Icebox,Gamax Lite,Odd 1 OUT,4,13,0,5,8,4,"Sova,Killjoy,Viper,Jett,Gekko","Sova,Killjoy,Viper,Jett,KAY/O"
Lotus,Mandatory,Joblife,8,13,3,6,7,5,"Raze,Cypher,Viper,Omen,Fade","Raze,Sova,Killjoy,Omen,Gekko"
Bind,SISSI STΛTΞ PUNKS Kaizen,Morekats Aurora,13,11,9,3,8,4,"Raze,Cypher,Viper,Brimstone,Skye","Breach,Raze,Viper,Brimstone,Skye"
Split,SK Gaming,Ovation eSports,12,14,6,7,7,6,"Raze,Cypher,Viper,Omen,Skye","Breach,Cypher,Viper,Omen,Jett"
Split,VX300 Gaming,NOVO Esports,13,5,3,3,2,10,"Breach,Raze,Cypher,Omen,Fade","Raze,Cypher,Omen,Skye,Deadlock"
Bind,MLT Esports GC,9to5 workers,13,10,6,5,5,7,"Raze,Cypher,Brimstone,Jett,Skye","Raze,Cypher,Viper,Brimstone,Skye"
Icebox,Mandatory,Joblife,13,8,7,2,6,6,"Killjoy,Viper,Jett,KAY/O,Gekko","Killjoy,Viper,Sage,Yoru,Gekko"
Lotus,Karmine Corp GC,Gamax Lite,13,7,10,2,5,3,"Raze,Killjoy,Viper,Omen,Fade","Raze,Killjoy,Viper,Omen,Fade"
Bind,SK Gaming,Ovation eSports,13,6,5,2,4,8,"Viper,Brimstone,Jett,Skye,Gekko","Raze,Viper,Omen,Skye,Yoru"
Sunset,SISSI STΛTΞ PUNKS Kaizen,Morekats Aurora,12,14,6,7,7,6,"Raze,Cypher,Sova,Omen,Gekko","Breach,Raze,Cypher,Omen,Gekko"
Lotus,Chipi Chapa's,Zero Tenacity,15,13,8,6,7,7,"Raze,Killjoy,Viper,Omen,Skye","Raze,Killjoy,Viper,Omen,Fade"
Ascent,VX300 Gaming,NOVO Esports,13,8,9,3,5,4,"Breach,Raze,Cypher,Sova,Omen","Sova,Killjoy,Omen,Jett,KAY/O"
Lotus,Odd 1 OUT,MAD Lions KOI,14,12,8,5,7,6,"Breach,Raze,Cypher,Sova,Omen","Breach,Raze,Omen,Chamber,Fade"
Lotus,Formulation Gaming,who cars?,13,7,8,4,3,5,"Raze,Viper,Omen,Chamber,Fade","Raze,Sova,Killjoy,Omen,Gekko"
Ascent,Galatasaray Esports,Galakticos,10,13,0,11,2,10,"Cypher,Viper,Omen,Yoru,KAY/O","Breach,Viper,Omen,Jett,KAY/O"
Split,MLT Esports GC,9to5 workers,6,13,2,5,8,4,"Raze,Killjoy,Sage,Omen,Skye","Raze,Cypher,Sage,Omen,Skye"
Ascent,Karmine Corp GC,Gamax Lite,7,13,1,7,6,6,"Sova,Killjoy,Omen,Jett,KAY/O","Sova,Killjoy,Omen,Jett,KAY/O"
Lotus,CTRL x YARI Esports,K10,13,2,10,2,0,3,"Raze,Killjoy,Viper,Omen,Fade","Raze,Killjoy,Viper,Omen,Fade"
Bind,Chipi Chapa's,Zero Tenacity,13,5,9,3,2,4,"Raze,Viper,Omen,Skye,Gekko","Raze,Viper,Skye,Astra,Gekko"
Bind,chuvisexuales edicom lovers,MADAGASCAR PENGUINS,13,6,4,3,3,9,"Raze,Cypher,Brimstone,Reyna,Skye","Cypher,Brimstone,Jett,Yoru,Gekko"
Split,Mandatory,Joblife,13,15,5,9,6,8,"Raze,Cypher,Viper,Omen,Skye","Raze,Cypher,Omen,Skye,Gekko"
Icebox,SK Gaming,Ovation eSports,11,13,8,4,9,3,"Sova,Killjoy,Viper,Sage,Jett","Sova,Killjoy,Viper,Sage,Jett"
Sunset,VX300 Gaming,NOVO Esports,5,13,1,5,8,4,"Breach,Raze,Killjoy,Omen,Gekko","Breach,Raze,Cypher,Omen,Deadlock"
Ascent,Formulation Gaming,who cars?,13,8,8,4,4,5,"Cypher,Sova,Omen,Jett,KAY/O","Sova,Killjoy,Omen,Jett,Gekko"
Bind,Odd 1 OUT,MAD Lions KOI,12,14,6,7,7,6,"Breach,Raze,Cypher,Brimstone,Skye","Breach,Raze,Cypher,Brimstone,Gekko"
Lotus,chuvisexuales edicom lovers,MADAGASCAR PENGUINS,13,0,12,0,0,1,"Breach,Raze,Killjoy,Omen,Gekko","Breach,Raze,Viper,Omen,Gekko"
Sunset,Galatasaray Esports,Galakticos,6,13,2,10,3,4,"Raze,Sage,Omen,KAY/O,Gekko","Breach,Sova,Viper,Omen,Neon"
Ascent,MLT Esports GC,9to5 workers,13,3,4,0,3,9,"Sova,Killjoy,Reyna,Omen,Jett","Sova,Killjoy,Omen,Jett,KAY/O"
Split,JELQ MAXXING,Vennegjengen,5,13,4,8,5,1,"Raze,Cypher,Viper,Omen,Skye","Raze,Cypher,Viper,Omen,Skye"
Icebox,CTRL x YARI Esports,K10,13,6,10,2,4,3,"Killjoy,Viper,Reyna,KAY/O,Gekko","Sova,Killjoy,Viper,Sage,Jett"
Sunset,SLTitans Esports,Fire Hawks,13,6,7,0,6,6,"Breach,Raze,Cypher,Omen,Gekko","Raze,Cypher,Omen,KAY/O,Gekko"
Ascent,Odd 1 OUT,MAD Lions KOI,13,1,11,1,0,2,"Sova,Killjoy,Omen,Jett,KAY/O","Sova,Killjoy,Omen,Jett,KAY/O"
Icebox,VX300 Gaming,NOVO Esports,3,13,1,3,10,2,"Sova,Killjoy,Viper,Omen,KAY/O","Sova,Killjoy,Viper,Sage,Jett"
Ascent,Mandatory,Joblife,9,13,4,6,7,5,"Cypher,Sova,Omen,Jett,KAY/O","Sova,Killjoy,Omen,Jett,KAY/O"
Breeze,Karmine Corp GC,Gamax Lite,18,16,6,11,5,12,"Cypher,Sova,Viper,Jett,KAY/O","Cypher,Sova,Viper,Jett,KAY/O"
Lotus,JELQ MAXXING,Vennegjengen,5,13,5,7,6,0,"Raze,Killjoy,Viper,Omen,Fade","Breach,Raze,Cypher,Harbor,Deadlock"
Sunset,Owls UPC,Thunders,13,3,3,1,2,10,"Raze,Cypher,Omen,KAY/O,Gekko","Raze,Cypher,Omen,KAY/O,Gekko"
Split,Requiem,NoodleSoupWarriors,8,13,3,6,7,5,"Breach,Raze,Cypher,Viper,Omen","Raze,Cypher,Omen,Jett,Skye"
Icebox,Galatasaray Esports,Galakticos,8,13,4,8,5,4,"Killjoy,Viper,Sage,KAY/O,Gekko","Sova,Killjoy,Viper,Jett,Gekko"
Split,Eintracht Frankfurt,DIVIZON,12,14,7,6,8,5,"Breach,Raze,Cypher,Viper,Omen","Cypher,Viper,Omen,Jett,Skye"
Lotus,Diamant Esports,GoNext Esports,16,18,10,7,11,6,"Raze,Killjoy,Viper,Omen,Skye","Breach,Sova,Killjoy,Omen,Jett"
Sunset,Reveal Multigaming,Permitta Unicorns,7,13,3,5,8,4,"Breach,Cypher,Sova,Omen,Jett","Raze,Cypher,Viper,Sage,Reyna"
Lotus,MLT Esports GC,9to5 workers,13,8,4,8,0,9,"Raze,Killjoy,Omen,Chamber,Fade","Raze,Killjoy,Viper,Omen,Skye"
Icebox,Formulation Gaming,who cars?,13,15,7,7,8,6,"Sova,Killjoy,Viper,Yoru,Harbor","Sova,Killjoy,Viper,Jett,Gekko"
Icebox,SLTitans Esports,Fire Hawks,13,6,5,2,4,8,"Sova,Killjoy,Viper,Reyna,Jett","Sova,Killjoy,Viper,Reyna,Jett"
Ascent,Owls UPC,Thunders,8,13,2,7,6,6,"Sova,Killjoy,Omen,Jett,KAY/O","Cypher,Sova,Omen,Jett,KAY/O"
Bind,Diamant Esports,GoNext Esports,2,13,2,10,3,0,"Raze,Viper,Omen,Skye,Fade","Raze,Viper,Brimstone,Skye,Gekko"
Ascent,Requiem,NoodleSoupWarriors,7,13,4,4,9,3,"Raze,Cypher,Sova,Omen,Deadlock","Sova,Killjoy,Omen,Jett,Neon"
Split,K10,Lost Puppies,17,15,11,5,10,6,"Raze,Cypher,Viper,Omen,Skye","Breach,Raze,Cypher,Astra,Gekko"
Lotus,Reveal Multigaming,Lootcifer,13,5,4,2,3,9,"Breach,Sova,Killjoy,Omen,Jett","Breach,Raze,Cypher,Omen,KAY/O"
Ascent,Permitta Unicorns,Novita Esports,13,10,3,8,2,10,"Sova,Killjoy,Omen,Jett,KAY/O","Sova,Killjoy,Jett,Yoru,Astra"
Sunset,Eintracht Frankfurt,DIVIZON,8,13,2,7,6,6,"Breach,Raze,Cypher,Omen,Skye","Raze,Cypher,Viper,Omen,Gekko"
Sunset,MLT Esports GC,9to5 workers,10,13,8,3,10,2,"Raze,Cypher,Sova,Omen,Jett","Raze,Cypher,Sova,Omen,Gekko"
Sunset,Requiem,NoodleSoupWarriors,13,5,4,2,3,9,"Breach,Raze,Cypher,Omen,Yoru","Raze,Cypher,Sova,Omen,Gekko"
Lotus,Vennegjengen,KIMCHI,13,9,8,4,5,5,"Breach,Raze,Cypher,Harbor,Deadlock","Raze,Cypher,Omen,KAY/O,Gekko"
Lotus,Owls UPC,Thunders,14,12,6,7,5,8,"Breach,Raze,Killjoy,Omen,Fade","Breach,Raze,Cypher,Omen,Gekko"
Icebox,Metizport,Apeks,6,13,3,4,9,3,"Sova,Killjoy,Viper,Sage,Jett","Sova,Killjoy,Viper,Yoru,Harbor"
Split,JELQ MAXXING,Gladius,13,2,10,2,0,3,"Raze,Cypher,Viper,Omen,Skye","Raze,Cypher,Viper,Omen,Skye"
Lotus,Eintracht Frankfurt,DIVIZON,13,6,10,2,4,3,"Raze,Viper,Omen,Skye,Gekko","Raze,Killjoy,Viper,Omen,Skye"
Split,IRREGULARS,Lootcifer,8,13,8,1,12,0,"Raze,Cypher,Viper,Omen,Skye","Cypher,Sage,Omen,Jett,Skye"
Bind,K10,Lost Puppies,15,13,6,8,5,9,"Raze,Cypher,Viper,Brimstone,Skye","Raze,Cypher,Viper,Brimstone,Gekko"
Ascent,Permitta Unicorns,TeamOrangeGaming,13,10,9,2,8,4,"Sova,Killjoy,Omen,Jett,KAY/O","Raze,Viper,Astra,Fade,Gekko"
Ascent,XPERION NXT,Novita Esports,11,13,6,6,7,5,"Sova,Killjoy,Omen,Jett,KAY/O","Sova,Killjoy,Jett,Yoru,Astra"
Bind,Reveal Multigaming,Veni eSports,13,7,7,1,6,6,"Raze,Viper,Brimstone,Skye,Gekko","Breach,Raze,Cypher,Brimstone,Skye"
Breeze,Vennegjengen,KIMCHI,8,13,5,4,9,3,"Cypher,Sova,Viper,Yoru,Harbor","Cypher,Sova,Viper,Jett,KAY/O"
Split,NoodleSoupWarriors,EXO Clan,13,3,4,0,3,9,"Raze,Cypher,Omen,Jett,Skye","Breach,Raze,Viper,Omen,Skye"
Bind,CTRL x YARI Esports,Vanir,13,9,4,6,3,9,"Raze,Cypher,Viper,Brimstone,Skye","Raze,Viper,Brimstone,Skye,Yoru"
Lotus,Fire Hawks,Signum Reges,14,12,8,5,7,6,"Breach,Raze,Killjoy,Omen,Gekko","Raze,Killjoy,Omen,Skye,Gekko"
Bind,Metizport,Apeks,9,13,3,7,6,6,"Raze,Viper,Omen,Skye,Deadlock","Raze,Viper,Omen,Skye,Gekko"
Bind,JELQ MAXXING,Gladius,13,6,5,2,4,8,"Raze,Viper,Brimstone,Skye,Gekko","Raze,Viper,Brimstone,Skye,Deadlock"
Ascent,SOS Affenalarm,TeamOrangeGaming,3,13,0,4,9,3,"Cypher,Sova,Phoenix,Omen,Jett","Raze,Viper,Astra,Fade,Gekko"
Bind,T1,Paper Rex,12,14,6,7,7,6,"Raze,Viper,Skye,Harbor,Gekko","Raze,Brimstone,Reyna,Skye,Harbor"
Icebox,IRREGULARS,J4,13,11,5,7,4,8,"Killjoy,Viper,Jett,KAY/O,Gekko","Sova,Killjoy,Viper,Reyna,Jett"
Icebox,K10,Lost Puppies,7,13,7,5,8,0,"Sova,Killjoy,Viper,Sage,Jett","Sova,Killjoy,Viper,Sage,Jett"
Split,Novita Esports,BUCHCLUB,13,7,7,1,6,6,"Raze,Cypher,Viper,Omen,Skye","Raze,Viper,Omen,Skye,Gekko"
Lotus,Lootcifer,Dortmund Esports,13,4,10,2,2,3,"Breach,Raze,Cypher,Omen,KAY/O","Raze,Viper,Yoru,Harbor,Gekko"
Bind,Vennegjengen,KIMCHI,13,9,3,7,2,10,"Raze,Cypher,Viper,Brimstone,Skye","Breach,Viper,Omen,Skye,Yoru"
Icebox,Veni eSports,Sissi State Punks,13,9,9,1,8,4,"Raze,Sova,Killjoy,Viper,Gekko","Sova,Killjoy,Viper,Jett,KAY/O"
Sunset,NoodleSoupWarriors,EXO Clan,13,8,9,3,5,4,"Cypher,Sova,Omen,Jett,Gekko","Breach,Raze,Cypher,Omen,Gekko"
Lotus,CTRL x YARI Esports,Vanir,13,10,6,5,5,7,"Breach,Raze,Sage,Astra,Deadlock","Breach,Killjoy,Omen,Neon,Fade"
Sunset,Fire Hawks,Signum Reges,13,10,5,6,4,8,"Raze,Cypher,Omen,KAY/O,Gekko","Cypher,Sova,Omen,KAY/O,Neon"
Lotus,MOUZ,Unicorns of Love,13,4,8,4,0,5,"Breach,Raze,Cypher,Omen,Fade","Breach,Sova,Killjoy,Omen,Jett"
Split,Requiem,CTRL Esports,15,13,5,9,4,10,"Breach,Raze,Cypher,Viper,Omen","Raze,Cypher,Viper,Omen,Skye"
Lotus,NoodleSoupWarriors,EXO Clan,10,13,7,5,8,3,"Raze,Sova,Killjoy,Viper,Omen","Breach,Raze,Killjoy,Omen,Gekko"
Icebox,PURE Esports,Gladius,12,14,3,10,4,9,"Sova,Killjoy,Viper,Reyna,Jett","Sova,Killjoy,Viper,Reyna,Gekko"
Lotus,boy kissers,Vanir,7,13,2,6,7,5,"Raze,Killjoy,Omen,Jett,Gekko","Breach,Killjoy,Omen,Neon,Fade"
Sunset,KIMCHI,5STARS,13,11,7,5,6,6,"Cypher,Sova,Omen,KAY/O,Neon","Raze,Cypher,Omen,KAY/O,Gekko"
Lotus,T1,Paper Rex,10,13,2,9,4,8,"Raze,Viper,Omen,Chamber,Fade","Raze,Cypher,Omen,Jett,Skye"
Sunset,Requiem,CTRL Esports,13,6,9,3,3,4,"Breach,Raze,Cypher,Omen,Yoru","Raze,Cypher,Omen,KAY/O,Gekko"
Sunset,Lost Puppies,EXIT Esports,13,11,8,4,7,5,"Raze,Cypher,Viper,Astra,Fade","Breach,Cypher,Viper,Omen,KAY/O"
Breeze,Lotus Knights,SLTitans Esports,11,13,7,5,8,4,"Cypher,Sova,Jett,KAY/O,Harbor","Cypher,Sova,Viper,Jett,KAY/O"
Icebox,Bleed Esports,Talon Esports,6,13,4,3,10,2,"Killjoy,Jett,KAY/O,Harbor,Gekko","Killjoy,Viper,Jett,KAY/O,Gekko"
Ascent,Justice For Tomorrow,Xu Gang,13,7,8,4,3,5,"Sova,Killjoy,Omen,Jett,KAY/O","Sova,Killjoy,Omen,Jett,KAY/O"
Icebox,Lotus Knights,SLTitans Esports,4,13,3,9,4,1,"Sova,Killjoy,Viper,Sage,Gekko","Sova,Killjoy,Viper,Reyna,Jett"
Bind,Bleed Esports,Talon Esports,7,13,2,6,7,5,"Breach,Raze,Cypher,Brimstone,Gekko","Raze,Viper,Skye,Harbor,Gekko"
Sunset,Justice For Tomorrow,Xu Gang,13,9,6,4,5,7,"Raze,Cypher,Omen,KAY/O,Gekko","Breach,Raze,Cypher,Sova,Omen"
Ascent,Lotus Knights,SLTitans Esports,13,6,8,4,2,5,"Cypher,Sova,Omen,Jett,KAY/O","Sova,Killjoy,Omen,Jett,KAY/O"
Lotus,Bleed Esports,Talon Esports,13,9,7,5,4,6,"Raze,Killjoy,Viper,Omen,Fade","Raze,Killjoy,Viper,Omen,Fade"
Icebox,We are Groot,F1 Black,13,9,8,4,5,5,"Sova,Killjoy,Viper,Jett,KAY/O","Killjoy,Viper,Jett,Harbor,Gekko"
Split,RyZe Esports,1337 (NA),4,13,4,8,5,0,"Raze,Viper,Skye,Astra,Iso","Raze,Cypher,Viper,Omen,Skye"
Split,Blinn Esports,SaD Purple,13,1,11,1,0,2,"Raze,Cypher,Viper,Omen,Skye","Raze,Cypher,Viper,Omen,Skye"
Lotus,We are Groot,F1 Black,13,11,7,5,6,6,"Raze,Killjoy,Viper,Omen,Gekko","Cypher,Viper,Jett,Skye,Clove"
Ascent,RyZe Esports,1337 (NA),13,5,11,1,4,2,"Sova,Killjoy,Omen,Jett,KAY/O","Sova,Killjoy,Omen,Jett,KAY/O"
Ascent,We are Groot,F1 Black,5,13,1,5,8,4,"Sova,Killjoy,Viper,Jett,Clove","Cypher,Sova,Omen,Jett,KAY/O"
Sunset,Blinn Esports,SaD Purple,13,11,8,4,7,5,"Raze,Cypher,Omen,KAY/O,Gekko","Breach,Raze,Cypher,Omen,Gekko"
Icebox,RyZe Esports,1337 (NA),5,13,1,5,8,4,"Sova,Killjoy,Viper,Jett,KAY/O","Sova,Killjoy,Viper,Sage,Chamber"
Sunset,NRG Esports,LOUD,13,2,10,2,0,3,"Raze,Cypher,Omen,KAY/O,Gekko","Breach,Sova,Viper,Phoenix,Omen"
Ascent,VisionZ,Burger Boyz 2.0,12,14,4,9,5,8,"Sova,Killjoy,Omen,Jett,KAY/O","Sova,Killjoy,Omen,Jett,KAY/O"
Ascent,We are Groot,KU Esports,13,5,8,4,1,5,"Sova,Killjoy,Viper,Jett,Clove","Sova,Killjoy,Omen,Jett,KAY/O"
Icebox,Zero MarksMen Black,Ions Day Care,13,11,8,4,7,5,"Sova,Killjoy,Viper,Reyna,Jett","Raze,Sova,Killjoy,Viper,Harbor"
Icebox,Blinn Esports,SaD Purple,11,13,5,7,6,6,"Killjoy,Viper,KAY/O,Harbor,Gekko","Sova,Killjoy,Viper,Reyna,Jett"
Lotus,F1 Black,Predator X Gaming,13,11,7,5,6,6,"Cypher,Viper,Jett,Skye,Clove","Raze,Killjoy,Viper,Fade,Clove"
Icebox,VisionZ,Burger Boyz 2.0,11,13,6,6,7,5,"Sova,Killjoy,Viper,Jett,Harbor","Sova,Killjoy,Viper,Jett,Gekko"
Sunset,We are Groot,Big Brim Gamers,13,1,2,0,1,11,"Raze,Cypher,Viper,Omen,Gekko","Cypher,Sova,Viper,Phoenix,Harbor"
Breeze,NRG Esports,LOUD,13,10,8,3,7,5,"Cypher,Sova,Viper,Jett,Yoru","Cypher,Sova,Viper,Jett,KAY/O"
Ascent,RyZe Esports,Culturized,13,11,6,6,5,7,"Sova,Killjoy,Omen,Jett,KAY/O","Sova,Killjoy,Omen,Jett,KAY/O"
Lotus,Predator X Gaming,LC,13,1,11,1,0,2,"Raze,Killjoy,Viper,Fade,Clove","Breach,Raze,Killjoy,Omen,Gekko"
Bind,KU Esports,Cheezy Chungus,15,13,10,4,9,5,"Raze,Sova,Viper,Brimstone,Skye","Raze,Sova,Viper,Gekko,Clove"
Ascent,Zero MarksMen Black,Ions Day Care,13,11,7,5,6,6,"Sova,Killjoy,Omen,Jett,KAY/O","Sova,Killjoy,Reyna,Omen,Jett"
Icebox,F1 Black,Team Virtuosity,13,3,4,0,3,9,"Killjoy,Viper,Jett,Harbor,Gekko","Sova,Killjoy,Viper,Omen,Gekko"
Sunset,Blinn Esports,Awaken,13,6,7,0,6,6,"Raze,Cypher,Omen,KAY/O,Gekko","Raze,Cypher,Omen,KAY/O,Gekko"
Icebox,SaD Purple,Prospects,13,5,8,4,1,5,"Sova,Killjoy,Viper,Reyna,Jett","Sova,Viper,Reyna,Jett,Chamber"
Sunset,1337 (NA),Good Luck,13,11,7,5,6,6,"Breach,Raze,Cypher,Omen,Gekko","Breach,Raze,Cypher,Omen,Fade"
Sunset,We are Groot,One Lung,13,9,8,4,5,5,"Raze,Cypher,Viper,Omen,Gekko","Breach,Raze,Cypher,Omen,Gekko"
Bind,Passion Project,Supernova x Pals,13,6,11,1,5,2,"Raze,Cypher,Viper,Brimstone,Skye","Raze,Viper,Brimstone,Skye,Gekko"
Icebox,LAG Yellow,VisionZ,9,13,6,6,7,3,"Killjoy,Viper,Omen,KAY/O,Gekko","Sova,Killjoy,Viper,Jett,Harbor"
Bind,RyZe Esports,Culturized,13,6,6,1,5,7,"Raze,Viper,Phoenix,Brimstone,Skye","Raze,Cypher,Viper,Brimstone,Skye"
Icebox,Predator X Gaming,Caldera eSports,13,5,6,0,5,7,"Raze,Sova,Killjoy,Viper,Yoru","Sova,Killjoy,Viper,Jett,KAY/O"
Ascent,SaD Purple,Prospects,13,0,1,0,0,12,"Cypher,Sova,Reyna,Omen,Jett","Cypher,Sova,Phoenix,Omen,Jett"
Lotus,F1 Black,sosa,13,3,10,2,1,3,"Cypher,Viper,Jett,Skye,Clove","Raze,Killjoy,Jett,Skye,Clove"
Ascent,Bionic,KU Esports,8,13,2,10,3,6,"Sova,Killjoy,Omen,Jett,KAY/O","Sova,Killjoy,Omen,Jett,KAY/O"
Icebox,Burger Boyz 2.0,Nepotism,13,6,6,1,5,7,"Sova,Killjoy,Viper,Jett,Gekko","Sova,Killjoy,Viper,Reyna,Gekko"
Bind,Justice for Clear,Zero MarksMen Black,12,14,8,5,9,4,"Raze,Cypher,Viper,Brimstone,Skye","Breach,Viper,Phoenix,Brimstone,KAY/O"
Ascent,Blinn Esports,Awaken,11,13,5,7,6,6,"Viper,Omen,Jett,KAY/O,Gekko","Sova,Killjoy,Omen,Jett,KAY/O"
Bind,LAG Yellow,VisionZ,13,5,5,1,4,8,"Raze,Viper,Omen,KAY/O,Gekko","Raze,Viper,Brimstone,Skye,Gekko"
Icebox,Passion Project,Supernova x Pals,13,6,5,2,4,8,"Killjoy,Viper,Jett,KAY/O,Gekko","Killjoy,Viper,Reyna,Harbor,Gekko"
Sunset,Spandex Warriors,We are Groot,9,13,5,7,6,4,"Raze,Sova,Sage,Omen,Gekko","Raze,Cypher,Viper,Omen,Gekko"
Lotus,1337 (NA),Good Luck,13,10,7,4,6,6,"Raze,Killjoy,Viper,Omen,Fade","Raze,Killjoy,Viper,Omen,Gekko"
Ascent,north american west coast,WASTED TALENT,13,5,5,1,4,8,"Sova,Killjoy,Reyna,Omen,Jett","Sova,Killjoy,Omen,Jett,KAY/O"
Ascent,Last Resistance,LC,11,13,7,5,8,4,"Sova,Killjoy,Omen,Jett,KAY/O","Sova,Killjoy,Jett,Astra,KAY/O"
Ascent,Cloud9,Leviatán,18,16,9,8,8,9,"Sova,Killjoy,Omen,Jett,KAY/O","Raze,Viper,Sage,Omen,KAY/O"
Lotus,RyZe Esports,Culturized,11,13,7,5,8,4,"Raze,Killjoy,Viper,Omen,KAY/O","Breach,Raze,Killjoy,Omen,Gekko"
Icebox,BSC Bobcats VA,Alvernia University,7,13,5,7,6,2,"Sova,Killjoy,Viper,Reyna,Harbor","Sova,Viper,Yoru,Chamber,Gekko"
Icebox,cat lovers :3,Team Virtuosity,3,13,2,2,11,1,"Sova,Killjoy,Viper,Jett,Deadlock","Sova,Killjoy,Viper,Omen,Gekko"
Ascent,Bronco's,Bionic,3,13,2,10,3,1,"Sova,Omen,Jett,KAY/O,Deadlock","Sova,Killjoy,Omen,Jett,KAY/O"
Lotus,Cheezy Chungus,Arcadia,13,2,3,0,2,10,"Raze,Killjoy,Viper,Gekko,Clove","Breach,Viper,Omen,Chamber,Fade"
Ascent,RBX,F1 Black,2,13,0,3,10,2,"Sova,Killjoy,Omen,Jett,KAY/O","Cypher,Sova,Omen,Jett,KAY/O"
Lotus,MSU White,U4RIA Radiata,0,13,0,12,1,0,"Raze,Viper,Omen,Chamber,Fade","Raze,Killjoy,Viper,Omen,Skye"
Ascent,The GRID,Ions Day Care,8,13,6,6,7,2,"Sova,Killjoy,Phoenix,Omen,Jett","Sova,Killjoy,Phoenix,Omen,Jett"
Split,Burger Boyz 2.0,Nepotism,10,13,4,8,5,6,"Raze,Cypher,Viper,Skye,Astra","Raze,Cypher,Viper,Omen,Skye"
Sunset,Radford University,GMU Patriots,13,9,6,6,3,7,"Breach,Raze,Cypher,Omen,Gekko","Breach,Raze,Cypher,Sova,Omen"
Icebox,Neck Beards,Big Brim Gamers,4,13,0,5,8,4,"Sova,Killjoy,Viper,Jett,Harbor","Sova,Killjoy,Viper,Jett,Gekko"
Split,Blinn Esports,Awaken,13,3,2,2,1,11,"Raze,Cypher,Viper,Omen,Skye","Raze,Cypher,Viper,Omen,Skye"
Icebox,Supernova x Pals,Equinox GC,13,4,5,0,4,8,"Killjoy,Viper,Reyna,Harbor,Gekko","Sova,Viper,Reyna,Jett,Chamber"
Icebox,Justice for Clear,Zero MarksMen Black,10,13,7,5,8,3,"Sova,Killjoy,Viper,Reyna,Jett","Sova,Killjoy,Viper,Reyna,Jett"
Lotus,LAG Yellow,VisionZ,12,14,5,8,6,7,"Raze,Killjoy,Viper,Omen,Fade","Breach,Raze,Omen,Chamber,Gekko"
Ascent,UCF Gold,Prospects,13,15,5,9,6,8,"Sova,Killjoy,Omen,Jett,KAY/O","Cypher,Sova,Phoenix,Omen,Jett"
Bind,KU Esports,UBC Blue,13,9,7,5,4,6,"Raze,Sova,Viper,Brimstone,Skye","Raze,Viper,Brimstone,Jett,Skye"
Split,Culturized,Converse NBG,13,5,7,5,0,6,"Breach,Raze,Cypher,Omen,Gekko","Raze,Cypher,Viper,Omen,Skye"
Lotus,That's Bright,sosa,6,13,4,8,5,2,"Breach,Raze,Killjoy,Omen,Gekko","Raze,Killjoy,Jett,Skye,Clove"
Ascent,We are Groot,SRVR,13,7,6,6,1,7,"Sova,Killjoy,Viper,Jett,Clove","Sova,Killjoy,Omen,Jett,KAY/O"
Icebox,NEO Esports,Team Virtuosity,5,13,2,4,9,3,"Sova,Killjoy,Viper,Reyna,Jett","Sova,Killjoy,Viper,Omen,Gekko"
Ascent,NEU Aqua,Cheezy Chungus,0,13,0,1,12,0,"Raze,Sova,Killjoy,Omen,KAY/O","Cypher,Sova,Omen,Jett,Deadlock"
Sunset,ROSE,Good Luck,4,13,4,8,5,0,"Raze,Cypher,Viper,Omen,Fade","Breach,Raze,Cypher,Omen,Fade"
Ascent,RENEGADE E-SPORTS,Arcadia,6,13,4,3,10,2,"Cypher,Killjoy,Omen,Jett,KAY/O","Sova,Killjoy,Omen,Jett,KAY/O"
Sunset,Cloud9,Leviatán,13,7,7,1,6,6,"Raze,Cypher,Viper,Omen,Skye","Breach,Cypher,Sova,Phoenix,Omen"
Lotus,The GRID,Ions Day Care,11,13,6,6,7,5,"Raze,Killjoy,Reyna,Omen,Gekko","Raze,Killjoy,Viper,Omen,Skye"
Bind,Last Resistance,VOP,13,0,1,0,0,12,"Raze,Cypher,Viper,Brimstone,Skye","Raze,Killjoy,Brimstone,Skye,Gekko"
Sunset,Tension,Big Brim Gamers,3,13,1,3,10,2,"Breach,Raze,Cypher,Omen,Gekko","Cypher,Sova,Viper,Phoenix,Harbor"
Ascent,SJ6 AND TRIMADOL,F1 Black,4,13,3,9,4,1,"Sova,Killjoy,Omen,Jett,KAY/O","Cypher,Sova,Omen,Jett,KAY/O"
Sunset,LC,Cyber Elite Esports,13,7,5,3,4,8,"Breach,Raze,Cypher,Omen,Gekko","Cypher,Omen,Jett,Fade,Gekko"
Sunset,Bionic,Team Disrupt,13,4,8,4,0,5,"Breach,Raze,Cypher,Omen,Gekko","Raze,Cypher,Omen,KAY/O,Gekko"
Lotus,Neck Beards,BlanK,13,2,1,2,0,12,"Raze,Killjoy,Viper,Omen,Fade","Raze,Killjoy,Omen,Jett,Skye"
Breeze,cat lovers :3,MCG,13,11,8,4,7,5,"Breach,Sova,Killjoy,Viper,Jett","Cypher,Sova,Viper,Jett,Gekko"
Bind,One Lung,Status Red,13,7,5,3,4,8,"Raze,Cypher,Viper,Brimstone,Skye","Raze,Viper,Brimstone,Sage,Skye"
Lotus,UTD Esports,Harmony,13,10,6,6,4,7,"Raze,Killjoy,Viper,Omen,Skye","Breach,Viper,Astra,Neon,Gekko"
Bind,Harmony Azure,Caldera eSports,0,13,0,1,12,0,"Raze,Cypher,Viper,Skye,Clove","Raze,Viper,Skye,Gekko,Clove"
Ascent,Burger Boyz 2.0,Nepotism,13,9,5,7,2,8,"Sova,Killjoy,Omen,Jett,KAY/O","Sova,Killjoy,Omen,Jett,KAY/O"
Split,Radford University,GMU Patriots,13,7,4,4,3,9,"Raze,Cypher,Viper,Omen,Skye","Raze,Cypher,Omen,Jett,Skye"
Bind,north american west coast,MSU White,13,1,2,0,1,11,"Raze,Cypher,Jett,Skye,Clove","Raze,Viper,Omen,Skye,Gekko"
Sunset,FlyQuest RED,Passion Project,6,13,5,7,6,1,"Breach,Raze,Cypher,Sova,Omen","Breach,Raze,Cypher,Omen,Gekko"
Ascent,BSC Bobcats VA,Alvernia University,16,18,10,7,11,6,"Sova,Killjoy,Omen,Jett,KAY/O","Breach,Omen,Yoru,Harbor,Gekko"
Sunset,Supernova x Pals,Equinox GC,5,13,3,9,4,2,"Breach,Raze,Cypher,Omen,Fade","Raze,Cypher,Reyna,Omen,Gekko"
Icebox,WASTED TALENT,U4RIA Radiata,14,12,5,8,4,9,"Sova,Killjoy,Viper,Jett,Clove","Sova,Killjoy,Viper,Sage,Jett"
Ascent,ASTANE,Zero MarksMen Black,6,13,1,6,7,5,"Sova,Killjoy,Omen,Jett,KAY/O","Sova,Killjoy,Omen,Jett,KAY/O"
Sunset,wows little pugstars,Awaken,9,13,5,5,8,4,"Breach,Raze,Cypher,Omen,Fade","Raze,Cypher,Omen,KAY/O,Gekko"
Lotus,UCF Gold,Prospects,8,13,3,6,7,5,"Breach,Raze,Omen,Chamber,Gekko","Raze,Killjoy,Viper,Omen,Fade"
Lotus,Culturized,Converse NBG,8,13,7,5,8,1,"Breach,Raze,Killjoy,Omen,Gekko","Raze,Killjoy,Viper,Omen,Skye"
Icebox,The GRID,L2Puggers,13,11,5,7,4,8,"Raze,Sova,Killjoy,Viper,Reyna","Sova,Killjoy,Viper,Reyna,Jett"
Split,Burger Boyz 2.0,Van Lyn Black,13,2,10,2,0,3,"Raze,Cypher,Viper,Skye,Astra","Raze,Cypher,Viper,Omen,Skye"
Lotus,Crack Babies,north american west coast,7,13,0,8,5,7,"Breach,Raze,Killjoy,Omen,Gekko","Raze,Killjoy,Jett,Skye,Clove"
Breeze,SaD Purple,Boise State University,13,4,3,2,2,10,"Cypher,Sova,Viper,Jett,Yoru","Cypher,Sova,Viper,Yoru,KAY/O"
Bind,FlyQuest RED,Passion Project,4,13,1,4,9,3,"Raze,Viper,Brimstone,Skye,Yoru","Raze,Cypher,Viper,Brimstone,Skye"
Bind,ROSE,Good Luck,12,14,6,7,7,6,"Raze,Viper,Brimstone,Skye,Gekko","Raze,Viper,Brimstone,Reyna,Gekko"
Lotus,WASTED TALENT,Hyperion Gold,13,5,5,1,4,8,"Breach,Raze,Killjoy,Omen,Gekko","Raze,Killjoy,Viper,Omen,Gekko"
Ascent,Supernova x Pals,Equinox GC,13,7,5,3,4,8,"Sova,Killjoy,Omen,Jett,KAY/O","Sova,Killjoy,Omen,Jett,KAY/O"
Split,ASTANE,Zero MarksMen Black,13,1,2,0,1,11,"Raze,Cypher,Omen,Yoru,Fade","Raze,Cypher,Viper,Omen,Skye"
Split,U4RIA Radiata,INF THIEVES,13,4,4,1,3,9,"Raze,Cypher,Viper,Omen,Skye","Breach,Cypher,Omen,Jett,Gekko"
Split,MSU White,UTD Green,13,8,6,6,2,7,"Raze,Cypher,Viper,Omen,Skye","Breach,Raze,Cypher,Omen,Skye"
Sunset,Head Down Bag Up,Nepotism,6,13,0,7,6,6,"Breach,Raze,Cypher,Omen,Fade","Breach,Raze,Cypher,Sova,Omen"
Bind,wows little pugstars,Awaken,7,13,5,7,6,2,"Raze,Viper,Brimstone,Skye,Gekko","Raze,Viper,Brimstone,Fade,Gekko"
Icebox,Cloud9,Leviatán,7,13,4,4,9,3,"Sova,Killjoy,Viper,Sage,Jett","Sova,Killjoy,Viper,Jett,Harbor"
Lotus,1337 (NA),YDZ Esports,13,0,12,0,0,1,"Raze,Killjoy,Viper,Omen,Fade","Raze,Killjoy,Viper,Omen,Skye"
Icebox,GMU Patriots,Alvernia University,13,11,3,9,2,10,"Sova,Killjoy,Viper,Sage,Jett","Sova,Killjoy,Viper,Reyna,Jett"
Sunset,Ions Day Care,eRa (NA),13,7,7,1,6,6,"Raze,Cypher,Sova,Omen,Gekko","Raze,Cypher,Sova,Omen,Gekko"
Bind,VisionZ,SRVR RED,13,6,8,4,2,5,"Raze,Viper,Brimstone,Skye,Gekko","Raze,Viper,Brimstone,Skye,Yoru"
Ascent,WASTED TALENT,Ulric Gaming Club,13,4,4,1,3,9,"Sova,Killjoy,Omen,Jett,KAY/O","Sova,Killjoy,Omen,Jett,KAY/O"
Sunset,SaD Purple,Boise State University,13,9,4,6,3,9,"Raze,Cypher,Sova,Omen,Jett","Raze,Cypher,Viper,Omen,Skye"
Bind,Crack Babies,Arcadia,13,6,5,2,4,8,"Raze,Viper,Brimstone,Skye,Yoru","Raze,Viper,Brimstone,Skye,Chamber"
Split,UCF Gold,Prospects,13,8,9,3,5,4,"Raze,Cypher,Viper,Omen,Skye","Raze,Cypher,Viper,Omen,Skye"
Ascent,Valiant,Akroma,15,13,9,5,8,6,"Sova,Killjoy,Omen,Jett,KAY/O","Sova,Killjoy,Phoenix,Omen,Jett"
Split,The GRID,L2Puggers,14,12,7,6,6,7,"Raze,Cypher,Viper,Omen,Gekko","Raze,Cypher,Viper,Omen,Skye"
Lotus,Head Down Bag Up,Nepotism,4,13,0,5,8,4,"Raze,Killjoy,Viper,Omen,Skye","Raze,Killjoy,Viper,Omen,Fade"
Bind,ASTANE,Zero MarksMen Black,11,13,6,6,7,5,"Raze,Viper,Brimstone,Skye,Yoru","Breach,Viper,Phoenix,Brimstone,KAY/O"
Ascent,Culturized,Converse NBG,13,11,6,6,5,7,"Sova,Killjoy,Omen,Jett,KAY/O","Sova,Killjoy,Omen,Jett,KAY/O"
Ascent,Ions Day Care,eRa (NA),13,1,11,1,0,2,"Sova,Killjoy,Phoenix,Omen,Jett","Sova,Killjoy,Omen,Jett,KAY/O"
Lotus,ROSE,Good Luck,13,8,7,2,6,6,"Raze,Killjoy,Viper,Omen,Fade","Breach,Raze,Killjoy,Omen,Gekko"
Icebox,Burger Boyz 2.0,Van Lyn Black,15,13,6,8,5,9,"Sova,Killjoy,Viper,Jett,Gekko","Sova,Killjoy,Viper,Omen,Jett"
Lotus,VisionZ,SRVR RED,13,0,12,0,0,1,"Breach,Raze,Omen,Chamber,Gekko","Raze,Killjoy,Viper,Omen,Fade"
Lotus,wows little pugstars,Awaken,13,6,9,3,3,4,"Breach,Raze,Cypher,Omen,Fade","Raze,Killjoy,Viper,Omen,Fade"
Icebox,1337 (NA),YDZ Esports,13,4,9,3,1,4,"Sova,Killjoy,Viper,Sage,Chamber","Sova,Killjoy,Viper,Reyna,Jett"
Lotus,MSU White,mickey mouse,13,5,8,4,1,5,"Raze,Viper,Omen,Chamber,Fade","Raze,Killjoy,Viper,Omen,Fade"
Bind,Radford University,BSC Bobcats VA,13,3,4,0,3,9,"Raze,Viper,Brimstone,Skye,Gekko","Raze,Cypher,Sova,Brimstone,Yoru"
Lotus,Valorant Team Type Beat,north american west coast,8,13,4,5,8,4,"Raze,Killjoy,Viper,Omen,Fade","Raze,Jett,Skye,Deadlock,Clove"
Lotus,UMBC Gold,UTD Green,3,13,3,9,4,0,"Raze,Killjoy,Viper,Omen,Fade","Raze,Killjoy,Viper,Omen,Fade"
Lotus,Hyperion Gold,Team Disrupt,13,3,4,0,3,9,"Raze,Killjoy,Viper,Omen,Gekko","Raze,Killjoy,Viper,Omen,Fade"
Icebox,We are Groot,U4RIA Radiata,11,13,6,6,7,5,"Sova,Killjoy,Viper,Jett,KAY/O","Sova,Killjoy,Viper,Sage,Jett"
Bind,INF THIEVES,Big Brim Gamers,14,12,9,4,8,5,"Raze,Cypher,Omen,Skye,Yoru","Raze,Viper,Brimstone,Skye,Yoru"
Split,GMU Patriots,Alvernia University,13,9,8,2,7,5,"Raze,Cypher,Omen,Jett,Skye","Breach,Yoru,Astra,Chamber,Gekko"
Ascent,LC,WASTED TALENT,10,13,4,7,6,6,"Sova,Killjoy,Jett,Astra,KAY/O","Sova,Killjoy,Omen,Jett,KAY/O"
Ascent,TOXIC,north american west coast,2,13,1,2,11,1,"Sova,Phoenix,Brimstone,Sage,Jett","Sova,Killjoy,Reyna,Omen,Jett"
Lotus,TMU Blue,Arcadia,6,13,3,4,9,3,"Raze,Killjoy,Sage,Omen,Skye","Breach,Viper,Chamber,Fade,Clove"
Bind,MSU White,UTD Orange,13,7,7,5,2,6,"Raze,Viper,Omen,Skye,Gekko","Raze,Cypher,Viper,Brimstone,Skye"
Split,Team Liquid Brazil,MIBR GC,13,9,6,4,5,7,"Breach,Raze,Viper,Omen,Skye","Raze,Viper,Astra,Fade,Gekko"
Split,Radford University,BSC Bobcats VA,13,5,8,4,1,5,"Raze,Cypher,Viper,Omen,Skye","Raze,Cypher,Viper,Omen,Skye"
Icebox,Crack Babies,SRVR,13,9,9,1,8,4,"Sova,Killjoy,Viper,Jett,Gekko","Sova,Killjoy,Viper,Reyna,Gekko"
Bind,Valiant,Akroma,10,13,5,6,7,5,"Raze,Viper,Brimstone,Skye,Gekko","Raze,Viper,Omen,Skye,Yoru"
Icebox,Big Brim Gamers,Washed Up,13,2,3,0,2,10,"Sova,Killjoy,Viper,Jett,Gekko","Raze,Sova,Viper,Chamber,Gekko"
Ascent,INF THIEVES,One Lung,13,5,8,4,1,5,"Sova,Killjoy,Omen,Jett,KAY/O","Sova,Killjoy,Omen,Jett,KAY/O"
Sunset,AQUA Nation,Team Disrupt,5,13,4,8,5,1,"Breach,Raze,Cypher,Omen,Gekko","Raze,Cypher,Omen,KAY/O,Gekko"
Lotus,UTD Green,Outlaw Reckoning,13,8,6,3,5,7,"Raze,Killjoy,Viper,Omen,Fade","Raze,Cypher,Viper,Fade,Clove"
Lotus,Spandex Warriors,Hyperion Gold,9,13,1,11,2,8,"Raze,Killjoy,Viper,Omen,Skye","Raze,Killjoy,Viper,Omen,Gekko"
Lotus,glasses,mickey mouse,1,13,0,2,11,1,"Raze,Cypher,Reyna,Omen,Fade","Raze,Killjoy,Viper,Omen,Fade"
Split,Reli Gaming,Ulric Gaming Club,4,13,0,5,8,4,"Raze,Cypher,Viper,Omen,Skye","Raze,Viper,Omen,Jett,Skye"
Bind,U4RIA Radiata,Viking Valorant Varsity,13,6,4,3,3,9,"Raze,Cypher,Viper,Brimstone,Skye","Raze,Cypher,Viper,Skye,Astra"
Ascent,We are Groot,ranked players,13,3,9,3,0,4,"Sova,Killjoy,Viper,Jett,Clove","Sova,Killjoy,Omen,Jett,KAY/O"
Lotus,UMBC Gold,RBX,13,8,8,1,7,5,"Raze,Killjoy,Viper,Omen,Fade","Raze,Viper,Omen,Chamber,Gekko"
Split,BLVKHVND,Odd 1 OUT,11,13,6,6,7,5,"Raze,Viper,Omen,Jett,Skye","Breach,Raze,Cypher,Omen,Skye"
Split,Zero Tenacity,GoNext Esports,10,13,5,7,6,5,"Raze,Skye,Astra,Chamber,Gekko","Breach,Raze,Cypher,Omen,Skye"
Bind,MAD Lions KOI,ALTERNATE aTTaX Ruby,13,6,4,3,3,9,"Breach,Raze,Cypher,Brimstone,Gekko","Breach,Raze,Viper,Brimstone,Fade"
Sunset,ALTERNATE aTTaX,RIZON,14,12,6,7,5,8,"Breach,Raze,Cypher,Sova,Omen","Breach,Raze,Cypher,Omen,Gekko"
Split,Nepotism,Prospects Hitmen,13,8,10,2,6,3,"Raze,Cypher,Viper,Omen,Skye","Raze,Viper,Jett,Skye,Astra"
Icebox,BLVKHVND,Odd 1 OUT,4,13,4,8,5,0,"Sova,Killjoy,Viper,Sage,Chamber","Sova,Killjoy,Viper,Jett,KAY/O"
Ascent,Team Full Of Cuties,Zero Comms,13,10,9,3,7,4,"Sova,Phoenix,Omen,Jett,KAY/O","Sova,Killjoy,Omen,Jett,KAY/O"
Lotus,Valiant,Akroma,11,13,5,7,6,6,"Breach,Raze,Sova,Killjoy,Omen","Raze,Sova,Killjoy,Viper,Omen"
Lotus,Nepotism,Prospects Hitmen,13,3,10,2,1,3,"Raze,Killjoy,Viper,Omen,Fade","Raze,Cypher,Omen,KAY/O,Gekko"
Sunset,MAD Lions KOI,ALTERNATE aTTaX Ruby,13,6,6,1,5,7,"Breach,Raze,Cypher,Omen,Deadlock","Breach,Raze,Cypher,Sova,Omen"
Lotus,Zero Tenacity,GoNext Esports,7,13,6,6,7,1,"Raze,Killjoy,Viper,Omen,Fade","Breach,Sova,Killjoy,Omen,Jett"
Bind,Team Liquid Brazil,MIBR GC,16,14,11,4,10,5,"Raze,Viper,Brimstone,Skye,Gekko","Raze,Viper,Brimstone,Fade,Gekko"
Lotus,ALTERNATE aTTaX,RIZON,13,2,10,2,0,3,"Breach,Raze,Sova,Killjoy,Omen","Raze,Killjoy,Viper,Omen,Skye"
Icebox,Galatasaray Esports,Fire Flux Esports,6,13,2,5,8,4,"Killjoy,Viper,Sage,KAY/O,Gekko","Sova,Killjoy,Viper,Jett,Harbor"
Ascent,EXO Clan,K10,13,4,10,2,2,3,"Breach,Cypher,Sova,Omen,Jett","Sova,Killjoy,Omen,Jett,KAY/O"
Sunset,100Tatov,gamba4life,13,2,3,0,2,10,"Cypher,Omen,Jett,Fade,Gekko","Raze,Cypher,Omen,KAY/O,Gekko"
Lotus,KIMCHI,shsh,13,6,9,3,3,4,"Raze,Cypher,Omen,KAY/O,Gekko","Breach,Raze,Sova,Killjoy,Omen"
Split,Vennegjengen,CTRL Esports,10,13,6,6,7,4,"Raze,Cypher,Viper,Omen,Skye","Raze,Cypher,Viper,Omen,Skye"
Icebox,Odd 1 OUT,Twisted Minds Orchid,13,7,10,2,5,3,"Sova,Killjoy,Viper,Jett,KAY/O","Sova,Killjoy,Viper,Reyna,Gekko"
Icebox,Berserkrs,Lost Puppies,13,15,6,8,7,7,"Sova,Killjoy,Viper,Jett,Yoru","Sova,Killjoy,Viper,Sage,Jett"
Sunset,Valiant,Akroma,13,5,3,3,2,10,"Breach,Raze,Cypher,Sova,Omen","Raze,Cypher,Omen,Yoru,Fade"
Icebox,Jabba Enjoyers,5STARS,12,14,5,8,6,7,"Sova,Killjoy,Viper,Jett,Deadlock","Sova,Killjoy,Viper,Reyna,Jett"
Lotus,Team Liquid Brazil,MIBR GC,6,13,6,6,7,0,"Raze,Killjoy,Viper,Omen,Fade","Raze,Killjoy,Viper,Omen,Fade"
Split,Team Full Of Cuties,Zero Comms,13,11,5,7,4,8,"Breach,Raze,Omen,Jett,Gekko","Cypher,Sage,Omen,Jett,Skye"
Ascent,ALTERNATE aTTaX,RIZON,6,13,3,9,4,3,"Sova,Killjoy,Omen,Jett,KAY/O","Sova,Killjoy,Omen,Jett,KAY/O"
Split,MUP Gaming,Gladius,10,13,5,6,7,5,"Raze,Viper,Omen,Jett,Skye","Raze,Cypher,Viper,Omen,Skye"
Sunset,boy kissers,Surely Tragic,13,6,5,2,4,8,"Breach,Raze,Cypher,Omen,Gekko","Raze,Cypher,Omen,KAY/O,Gekko"
Icebox,Diamant Esports,Chipi Chapa's,13,8,8,1,7,5,"Raze,Killjoy,Viper,Reyna,Gekko","Sova,Killjoy,Viper,Jett,Harbor"
Ascent,Incognito GC,ALTERNATE aTTaX Ruby,8,13,7,5,8,1,"Breach,Sova,Killjoy,Omen,Jett","Sova,Killjoy,Omen,Jett,KAY/O"
Sunset,Verdant,EXIT Esports,11,13,6,6,7,5,"Raze,Cypher,Omen,KAY/O,Gekko","Breach,Cypher,Viper,Omen,KAY/O"
Sunset,Galatasaray Esports,Fire Flux Esports,10,13,6,5,8,4,"Raze,Sage,Omen,KAY/O,Gekko","Breach,Cypher,Sova,Omen,Jett"
Bind,9to5 workers,Hexagon,13,3,10,2,1,3,"Raze,Cypher,Viper,Brimstone,Skye","Raze,Cypher,Brimstone,Skye,KAY/O"
Lotus,Cognizant,PURE Esports,3,13,3,9,4,0,"Raze,Sova,Omen,KAY/O,Chamber","Raze,Killjoy,Viper,Omen,Fade"
Lotus,EXO Clan,K10,13,10,8,4,6,5,"Breach,Raze,Killjoy,Omen,Gekko","Raze,Killjoy,Viper,Omen,Fade"
Sunset,SweetNsour,OnlyFins,9,13,5,7,6,4,"Raze,Cypher,Omen,KAY/O,Gekko","Breach,Raze,Cypher,Sova,Omen"
Lotus,Vanir,Free Orbs,13,10,7,5,5,6,"Breach,Killjoy,Omen,Neon,Fade","Raze,Viper,Omen,KAY/O,Gekko"
Split,Requiem,JELQ MAXXING,13,8,5,4,4,8,"Breach,Raze,Cypher,Viper,Omen","Raze,Cypher,Viper,Omen,Skye"
Lotus,Vennegjengen,CTRL Esports,14,12,11,2,10,3,"Breach,Raze,Cypher,Harbor,Deadlock","Raze,Killjoy,Viper,Omen,Fade"
Bind,MADAGASCAR PENGUINS,Bulls UCLM,13,4,4,1,3,9,"Cypher,Brimstone,Jett,Yoru,Gekko","Raze,Viper,Omen,Skye,Gekko"
Icebox,100Tatov,gamba4life,14,12,8,5,7,6,"Sova,Killjoy,Viper,Jett,Gekko","Sova,Killjoy,Viper,Jett,Gekko"
Lotus,shsh,tiktok rizz party,13,11,6,6,5,7,"Breach,Raze,Sova,Killjoy,Omen","Raze,Sova,Killjoy,Omen,Skye"
Sunset,Team Liquid Brazil,MIBR GC,13,10,8,3,7,5,"Breach,Raze,Sage,Omen,Fade","Raze,Cypher,Omen,Fade,Gekko"
Sunset,Obscene,EXIT Esports,7,13,5,7,6,2,"Breach,Raze,Cypher,Sova,Omen","Breach,Cypher,Viper,Omen,KAY/O"
Split,FearFerox,Lost Puppies,9,13,3,7,6,6,"Raze,Cypher,Viper,Skye,Astra","Breach,Raze,Cypher,Astra,Gekko"
Sunset,Incognito GC,ALTERNATE aTTaX Ruby,7,13,4,8,5,3,"Breach,Raze,Cypher,Omen,Fade","Breach,Raze,Cypher,Sova,Omen"
Breeze,Odd 1 OUT,Twisted Minds Orchid,13,11,6,6,5,7,"Cypher,Sova,Viper,Jett,KAY/O","Cypher,Sova,Viper,Jett,KAY/O"
Breeze,Valiant,Akroma,13,10,9,2,8,4,"Cypher,Sova,Viper,Yoru,KAY/O","Cypher,Sova,Viper,Jett,Yoru"
Breeze,9to5 workers,Hexagon,13,0,1,0,0,12,"Cypher,Sova,Viper,Jett,KAY/O","Cypher,Sova,Viper,Reyna,Jett"
Bind,Mania,5STARS,9,13,4,8,5,5,"Viper,Brimstone,Skye,Chamber,Gekko","Raze,Viper,Brimstone,Skye,Gekko"
Sunset,Project 1,Surely Tragic,10,13,1,10,3,9,"Breach,Raze,Cypher,Omen,Fade","Raze,Cypher,Omen,KAY/O,Gekko"
Lotus,Diamant Esports,Chipi Chapa's,13,11,7,5,6,6,"Raze,Killjoy,Viper,Omen,Skye","Raze,Killjoy,Viper,Omen,Skye"
Sunset,CTRL x YARI Esports,NoodleSoupWarriors,16,18,8,9,9,8,"Breach,Raze,Cypher,Omen,Gekko","Cypher,Sova,Omen,Jett,Gekko"
Split,gowna,Symbol,5,13,4,2,11,1,"Raze,Viper,Omen,Jett,Skye","Cypher,Sage,Reyna,Astra,Fade"
Icebox,Team Full Of Cuties,Zero Comms,11,13,5,7,6,6,"Sova,Viper,Reyna,Jett,KAY/O","Sova,Killjoy,Viper,Jett,Gekko"
Bind,CGN Esports,FOKUS,9,13,7,5,8,2,"Raze,Sova,Viper,Brimstone,Skye","Raze,Viper,Brimstone,Yoru,Gekko"
Lotus,Galakticos,HOWL Esports,13,5,9,3,2,4,"Viper,Omen,Neon,Fade,Gekko","Breach,Raze,Sova,Killjoy,Omen"
Icebox,PURE Esports,XRAVEL,13,3,4,0,3,9,"Sova,Killjoy,Viper,Reyna,Jett","Sova,Killjoy,Viper,Jett,Harbor"
Breeze,Requiem,JELQ MAXXING,13,3,4,0,3,9,"Cypher,Sova,Viper,Jett,Yoru","Cypher,Sova,Viper,Jett,KAY/O"
Split,Free Orbs,brx,13,8,4,5,3,9,"Raze,Cypher,Viper,Omen,Skye","Raze,Cypher,Omen,Jett,Skye"
Bind,EXO Clan,K10,10,13,6,5,8,4,"Breach,Raze,Cypher,Brimstone,Gekko","Raze,Cypher,Viper,Brimstone,Skye"
Icebox,BGFPG,Gladius,2,13,0,3,10,2,"Sova,Killjoy,Viper,Reyna,Jett","Sova,Killjoy,Viper,Reyna,Gekko"
Split,SweetNsour,OnlyFins,10,13,7,4,9,3,"Raze,Cypher,Viper,Omen,Skye","Raze,Killjoy,Viper,Omen,KAY/O"
Bind,Vennegjengen,CTRL Esports,9,13,3,7,6,6,"Raze,Cypher,Viper,Brimstone,Skye","Raze,Cypher,Viper,Brimstone,Skye"
Bind,Thunders,UPCT ESPORTS,13,11,7,5,6,6,"Raze,Viper,Omen,Skye,Chamber","Breach,Raze,Viper,Brimstone,Skye"
Sunset,MADAGASCAR PENGUINS,Bulls UCLM,8,13,1,8,5,7,"Cypher,Sova,Phoenix,Omen,Gekko","Raze,Cypher,Sage,Omen,Gekko"
Lotus,Vision Esports (EU),Obscene,7,13,2,10,3,5,"Raze,Viper,Omen,KAY/O,Chamber","Breach,Raze,Killjoy,Omen,Fade"
Sunset,shsh,HShomers,13,9,4,6,3,9,"Breach,Raze,Cypher,Sova,Omen","Cypher,Phoenix,Omen,KAY/O,Gekko"
Ascent,XRAVEL,Hidden Horizon,13,2,3,0,2,10,"Sova,Killjoy,Omen,Jett,KAY/O","Sova,Killjoy,Omen,Jett,KAY/O"
Lotus,Mania,megatrons maidens,13,6,10,2,4,3,"Breach,Raze,Killjoy,Omen,Gekko","Raze,Killjoy,Omen,Jett,Gekko"
Ascent,CTRL x YARI Esports,NoodleSoupWarriors,5,13,0,6,7,5,"Breach,Viper,Phoenix,Omen,KAY/O","Sova,Killjoy,Omen,Jett,Neon"
Sunset,vibes?,Project 1,7,13,3,5,8,4,"Breach,Cypher,Omen,Jett,KAY/O","Breach,Raze,Cypher,Omen,Fade"
Sunset,Lost Puppies,Life Purpose,13,10,5,7,3,8,"Raze,Cypher,Viper,Astra,Fade","Raze,Cypher,Omen,KAY/O,Gekko"
Breeze,Diamant Esports,Chipi Chapa's,9,13,7,5,8,2,"Cypher,Sova,Viper,Omen,Yoru","Cypher,Sova,Viper,Jett,Yoru"
Sunset,CGN Esports,FOKUS,5,13,2,4,9,3,"Raze,Cypher,Phoenix,Omen,Fade","Raze,Cypher,Omen,KAY/O,Gekko"
Sunset,gowna,Symbol,8,13,2,7,6,6,"Breach,Raze,Cypher,Omen,Gekko","Breach,Raze,Cypher,Sova,Omen"
Icebox,Tech Fleece Troopers,5STARS,11,13,4,8,5,7,"Sova,Killjoy,Viper,Reyna,Jett","Sova,Killjoy,Viper,Reyna,Jett"
Lotus,Free Orbs,Dipsy & Co,13,5,6,0,5,7,"Raze,Viper,Omen,KAY/O,Gekko","Raze,Killjoy,Viper,Omen,Fade"
Split,OOT Esports,EXIT Esports,5,13,4,8,5,1,"Raze,Cypher,Omen,Jett,Skye","Breach,Raze,Viper,Omen,Skye"
Ascent,Lets Be Great,tiktok rizz party,12,14,6,7,7,6,"Sova,Killjoy,Omen,Jett,KAY/O","Sova,Killjoy,Omen,Jett,KAY/O"
Lotus,In The Face,PURE Esports,7,13,3,9,4,4,"Killjoy,Viper,Omen,Neon,Fade","Raze,Killjoy,Viper,Omen,Fade"
Icebox,Team Celestials,MLT Esports GC,11,13,4,8,5,7,"Sova,Killjoy,Viper,Jett,Gekko","Sova,Killjoy,Viper,Reyna,Jett"
Split,JELQ MAXXING,Vanir,13,7,3,5,2,10,"Raze,Cypher,Viper,Omen,Skye","Raze,Cypher,Viper,Omen,Skye"
Ascent,Surely Tragic,Fortress,13,10,7,4,6,6,"Sova,Killjoy,Omen,Jett,KAY/O","Cypher,Sova,Phoenix,Omen,Jett"
Ascent,BGFPG,PRYDWEN,13,8,4,5,3,9,"Sova,Killjoy,Phoenix,Omen,Jett","Raze,Sova,Omen,KAY/O,Deadlock"
Lotus,brx,Basilisk,13,5,3,3,2,10,"Raze,Killjoy,Omen,Jett,Gekko","Raze,Viper,Omen,Chamber,Gekko"
Bind,Galakticos,HOWL Esports,13,10,6,6,4,7,"Raze,Viper,Omen,KAY/O,Gekko","Raze,Viper,Skye,Astra,Gekko"
Ascent,TheSecretClub,BIG MAC BANDITS,13,11,8,4,7,5,"Sova,Killjoy,Omen,Jett,KAY/O","Sova,Killjoy,Omen,Jett,KAY/O"
Ascent,Ionized,Obscene,1,13,1,11,2,0,"Sova,Killjoy,Omen,Jett,KAY/O","Cypher,Sova,Omen,Jett,KAY/O"
Split,FreeBird,FearFerox,9,13,6,6,7,3,"Breach,Raze,Cypher,Viper,Omen","Raze,Cypher,Viper,Skye,Astra"
Lotus,HShomers,Serpent,14,12,7,6,6,7,"Raze,Killjoy,Omen,Fade,Gekko","Breach,Raze,Killjoy,Omen,Gekko"
Lotus,MUP Gaming,NoodleSoupWarriors,2,13,2,10,3,0,"Raze,Killjoy,Viper,Omen,Fade","Raze,Sova,Killjoy,Viper,Omen"
Ascent,MADAGASCAR PENGUINS,Bulls UCLM,13,11,4,8,3,9,"Cypher,Sova,Omen,Jett,KAY/O","Cypher,Sova,Omen,Jett,KAY/O"
Lotus,Hidden Horizon,REAL1Z,13,5,9,3,2,4,"Breach,Raze,Killjoy,Omen,Gekko","Raze,Killjoy,Omen,Skye,Gekko"
Ascent,Thunders,UPCT ESPORTS,14,12,6,7,5,8,"Cypher,Sova,Omen,Jett,KAY/O","Raze,Killjoy,Brimstone,Reyna,Skye"
Lotus,Requiem,boy kissers,13,10,9,2,8,4,"Breach,Raze,Cypher,Harbor,Deadlock","Raze,Killjoy,Omen,Jett,Gekko"
Sunset,EXO Clan,KIMCHI,18,16,6,11,5,12,"Breach,Raze,Cypher,Omen,Gekko","Cypher,Sova,Omen,KAY/O,Neon"
Sunset,Apinaorkesteri,NXT,13,5,5,1,4,8,"Raze,Cypher,Omen,KAY/O,Gekko","Raze,Cypher,Omen,Yoru,Gekko"
Lotus,Vennegjengen,Berserkrs,13,10,10,1,9,3,"Breach,Raze,Cypher,Harbor,Deadlock","Breach,Raze,Killjoy,Omen,Yoru"
Split,Team Celestials,MLT Esports GC,5,13,3,9,4,2,"Raze,Cypher,Sage,Omen,Skye","Raze,Killjoy,Sage,Omen,Skye"
Ascent,tiktok rizz party,SOUL Black,13,6,9,3,3,4,"Sova,Killjoy,Omen,Jett,KAY/O","Sova,Killjoy,Omen,Jett,KAY/O"
Lotus,CTRL x YARI Esports,Cognizant,13,7,6,2,5,7,"Raze,Killjoy,Viper,Omen,Fade","Raze,Sova,Omen,KAY/O,Chamber"
Lotus,Life Purpose,Essence,13,10,5,6,4,8,"Breach,Raze,Cypher,Omen,Gekko","Breach,Raze,Killjoy,Omen,Fade"
Sunset,5STARS,RG,13,6,8,4,2,5,"Raze,Cypher,Omen,KAY/O,Gekko","Breach,Raze,Cypher,Sova,Omen"
Split,Verdant,CTRL Esports,11,13,4,8,5,7,"Breach,Raze,Cypher,Astra,KAY/O","Raze,Cypher,Viper,Omen,Skye"
Bind,K10,Jabba Enjoyers,13,7,7,5,2,6,"Raze,Cypher,Viper,Brimstone,Skye","Breach,Raze,Viper,Brimstone,Skye"
Lotus,Project 1,sammakkojoukkue,13,7,5,3,4,8,"Raze,Killjoy,Viper,Omen,Fade","Raze,Cypher,Omen,KAY/O,Gekko"
Bind,Gladius,Simping for Monkeys,13,5,8,4,1,5,"Raze,Viper,Brimstone,Skye,Deadlock","Raze,Viper,Brimstone,Skye,Gekko"
Lotus,megatrons maidens,Quantum Flux,13,11,9,3,8,4,"Raze,Killjoy,Omen,Jett,Gekko","Breach,Raze,Omen,Chamber,Gekko"
Ascent,TN1GHT Clan,PURE Esports,8,13,3,9,4,5,"Sova,Killjoy,Reyna,Omen,Jett","Sova,Killjoy,Omen,Jett,KAY/O"
Bind,REY eSports,EXIT Esports,10,13,5,7,6,5,"Raze,Cypher,Viper,Brimstone,Skye","Breach,Viper,Brimstone,Yoru,Gekko"
Bind,Ducks Esports,Fortress,6,13,1,6,7,5,"Raze,Cypher,Viper,Brimstone,Skye","Raze,Cypher,Brimstone,Yoru,Gekko"
Ascent,Golden Dusk,Dipsy & Co,12,14,4,9,5,8,"Sova,Killjoy,Omen,Jett,KAY/O","Sova,Killjoy,Omen,Jett,KAY/O"
Lotus,FearFerox,TactiBears,13,4,5,0,4,8,"Raze,Killjoy,Viper,Omen,Gekko","Breach,Raze,Viper,Omen,Skye"
Sunset,Basilisk,Eclipse,13,9,8,4,5,5,"Breach,Raze,Cypher,Skye,Astra","Raze,Cypher,Omen,KAY/O,Gekko"
Lotus,TheSecretClub,BIG MAC BANDITS,13,7,9,3,4,4,"Killjoy,Viper,Omen,Jett,Fade","Raze,Cypher,Neon,Gekko,Clove"
Icebox,gowna,Symbol,17,15,8,8,7,9,"Sova,Killjoy,Viper,Sage,Jett","Sova,Killjoy,Viper,Jett,Gekko"
Ascent,PRYDWEN,Friends,14,12,10,3,9,4,"Raze,Sova,Omen,KAY/O,Deadlock","Sova,Killjoy,Omen,Jett,KAY/O"
Bind,JELQ MAXXING,Lets Be Great,13,11,7,5,6,6,"Raze,Viper,Brimstone,Skye,Gekko","Raze,Viper,Brimstone,Skye,Chamber"
Bind,Mania,boy kissers,6,13,5,7,6,1,"Viper,Brimstone,Skye,Chamber,Gekko","Raze,Viper,Brimstone,Skye,Yoru"
Lotus,NoodleSoupWarriors,FreeBird,13,8,8,4,4,5,"Raze,Sova,Killjoy,Viper,Omen","Breach,Raze,Killjoy,Omen,Gekko"
Lotus,vibes?,Jabba Enjoyers,7,13,6,6,7,1,"Breach,Raze,Killjoy,Omen,Gekko","Breach,Raze,Killjoy,Omen,Fade"
Ascent,Lost Puppies,MUP Gaming,9,13,6,6,7,3,"Cypher,Viper,Omen,Jett,KAY/O","Sova,Killjoy,Omen,Jett,KAY/O"
Bind,Verdant,XRAVEL,13,5,6,0,5,7,"Raze,Sova,Viper,Astra,KAY/O","Raze,Viper,Brimstone,Skye,Gekko"
Lotus,CTRL x YARI Esports,OOT Esports,13,0,1,0,0,12,"Raze,Killjoy,Viper,Omen,Fade","Raze,Killjoy,Viper,Omen,Fade"
Sunset,Simping for Monkeys,HEAT eSports,3,13,3,9,4,0,"Breach,Raze,Cypher,Omen,Fade","Breach,Raze,Cypher,Omen,Gekko"
Sunset,Vision Esports (EU),Cognizant,6,13,3,9,4,3,"Cypher,Sova,Omen,KAY/O,Neon","Breach,Raze,Cypher,Sova,Omen"
Lotus,K10,Surely Tragic,13,2,3,0,2,10,"Raze,Killjoy,Viper,Omen,Fade","Raze,Killjoy,Viper,Omen,Fade"
Ascent,Berserkrs,BGFPG,13,9,7,5,4,6,"Sova,Killjoy,Omen,Jett,Yoru","Sova,Viper,Phoenix,Omen,Chamber"
Lotus,Vanir,shsh,13,7,9,3,4,4,"Breach,Killjoy,Omen,Neon,Fade","Breach,Raze,Sova,Killjoy,Omen"
Split,Apinaorkesteri,NXT,13,4,9,3,1,4,"Raze,Cypher,Viper,Omen,Skye","Raze,Cypher,Viper,Omen,Skye"
Bind,CTRL Esports,In The Face,13,4,5,0,4,8,"Raze,Cypher,Viper,Brimstone,Skye","Raze,Cypher,Viper,Brimstone,Skye"
Ascent,Requiem,Tech Fleece Troopers,13,1,2,0,1,11,"Raze,Cypher,Sova,Omen,Deadlock","Sova,Killjoy,Omen,Jett,KAY/O"
Sunset,Free Orbs,KIMCHI,11,13,4,8,5,7,"Raze,Cypher,Omen,KAY/O,Gekko","Cypher,Sova,Omen,KAY/O,Neon"
Bind,EXO Clan,brx,13,10,6,6,4,7,"Breach,Raze,Cypher,Brimstone,Gekko","Raze,Cypher,Brimstone,Jett,Skye"
Bind,Vennegjengen,Gladius,13,10,6,5,5,7,"Raze,Cypher,Viper,Brimstone,Skye","Raze,Viper,Brimstone,Skye,Deadlock"
Lotus,Mania,Obscene,13,7,5,3,4,8,"Breach,Raze,Killjoy,Omen,Gekko","Breach,Raze,Killjoy,Viper,Omen"
Lotus,NoodleSoupWarriors,Serpent,13,2,2,1,1,11,"Raze,Sova,Killjoy,Viper,Omen","Breach,Raze,Killjoy,Omen,Gekko"
Bind,CTRL x YARI Esports,Hive9,13,1,11,1,0,2,"Raze,Cypher,Viper,Brimstone,Skye","Raze,Brimstone,Sage,Skye,Gekko"
Lotus,boy kissers,Ionized,13,3,3,1,2,10,"Raze,Killjoy,Omen,Jett,Gekko","Raze,Cypher,Viper,Omen,Fade"
Lotus,Verdant,Fortress,13,6,6,1,5,7,"Raze,Cypher,Omen,KAY/O,Gekko","Breach,Raze,Killjoy,Viper,Omen"
Lotus,Lets Be Great,Life Purpose,13,3,10,2,1,3,"Raze,Viper,Omen,Skye,Chamber","Breach,Raze,Cypher,Omen,Gekko"
Ascent,JELQ MAXXING,Essence,13,8,7,2,6,6,"Sova,Killjoy,Omen,Jett,KAY/O","Sova,Killjoy,Omen,Jett,KAY/O"
Icebox,Lost Puppies,SOUL Black,13,5,10,2,3,3,"Sova,Killjoy,Viper,Sage,Jett","Raze,Sova,Killjoy,Viper,Gekko"
Icebox,Hidden Horizon,Surely Tragic,6,13,2,10,3,4,"Sova,Killjoy,Viper,Jett,Harbor","Sova,Killjoy,Viper,Omen,Jett"
Lotus,Jabba Enjoyers,TN1GHT Clan,13,7,6,6,1,7,"Breach,Raze,Killjoy,Omen,Fade","Raze,Killjoy,Viper,Omen,Skye"
Lotus,BIG MAC BANDITS,Symbol,9,13,7,5,8,2,"Breach,Raze,Killjoy,Omen,Gekko","Breach,Raze,Killjoy,Omen,Fade"
Ascent,Requiem,Renegade Raiders,13,3,2,2,1,11,"Raze,Cypher,Sova,Omen,Deadlock","Cypher,Sova,Omen,Jett,KAY/O"
Lotus,Vision Esports (EU),Quantum Flux,13,6,5,2,4,8,"Raze,Viper,Omen,KAY/O,Chamber","Raze,Killjoy,Viper,Omen,Fade"
Bind,REY eSports,Tech Fleece Troopers,6,13,3,9,4,3,"Raze,Cypher,Viper,Brimstone,Skye","Raze,Cypher,Viper,Brimstone,Skye"
Lotus,EXO Clan,HEAT eSports,13,3,10,2,1,3,"Breach,Raze,Killjoy,Omen,Gekko","Breach,Raze,Killjoy,Omen,Fade"
Lotus,BGFPG,Golden Dusk,13,3,3,1,2,10,"Raze,Sova,Viper,Omen,Chamber","Raze,Killjoy,Viper,Omen,Fade"
Bind,Vanir,TactiBears,13,3,10,2,1,3,"Raze,Viper,Brimstone,Skye,Yoru","Raze,Cypher,Brimstone,Skye,Yoru"
Bind,Cognizant,Thin Fecking Ice,13,7,5,3,4,8,"Breach,Raze,Cypher,Brimstone,Fade","Breach,Raze,Viper,Brimstone,Yoru"
Lotus,Team Secret,DRX,8,13,5,7,6,3,"Raze,Killjoy,Viper,Omen,Skye","Raze,Killjoy,Viper,Omen,Fade"
Icebox,Ducks Esports,XRAVEL,5,13,4,2,11,1,"Sova,Killjoy,Viper,Jett,Gekko","Sova,Killjoy,Viper,Jett,Harbor"
Ascent,gowna,TheSecretClub,17,15,11,5,10,6,"Cypher,Sova,Omen,Jett,KAY/O","Sova,Killjoy,Omen,Jett,KAY/O"
Icebox,Berserkrs,Dipsy & Co,13,7,7,1,6,6,"Sova,Killjoy,Viper,Jett,Yoru","Sova,Killjoy,Viper,Jett,KAY/O"
Sunset,CTRL Esports,sammakkojoukkue,13,3,4,0,3,9,"Raze,Cypher,Omen,KAY/O,Gekko","Breach,Raze,Cypher,Omen,Fade"
Split,Team Full Of Cuties,100Tatov,11,13,6,6,7,5,"Breach,Raze,Omen,Jett,Gekko","Raze,Cypher,Omen,Jett,Skye"
Split,FreeBird,1 6,13,11,9,3,8,4,"Breach,Raze,Cypher,Viper,Omen","Raze,Cypher,Viper,Omen,Skye"
Bind,K10,REAL1Z,13,3,4,0,3,9,"Raze,Cypher,Viper,Brimstone,Skye","Raze,Brimstone,Jett,Skye,Harbor"
Ascent,Vennegjengen,Eclipse,13,3,10,2,1,3,"Sova,Killjoy,Omen,Jett,KAY/O","Sova,Killjoy,Omen,Jett,KAY/O"
Sunset,KIMCHI,PRYDWEN,13,5,3,3,2,10,"Cypher,Sova,Omen,KAY/O,Neon","Raze,Cypher,Omen,Yoru,Gekko"
Lotus,Free Orbs,Friends,13,6,4,3,3,9,"Raze,Viper,Omen,KAY/O,Gekko","Raze,Killjoy,Viper,Omen,Gekko"
Lotus,shsh,FearFerox,13,8,8,4,4,5,"Breach,Raze,Sova,Killjoy,Omen","Breach,Raze,Cypher,Omen,Gekko"
Sunset,tiktok rizz party,MUP Gaming,11,13,9,3,10,2,"Raze,Cypher,Sova,Omen,Gekko","Raze,Cypher,Omen,KAY/O,Gekko"
Lotus,Project 1,In The Face,10,13,7,5,8,3,"Raze,Killjoy,Viper,Omen,Fade","Killjoy,Viper,Omen,Neon,Fade"
Bind,brx,Simping for Monkeys,13,3,3,1,2,10,"Raze,Brimstone,Jett,Skye,Gekko","Raze,Viper,Brimstone,Skye,Gekko"
Icebox,OOT Esports,5STARS,13,11,8,4,7,5,"Sova,Killjoy,Viper,Yoru,Harbor","Sova,Killjoy,Viper,Reyna,Jett"
Lotus,Team Full Of Cuties,100Tatov,9,13,4,6,7,5,"Breach,Raze,Omen,Neon,Fade","Raze,Killjoy,Reyna,Omen,Fade"
Sunset,Symbol,FlyingChamps Prophecy,13,6,8,4,2,5,"Breach,Raze,Cypher,Sova,Omen","Breach,Raze,Cypher,Omen,Gekko"
Sunset,Team Secret,DRX,8,13,5,4,9,3,"Breach,Raze,Cypher,Sova,Omen","Raze,Cypher,Viper,Omen,Fade"
Sunset,gowna,EX MACHINA,13,3,4,0,3,9,"Breach,Raze,Cypher,Omen,Gekko","Breach,Raze,Cypher,Omen,Fade"
Split,BIG MAC BANDITS,Arcanum Esports,13,9,4,8,1,9,"Raze,Cypher,Omen,Jett,Skye","Breach,Raze,Cypher,Viper,Omen"
Lotus,TheSecretClub,TEAM BLINDSPOT,13,10,6,5,5,7,"Killjoy,Viper,Omen,Jett,Fade","Breach,Raze,Killjoy,Omen,Skye"
Lotus,Zero Comms,gamba4life,4,13,0,5,8,4,"Raze,Reyna,Omen,Chamber,Gekko","Raze,Killjoy,Omen,Chamber,Gekko"
Ascent,Global Esports,ZETA DIVISION,8,13,6,6,7,2,"Sova,Killjoy,Omen,Jett,KAY/O","Sova,Killjoy,Omen,Jett,KAY/O"
Ascent,Zero Comms,gamba4life,1,13,0,12,1,1,"Cypher,Sova,Omen,Jett,KAY/O","Sova,Killjoy,Omen,Jett,KAY/O"
Icebox,Global Esports,ZETA DIVISION,13,10,5,6,4,8,"Killjoy,Viper,Sage,Jett,Gekko","Killjoy,Viper,Jett,KAY/O,Gekko"
Sunset,Global Esports,ZETA DIVISION,1,13,1,11,2,0,"Raze,Sova,Viper,Omen,Gekko","Sova,Viper,Phoenix,Omen,Chamber"
Bind,Illicit Gaming,Hyperion Gaming,13,9,3,7,2,10,"Raze,Viper,Brimstone,Skye,KAY/O","Raze,Viper,Brimstone,Skye,Yoru"
Lotus,Good Luck,Rex-Mex,15,13,6,8,5,9,"Breach,Raze,Killjoy,Omen,Gekko","Raze,Killjoy,Viper,Omen,Fade"
Lotus,Illicit Gaming,Hyperion Gaming,13,7,8,0,7,5,"Raze,Killjoy,Viper,Omen,Fade","Breach,Raze,Killjoy,Omen,Neon"
Ascent,bucky bandits,Prospects,11,13,4,8,5,7,"Sova,Killjoy,Omen,Jett,KAY/O","Cypher,Sova,Phoenix,Omen,Jett"
Split,Good Luck,Rex-Mex,13,11,7,5,6,6,"Raze,Cypher,Viper,Omen,Skye","Raze,Killjoy,Viper,Skye,Astra"
Bind,Van Lyn Black,Predator X Gaming,14,12,7,6,6,7,"Raze,Viper,Brimstone,Fade,Gekko","Raze,Viper,Brimstone,KAY/O,Gekko"
Ascent,Converse NBG,Cataclysm Gaming,13,3,9,3,0,4,"Sova,Killjoy,Omen,Jett,KAY/O","Sova,Killjoy,Omen,Jett,KAY/O"
Bind,L2Puggers,Foreigners,13,3,4,0,3,9,"Raze,Cypher,Brimstone,Reyna,Skye","Raze,Viper,Brimstone,Skye,Deadlock"
Split,bucky bandits,Prospects,12,14,3,10,4,9,"Raze,Cypher,Viper,Astra,Gekko","Raze,Cypher,Viper,Omen,Skye"
Lotus,Boise State University,Reactor 9,18,16,13,4,12,5,"Killjoy,Viper,Omen,Skye,Neon","Raze,Killjoy,Viper,Omen,Skye"
Ascent,Good Luck,Rex-Mex,11,13,6,6,7,5,"Sova,Killjoy,Omen,Jett,KAY/O","Sova,Killjoy,Omen,Jett,KAY/O"
Ascent,iKU,Overkill Gaming Clan,17,19,8,10,9,9,"Sova,Killjoy,Omen,Jett,KAY/O","Sova,Killjoy,Omen,Jett,KAY/O"
Icebox,Van Lyn Black,Predator X Gaming,13,6,4,3,3,9,"Sova,Killjoy,Viper,Omen,Jett","Raze,Sova,Killjoy,Viper,Yoru"
Sunset,wows little pugstars,Defiant Gaming,13,8,7,2,6,6,"Breach,Raze,Cypher,Omen,Fade","Raze,Cypher,Sova,Omen,Gekko"
Lotus,Reign Above,Culturized,6,13,1,6,7,5,"Breach,Killjoy,Omen,Neon,Gekko","Breach,Raze,Killjoy,Omen,Gekko"
Breeze,SRVR RED,piece control,14,12,5,8,4,9,"Cypher,Sova,Viper,Jett,Yoru","Cypher,Sova,Viper,Jett,Yoru"
Icebox,Converse NBG,Cataclysm Gaming,13,5,4,2,3,9,"Sova,Killjoy,Viper,Jett,Gekko","Sova,Killjoy,Viper,Chamber,Harbor"
Lotus,Team Virtuosity,YDZ Esports,12,14,5,8,6,7,"Raze,Killjoy,Viper,Omen,Skye","Raze,Killjoy,Viper,Omen,Skye"
Split,eRa (NA),Lesser Molerats,13,4,5,0,4,8,"Raze,Cypher,Viper,Omen,Skye","Raze,Cypher,Viper,Omen,Skye"
Sunset,Awaken,Vulcan Rising,13,11,7,5,6,6,"Raze,Cypher,Omen,KAY/O,Gekko","Raze,Cypher,Omen,KAY/O,Gekko"
Icebox,Zero MarksMen Black,St. Clair Saints Academy,13,9,7,3,6,6,"Sova,Killjoy,Viper,Reyna,Jett","Sova,Killjoy,Viper,Sage,Jett"
Icebox,L2Puggers,Foreigners,13,9,8,4,5,5,"Sova,Killjoy,Viper,Reyna,Jett","Sova,Killjoy,Viper,Reyna,Deadlock"
Lotus,wows little pugstars,Defiant Gaming,13,4,9,3,1,4,"Breach,Raze,Cypher,Omen,Fade","Breach,Raze,Killjoy,Omen,Gekko"
Ascent,Pewu’s Prodigies,Prospects,6,13,1,6,7,5,"Cypher,Sova,Omen,Jett,KAY/O","Cypher,Sova,Phoenix,Omen,Jett"
Sunset,Boise State University,Reactor 9,13,9,8,2,7,5,"Raze,Cypher,Viper,Omen,Skye","Raze,Cypher,Sova,Omen,Gekko"
Bind,Zero MarksMen Black,St. Clair Saints Academy,13,2,1,2,0,12,"Breach,Viper,Phoenix,Brimstone,KAY/O","Raze,Cypher,Viper,Brimstone,Fade"
Icebox,Bon Bon Bum Contra GC,OK Gaming,13,10,5,6,4,8,"Sova,Killjoy,Viper,Reyna,Jett","Sova,Killjoy,Viper,Jett,KAY/O"
Bind,iKU,Overkill Gaming Clan,13,8,5,4,4,8,"Raze,Cypher,Viper,Brimstone,Gekko","Raze,Viper,Brimstone,Skye,Chamber"
Bind,SRVR RED,piece control,13,9,6,4,5,7,"Raze,Viper,Brimstone,Skye,Yoru","Raze,Cypher,Viper,Brimstone,Gekko"
Split,Reign Above,Culturized,10,13,6,6,7,4,"Raze,Cypher,Viper,Omen,Skye","Breach,Raze,Cypher,Omen,Gekko"
Lotus,eRa (NA),Lesser Molerats,13,5,4,2,3,9,"Raze,Killjoy,Viper,Omen,Gekko","Raze,Viper,Omen,Skye,Chamber"
Lotus,RyZe Esports,Van Lyn Black,13,8,7,2,6,6,"Raze,Killjoy,Viper,Omen,KAY/O","Raze,Killjoy,Viper,Omen,Fade"
Ascent,Foreigners,Luxoria,13,3,3,1,2,10,"Sova,Killjoy,Omen,Jett,KAY/O","Sova,Killjoy,Omen,Jett,KAY/O"
Sunset,Team Virtuosity,YDZ Esports,8,13,5,7,6,3,"Breach,Raze,Cypher,Sova,Omen","Raze,Cypher,Omen,KAY/O,Gekko"
Bind,VisionZ,Converse NBG,13,6,8,4,2,5,"Raze,Viper,Brimstone,Skye,Gekko","Raze,Cypher,Viper,Brimstone,Skye"
Lotus,Awaken,Vulcan Rising,13,9,5,5,4,8,"Killjoy,Viper,Omen,Neon,Fade","Raze,Killjoy,Viper,Omen,Fade"
Lotus,Rex-Mex,Last Resistance,13,11,6,6,5,7,"Raze,Killjoy,Viper,Omen,Fade","Raze,Killjoy,Viper,Omen,Fade"
Lotus,Justice for Clear,Good Luck,13,3,9,3,0,4,"Raze,Killjoy,Omen,Jett,Gekko","Breach,Raze,Killjoy,Omen,Gekko"
Ascent,Boise State University,Reactor 9,9,13,4,6,7,5,"Sova,Killjoy,Omen,Jett,KAY/O","Sova,Killjoy,Omen,Jett,KAY/O"
Split,Pewu’s Prodigies,Prospects,13,6,4,3,3,9,"Raze,Cypher,Viper,Omen,Skye","Raze,Cypher,Viper,Omen,Skye"
Icebox,Cataclysm Gaming,UW Esports,13,0,1,0,0,12,"Sova,Killjoy,Viper,Chamber,Harbor","Sova,Viper,Reyna,Jett,Deadlock"
Breeze,RETA Esports,Six Karma,13,10,7,4,6,6,"Cypher,Sova,Viper,Jett,KAY/O","Cypher,Sova,Viper,Omen,Jett"
Lotus,Defiant Gaming,LazerrFreeks8,13,6,5,2,4,8,"Breach,Raze,Killjoy,Omen,Gekko","Breach,Raze,Killjoy,Omen,Jett"
Bind,Prospects Hitmen,Chivas Esports,16,14,4,11,3,12,"Raze,Cypher,Viper,Brimstone,Skye","Raze,Viper,Brimstone,Skye,Gekko"
Bind,LAG Yellow,Team Virtuosity,13,4,9,3,1,4,"Raze,Viper,Omen,KAY/O,Gekko","Raze,Viper,Brimstone,Skye,Gekko"
Sunset,wows little pugstars,ASTANE,10,13,5,6,7,5,"Breach,Raze,Cypher,Omen,Fade","Breach,Raze,Cypher,Sova,Omen"
Split,FlyQuest RED,Kinetic GC,13,3,11,1,2,2,"Raze,Cypher,Viper,Omen,Skye","Breach,Raze,Cypher,Omen,Fade"
Ascent,Zero MarksMen Black,UCF Gold,12,14,6,7,7,6,"Sova,Killjoy,Omen,Jett,KAY/O","Sova,Killjoy,Omen,Jett,KAY/O"
Ascent,Reign Above,Head Down Bag Up,4,13,3,9,4,1,"Sova,Killjoy,Omen,Jett,KAY/O","Sova,Killjoy,Omen,Jett,KAY/O"
Ascent,Bon Bon Bum Contra GC,OK Gaming,13,7,6,2,5,7,"Breach,Raze,Sova,Killjoy,Omen","Sova,Killjoy,Omen,Jett,KAY/O"
Icebox,SaD Purple,eRa (NA),13,10,10,2,8,3,"Sova,Killjoy,Viper,Reyna,Jett","Sova,Killjoy,Viper,Jett,Gekko"
Sunset,1337 (NA),Awaken,13,6,6,1,5,7,"Breach,Raze,Cypher,Omen,Gekko","Raze,Cypher,Omen,KAY/O,Gekko"
Lotus,Six Figures,Predator X Gaming,8,13,6,6,7,2,"Breach,Astra,Chamber,Neon,Gekko","Raze,Killjoy,Viper,Omen,Fade"
Ascent,VisionZ,Converse NBG,9,13,4,8,5,5,"Sova,Killjoy,Omen,Jett,KAY/O","Sova,Killjoy,Omen,Jett,KAY/O"
Split,Nepotism,The GRID,6,13,2,5,8,4,"Raze,Cypher,Viper,Omen,Skye","Raze,Cypher,Viper,Omen,Gekko"
Sunset,Supernova Nebula,Vulcan Rising,4,13,0,5,8,4,"Raze,Cypher,Omen,KAY/O,Gekko","Raze,Cypher,Omen,KAY/O,Gekko"
Ascent,RyZe Esports,Van Lyn Black,11,13,4,8,5,7,"Sova,Killjoy,Omen,Jett,KAY/O","Sova,Killjoy,Omen,Jett,KAY/O"
Lotus,Foreigners,Luxoria,12,14,2,11,3,10,"Raze,Killjoy,Viper,Omen,Skye","Breach,Raze,Killjoy,Omen,Gekko"
Icebox,Passion Project,friends GC,13,6,7,5,1,6,"Killjoy,Viper,Jett,KAY/O,Gekko","Sova,Killjoy,Viper,Jett,KAY/O"
Icebox,piece control,Name TBD,13,7,6,6,1,7,"Sova,Killjoy,Viper,Reyna,Jett","Sova,Killjoy,Viper,Jett,Chamber"
Ascent,1Millisecond,Culturized,9,13,3,7,6,6,"Sova,Killjoy,Omen,Jett,KAY/O","Sova,Killjoy,Omen,Jett,KAY/O"
Ascent,Blinn Esports,L2Puggers,13,6,7,5,1,6,"Viper,Omen,Jett,KAY/O,Gekko","Sova,Killjoy,Omen,Jett,KAY/O"
Icebox,YDZ Esports,Fat and Really Tired,13,9,6,6,3,7,"Sova,Killjoy,Viper,Reyna,Jett","Sova,Viper,Reyna,Jett,Astra"
Ascent,Rex-Mex,Last Resistance,13,10,8,3,7,5,"Sova,Killjoy,Omen,Jett,KAY/O","Sova,Killjoy,Omen,Jett,KAY/O"
Bind,OKAY,Equinox GC,8,13,4,8,5,4,"Raze,Cypher,Viper,Brimstone,Skye","Raze,Viper,Brimstone,Skye,Yoru"
Breeze,Justice for Clear,Good Luck,13,11,5,7,4,8,"Cypher,Sova,Viper,Jett,Yoru","Cypher,Viper,Reyna,Jett,KAY/O"
Bind,ROSE,SRVR RED,13,1,11,1,0,2,"Raze,Viper,Brimstone,Skye,Gekko","Raze,Viper,Brimstone,Skye,Yoru"
Lotus,Malecient,Infiriumz Gaming,13,10,4,7,3,9,"Raze,Killjoy,Omen,Jett,Gekko","Raze,Killjoy,Viper,Omen,Fade"
Bind,Unity Brasil,Lower Esports,13,5,8,4,1,5,"Raze,Brimstone,Skye,Astra,Gekko","Raze,Viper,Brimstone,Skye,Gekko"
Sunset,LAG Yellow,Team Virtuosity,13,7,9,3,4,4,"Breach,Raze,Cypher,Omen,Fade","Breach,Raze,Sova,Viper,Omen"
Bind,Cataclysm Gaming,UW Esports,10,13,5,7,6,5,"Viper,Brimstone,Omen,KAY/O,Gekko","Raze,Cypher,Sova,Brimstone,Reyna"
Bind,Ions Day Care,Boise State University,13,10,7,5,5,6,"Raze,Cypher,Viper,Brimstone,Skye","Raze,Viper,Brimstone,Skye,Gekko"
Sunset,Defiant Gaming,LazerrFreeks8,14,12,7,6,6,7,"Raze,Cypher,Sova,Omen,Gekko","Raze,Cypher,Omen,Skye,Gekko"
Ascent,YDZ Esports,Fat and Really Tired,13,0,1,0,0,12,"Sova,Killjoy,Omen,Jett,KAY/O","Sova,Killjoy,Omen,Jett,KAY/O"
Bind,wows little pugstars,ASTANE,8,13,6,6,7,2,"Raze,Viper,Brimstone,Skye,Gekko","Raze,Viper,Brimstone,Skye,Yoru"
Split,Zero MarksMen Black,UCF Gold,6,13,4,8,5,2,"Raze,Cypher,Viper,Omen,Skye","Raze,Cypher,Viper,Omen,Skye"
Lotus,FlyQuest RED,Kinetic GC,13,2,10,2,0,3,"Raze,Killjoy,Viper,Omen,Skye","Raze,Killjoy,Viper,Omen,Fade"
Split,Burger Boyz 2.0,bucky bandits,13,2,10,2,0,3,"Raze,Cypher,Viper,Skye,Astra","Raze,Cypher,Viper,Astra,Gekko"
Lotus,Prospects Hitmen,Chivas Esports,13,11,9,3,8,4,"Raze,Cypher,Omen,KAY/O,Gekko","Raze,Cypher,Omen,Neon,Gekko"
Lotus,Reign Above,Head Down Bag Up,4,13,2,10,3,2,"Breach,Killjoy,Omen,Neon,Gekko","Raze,Killjoy,Viper,Omen,Skye"
Breeze,Nepotism,The GRID,13,7,3,5,2,10,"Cypher,Sova,Viper,Jett,KAY/O","Cypher,Sova,Viper,Reyna,Jett"
Lotus,Reactor 9,ZYN ENJOYERS,13,4,2,3,1,11,"Raze,Killjoy,Viper,Omen,Skye","Raze,Killjoy,Omen,Jett,Gekko"
Ascent,SaD Purple,eRa (NA),7,13,3,9,4,4,"Cypher,Sova,Phoenix,Omen,Jett","Sova,Killjoy,Omen,Jett,KAY/O"
Bind,St. Clair Saints Academy,Fisher Rising,13,3,9,3,0,4,"Raze,Cypher,Viper,Brimstone,Fade","Raze,Cypher,Viper,Brimstone,Skye"
Lotus,1337 (NA),Awaken,13,7,8,4,3,5,"Raze,Killjoy,Viper,Omen,Fade","Raze,Killjoy,Viper,Omen,Fade"
Ascent,Lesser Molerats,University of Idaho,13,8,8,4,4,5,"Sova,Killjoy,Omen,Jett,KAY/O","Sova,Killjoy,Omen,Jett,KAY/O"
Lotus,Pewu’s Prodigies,Prospects,15,17,8,8,9,7,"Raze,Killjoy,Reyna,Omen,Gekko","Raze,Killjoy,Viper,Omen,Fade"
Icebox,Blinn Esports,L2Puggers,13,5,6,0,5,7,"Killjoy,Viper,KAY/O,Harbor,Gekko","Sova,Killjoy,Viper,Reyna,Jett"
Bind,Foreigners,Luxoria,13,6,8,4,2,5,"Raze,Viper,Brimstone,Skye,Deadlock","Raze,Cypher,Viper,Brimstone,Skye"
Lotus,1Millisecond,Culturized,8,13,7,5,8,1,"Raze,Killjoy,Viper,Omen,Fade","Breach,Raze,Killjoy,Omen,Gekko"
Bind,Supernova Nebula,Vulcan Rising,9,13,4,8,5,5,"Raze,Viper,Brimstone,Skye,Gekko","Raze,Viper,Brimstone,Skye,Yoru"
Ascent,RETA Esports,Six Karma,14,12,8,5,7,6,"Sova,Killjoy,Omen,Jett,KAY/O","Sova,Killjoy,Omen,Jett,KAY/O"
Bind,piece control,Name TBD,13,3,4,0,3,9,"Raze,Cypher,Viper,Brimstone,Gekko","Raze,Viper,Brimstone,Skye,Gekko"
Ascent,Malecient,Infiriumz Gaming,4,13,0,5,8,4,"Sova,Killjoy,Omen,Jett,KAY/O","Killjoy,Omen,Jett,Yoru,Fade"
Lotus,VisionZ,Converse NBG,13,9,7,5,4,6,"Breach,Raze,Omen,Chamber,Gekko","Raze,Killjoy,Viper,Omen,Skye"
Icebox,RyZe Esports,Van Lyn Black,13,10,5,7,3,8,"Sova,Killjoy,Viper,Jett,KAY/O","Sova,Killjoy,Viper,Omen,Jett"
Lotus,OKAY,Equinox GC,13,5,10,2,3,3,"Raze,Cypher,Omen,KAY/O,Gekko","Raze,Cypher,Omen,Jett,Skye"
Icebox,Six Figures,Predator X Gaming,11,13,6,6,7,5,"Sova,Viper,Yoru,Chamber,Harbor","Raze,Sova,Killjoy,Viper,Yoru"
Lotus,ROSE,SRVR RED,13,8,6,3,5,7,"Raze,Killjoy,Viper,Omen,Fade","Raze,Killjoy,Viper,Omen,Fade"
Icebox,Supernova x Pals,mesos millionaires,13,10,8,4,6,5,"Killjoy,Viper,Reyna,Harbor,Gekko","Sova,Killjoy,Viper,Jett,KAY/O"
Ascent,Cataclysm Gaming,UW Esports,13,2,2,1,1,11,"Sova,Killjoy,Omen,Jett,KAY/O","Cypher,Sova,Omen,Jett,KAY/O"
Sunset,Oxygen Esports,FLUFFY AIMERS,13,2,10,2,0,3,"Breach,Raze,Cypher,Omen,KAY/O","Raze,Cypher,Viper,Omen,KAY/O"
Bind,Reformed Team,Deagle Ravagers,13,6,10,2,4,3,"Breach,Viper,Brimstone,Jett,Gekko","Breach,Raze,Cypher,Brimstone,Skye"
Breeze,Ions Day Care,Boise State University,13,5,9,3,2,4,"Cypher,Sova,Viper,Jett,Yoru","Cypher,Sova,Viper,Yoru,KAY/O"
Icebox,Burger Boyz 2.0,bucky bandits,13,3,11,1,2,2,"Sova,Killjoy,Viper,Jett,Gekko","Sova,Killjoy,Viper,Sage,Chamber"
Split,Defiant Gaming,LazerrFreeks8,3,13,0,4,9,3,"Raze,Cypher,Viper,Omen,Skye","Raze,Cypher,Viper,Omen,Skye"
Ascent,Reactor 9,ZYN ENJOYERS,13,2,3,0,2,10,"Sova,Killjoy,Omen,Jett,KAY/O","Sova,Killjoy,Omen,Jett,KAY/O"
Breeze,MIBR GC,LOUD GC,13,9,7,5,4,6,"Cypher,Sova,Viper,Jett,KAY/O","Cypher,Sova,Viper,Jett,KAY/O"
Sunset,Zero MarksMen Black,UCF Gold,13,3,10,2,1,3,"Breach,Sova,Viper,Phoenix,Omen","Raze,Cypher,Omen,KAY/O,Gekko"
Lotus,Passion Project,friends GC,9,13,5,7,6,4,"Raze,Killjoy,Viper,Omen,Skye","Raze,Cypher,Omen,KAY/O,Gekko"
Ascent,St. Clair Saints Academy,Fisher Rising,13,4,4,1,3,9,"Breach,Viper,Phoenix,Omen,KAY/O","Sova,Killjoy,Omen,Jett,KAY/O"
Split,SaD Purple,eRa (NA),13,2,3,0,2,10,"Raze,Cypher,Viper,Omen,Skye","Raze,Cypher,Viper,Omen,Skye"
Lotus,wows little pugstars,ASTANE,13,9,9,1,8,4,"Breach,Raze,Cypher,Omen,Fade","Raze,Killjoy,Viper,Omen,Skye"
Sunset,Rex-Mex,Good Luck,12,14,8,5,9,4,"Raze,Cypher,Viper,Omen,Fade","Breach,Raze,Cypher,Omen,Fade"
Split,Lesser Molerats,University of Idaho,13,4,3,2,2,10,"Raze,Cypher,Viper,Omen,Skye","Raze,Cypher,Viper,Omen,Skye"
Split,Prospects Hitmen,The GRID,9,13,3,7,6,6,"Raze,Viper,Omen,Skye,Astra","Raze,Cypher,Viper,Omen,Gekko"
Sunset,YDZ Esports,Team Virtuosity,11,13,4,8,5,7,"Raze,Cypher,Omen,KAY/O,Gekko","Breach,Raze,Sova,Viper,Omen"
Ascent,OKAY,Equinox GC,2,13,0,3,10,2,"Sova,Killjoy,Omen,Jett,KAY/O","Sova,Killjoy,Omen,Jett,KAY/O"
Sunset,Unity Brasil,Lower Esports,13,15,7,7,8,6,"Breach,Raze,Cypher,Omen,Gekko","Raze,Cypher,Omen,Fade,Gekko"
Bind,Culturized,Reign Above,5,13,4,8,5,1,"Raze,Cypher,Viper,Brimstone,Skye","Raze,Viper,Brimstone,Skye,Gekko"
Ascent,Converse NBG,Cataclysm Gaming,13,2,10,2,0,3,"Sova,Killjoy,Omen,Jett,KAY/O","Sova,Killjoy,Omen,Jett,KAY/O"
Bind,Supernova x Pals,mesos millionaires,13,11,4,8,3,9,"Raze,Viper,Brimstone,Skye,Gekko","Raze,Viper,Brimstone,Skye,Chamber"
Icebox,Foreigners,L2Puggers,12,14,7,6,8,5,"Sova,Killjoy,Viper,Reyna,Chamber","Sova,Killjoy,Viper,Reyna,Jett"
Split,Awaken,Supernova Nebula,13,10,6,5,5,7,"Raze,Cypher,Viper,Omen,Skye","Raze,Viper,Jett,Skye,Astra"
Split,Team Falcons,Underground Gaming,13,11,6,6,5,7,"Breach,Raze,Cypher,Omen,Skye","Raze,Cypher,Sage,Omen,Skye"
Split,Reformed Team,Deagle Ravagers,3,13,1,11,2,2,"Breach,Cypher,Jett,Skye,Astra","Breach,Raze,Cypher,Astra,Fade"
Bind,Six Figures,Van Lyn Black,8,13,4,5,8,4,"Raze,Viper,Brimstone,Skye,Gekko","Raze,Viper,Brimstone,Fade,Gekko"
Ascent,Oxygen Esports,FLUFFY AIMERS,13,4,5,0,4,8,"Sova,Killjoy,Omen,Jett,KAY/O","Cypher,Viper,Omen,Jett,KAY/O"
Lotus,1337 (NA),Vulcan Rising,13,6,10,2,4,3,"Raze,Killjoy,Viper,Omen,Fade","Raze,Killjoy,Viper,Omen,Fade"
Breeze,Burger Boyz 2.0,Prospects,13,8,3,6,2,10,"Cypher,Sova,Viper,Jett,Yoru","Cypher,Sova,Viper,Jett,Yoru"
Lotus,Teddy Tactics,Kinetic GC,12,14,3,10,4,9,"Killjoy,Viper,Omen,Neon,Gekko","Raze,Killjoy,Viper,Omen,Fade"
Sunset,MIBR GC,LOUD GC,13,3,11,1,2,2,"Raze,Cypher,Omen,Fade,Gekko","Breach,Raze,Cypher,Omen,Fade"
Bind,Passion Project,friends GC,13,2,11,1,1,2,"Raze,Cypher,Viper,Brimstone,Skye","Raze,Viper,Brimstone,Skye,Yoru"
Lotus,Ions Day Care,ZYN ENJOYERS,13,2,10,2,0,3,"Killjoy,Viper,Omen,Neon,Gekko","Raze,Killjoy,Omen,Skye,Gekko"
Ascent,piece control,SRVR RED,11,13,8,4,9,3,"Sova,Killjoy,Omen,Jett,KAY/O","Sova,Killjoy,Omen,Jett,KAY/O"
Ascent,Rex-Mex,Good Luck,3,13,2,10,3,1,"Sova,Killjoy,Omen,Jett,KAY/O","Sova,Killjoy,Omen,Jett,KAY/O"
Ascent,RyZe Esports,Predator X Gaming,13,5,10,2,3,3,"Sova,Killjoy,Omen,Jett,KAY/O","Viper,Omen,Jett,KAY/O,Gekko"
Bind,Boise State University,Reactor 9,13,7,6,6,1,7,"Raze,Viper,Brimstone,Skye,Gekko","Raze,Viper,Brimstone,Skye,Yoru"
Icebox,RETA Esports,Six Karma,13,10,8,4,6,5,"Sova,Killjoy,Viper,Jett,Harbor","Sova,Killjoy,Viper,Jett,Harbor"
Breeze,SaD Purple,University of Idaho,13,2,10,2,0,3,"Cypher,Sova,Viper,Jett,Yoru","Cypher,Sova,Viper,Jett,KAY/O"
Split,Nepotism,Chivas Esports,13,6,5,2,4,8,"Raze,Cypher,Viper,Omen,Skye","Raze,Viper,Omen,Jett,Skye"
Icebox,eRa (NA),Lesser Molerats,13,3,3,1,2,10,"Sova,Killjoy,Viper,Jett,Gekko","Sova,Killjoy,Viper,Jett,Gekko"
Ascent,bucky bandits,Pewu’s Prodigies,13,6,7,5,1,6,"Sova,Killjoy,Omen,Jett,KAY/O","Sova,Killjoy,Omen,Jett,KAY/O"
Lotus,Head Down Bag Up,1Millisecond,13,6,6,1,5,7,"Raze,Killjoy,Viper,Omen,Skye","Raze,Killjoy,Viper,Omen,Fade"
Bind,UCF Gold,St. Clair Saints Academy,13,11,10,2,9,3,"Raze,Viper,Omen,KAY/O,Gekko","Raze,Cypher,Viper,Brimstone,Fade"
Split,wows little pugstars,LazerrFreeks8,13,11,3,9,2,10,"Raze,Cypher,Omen,Jett,Skye","Raze,Cypher,Viper,Omen,Skye"
Ascent,Blinn Esports,Luxoria,13,6,7,5,1,6,"Viper,Omen,Jett,KAY/O,Gekko","Sova,Killjoy,Omen,Jett,KAY/O"
Lotus,YDZ Esports,Team Virtuosity,13,8,8,4,4,5,"Raze,Killjoy,Viper,Omen,Skye","Killjoy,Viper,Omen,Skye,Neon"
Lotus,VisionZ,UW Esports,13,4,9,3,1,4,"Breach,Raze,Omen,Chamber,Gekko","Breach,Raze,Killjoy,Omen,Fade"
Bind,LAG Yellow,Fat and Really Tired,13,1,11,1,0,2,"Raze,Viper,Omen,KAY/O,Gekko","Raze,Viper,Brimstone,Reyna,Skye"
Sunset,Prospects Hitmen,The GRID,13,5,9,3,2,4,"Cypher,Viper,Omen,Jett,Skye","Raze,Cypher,Omen,KAY/O,Gekko"
Bind,Foreigners,L2Puggers,13,6,5,2,4,8,"Raze,Viper,Brimstone,Skye,Deadlock","Raze,Cypher,Viper,Brimstone,Skye"
Bind,ROSE,Name TBD,13,7,9,3,4,4,"Raze,Viper,Brimstone,Skye,Gekko","Raze,Viper,Brimstone,Skye,Gekko"
Bind,Zero MarksMen Black,Fisher Rising,13,7,9,3,4,4,"Breach,Viper,Phoenix,Brimstone,KAY/O","Raze,Cypher,Viper,Brimstone,Skye"
Ascent,ASTANE,Defiant Gaming,13,3,3,1,2,10,"Sova,Killjoy,Omen,Jett,KAY/O","Sova,Killjoy,Omen,Jett,KAY/O"
Split,Culturized,Reign Above,10,13,5,7,6,5,"Breach,Raze,Cypher,Omen,Gekko","Raze,Cypher,Viper,Omen,Skye"
Sunset,Awaken,Supernova Nebula,6,13,2,5,8,4,"Raze,Cypher,Omen,KAY/O,Gekko","Raze,Cypher,Omen,KAY/O,Gekko"
Sunset,Justice for Clear,Last Resistance,13,2,2,1,1,11,"Raze,Cypher,Omen,Jett,Gekko","Raze,Cypher,Omen,KAY/O,Gekko"
Ascent,SaD Purple,University of Idaho,13,2,2,1,1,11,"Cypher,Sova,Reyna,Omen,Jett","Sova,Killjoy,Omen,Jett,KAY/O"
Ascent,Ions Day Care,ZYN ENJOYERS,13,2,11,1,1,2,"Sova,Killjoy,Omen,Jett,KAY/O","Sova,Killjoy,Omen,Jett,KAY/O"
Ascent,Equinox GC,Bumble Bees,13,3,9,3,0,4,"Sova,Killjoy,Omen,Jett,KAY/O","Sova,Killjoy,Omen,Jett,KAY/O"
Icebox,LAG Yellow,Fat and Really Tired,13,4,10,2,2,3,"Killjoy,Viper,Omen,KAY/O,Gekko","Killjoy,Viper,Reyna,Jett,Gekko"
Icebox,Prospects Amethyst,mesos millionaires,8,13,5,4,9,3,"Killjoy,Viper,Harbor,Gekko,Deadlock","Sova,Killjoy,Viper,Jett,Gekko"
Sunset,UCF Gold,St. Clair Saints Academy,13,3,3,1,2,10,"Raze,Cypher,Omen,KAY/O,Gekko","Breach,Raze,Cypher,Sova,Omen"
Icebox,1337 (NA),Vulcan Rising,13,9,5,5,4,8,"Sova,Killjoy,Viper,Sage,Chamber","Sova,Killjoy,Viper,Jett,Harbor"
Icebox,Teddy Tactics,Kinetic GC,11,13,8,4,9,3,"Sova,Killjoy,Viper,Jett,Harbor","Sova,Killjoy,Viper,Jett,Gekko"
Lotus,piece control,SRVR RED,8,13,2,7,6,6,"Killjoy,Viper,Omen,Jett,Skye","Raze,Killjoy,Viper,Omen,Fade"
Lotus,Rex-Mex,Good Luck,13,9,9,3,6,4,"Raze,Killjoy,Viper,Omen,Fade","Breach,Raze,Killjoy,Omen,Gekko"
Lotus,Burger Boyz 2.0,Prospects,13,10,8,4,6,5,"Raze,Killjoy,Viper,Omen,Skye","Raze,Killjoy,Viper,Omen,Fade"
Split,Unity Brasil,Lower Esports,13,10,6,5,5,7,"Breach,Raze,Omen,Gekko,Deadlock","Raze,Cypher,Viper,Omen,Skye"
Split,bucky bandits,Pewu’s Prodigies,13,9,5,7,2,8,"Raze,Cypher,Viper,Astra,Gekko","Raze,Viper,Omen,Jett,Skye"
Lotus,Six Figures,Van Lyn Black,9,13,3,7,6,6,"Breach,Astra,Chamber,Neon,Gekko","Raze,Killjoy,Viper,Omen,Fade"
Split,Zero MarksMen Black,Fisher Rising,13,1,2,0,1,11,"Raze,Cypher,Viper,Omen,Skye","Raze,Cypher,Viper,Omen,Skye"
Breeze,Foreigners,L2Puggers,5,13,4,8,5,1,"Cypher,Sova,Viper,Reyna,Jett","Cypher,Sova,Viper,Jett,KAY/O"
Icebox,RyZe Esports,Predator X Gaming,13,2,11,1,1,2,"Sova,Killjoy,Viper,Reyna,Jett","Raze,Sova,Killjoy,Viper,Yoru"
Sunset,eRa (NA),Lesser Molerats,13,8,9,3,5,4,"Raze,Cypher,Sova,Omen,Gekko","Raze,Cypher,Sova,Omen,KAY/O"
Bind,ASTANE,Defiant Gaming,13,5,5,1,4,8,"Raze,Viper,Brimstone,Skye,Yoru","Raze,Viper,Brimstone,Fade,Gekko"
Bind,Head Down Bag Up,1Millisecond,13,4,5,0,4,8,"Raze,Viper,Brimstone,Reyna,Skye","Raze,Viper,Brimstone,Skye,Deadlock"
Lotus,Boise State University,Reactor 9,13,10,6,5,5,7,"Killjoy,Viper,Omen,Skye,Neon","Raze,Killjoy,Viper,Omen,Skye"
Sunset,Nepotism,Chivas Esports,13,9,7,5,4,6,"Breach,Raze,Cypher,Omen,Fade","Raze,Cypher,Viper,Omen,Fade"
Lotus,wows little pugstars,LazerrFreeks8,13,4,4,1,3,9,"Breach,Raze,Cypher,Omen,Fade","Breach,Raze,Killjoy,Omen,Jett"
Lotus,ROSE,Name TBD,13,5,11,1,4,2,"Raze,Killjoy,Viper,Omen,Fade","Breach,Raze,Omen,Chamber,Gekko"
Lotus,Blinn Esports,Luxoria,13,8,10,2,6,3,"Raze,Killjoy,Viper,Omen,Fade","Breach,Raze,Killjoy,Omen,Gekko"
Bind,VisionZ,UW Esports,13,7,3,5,2,10,"Raze,Viper,Brimstone,Skye,Gekko","Raze,Cypher,Sova,Brimstone,Gekko"
Lotus,Culturized,Reign Above,13,3,4,0,3,9,"Breach,Raze,Killjoy,Omen,Gekko","Breach,Killjoy,Omen,Neon,Gekko"
Lotus,Prospects Hitmen,The GRID,9,13,4,6,7,5,"Raze,Cypher,Omen,KAY/O,Gekko","Raze,Killjoy,Reyna,Omen,Gekko"
Icebox,YDZ Esports,Team Virtuosity,10,13,7,5,8,3,"Sova,Killjoy,Viper,Reyna,Jett","Sova,Killjoy,Viper,Omen,Gekko"
Breeze,Justice for Clear,Last Resistance,13,4,10,2,2,3,"Cypher,Sova,Viper,Jett,Yoru","Cypher,Sova,Viper,Jett,KAY/O"
Lotus,Reformed Team,Deagle Ravagers,13,10,7,4,6,6,"Breach,Raze,Killjoy,Viper,Omen","Breach,Raze,Cypher,Sova,Omen"
Lotus,Converse NBG,Cataclysm Gaming,13,8,7,5,3,6,"Raze,Killjoy,Viper,Omen,Skye","Breach,Raze,Killjoy,Omen,Gekko"
Lotus,Awaken,Supernova Nebula,13,4,4,1,3,9,"Raze,Killjoy,Viper,Omen,Fade","Raze,Killjoy,Viper,Omen,Fade"
Ascent,Infinity X,friends GC,9,13,6,6,7,3,"Cypher,Viper,Omen,Jett,KAY/O","Sova,Killjoy,Omen,Jett,KAY/O"
Split,Team Liquid Brazil,TBS GC,13,8,8,4,4,5,"Breach,Raze,Viper,Omen,Skye","Raze,Viper,Omen,Jett,Skye"
Lotus,DarkZero Esports,SaD Esports,13,7,4,4,3,9,"Breach,Cypher,Omen,Neon,Fade","Raze,Sova,Killjoy,Viper,Omen"
Sunset,OKAY,C4C Flare,13,9,5,7,2,8,"Raze,Cypher,Sova,Viper,Omen","Breach,Raze,Cypher,Omen,Fade"
Split,FlyQuest RED,RyZe Eclipsa GC,13,2,10,2,0,3,"Raze,Cypher,Viper,Omen,Skye","Raze,Cypher,Viper,Omen,Skye"
Lotus,Passion Project,minions united GC,13,6,8,4,2,5,"Raze,Killjoy,Viper,Omen,Skye","Breach,Raze,Killjoy,Omen,Gekko"
Breeze,Team Falcons,Underground Gaming,20,18,8,11,7,12,"Cypher,Sova,Viper,Jett,KAY/O","Cypher,Sova,Viper,Jett,Yoru"
Breeze,Prospects Amethyst,mesos millionaires,6,13,6,6,7,0,"Cypher,Sova,Viper,Yoru,Gekko","Cypher,Sova,Viper,Jett,KAY/O"
Bind,Supernova x Pals,42C Crayola Pack,13,2,10,2,0,3,"Raze,Viper,Brimstone,Skye,Gekko","Raze,Viper,Brimstone,Skye,Gekko"
Bind,Teddy Tactics,Kinetic GC,13,8,7,2,6,6,"Raze,Viper,Brimstone,KAY/O,Gekko","Raze,Viper,Brimstone,Skye,Chamber"
Lotus,Equinox GC,Bumble Bees,13,10,8,4,6,5,"Raze,Cypher,Omen,Jett,Skye","Raze,Killjoy,Viper,Omen,Fade"
Bind,Team Liquid Brazil,TBS GC,13,1,11,1,0,2,"Raze,Viper,Brimstone,Skye,Gekko","Raze,Viper,Brimstone,Skye,Yoru"
Lotus,FlyQuest RED,RyZe Eclipsa GC,13,1,11,1,0,2,"Raze,Killjoy,Viper,Omen,Skye","Breach,Raze,Killjoy,Omen,Gekko"
Bind,Passion Project,minions united GC,13,5,9,3,2,4,"Raze,Cypher,Viper,Brimstone,Skye","Breach,Raze,Cypher,Brimstone,Skye"
Breeze,OKAY,C4C Flare,13,6,9,3,3,4,"Cypher,Sova,Viper,Yoru,Astra","Cypher,Sova,Viper,Jett,KAY/O"
Lotus,Infinity X,friends GC,7,13,4,8,5,3,"Raze,Killjoy,Viper,Omen,Fade","Raze,Cypher,Omen,KAY/O,Gekko"
Sunset,Supernova x Pals,42C Crayola Pack,13,1,2,0,1,11,"Breach,Raze,Cypher,Omen,Fade","Raze,Cypher,Omen,KAY/O,Gekko"
Sunset,DarkZero Esports,SaD Esports,8,13,1,8,5,7,"Viper,Brimstone,Jett,Fade,Deadlock","Raze,Cypher,Viper,Omen,Skye"
Icebox,Karmine Corp GC,MAD Lions KOI,13,9,6,6,3,7,"Sova,Killjoy,Viper,Sage,Jett","Sova,Killjoy,Viper,Jett,Harbor"
Bind,SOS Affenalarm,XPERION NXT,9,13,5,5,8,4,"Reyna,Omen,Jett,Yoru,Iso","Breach,Raze,Sova,Viper,Omen"
Ascent,Lootcifer,IRREGULARS,13,10,4,7,3,9,"Sova,Killjoy,Omen,Jett,KAY/O","Breach,Viper,Phoenix,Omen,KAY/O"
Icebox,Reveal Multigaming,Novita Esports,13,11,7,5,6,6,"Sova,Killjoy,Viper,Reyna,Jett","Killjoy,Viper,Reyna,Jett,Gekko"
Sunset,Veni eSports,Permitta Unicorns,5,13,5,7,6,0,"Breach,Raze,Cypher,Sova,Omen","Breach,Raze,Cypher,Omen,Fade"
Lotus,Sissi State Punks,BUCHCLUB,13,4,4,1,3,9,"Breach,Sage,Omen,Chamber,Neon","Breach,Raze,Killjoy,Omen,Gekko"
Ascent,DarkZero Esports,SaD Esports,13,5,8,4,1,5,"Cypher,Sova,Omen,Jett,Deadlock","Breach,Viper,Brimstone,Yoru,Gekko"
Sunset,SOS Affenalarm,XPERION NXT,10,13,5,7,6,5,"Phoenix,Reyna,Omen,Jett,Yoru","Breach,Raze,Cypher,Sova,Omen"
Split,Karmine Corp GC,MAD Lions KOI,13,9,6,4,5,7,"Breach,Raze,Cypher,Omen,Jett","Raze,Viper,Omen,Jett,Skye"
Split,Team Falcons,The Ultimates,2,13,0,3,10,2,"Breach,Raze,Cypher,Omen,Skye","Raze,Viper,Jett,Skye,Astra"
Split,The Ultimates,Team Falcons,13,2,10,2,0,3,"Raze,Viper,Jett,Skye,Astra","Breach,Raze,Cypher,Omen,Skye"
Lotus,Incognito GC,Zerance Mint,13,9,6,6,3,7,"Raze,Killjoy,Viper,Omen,Skye","Breach,Raze,Killjoy,Omen,Skye"
Lotus,Lootcifer,IRREGULARS,13,9,10,2,7,3,"Breach,Raze,Cypher,Omen,KAY/O","Raze,Killjoy,Viper,Omen,Fade"
Lotus,Reveal Multigaming,Novita Esports,13,4,3,2,2,10,"Breach,Sova,Killjoy,Omen,Jett","Killjoy,Reyna,Omen,Jett,Gekko"
Lotus,Veni eSports,Permitta Unicorns,4,13,1,4,9,3,"Breach,Killjoy,Omen,Neon,Gekko","Breach,Raze,Killjoy,Omen,Fade"
Lotus,Onyx Ravens,Underground Gaming,11,13,8,4,9,3,"Breach,Raze,Cypher,Omen,Gekko","Raze,Viper,Omen,Chamber,Fade"
Lotus,Underground Gaming,Onyx Ravens,13,11,9,3,8,4,"Raze,Viper,Omen,Chamber,Fade","Breach,Raze,Cypher,Omen,Gekko"
Bind,Gamax Lite,BLVKHVND,16,14,7,8,6,9,"Raze,Viper,Brimstone,Skye,Gekko","Raze,Viper,Brimstone,Jett,Skye"
Ascent,Odd 1 OUT,Snoozers,13,8,10,2,6,3,"Sova,Killjoy,Omen,Jett,KAY/O","Sova,Killjoy,Omen,Jett,KAY/O"
Lotus,HOWL Moonlight,ALTERNATE aTTaX Ruby,4,13,2,3,10,2,"Breach,Raze,Killjoy,Omen,Gekko","Breach,Raze,Cypher,Omen,Fade"
Ascent,Sissi State Punks,BUCHCLUB,13,9,7,5,4,6,"Sova,Killjoy,Omen,Jett,KAY/O","Sova,Killjoy,Omen,Jett,KAY/O"
Sunset,Twisted Minds Orchid,NPCS GC,13,7,7,1,6,6,"Breach,Raze,Cypher,Omen,Gekko","Raze,Cypher,Omen,KAY/O,Gekko"
Ascent,Incognito GC,Zerance Mint,13,7,7,5,2,6,"Breach,Sova,Killjoy,Omen,Jett","Sova,Killjoy,Omen,Jett,KAY/O"
Sunset,The Ultimates,Team Falcons,10,13,4,7,6,6,"Breach,Raze,Cypher,Omen,Gekko","Breach,Raze,Cypher,Omen,Fade"
Sunset,Team Falcons,The Ultimates,13,10,6,6,4,7,"Breach,Raze,Cypher,Omen,Fade","Breach,Raze,Cypher,Omen,Gekko"
Lotus,Karmine Corp GC,MAD Lions KOI,9,13,4,6,7,5,"Raze,Killjoy,Viper,Omen,Fade","Breach,Raze,Omen,Chamber,Fade"
Icebox,Permitta Unicorns,XPERION NXT,13,3,4,0,3,9,"Sova,Killjoy,Viper,Omen,Jett","Sova,Killjoy,Viper,Jett,Harbor"
Ascent,Onyx Ravens,Underground Gaming,13,5,4,2,3,9,"Sova,Killjoy,Omen,Jett,KAY/O","Sova,Killjoy,Phoenix,Omen,Jett"
Sunset,HOWL Moonlight,ALTERNATE aTTaX Ruby,4,13,0,5,8,4,"Breach,Raze,Cypher,Omen,Fade","Breach,Raze,Cypher,Sova,Omen"
Split,Gamax Lite,BLVKHVND,6,13,1,6,7,5,"Raze,Cypher,Viper,Omen,Skye","Raze,Viper,Omen,Jett,Skye"
Sunset,Lootcifer,Reveal Multigaming,5,13,4,8,5,1,"Raze,Cypher,Omen,KAY/O,Gekko","Breach,Cypher,Sova,Omen,Jett"
Split,Odd 1 OUT,Snoozers,13,5,4,2,3,9,"Breach,Raze,Cypher,Omen,Skye","Raze,Cypher,Jett,Skye,Astra"
Ascent,Veni eSports,IRREGULARS,5,13,2,4,9,3,"Sova,Killjoy,Omen,Jett,KAY/O","Breach,Viper,Phoenix,Omen,KAY/O"
Lotus,Twisted Minds Orchid,NPCS GC,13,7,2,6,1,11,"Killjoy,Viper,Omen,Neon,Gekko","Breach,Raze,Killjoy,Omen,Gekko"
Bind,Sissi State Punks,DREAMED WORLD,13,6,10,2,4,3,"Breach,Raze,Cypher,Brimstone,Yoru","Raze,Viper,Brimstone,Yoru,Fade"
Icebox,The Ultimates,Team Falcons,13,3,10,2,1,3,"Sova,Killjoy,Viper,Sage,Jett","Sova,Killjoy,Viper,Jett,Gekko"
Icebox,Team Falcons,The Ultimates,3,13,1,3,10,2,"Sova,Killjoy,Viper,Jett,Gekko","Sova,Killjoy,Viper,Sage,Jett"
Sunset,Permitta Unicorns,XPERION NXT,13,3,9,3,0,4,"Breach,Raze,Cypher,Omen,Fade","Breach,Raze,Cypher,Sova,Omen"
Icebox,Lootcifer,Reveal Multigaming,1,13,1,11,2,0,"Sova,Killjoy,Viper,Sage,Jett","Sova,Killjoy,Viper,Reyna,Jett"
Split,HOWL Moonlight,ALTERNATE aTTaX Ruby,13,4,10,2,2,3,"Breach,Raze,Cypher,Skye,Astra","Breach,Raze,Cypher,Omen,Skye"
Split,Onyx Ravens,Underground Gaming,4,13,2,10,3,2,"Breach,Raze,Cypher,Sage,Omen","Raze,Cypher,Sage,Omen,Skye"
Ascent,TeamOrangeGaming,Pingu E-Sports,14,12,7,6,6,7,"Raze,Viper,Astra,Fade,Gekko","Breach,Raze,Cypher,Omen,Fade"
Ascent,Gamax Lite,BLVKHVND,13,5,9,3,2,4,"Sova,Killjoy,Omen,Jett,KAY/O","Sova,Killjoy,Omen,Jett,KAY/O"
Ascent,404 Multigaming,BUCHCLUB,3,13,0,4,9,3,"Sova,Killjoy,Omen,Jett,KAY/O","Sova,Killjoy,Omen,Jett,KAY/O"
Icebox,Incognito GC,Zerance Mint,8,13,5,7,6,3,"Sova,Killjoy,Viper,Jett,Gekko","Sova,Killjoy,Viper,Omen,Jett"
Sunset,BBL Esports,Gentle Mates,11,13,5,7,6,6,"Cypher,Sova,Omen,KAY/O,Neon","Raze,Cypher,Omen,KAY/O,Neon"
Split,MAD Lions KOI,Odd 1 OUT,13,5,11,1,4,2,"Raze,Viper,Omen,Jett,Skye","Breach,Raze,Cypher,Omen,Skye"
Icebox,SOS Affenalarm,Novita Esports,5,13,1,5,8,4,"Sova,Killjoy,Viper,Reyna,Jett","Killjoy,Viper,Reyna,Jett,Gekko"
Lotus,404 Multigaming,BUCHCLUB,6,13,2,5,8,4,"Raze,Killjoy,Viper,Omen,Fade","Breach,Raze,Killjoy,Omen,Gekko"
Lotus,Karmine Corp GC,Twisted Minds Orchid,13,6,9,3,3,4,"Raze,Killjoy,Viper,Omen,Fade","Killjoy,Viper,Omen,Neon,Gekko"
Lotus,Lootcifer,Reveal Multigaming,13,6,7,5,1,6,"Breach,Raze,Cypher,Omen,KAY/O","Breach,Sova,Killjoy,Omen,Jett"
Sunset,Sissi State Punks,DREAMED WORLD,15,13,8,6,7,7,"Breach,Cypher,Omen,Jett,Yoru","Raze,Viper,Omen,KAY/O,Gekko"
Sunset,TeamOrangeGaming,Pingu E-Sports,13,6,8,4,2,5,"Breach,Raze,Cypher,Omen,Fade","Breach,Cypher,Sova,Omen,Neon"
Lotus,Veni eSports,IRREGULARS,14,16,6,9,7,8,"Breach,Killjoy,Omen,Neon,Gekko","Raze,Killjoy,Viper,Omen,Fade"
Lotus,SOS Affenalarm,Novita Esports,5,13,1,5,8,4,"Breach,Raze,Killjoy,Omen,Jett","Killjoy,Reyna,Omen,Jett,Gekko"
Ascent,Permitta Unicorns,XPERION NXT,7,13,5,7,6,2,"Sova,Killjoy,Omen,Jett,KAY/O","Sova,Killjoy,Omen,Jett,KAY/O"
Ascent,HOWL Moonlight,Gamax Lite,4,13,0,5,8,4,"Breach,Killjoy,Yoru,Astra,Gekko","Sova,Killjoy,Omen,Jett,KAY/O"
Sunset,MAD Lions KOI,Odd 1 OUT,13,6,8,4,2,5,"Breach,Raze,Cypher,Omen,Deadlock","Breach,Raze,Cypher,Omen,Fade"
Ascent,BBL Esports,Gentle Mates,7,13,3,5,8,4,"Sova,Killjoy,Omen,Jett,KAY/O","Cypher,Sova,Phoenix,Omen,Yoru"
Bind,BLVKHVND,Incognito GC,13,5,7,5,0,6,"Raze,Viper,Brimstone,Jett,Skye","Raze,Viper,Brimstone,KAY/O,Gekko"
Breeze,Karmine Corp GC,Twisted Minds Orchid,13,11,7,5,6,6,"Cypher,Sova,Viper,Jett,KAY/O","Cypher,Sova,Viper,Jett,KAY/O"
Split,BLVKHVND,Incognito GC,13,2,10,2,0,3,"Raze,Viper,Omen,Jett,Skye","Raze,Cypher,Omen,Jett,Skye"
Lotus,HOWL Moonlight,Gamax Lite,11,13,8,4,9,3,"Breach,Raze,Killjoy,Omen,Gekko","Raze,Killjoy,Viper,Omen,Fade"
Ascent,MAD Lions KOI,Odd 1 OUT,11,13,5,7,6,6,"Sova,Killjoy,Omen,Jett,KAY/O","Sova,Killjoy,Omen,Jett,KAY/O"
Icebox,Team Liquid,FUT Esports,8,13,4,8,5,4,"Killjoy,Viper,Jett,Harbor,Gekko","Sova,Viper,Sage,Jett,KAY/O"
Split,Team Liquid,FUT Esports,5,13,3,3,10,2,"Raze,Cypher,Viper,Omen,Skye","Raze,Viper,Omen,Skye,Chamber"
Bind,Orangutan,True Rippers,8,13,4,8,5,4,"Raze,Brimstone,Reyna,Skye,Harbor","Raze,Cypher,Viper,Brimstone,Skye"
Icebox,Xipto Esports,BOBA,13,4,10,2,2,3,"Killjoy,Viper,Jett,KAY/O,Gekko","Sova,Killjoy,Viper,Reyna,Jett"
Icebox,Orangutan,True Rippers,11,13,7,5,8,4,"Sova,Killjoy,Viper,Jett,Harbor","Sova,Killjoy,Viper,Jett,Gekko"
Sunset,Xipto Esports,BOBA,13,3,4,0,3,9,"Viper,Sage,Omen,KAY/O,Gekko","Breach,Raze,Cypher,Sova,Omen"
Bind,Xipto Esports,BOBA,13,1,11,1,0,2,"Raze,Viper,Brimstone,Skye,Gekko","Raze,Cypher,Viper,Brimstone,Skye"
Lotus,Carnival Gaming,MLT Esports,7,13,5,7,6,2,"Breach,Raze,Viper,Omen,Fade","Raze,Killjoy,Viper,Omen,Fade"
Ascent,Carnival Gaming,MLT Esports,9,13,3,7,6,6,"Breach,Raze,Cypher,Omen,KAY/O","Sova,Killjoy,Omen,Jett,KAY/O"
Breeze,E-Xolos LAZER,Six Karma,11,13,7,5,8,4,"Cypher,Sova,Viper,Yoru,KAY/O","Cypher,Sova,Viper,Omen,Jett"
Ascent,E-Xolos LAZER,Six Karma,11,13,2,10,3,9,"Sova,Killjoy,Omen,Jett,KAY/O","Sova,Killjoy,Omen,Jett,KAY/O"
Lotus,E-Xolos LAZER,Six Karma,13,8,8,4,4,5,"Raze,Killjoy,Viper,Omen,Fade","Breach,Raze,Cypher,Omen,Fade"
Breeze,SAIDEIRA ESPORTS,DASKAR,13,6,5,2,4,8,"Cypher,Sova,Viper,Jett,KAY/O","Cypher,Sova,Viper,Jett,KAY/O"
Lotus,ULL Red,Muskingum University,11,13,3,9,4,8,"Breach,Cypher,Omen,Jett,Gekko","Raze,Cypher,Viper,Omen,Fade"
Ascent,Legacy,CO-OP,13,4,5,0,4,8,"Sova,Killjoy,Omen,Jett,KAY/O","Sova,Killjoy,Omen,Jett,KAY/O"
Ascent,ULL Black,SJF Valorant Black,14,16,10,5,11,4,"Cypher,Phoenix,Omen,Jett,KAY/O","Sova,Killjoy,Omen,Jett,KAY/O"
Lotus,Elite Gaming,ZAGAS,0,13,0,1,12,0,"Raze,Killjoy,Omen,Skye,Gekko","Breach,Killjoy,Skye,Neon,Clove"
Sunset,ULL Red,Muskingum University,10,13,6,5,8,4,"Breach,Cypher,Omen,Jett,Yoru","Raze,Cypher,Omen,Fade,Gekko"
Icebox,E-Xolos LAZER,Six Karma,12,14,6,7,7,6,"Sova,Killjoy,Viper,KAY/O,Harbor","Sova,Killjoy,Viper,Jett,Harbor"
Sunset,Legacy,CO-OP,13,3,11,1,2,2,"Breach,Raze,Cypher,Omen,Fade","Breach,Cypher,Sova,Omen,Jett"
Icebox,ULL Black,SJF Valorant Black,13,5,3,3,2,10,"Breach,Cypher,Viper,Reyna,Jett","Sova,Killjoy,Viper,Jett,Harbor"
Split,Twisted Minds Esports,Underground Gaming,8,13,1,8,5,7,"Raze,Viper,Omen,Yoru,Fade","Raze,Cypher,Sage,Omen,Skye"
Lotus,Onyx Ravens,Vision Esports,16,14,7,8,6,9,"Breach,Raze,Cypher,Omen,Gekko","Breach,Cypher,Sova,Omen,Neon"
Lotus,Stellae Gaming Academy,Lower Esports,13,8,8,1,7,5,"Raze,Killjoy,Viper,Omen,Skye","Breach,Raze,Killjoy,Omen,Gekko"
Split,M80,Dough Bros,13,6,5,2,4,8,"Raze,Cypher,Viper,Omen,Skye","Raze,Cypher,Viper,Omen,Skye"
Split,E-Xolos LAZER,Six Karma,13,8,8,4,4,5,"Raze,Cypher,Viper,Omen,Skye","Raze,Viper,Omen,Jett,Skye"
Bind,ULL Black,SJF Valorant Black,7,13,6,6,7,1,"Breach,Raze,Killjoy,Phoenix,Brimstone","Cypher,Viper,Brimstone,Skye,Yoru"
Icebox,Onyx Ravens,Vision Esports,4,13,1,4,9,3,"Sova,Viper,Chamber,Harbor,Gekko","Sova,Killjoy,Viper,Sage,Jett"
Lotus,Twisted Minds Esports,Underground Gaming,13,10,9,2,8,4,"Killjoy,Viper,Omen,Neon,Gekko","Raze,Viper,Omen,Chamber,Fade"
Bind,OLIMPO,2Game Esports,13,7,5,3,4,8,"Raze,Viper,Brimstone,Sage,Skye","Raze,Viper,Brimstone,Skye,Gekko"
Icebox,Unity Brasil,Advogatos,9,13,5,5,8,4,"Killjoy,Brimstone,Jett,KAY/O,Gekko","Sova,Killjoy,Viper,Jett,Gekko"
Icebox,M80,Dough Bros,13,7,5,3,4,8,"Killjoy,Viper,Omen,KAY/O,Gekko","Sova,Killjoy,Viper,Omen,KAY/O"
Sunset,Onyx Ravens,Vision Esports,13,3,9,3,0,4,"Breach,Raze,Cypher,Omen,Fade","Breach,Raze,Cypher,Omen,Fade"
Ascent,OLIMPO,2Game Esports,7,13,3,5,8,4,"Sova,Killjoy,Omen,Jett,KAY/O","Sova,Killjoy,Omen,Jett,KAY/O"
Breeze,Twisted Minds Esports,Underground Gaming,9,13,7,3,10,2,"Cypher,Sova,Viper,Jett,Yoru","Cypher,Sova,Viper,Jett,Yoru"
Breeze,TSM,Winthrop University,13,4,9,3,1,4,"Cypher,Sova,Viper,Jett,KAY/O","Cypher,Sova,Viper,Jett,Yoru"
Lotus,A One Man Army,Siko Esports,8,13,3,6,7,5,"Breach,Killjoy,Omen,Neon,Gekko","Raze,Killjoy,Viper,Omen,Skye"
Lotus,TSM,Winthrop University,13,9,5,7,2,8,"Raze,Killjoy,Viper,Omen,Skye","Raze,Killjoy,Viper,Omen,Fade"
Lotus,OLIMPO,2Game Esports,15,13,9,5,8,6,"Raze,Killjoy,Viper,Omen,Fade","Raze,Killjoy,Viper,Omen,Fade"
Split,The Ultimates,Onyx Ravens,13,11,6,6,5,7,"Raze,Viper,Jett,Skye,Astra","Breach,Raze,Cypher,Sage,Omen"
Lotus,Dortmund Esports Safire,SISSI STΛTΞ PUNKS Kaizen,5,13,1,5,8,4,"Breach,Raze,Killjoy,Reyna,Omen","Raze,Cypher,Omen,Skye,Gekko"
Split,Esports Team Twente,BLX CORP X BCG,4,13,4,8,5,0,"Breach,Raze,Viper,Omen,Jett","Raze,Cypher,Astra,Gekko,Deadlock"
Breeze,Team Falcons,Twisted Minds Esports,13,7,6,6,1,7,"Cypher,Sova,Viper,Jett,KAY/O","Cypher,Sova,Viper,Jett,Yoru"
Ascent,aNc Outplayed GC,MAKERSNOLAUGHTERS,13,4,8,4,0,5,"Breach,Cypher,Sova,Omen,Jett","Sova,Killjoy,Omen,Jett,KAY/O"
Sunset,Morekats Aurora,Permitta Unicorns GC,9,13,6,6,7,3,"Breach,Raze,Cypher,Omen,Gekko","Breach,Raze,Cypher,Sova,Omen"
Ascent,Dortmund Esports Safire,SISSI STΛTΞ PUNKS Kaizen,13,4,5,0,4,8,"Sova,Killjoy,Omen,Jett,KAY/O","Sova,Killjoy,Reyna,Omen,Jett"
Ascent,The Ultimates,Onyx Ravens,13,6,6,1,5,7,"Sova,Killjoy,Omen,Jett,KAY/O","Sova,Killjoy,Omen,Jett,KAY/O"
Icebox,Team Falcons,Twisted Minds Esports,13,7,10,2,5,3,"Sova,Killjoy,Viper,Jett,Gekko","Sova,Killjoy,Viper,Jett,Gekko"
Sunset,A One Man Army,SNOOZE Esports,13,15,8,6,9,5,"Raze,Cypher,Omen,KAY/O,Gekko","Cypher,Omen,Yoru,Chamber,Fade"
Lotus,HEROIC Valkyries,TOG Kitsune,13,11,8,4,7,5,"Raze,Viper,Sage,Omen,Skye","Breach,Raze,Sova,Killjoy,Omen"
Sunset,The Ultimates,Onyx Ravens,5,13,2,10,3,3,"Breach,Raze,Cypher,Omen,Gekko","Breach,Raze,Cypher,Omen,Fade"
Lotus,Morekats Aurora,Permitta Unicorns GC,9,13,1,9,4,8,"Breach,Raze,Killjoy,Omen,Deadlock","Breach,Raze,Omen,Chamber,Gekko"
Lotus,aNc Outplayed GC,MAKERSNOLAUGHTERS,13,11,7,5,6,6,"Breach,Raze,Killjoy,Omen,Gekko","Breach,Raze,Killjoy,Omen,Gekko"
Sunset,Dortmund Esports Safire,SISSI STΛTΞ PUNKS Kaizen,9,13,5,7,6,4,"Breach,Cypher,Phoenix,Omen,Fade","Raze,Cypher,Sova,Reyna,Omen"
Lotus,FNATIC,Team Heretics,15,17,8,8,9,7,"Raze,Killjoy,Viper,Omen,Fade","Killjoy,Viper,Omen,Neon,Gekko"
Sunset,eSports Cologne,Sissi State Punks,0,13,0,12,1,0,"Raze,Killjoy,Viper,Astra,Fade","Breach,Cypher,Omen,Jett,Yoru"
Bind,HEROIC Valkyries,TOG Kitsune,13,6,7,5,1,6,"Raze,Viper,Brimstone,Skye,Gekko","Breach,Raze,Cypher,Sova,Brimstone"
Lotus,Royal Family eSports,Siko Esports,2,13,0,3,10,2,"Killjoy,Viper,Omen,Neon,Gekko","Raze,Killjoy,Viper,Omen,Skye"
Lotus,eSports Cologne,Sissi State Punks,5,13,5,7,6,0,"Raze,Killjoy,Viper,Astra,Fade","Breach,Sage,Omen,Chamber,Neon"
Icebox,FNATIC,Team Heretics,4,13,1,4,9,3,"Sova,Killjoy,Viper,Jett,Harbor","Killjoy,Viper,Sage,KAY/O,Gekko"
Lotus,Team Vitality,Natus Vincere,4,13,1,4,9,3,"Raze,Killjoy,Viper,Omen,Fade","Breach,Raze,Killjoy,Brimstone,Gekko"
Bind,Team Vitality,Natus Vincere,9,13,4,6,7,5,"Raze,Viper,Brimstone,Gekko,Deadlock","Raze,Viper,Brimstone,KAY/O,Gekko"
Bind,Revenant Esports,True Rippers,9,13,2,8,5,7,"Raze,Cypher,Viper,Brimstone,Skye","Raze,Cypher,Viper,Brimstone,Skye"
Lotus,Dplus Esports,SLT Seongam,11,13,8,4,9,3,"Breach,Raze,Cypher,Omen,Fade","Breach,Raze,Killjoy,Omen,Gekko"
Split,Revenant Esports,True Rippers,13,5,6,0,5,7,"Raze,Viper,Jett,Skye,Astra","Breach,Raze,Cypher,Astra,KAY/O"
Lotus,BOBA,AURA DIFFERENTIAL,13,8,7,2,6,6,"Raze,Killjoy,Omen,Fade,Gekko","Raze,Killjoy,Viper,Omen,Skye"
Lotus,ONE Team Esports,Oblivion Force,15,13,6,8,5,9,"Raze,Killjoy,Viper,Omen,Gekko","Raze,Killjoy,Viper,Omen,Fade"
Icebox,Dplus Esports,SLT Seongam,7,13,4,4,9,3,"Killjoy,Viper,Jett,KAY/O,Gekko","Viper,Reyna,Omen,Jett,Gekko"
Icebox,Revenant Esports,True Rippers,5,13,3,9,4,2,"Sova,Killjoy,Viper,Jett,Harbor","Sova,Killjoy,Viper,Jett,Gekko"
Sunset,BOBA,AURA DIFFERENTIAL,13,9,6,6,3,7,"Breach,Raze,Cypher,Sova,Omen","Raze,Cypher,Omen,Jett,Skye"
Split,ONE Team Esports,Oblivion Force,13,7,6,2,5,7,"Raze,Cypher,Viper,Omen,Skye","Raze,Cypher,Viper,Omen,Skye"
Bind,MLT Esports,Medal Esports,13,7,7,5,2,6,"Raze,Viper,Brimstone,Skye,Gekko","Breach,Raze,Brimstone,Skye,Yoru"
Ascent,ONE Team Esports,Oblivion Force,13,4,8,4,0,5,"Sova,Killjoy,Omen,Jett,KAY/O","Sova,Killjoy,Omen,Jett,KAY/O"
Split,FearX,Nongshim RedForce,13,8,7,5,3,6,"Raze,Cypher,Viper,Omen,KAY/O","Cypher,Sova,Viper,Omen,Iso"
Ascent,MLT Esports,Medal Esports,8,13,6,6,7,2,"Sova,Killjoy,Omen,Jett,KAY/O","Breach,Viper,Phoenix,Omen,KAY/O"
Ascent,FearX,Nongshim RedForce,6,13,5,7,6,1,"Sova,Killjoy,Omen,Jett,KAY/O","Raze,Viper,Omen,Fade,Gekko"
Icebox,MLT Esports,Medal Esports,13,5,8,4,1,5,"Sova,Killjoy,Viper,Sage,Jett","Sova,Killjoy,Viper,Jett,Harbor"
Lotus,Justice For Tomorrow,Built For Greatness,13,5,8,4,1,5,"Raze,Killjoy,Viper,Omen,Fade","Phoenix,Omen,Chamber,Harbor,Deadlock"
Ascent,Justice For Tomorrow,Built For Greatness,7,13,6,6,7,1,"Sova,Killjoy,Omen,Jett,KAY/O","Sage,Yoru,Harbor,Deadlock,Iso"
Lotus,FearX,Nongshim RedForce,15,13,5,9,4,10,"Raze,Killjoy,Viper,Omen,Fade","Raze,Killjoy,Viper,Omen,Fade"
Bind,Justice For Tomorrow,Built For Greatness,13,6,6,1,5,7,"Raze,Viper,Brimstone,Skye,Gekko","Raze,Viper,Brimstone,Skye,Yoru"
Ascent,OTSU Esports,MSU Texas Esports,13,4,8,4,0,5,"Sova,Killjoy,Omen,Jett,KAY/O","Cypher,Sova,Omen,Jett,KAY/O"
Bind,Cumberland Academy,Michigan State University,9,13,4,6,7,5,"Raze,Cypher,Viper,Brimstone,Skye","Raze,Viper,Brimstone,Jett,Skye"
Lotus,Hyperion Gold,Predator X Gaming,10,13,4,8,5,6,"Raze,Killjoy,Viper,Omen,Gekko","Raze,Killjoy,Viper,Fade,Clove"
Icebox,OK Gaming,Ragnus Esports,13,6,6,1,5,7,"Sova,Killjoy,Viper,Jett,KAY/O","Viper,Jett,Skye,Harbor,Gekko"
Split,West Virginia University,NC State Red,11,13,6,6,7,5,"Breach,Raze,Viper,Skye,Astra","Raze,Cypher,Omen,Jett,Skye"
Lotus,St. Clair Saints,Akron Esports,13,3,9,3,0,4,"Raze,Sova,Killjoy,Viper,Omen","Breach,Raze,Phoenix,Omen,Jett"
Bind,Cafe Coke,Bumble Bees,10,13,6,5,8,4,"Raze,Cypher,Viper,Brimstone,Skye","Raze,Viper,Brimstone,Skye,Yoru"
Bind,Reformed GC,mesos millionaires,7,13,5,3,10,2,"Raze,Viper,Brimstone,Skye,Gekko","Raze,Viper,Brimstone,Skye,Chamber"
Split,Fisher Rising,Rochester University Esports,13,4,8,4,0,5,"Raze,Cypher,Viper,Omen,Skye","Raze,Cypher,Viper,Omen,Skye"
Bind,Cruzados Esports,Rebirth Esports,7,13,0,8,5,7,"Raze,Brimstone,Reyna,Chamber,Fade","Breach,Raze,Cypher,Omen,KAY/O"
Split,Harrisburg University,Wichita State Esports,13,3,11,1,2,2,"Raze,Cypher,Viper,Omen,Skye","Breach,Raze,Viper,Omen,Skye"
Sunset,IVC Blue,Mizzou Esports,2,13,0,3,10,2,"Raze,Cypher,Omen,KAY/O,Gekko","Breach,Raze,Cypher,Sova,Omen"
Sunset,UofG Gold,University of Virginia,8,13,5,4,9,3,"Breach,Raze,Cypher,Omen,Fade","Cypher,Sova,Viper,Omen,Yoru"
Split,OTSU Esports,MSU Texas Esports,15,13,11,3,10,4,"Raze,Viper,Omen,Jett,Skye","Raze,Cypher,Viper,Omen,Gekko"
Ascent,Demigods At UCSD,Temple Esports Valorant Cherry,13,6,7,0,6,6,"Sova,Killjoy,Sage,Omen,Jett","Sova,Killjoy,Omen,Jett,KAY/O"
Ascent,Alliance Angels,minions united GC,9,13,3,7,6,6,"Sova,Killjoy,Omen,Jett,KAY/O","Sova,Killjoy,Omen,Jett,KAY/O"
Bind,OXEN,Red Eye,5,13,2,4,9,3,"Raze,Viper,Brimstone,Skye,Gekko","Raze,Cypher,Viper,Brimstone,Skye"
Icebox,Maryville University,UW-Stout Blue Devils,13,8,4,8,0,9,"Sova,Killjoy,Viper,Reyna,Jett","Killjoy,Viper,KAY/O,Gekko,Deadlock"
Icebox,Brewton Parker College,James Madison University,13,7,6,2,5,7,"Sova,Killjoy,Viper,Jett,Harbor","Sova,Killjoy,Viper,Sage,Jett"
Bind,Predator X Gaming,F5 Esports,13,11,6,6,5,7,"Raze,Viper,KAY/O,Gekko,Clove","Raze,Viper,Brimstone,Skye,Gekko"
Breeze,Converse Purple,Northwest Vista College,13,8,7,5,3,6,"Cypher,Sova,Viper,Jett,KAY/O","Cypher,Sova,Viper,Jett,Harbor"
Lotus,Seneca Ruby,CSULB Black,6,13,2,5,8,4,"Raze,Killjoy,Omen,Jett,Gekko","Raze,Killjoy,Viper,Omen,Skye"
Bind,Redbird Varsity,Sheridan Bruins,13,5,10,2,3,3,"Viper,Brimstone,Skye,Yoru,Gekko","Raze,Cypher,Brimstone,Skye,Gekko"
Ascent,OK Gaming,Ragnus Esports,13,9,8,2,7,5,"Sova,Killjoy,Omen,Jett,KAY/O","Breach,Raze,Sova,Killjoy,Omen"
Lotus,Hyperion Gold,Final Form Black,13,7,6,2,5,7,"Raze,Killjoy,Viper,Omen,Gekko","Raze,Killjoy,Viper,Omen,Gekko"
Icebox,West Virginia University,NC State Red,10,13,7,5,8,3,"Killjoy,Jett,KAY/O,Harbor,Gekko","Sova,Killjoy,Viper,Sage,Jett"
Sunset,Kinetic GC,SaD FROST,13,8,8,1,7,5,"Raze,Cypher,Omen,KAY/O,Gekko","Raze,Cypher,Omen,KAY/O,Gekko"
Lotus,Cumberland Academy,Michigan State University,17,19,10,8,11,7,"Raze,Killjoy,Viper,Omen,Skye","Raze,Killjoy,Viper,Omen,Skye"
Icebox,RyZe Eclipsa GC,Psycho Cats,13,5,10,2,3,3,"Sova,Killjoy,Viper,Jett,Deadlock","Sova,Killjoy,Viper,Reyna,Jett"
Split,St. Clair Saints,Akron Esports,9,13,5,7,6,4,"Breach,Raze,Cypher,Omen,Gekko","Breach,Raze,Phoenix,Omen,Jett"
Sunset,C4C Flare,Tenax GC,13,2,11,1,1,2,"Breach,Raze,Cypher,Omen,Fade","Raze,Cypher,Viper,Omen,Skye"
Lotus,42C Crayola Pack,Van Lyn Frost,13,9,6,4,5,7,"Breach,Raze,Cypher,Omen,Gekko","Raze,Killjoy,Viper,Omen,Skye"
Bind,Alliance Angels,minions united GC,0,13,0,12,1,0,"Raze,Viper,Brimstone,Skye,Chamber","Breach,Raze,Cypher,Brimstone,Skye"
Split,Reformed GC,mesos millionaires,9,13,4,8,5,5,"Raze,Viper,Omen,Jett,Skye","Raze,Cypher,Omen,Jett,Skye"
Lotus,Cafe Coke,Bumble Bees,6,13,3,4,9,3,"Raze,Killjoy,Viper,Omen,Fade","Raze,Killjoy,Viper,Omen,Fade"
Sunset,Brewton Parker College,James Madison University,13,1,2,0,1,11,"Breach,Raze,Cypher,Sova,Omen","Breach,Raze,Cypher,Sova,Omen"
Lotus,Fisher Rising,Rochester University Esports,13,10,8,4,6,5,"Raze,Killjoy,Viper,Omen,Skye","Raze,Killjoy,Viper,Omen,Gekko"
Icebox,UofG Gold,University of Virginia,7,13,5,7,6,2,"Raze,Sova,Killjoy,Viper,Brimstone","Sova,Killjoy,Viper,Sage,Jett"
Ascent,IVC Blue,Mizzou Esports,8,13,3,9,4,5,"Sova,Killjoy,Omen,Jett,KAY/O","Sova,Killjoy,Omen,Jett,KAY/O"
Icebox,Demigods At UCSD,Temple Esports Valorant Cherry,13,3,2,2,1,11,"Sova,Killjoy,Viper,Reyna,Jett","Sova,Killjoy,Viper,Omen,Jett"
Breeze,Cruzados Esports,Rebirth Esports,10,13,5,7,6,5,"Cypher,Sova,Viper,Jett,KAY/O","Cypher,Sova,Viper,Jett,KAY/O"
Icebox,OXEN,Red Eye,5,13,2,4,9,3,"Sova,Killjoy,Viper,Jett,Harbor","Killjoy,Viper,Jett,KAY/O,Gekko"
Breeze,Harrisburg University,Wichita State Esports,13,9,7,3,6,6,"Cypher,Sova,Viper,Yoru,KAY/O","Sova,Viper,Yoru,KAY/O,Harbor"
Sunset,Seneca Ruby,CSULB Black,6,13,5,7,6,1,"Raze,Cypher,Omen,Jett,Skye","Breach,Raze,Cypher,Sova,Omen"
Lotus,Redbird Varsity,Sheridan Bruins,13,1,2,0,1,11,"Raze,Killjoy,Viper,Omen,Fade","Raze,Sova,Killjoy,Omen,Skye"
Sunset,Converse Purple,Northwest Vista College,13,3,9,3,0,4,"Cypher,Viper,Omen,KAY/O,Gekko","Cypher,Viper,Omen,Yoru,Gekko"
Breeze,Maryville University,UW-Stout Blue Devils,13,8,5,4,4,8,"Cypher,Sova,Viper,Jett,KAY/O","Cypher,Sova,Viper,Jett,Yoru"
Sunset,St. Clair Saints,Akron Esports,13,0,1,0,0,12,"Breach,Raze,Cypher,Omen,Fade","Breach,Raze,Cypher,Sova,Omen"
Sunset,friends GC,Loafing Cats,13,6,9,3,3,4,"Raze,Cypher,Omen,KAY/O,Gekko","Breach,Raze,Cypher,Astra,Gekko"
Lotus,Hyperion Gold,YBB,13,2,3,0,2,10,"Raze,Killjoy,Viper,Omen,Gekko","Raze,Fade,Gekko,Deadlock,Clove"
Sunset,hazzys puggers,F5 Esports,7,13,3,5,8,4,"Raze,Cypher,Viper,Omen,Fade","Raze,Cypher,Omen,KAY/O,Gekko"
Lotus,Final Form Black,5 washed idiots,13,3,10,2,1,3,"Raze,Killjoy,Viper,Omen,Gekko","Raze,Killjoy,Viper,Omen,Gekko"
Ascent,9z Team,All Knights,13,5,9,3,2,4,"Killjoy,Viper,Omen,Jett,Skye","Sova,Killjoy,Omen,Jett,KAY/O"
Lotus,Luminescent Sapphire,Predator X Gaming,6,13,4,8,5,2,"Raze,Cypher,Omen,Fade,Gekko","Raze,Killjoy,Viper,Fade,Clove"
Bind,Kinetic GC,SaD FROST,13,8,6,3,5,7,"Raze,Viper,Brimstone,Skye,Chamber","Viper,Brimstone,Jett,Skye,Gekko"
Bind,RyZe Eclipsa GC,Psycho Cats,13,6,6,1,5,7,"Breach,Raze,Viper,Brimstone,Fade","Raze,Cypher,Viper,Brimstone,Skye"
Sunset,Alliance Angels,minions united GC,13,10,7,5,5,6,"Raze,Cypher,Viper,Omen,Gekko","Breach,Raze,Cypher,Sova,Omen"
Sunset,YFP Gaming,QoR,14,16,8,7,9,6,"Breach,Raze,Cypher,Sova,Omen","Raze,Sova,Viper,Sage,Omen"
Sunset,Hero Base,XLD Gaming,13,7,7,1,6,6,"Breach,Raze,Viper,Omen,KAY/O","Cypher,Sova,Omen,Jett,Gekko"
Split,Cafe Coke,Bumble Bees,13,5,8,4,1,5,"Breach,Raze,Cypher,Omen,Skye","Raze,Viper,Omen,Skye,Neon"
Split,Cumberland Academy,Farmingdale State College,10,13,2,9,4,8,"Raze,Cypher,Viper,Omen,Skye","Raze,Cypher,Viper,Omen,Skye"
Ascent,XSOUL,LRV Esports,6,13,2,5,8,4,"Sova,Killjoy,Omen,Jett,KAY/O","Sova,Killjoy,Omen,Jett,KAY/O"
Lotus,C4C Flare,Tenax GC,15,13,11,3,10,4,"Breach,Raze,Killjoy,Omen,Fade","Raze,Killjoy,Omen,Skye,Gekko"
Icebox,Reformed GC,mesos millionaires,13,9,6,6,3,7,"Killjoy,Viper,Sage,Jett,Gekko","Sova,Killjoy,Viper,Jett,Gekko"
Sunset,42C Crayola Pack,Van Lyn Frost,13,10,9,3,7,4,"Raze,Cypher,Omen,KAY/O,Gekko","Breach,Raze,Cypher,Omen,Gekko"
Lotus,friends GC,Loafing Cats,13,3,9,3,0,4,"Raze,Cypher,Omen,KAY/O,Gekko","Breach,Raze,Cypher,Omen,Gekko"
Bind,Pineapple Express,Hyperion Gold,4,13,4,8,5,0,"Raze,Viper,Brimstone,Skye,Gekko","Raze,Cypher,Brimstone,KAY/O,Gekko"
Lotus,Take Back Control,hazzys puggers,3,13,2,10,3,1,"Breach,Raze,Cypher,Omen,Gekko","Raze,Killjoy,Viper,Omen,Fade"
Sunset,Twisted Minds Esports,Vision Esports,13,5,4,2,3,9,"Raze,Viper,Omen,KAY/O,Gekko","Breach,Raze,Cypher,Omen,Fade"
Ascent,F5 Esports,MSU White,13,7,4,4,3,9,"Cypher,Sova,Omen,Jett,KAY/O","Raze,Sova,Viper,Omen,Gekko"
Ascent,Reli Gaming,Luminescent Sapphire,6,13,0,7,6,6,"Raze,Sova,Killjoy,Phoenix,Omen","Cypher,Sova,Omen,Jett,KAY/O"
Bind,5 washed idiots,Also Amphibium,13,11,9,3,8,4,"Raze,Cypher,Viper,Brimstone,Skye","Raze,Viper,Brimstone,Jett,Skye"
Sunset,Border Monsters Chile,UNLP Esports,13,6,3,4,2,10,"Raze,Cypher,Omen,KAY/O,Gekko","Raze,Cypher,Phoenix,Omen,Gekko"
Split,XSOUL,LRV Esports,3,13,2,10,3,1,"Raze,Viper,Omen,Jett,Skye","Breach,Raze,Viper,Omen,Fade"
Split,Hero Base,XLD Gaming,13,2,10,2,0,3,"Breach,Raze,Viper,Omen,Skye","Viper,Jett,Astra,Fade,Gekko"
Bind,KRÜ BLAZE,ONA Family,4,13,3,9,4,1,"Raze,Viper,Brimstone,Skye,Gekko","Raze,Viper,Brimstone,Skye,Chamber"
Ascent,Dasein Club GC,Deagle Ravagers,9,13,6,6,7,3,"Sova,Killjoy,Omen,Jett,KAY/O","Sova,Killjoy,Omen,Jett,KAY/O"
Ascent,YFP Gaming,QoR,7,13,2,6,7,5,"Sova,Killjoy,Omen,Jett,KAY/O","Sova,Killjoy,Omen,Jett,KAY/O"
Breeze,U4RIA Magnolia,Psycho Cats,9,13,4,8,5,5,"Cypher,Sova,Viper,Jett,Yoru","Sova,Viper,Reyna,Jett,Chamber"
Split,9z Team,All Knights,9,13,4,8,5,5,"Breach,Raze,Viper,Omen,Skye","Raze,Killjoy,Viper,Skye,Astra"
Ascent,Cumberland Academy,Farmingdale State College,10,13,3,8,5,7,"Sova,Killjoy,Omen,Jett,KAY/O","Sova,Killjoy,Omen,Jett,KAY/O"
Split,Twisted Minds Esports,Vision Esports,13,4,9,3,1,4,"Raze,Viper,Omen,Yoru,Fade","Breach,Raze,Cypher,Omen,Jett"
Bind,Alliance Angels,Harmony Opal,13,10,10,2,8,3,"Raze,Viper,Brimstone,Skye,Chamber","Raze,Viper,Brimstone,Skye,Gekko"
Lotus,Hyperion Gold,Miami Varsity Red,13,10,8,3,7,5,"Raze,Killjoy,Viper,Omen,Gekko","Killjoy,Viper,Omen,Jett,Skye"
Ascent,BlanK,hazzys puggers,12,14,6,7,7,6,"Sova,Killjoy,Omen,Jett,KAY/O","Sova,Killjoy,Omen,Jett,KAY/O"
Bind,Purpose Gaming,Big Brim Gamers,4,13,3,9,4,1,"Raze,Viper,Brimstone,Skye,Yoru","Raze,Viper,Brimstone,Skye,Gekko"
Ascent,Team Infinity,YBB,0,13,0,1,12,0,"Raze,Sova,Killjoy,Omen,KAY/O","Breach,Sova,Omen,Jett,Yoru"
Ascent,KRÜ BLAZE,ONA Family,4,13,3,9,4,1,"Sova,Killjoy,Omen,Jett,KAY/O","Sova,Killjoy,Omen,Jett,KAY/O"
Ascent,MSU White,BOMB IMPOUNDMENT SQUADRON,13,2,3,0,2,10,"Raze,Sova,Viper,Omen,Gekko","Sova,Killjoy,Omen,Jett,KAY/O"
Ascent,Luminescent Sapphire,pugstars,13,7,10,2,5,3,"Cypher,Sova,Omen,Jett,KAY/O","Sova,Killjoy,Omen,Jett,KAY/O"
Sunset,Arctic Ace,Predator X Gaming,5,13,2,4,9,3,"Cypher,Sova,Jett,Gekko,Clove","Breach,Cypher,Sova,Jett,Clove"
Bind,yeahglo,Also Amphibium,6,13,3,4,9,3,"Breach,Raze,Cypher,Reyna,Omen","Raze,Viper,Brimstone,Skye,Yoru"
Split,Border Monsters Chile,UNLP Esports,4,13,2,3,10,2,"Raze,Viper,Omen,Skye,Deadlock","Raze,Viper,Omen,Jett,Skye"
Sunset,U4RIA Magnolia,Psycho Cats,13,3,10,2,1,3,"Breach,Raze,Cypher,Omen,Fade","Breach,Raze,Cypher,Sova,Omen"
Bind,Cumberland Academy,Farmingdale State College,13,8,8,4,4,5,"Raze,Cypher,Viper,Brimstone,Skye","Raze,Cypher,Viper,Brimstone,Skye"
Lotus,STARFIRE,Tenax GC,8,13,5,7,6,3,"Breach,Raze,Sova,Killjoy,Omen","Raze,Killjoy,Omen,Skye,Gekko"
Sunset,Dasein Club GC,Deagle Ravagers,10,13,7,4,9,3,"Breach,Raze,Cypher,Sova,Omen","Breach,Raze,Cypher,Omen,Fade"
Bind,9z Team,All Knights,13,7,7,1,6,6,"Raze,Sova,Viper,Brimstone,KAY/O","Breach,Raze,Astra,KAY/O,Chamber"
Lotus,Bumble Bees,Kinetic GC,4,13,3,9,4,1,"Raze,Killjoy,Viper,Omen,Fade","Raze,Killjoy,Viper,Omen,Fade"
Icebox,Prospects Amethyst,SRVR x PERLAS,13,7,6,2,5,7,"Killjoy,Viper,Harbor,Gekko,Deadlock","Sova,Killjoy,Viper,Reyna,Jett"
Bind,42C Crayola Pack,FlyQuest RED,4,13,3,9,4,1,"Raze,Viper,Brimstone,Skye,Gekko","Raze,Viper,Brimstone,Skye,Yoru"
Bind,Stellae Gaming,Galorys,9,13,4,8,5,5,"Raze,Viper,Brimstone,Sage,Skye","Raze,Viper,Brimstone,Skye,Chamber"
Icebox,Labyrinth White,RyZe Eclipsa GC,3,13,1,11,2,2,"Sova,Killjoy,Viper,Jett,Harbor","Sova,Killjoy,Viper,Jett,Deadlock"
Icebox,minions united GC,Infinity X,8,13,3,9,4,5,"Sova,Killjoy,Viper,Jett,KAY/O","Sova,Killjoy,Viper,Jett,Gekko"
Lotus,Alliance Angels,Harmony Opal,8,13,5,4,9,3,"Raze,Killjoy,Viper,Omen,Skye","Raze,Killjoy,Viper,Omen,Gekko"
Sunset,Reformed GC,Kryptic GC,13,4,5,0,4,8,"Breach,Raze,Cypher,KAY/O,Harbor","Raze,Cypher,Omen,Skye,Astra"
Ascent,RED Canids,TBK Esports,6,13,5,7,6,1,"Sova,Killjoy,Omen,Jett,KAY/O","Sova,Killjoy,Omen,Jett,KAY/O"
Split,Catnappers,Cafe Coke,5,13,0,6,7,5,"Raze,Cypher,Viper,Omen,Skye","Breach,Raze,Cypher,Omen,Skye"
Bind,Thinking Men,Moist x Shopify,10,13,5,6,7,5,"Raze,Viper,Brimstone,Skye,Yoru","Raze,Viper,Brimstone,Skye,Gekko"
Lotus,Passion Project,Take Back Control,13,3,10,2,1,3,"Raze,Killjoy,Reyna,Omen,Gekko","Breach,Raze,Cypher,Omen,Gekko"
Ascent,Bumble Bees,Kinetic GC,6,13,1,6,7,5,"Sova,Killjoy,Omen,Jett,KAY/O","Raze,Sova,Killjoy,Omen,KAY/O"
Split,42C Crayola Pack,FlyQuest RED,3,13,3,9,4,0,"Breach,Raze,Viper,Omen,Skye","Raze,Cypher,Viper,Omen,Skye"
Bind,Prospects Amethyst,SRVR x PERLAS,13,4,5,0,4,8,"Raze,Viper,Brimstone,Skye,Gekko","Raze,Cypher,Brimstone,Reyna,Skye"
Split,STARFIRE,Tenax GC,10,13,6,6,7,4,"Raze,Cypher,Viper,Omen,Skye","Raze,Cypher,Viper,Omen,Skye"
Ascent,U4RIA Magnolia,Psycho Cats,12,14,6,7,7,6,"Sova,Killjoy,Omen,Jett,KAY/O","Sova,Killjoy,Omen,Jett,KAY/O"
Bind,Passion Project,Take Back Control,13,2,11,1,1,2,"Raze,Brimstone,Yoru,Harbor,Gekko","Raze,Viper,Brimstone,Skye,Yoru"
Breeze,9z Team,All Knights,13,7,4,4,3,9,"Cypher,Sova,Viper,Jett,KAY/O","Cypher,Sova,Viper,Jett,KAY/O"
Sunset,Alliance Angels,Harmony Opal,13,8,7,5,3,6,"Raze,Cypher,Viper,Omen,Gekko","Breach,Raze,Cypher,Omen,Fade"
Lotus,Catnappers,Cafe Coke,1,13,0,2,11,1,"Raze,Killjoy,Viper,Omen,Fade","Raze,Killjoy,Viper,Omen,Fade"
Bind,minions united GC,Infinity X,7,13,4,4,9,3,"Breach,Raze,Cypher,Brimstone,Skye","Raze,Viper,Brimstone,Skye,Gekko"
Bind,Labyrinth White,RyZe Eclipsa GC,5,13,3,9,4,2,"Raze,Cypher,Viper,Brimstone,Skye","Breach,Raze,Viper,Brimstone,Fade"
Breeze,Reformed GC,Kryptic GC,13,9,6,6,3,7,"Cypher,Sova,Viper,Jett,KAY/O","Cypher,Viper,Jett,Skye,Astra"
Lotus,RED Canids,TBK Esports,13,5,5,1,4,8,"Raze,Killjoy,Viper,Omen,Skye","Raze,Killjoy,Viper,Omen,Skye"
Lotus,Stellae Gaming,Galorys,13,8,8,1,7,5,"Raze,Killjoy,Viper,Omen,Fade","Raze,Killjoy,Viper,Omen,Fade"
Breeze,Thinking Men,Moist x Shopify,5,13,3,9,4,2,"Cypher,Sova,Viper,Jett,KAY/O","Cypher,Sova,Viper,Jett,KAY/O"
Sunset,Underground Gaming,Onyx Ravens,11,13,4,8,5,7,"Breach,Raze,Cypher,Omen,Fade","Breach,Raze,Cypher,Omen,Fade"
Split,Thinking Men,Moist x Shopify,13,3,4,0,3,9,"Raze,Cypher,Viper,Omen,Skye","Raze,Cypher,Viper,Skye,Astra"
Icebox,9z Team,All Knights,11,13,4,8,5,7,"Sova,Killjoy,Viper,Sage,Jett","Sova,Killjoy,Viper,Jett,Harbor"
Icebox,Stellae Gaming,Galorys,6,13,2,5,8,4,"Breach,Sova,Killjoy,Viper,Phoenix","Sova,Killjoy,Viper,Sage,Jett"
Bind,RED Canids,TBK Esports,7,13,4,4,9,3,"Raze,Cypher,Viper,Brimstone,Skye","Raze,Viper,Brimstone,Sage,Skye"
Breeze,eQuizers,Team Galaga,13,11,5,7,4,8,"Sova,Viper,Jett,KAY/O,Iso","Cypher,Sova,Viper,Jett,Skye"
Lotus,Underground Gaming,Onyx Ravens,14,12,9,4,8,5,"Raze,Viper,Omen,Chamber,Fade","Breach,Raze,Cypher,Omen,Gekko"
Bind,GMBLERS Esports,TwentyStars,13,9,6,4,5,7,"Breach,Raze,Viper,Brimstone,Gekko","Raze,Viper,Brimstone,Yoru,Fade"
Lotus,eQuizers,Team Galaga,13,7,3,5,2,10,"Raze,Killjoy,Viper,Omen,Fade","Breach,Cypher,Omen,Skye,Neon"
Ascent,KOI,Team Liquid,7,13,3,5,8,4,"Cypher,Sova,Omen,Jett,KAY/O","Cypher,Sova,Viper,Omen,Yoru"
Breeze,IRON COMPANY,MÄNNER WIE WIR,11,13,3,9,4,8,"Cypher,Sova,Viper,Jett,Yoru","Cypher,Sova,Jett,Yoru,Chamber"
Ascent,GMBLERS Esports,TwentyStars,13,9,8,4,5,5,"Sova,Killjoy,Omen,Jett,KAY/O","Sova,Killjoy,Omen,Jett,KAY/O"
Icebox,eQuizers,Team Galaga,10,13,7,5,8,3,"Killjoy,Viper,Jett,KAY/O,Gekko","Sova,Killjoy,Viper,Sage,Jett"
Lotus,IRON COMPANY,MÄNNER WIE WIR,7,13,4,4,9,3,"Raze,Viper,Omen,Chamber,Fade","Raze,Killjoy,Omen,Neon,Gekko"
Split,KOI,Team Liquid,9,13,8,4,9,1,"Breach,Raze,Viper,Omen,Fade","Raze,Cypher,Viper,Omen,Skye"
Ascent,SZK Esports,Falke Esports,11,13,6,6,7,5,"Breach,Omen,Yoru,Chamber,Fade","Sova,Killjoy,Omen,Jett,KAY/O"
Sunset,Karmine Corp,GIANTX,13,9,6,6,3,7,"Raze,Cypher,Omen,KAY/O,Gekko","Breach,Raze,Cypher,Sova,Omen"
Bind,SZK Esports,Falke Esports,9,13,5,5,8,4,"Raze,Cypher,Viper,Brimstone,Skye","Sova,Viper,Omen,KAY/O,Neon"
Breeze,Karmine Corp,GIANTX,13,4,4,1,3,9,"Cypher,Sova,Viper,Jett,KAY/O","Cypher,Sova,Viper,Jett,Yoru"
Lotus,AURA DIFFERENTIAL,RIMA GC,13,0,12,0,0,1,"Raze,Killjoy,Viper,Omen,Skye","Raze,Killjoy,Viper,Omen,Fade"
Lotus,Carnival Gaming,Revenant Esports,10,13,5,6,7,5,"Breach,Raze,Viper,Omen,Fade","Raze,Killjoy,Viper,Omen,Fade"
Bind,Oblivion Force,PAPA ESPORTS,13,8,7,5,3,6,"Raze,Viper,Brimstone,Skye,Gekko","Raze,Brimstone,Jett,Skye,Chamber"
Bind,AURA DIFFERENTIAL,RIMA GC,7,13,6,6,7,1,"Raze,Viper,Brimstone,Skye,Yoru","Breach,Cypher,Brimstone,Yoru,Gekko"
Breeze,Carnival Gaming,Revenant Esports,0,13,0,12,1,0,"Sova,Viper,Omen,Yoru,KAY/O","Cypher,Sova,Viper,Jett,KAY/O"
Lotus,Oblivion Force,PAPA ESPORTS,13,5,4,2,3,9,"Raze,Killjoy,Viper,Omen,Fade","Breach,Raze,Killjoy,Omen,Jett"
Sunset,Team IAM,SLT Seongam,10,13,7,5,8,3,"Raze,Cypher,Phoenix,Omen,Skye","Breach,Raze,Cypher,Sova,Omen"
Breeze,AURA DIFFERENTIAL,RIMA GC,13,11,5,7,4,8,"Cypher,Sova,Viper,Reyna,Jett","Cypher,Sova,Viper,Jett,KAY/O"
Ascent,Oblivion Force,PAPA ESPORTS,13,4,2,3,1,11,"Sova,Killjoy,Omen,Jett,KAY/O","Sova,Killjoy,Omen,Jett,KAY/O"
Lotus,Team IAM,SLT Seongam,5,13,4,8,5,1,"Raze,Killjoy,Omen,Astra,Fade","Breach,Raze,Killjoy,Omen,Gekko"
Icebox,Orangutan,Medal Esports,15,17,6,10,7,9,"Sova,Killjoy,Viper,Jett,Harbor","Sova,Killjoy,Viper,Jett,Harbor"
Ascent,Xipto Esports,BOBA,13,9,5,7,2,8,"Raze,Viper,Reyna,Skye,Harbor","Sova,Killjoy,Omen,Jett,KAY/O"
Lotus,Orangutan,Medal Esports,11,13,4,8,5,7,"Breach,Raze,Sova,Killjoy,Omen","Breach,Raze,Sova,Killjoy,Omen"
Ascent,Dplus Esports,SHERPA,13,7,7,5,2,6,"Sova,Killjoy,Omen,Jett,KAY/O","Killjoy,Omen,Jett,KAY/O,Gekko"
Sunset,Xipto Esports,BOBA,13,8,4,5,3,9,"Viper,Sage,Omen,KAY/O,Gekko","Breach,Raze,Cypher,Sova,Omen"
Icebox,Dplus Esports,SHERPA,13,3,9,3,0,4,"Killjoy,Viper,Jett,KAY/O,Gekko","Sova,Killjoy,Viper,Jett,Harbor"
Breeze,Ragnus Esports,New Combat Line GC,13,6,9,3,3,4,"Cypher,Viper,Skye,Yoru,KAY/O","Cypher,Sova,Viper,Jett,Chamber"
Bind,Idaho Vandals JV,Gallaudet University,5,13,1,5,8,4,"Raze,Cypher,Viper,Brimstone,Skye","Cypher,Viper,Brimstone,Yoru,Fade"
Ascent,Catholic University,IONA White,13,9,4,8,1,9,"Breach,Raze,Sova,Killjoy,Omen","Raze,Killjoy,Brimstone,Sage,Neon"
Split,KU Esports,Wichita State Esports,13,15,4,10,5,9,"Breach,Raze,Cypher,Omen,Skye","Breach,Raze,Viper,Omen,Skye"
Split,ASTANE GC,Infinity X,11,13,3,9,4,8,"Raze,Cypher,Viper,Omen,Skye","Raze,Cypher,Viper,Skye,Astra"
Icebox,Ragnus Esports,New Combat Line GC,13,6,9,3,3,4,"Viper,Jett,Skye,Harbor,Gekko","Sova,Killjoy,Viper,Jett,Gekko"
Split,Idaho Vandals JV,Gallaudet University,14,16,7,8,8,7,"Raze,Cypher,Viper,Omen,Skye","Breach,Cypher,Omen,Yoru,KAY/O"
Bind,XSOUL,Rebirth Esports,7,13,5,7,6,2,"Raze,Viper,Brimstone,Reyna,Gekko","Breach,Raze,Cypher,Omen,KAY/O"
Split,Catholic University,IONA White,13,8,4,5,3,9,"Raze,Killjoy,Viper,Omen,KAY/O","Raze,Killjoy,Reyna,Omen,Skye"
Ascent,Skyline Dreamers GC,FlyQuest RED,0,13,0,12,1,0,"Sova,Killjoy,Omen,Jett,KAY/O","Sova,Killjoy,Omen,Jett,KAY/O"
Ascent,KU Esports,Wichita State Esports,9,13,5,5,8,4,"Sova,Killjoy,Omen,Jett,KAY/O","Sova,Killjoy,Omen,Jett,KAY/O"
Ascent,NEIT Tigers White,Adrian Esports,13,10,5,7,3,8,"Sova,Killjoy,Omen,Jett,Gekko","Sova,Killjoy,Omen,Jett,KAY/O"
Ascent,University At Albany B,RPI White,13,15,6,8,7,7,"Raze,Sova,Killjoy,Omen,Skye","Cypher,Sova,Omen,Jett,KAY/O"
Ascent,ASTANE GC,Infinity X,10,13,3,9,4,7,"Cypher,Sova,Omen,Jett,KAY/O","Cypher,Viper,Omen,Jett,KAY/O"
Bind,Synergy GC,Kinetic GC,3,13,3,9,4,0,"Raze,Cypher,Viper,Brimstone,Skye","Raze,Viper,Brimstone,Skye,Chamber"
Lotus,Ragnus Esports,New Combat Line GC,6,13,4,8,5,2,"Breach,Raze,Cypher,Phoenix,Omen","Breach,Raze,Killjoy,Viper,Omen"
Sunset,Catholic University,IONA White,6,13,6,6,7,0,"Breach,Raze,Killjoy,Omen,Gekko","Brimstone,Sage,Reyna,Omen,Neon"
Ascent,Brewton Parker College,Conestoga Condors,13,4,5,0,4,8,"Killjoy,Viper,Omen,Jett,Skye","Sova,Killjoy,Omen,Jett,KAY/O"
Bind,University of Idaho,Mountain Cat Esports,13,10,6,5,5,7,"Raze,Viper,Brimstone,Skye,Yoru","Raze,Cypher,Viper,Brimstone,Gekko"
Sunset,Van Lyn Frost,SRVR x PERLAS,13,3,9,3,0,4,"Breach,Raze,Cypher,Omen,Gekko","Breach,Raze,Cypher,Omen,Gekko"
Icebox,XSOUL,Rebirth Esports,15,13,8,6,7,7,"Sova,Sage,Reyna,Jett,Harbor","Viper,Reyna,Omen,Jett,Gekko"
Split,WIU Gold,Trine University JV,13,4,8,4,0,5,"Breach,Cypher,Omen,Jett,Skye","Killjoy,Phoenix,Brimstone,Skye,Deadlock"
Split,Columbia College,Fisher Rising,13,10,7,4,6,6,"Cypher,Viper,Omen,Jett,Skye","Raze,Cypher,Viper,Omen,Skye"
Lotus,Radford University,UMW Navy,13,4,3,2,2,10,"Raze,Killjoy,Viper,Omen,Fade","Raze,Viper,Omen,Skye,Chamber"
Bind,Ohio Northern University JV,SUNY POLY A,13,6,5,2,4,8,"Raze,Cypher,Viper,Brimstone,Skye","Cypher,Omen,Jett,Fade,Gekko"
Ascent,Trine University,CATU Val,13,0,1,0,0,12,"Cypher,Sova,Phoenix,Omen,Jett","Killjoy,Phoenix,Omen,Jett,Gekko"
Breeze,NEIT Tigers White,Adrian Esports,4,13,2,10,3,2,"Cypher,Sova,Viper,Jett,Skye","Cypher,Sova,Viper,Jett,KAY/O"
Bind,Randolph-Macon College,Sacred Heart University,13,3,1,3,0,12,"Raze,Viper,Brimstone,Skye,Yoru","Raze,Cypher,Viper,Brimstone,Skye"
Sunset,Synergy GC,Kinetic GC,0,13,0,12,1,0,"Breach,Raze,Cypher,Omen,Gekko","Raze,Cypher,Omen,KAY/O,Gekko"
Ascent,Loafing Cats,Kryptic GC,13,6,6,1,5,7,"Sova,Killjoy,Omen,Jett,KAY/O","Sova,Killjoy,Omen,Jett,KAY/O"
Ascent,Potomac State College,University of Delaware Sphinx,13,5,9,3,2,4,"Sova,Killjoy,Omen,Jett,KAY/O","Sova,Killjoy,Omen,Jett,KAY/O"
Split,Skyline Dreamers GC,FlyQuest RED,11,13,5,7,6,6,"Raze,Cypher,Viper,Omen,Skye","Raze,Cypher,Viper,Omen,Skye"
Ascent,Idaho Vandals JV,Gallaudet University,19,17,10,8,9,9,"Breach,Killjoy,Phoenix,Reyna,Omen","Killjoy,Omen,Jett,KAY/O,Fade"
Sunset,SaD FROST,Cafe Coke,10,13,5,6,7,5,"Raze,Viper,Omen,KAY/O,Gekko","Raze,Cypher,Sova,Viper,Omen"
Lotus,ASTANE GC,Infinity X,13,7,6,2,5,7,"Raze,Killjoy,Viper,Omen,Skye","Raze,Killjoy,Omen,Fade,Deadlock"
Split,Brewton Parker College,Conestoga Condors,13,3,9,3,0,4,"Breach,Raze,Cypher,Omen,Skye","Breach,Raze,Cypher,Omen,Skye"
Ascent,University of Idaho,Mountain Cat Esports,13,4,10,2,2,3,"Sova,Killjoy,Omen,Jett,KAY/O","Sova,Killjoy,Omen,Jett,KAY/O"
Breeze,Catholic University,IONA White,13,3,3,1,2,10,"Killjoy,Viper,Reyna,KAY/O,Harbor","Viper,Sage,Jett,Chamber,Neon"
Ascent,SJF Valorant Red,UM-FLINT,13,7,6,2,5,7,"Sova,Killjoy,Omen,Jett,KAY/O","Cypher,Sova,Omen,Jett,KAY/O"
Lotus,Ohio Northern University JV,SUNY POLY A,13,5,9,3,2,4,"Breach,Raze,Killjoy,Omen,Gekko","Cypher,Omen,Jett,Fade,Gekko"
Bind,University At Albany B,RPI White,14,16,8,7,9,6,"Raze,Killjoy,Viper,Brimstone,Skye","Raze,Cypher,Viper,Brimstone,Gekko"
Lotus,Randolph-Macon College,Sacred Heart University,13,2,3,0,2,10,"Raze,Killjoy,Viper,Omen,Fade","Breach,Raze,Cypher,Omen,Fade"
Lotus,Van Lyn Frost,SRVR x PERLAS,13,7,8,4,3,5,"Raze,Killjoy,Viper,Omen,Skye","Raze,Killjoy,Viper,Omen,Fade"
Icebox,KU Esports,Wichita State Esports,17,15,11,5,10,6,"Sova,Killjoy,Viper,KAY/O,Harbor","Sova,Killjoy,Viper,Jett,Harbor"
Sunset,Columbia College,Fisher Rising,13,5,4,2,3,9,"Breach,Raze,Cypher,Sova,Omen","Raze,Cypher,Sova,Omen,KAY/O"
Split,Potomac State College,University of Delaware Sphinx,13,0,12,0,0,1,"Raze,Cypher,Viper,Omen,Skye","Breach,Raze,Killjoy,Omen,Skye"
Split,Radford University,UMW Navy,13,5,4,2,3,9,"Raze,Cypher,Viper,Omen,Skye","Raze,Cypher,Viper,Omen,KAY/O"
Lotus,NEIT Tigers White,Adrian Esports,13,7,6,2,5,7,"Raze,Sova,Killjoy,Omen,Gekko","Raze,Killjoy,Omen,Skye,KAY/O"
Split,Trine University,CATU Val,13,4,11,1,3,2,"Cypher,Phoenix,Omen,Jett,Gekko","Raze,Killjoy,Sage,Omen,Gekko"
Ascent,Tiffin University JV,SJU Crimson,13,4,2,3,1,11,"Killjoy,Omen,Jett,KAY/O,Iso","Sova,Killjoy,Reyna,Omen,KAY/O"
Lotus,WIU Gold,Trine University JV,13,11,6,6,5,7,"Raze,Killjoy,Omen,Skye,Iso","Killjoy,Brimstone,Reyna,KAY/O,Deadlock"
Sunset,Loafing Cats,Kryptic GC,5,13,4,2,11,1,"Breach,Raze,Cypher,Sova,Omen","Raze,Cypher,Omen,Skye,Astra"
Ascent,OXEN BULL BEATS,Cruzados Esports,10,13,0,11,2,10,"Sova,Killjoy,Omen,Jett,KAY/O","Sova,Killjoy,Omen,Jett,KAY/O"
Bind,friends GC,626,13,0,1,0,0,12,"Raze,Viper,Brimstone,Skye,Yoru","Raze,Cypher,Viper,Brimstone,Skye"
Lotus,SJF Valorant Red,UM-FLINT,4,13,3,9,4,1,"Breach,Killjoy,Omen,Neon,Gekko","Breach,Raze,Cypher,Omen,Skye"
Split,SaD FROST,Cafe Coke,5,13,2,4,9,3,"Raze,Cypher,Viper,Omen,Skye","Breach,Raze,Cypher,Omen,Skye"
Lotus,Bumble Bees,Synergy GC,13,6,4,3,3,9,"Raze,Killjoy,Viper,Omen,Fade","Raze,Killjoy,Viper,Omen,Skye"
Icebox,C4C Flare,Take Back Control,13,8,7,5,3,6,"Sova,Killjoy,Viper,Reyna,Gekko","Raze,Sova,Viper,Omen,Gekko"
Sunset,42C Crayola Pack,Skyline Dreamers GC,13,10,5,7,3,8,"Raze,Cypher,Omen,KAY/O,Gekko","Raze,Cypher,Omen,KAY/O,Gekko"
Ascent,Equinox GC,Tenax GC,13,2,10,2,0,3,"Sova,Killjoy,Omen,Jett,KAY/O","Sova,Killjoy,Omen,Jett,KAY/O"
Bind,TBS GC,Team Leveling,13,11,7,5,6,6,"Raze,Viper,Brimstone,Skye,Yoru","Raze,Viper,Brimstone,Fade,Gekko"
Ascent,Prospects Amethyst,Van Lyn Frost,13,4,10,2,2,3,"Sova,Killjoy,Omen,Jett,Gekko","Sova,Killjoy,Omen,Jett,KAY/O"
Bind,Teddy Tactics,Psycho Cats,13,11,8,4,7,5,"Raze,Viper,Brimstone,KAY/O,Gekko","Raze,Cypher,Viper,Brimstone,Skye"
Bind,OKAY,Harmony Opal,13,7,11,1,6,2,"Raze,Cypher,Viper,Brimstone,Skye","Raze,Cypher,Brimstone,Skye,Gekko"
Bind,Tiffin University JV,SJU Crimson,13,10,7,5,5,6,"Raze,Cypher,Brimstone,Skye,Deadlock","Raze,Cypher,Brimstone,Skye,KAY/O"
Bind,OXEN BULL BEATS,Cruzados Esports,13,7,7,5,2,6,"Raze,Viper,Brimstone,Skye,Gekko","Raze,Cypher,Brimstone,Reyna,Fade"
Icebox,SJF Valorant Red,UM-FLINT,13,4,9,3,1,4,"Sova,Killjoy,Viper,Omen,Jett","Sova,Viper,Jett,Chamber,Gekko"
Sunset,minions united GC,ASTANE GC,13,11,7,5,6,6,"Breach,Raze,Cypher,Sova,Omen","Breach,Raze,Cypher,Omen,Fade"
Lotus,friends GC,626,13,6,9,3,3,4,"Raze,Cypher,Omen,KAY/O,Gekko","Breach,Raze,Killjoy,Astra,Fade"
Lotus,Loafing Cats,Kryptic GC,13,8,10,2,6,3,"Breach,Raze,Cypher,Omen,Gekko","Raze,Sova,Killjoy,Omen,KAY/O"
Ascent,Deagle Ravagers,Bellakitas,13,10,6,5,5,7,"Sova,Killjoy,Omen,Jett,KAY/O","Raze,Cypher,Reyna,Omen,Gekko"
Bind,Supernova x Pals,RyZe Eclipsa GC,13,1,1,1,0,12,"Raze,Viper,Brimstone,Skye,Gekko","Breach,Raze,Viper,Brimstone,Fade"
Lotus,Catnappers,SaD FROST,3,13,2,2,11,1,"Raze,Cypher,Viper,Omen,Fade","Raze,Killjoy,Omen,KAY/O,Gekko"
Ascent,OKAY,Harmony Opal,13,1,2,0,1,11,"Sova,Killjoy,Omen,Jett,KAY/O","Sova,Killjoy,Omen,Jett,KAY/O"
Bind,Equinox GC,Tenax GC,13,9,6,4,5,7,"Viper,Brimstone,Reyna,Skye,Yoru","Raze,Viper,Brimstone,Skye,Gekko"
Ascent,Teddy Tactics,Psycho Cats,13,3,4,0,3,9,"Sova,Killjoy,Omen,Jett,KAY/O","Sova,Killjoy,Omen,Jett,KAY/O"
Breeze,C4C Flare,Take Back Control,13,11,6,6,5,7,"Cypher,Sova,Viper,Jett,KAY/O","Cypher,Sova,Viper,Jett,Yoru"
Ascent,Bumble Bees,Synergy GC,10,13,6,6,7,4,"Sova,Killjoy,Omen,Jett,KAY/O","Sova,Killjoy,Omen,Jett,KAY/O"
Lotus,Supernova x Pals,RyZe Eclipsa GC,13,3,3,1,2,10,"Raze,Killjoy,Viper,Omen,Fade","Breach,Raze,Killjoy,Omen,Gekko"
Lotus,42C Crayola Pack,Skyline Dreamers GC,13,15,5,9,6,8,"Breach,Raze,Cypher,Omen,Gekko","Raze,Killjoy,Viper,Omen,Skye"
Breeze,TBS GC,Team Leveling,13,11,6,6,5,7,"Cypher,Sova,Viper,Jett,Yoru","Cypher,Sova,Viper,Jett,Yoru"
Icebox,Prospects Amethyst,Van Lyn Frost,13,11,9,3,8,4,"Killjoy,Viper,Harbor,Gekko,Deadlock","Killjoy,Viper,Jett,KAY/O,Gekko"
Bind,Catnappers,SaD FROST,2,13,2,10,3,0,"Raze,Viper,Skye,Astra,Gekko","Viper,Brimstone,Jett,Skye,Gekko"
Sunset,Deagle Ravagers,Bellakitas,13,7,6,6,1,7,"Breach,Raze,Cypher,Omen,Fade","Breach,Raze,Cypher,Omen,Fade"
Icebox,LOUD GC,DreamMax GC,13,5,5,1,4,8,"Sova,Killjoy,Viper,Jett,Harbor","Sova,Killjoy,Viper,Jett,Harbor"
Lotus,All Knights,Furious Gaming,13,5,4,2,3,9,"Raze,Killjoy,Viper,Omen,Fade","Raze,Killjoy,Viper,Omen,Fade"
Lotus,minions united GC,ASTANE GC,13,10,7,4,6,6,"Breach,Raze,Killjoy,Omen,Gekko","Raze,Killjoy,Viper,Omen,Skye"
Sunset,Reformed GC,Loafing Cats,13,2,3,0,2,10,"Breach,Raze,Cypher,KAY/O,Harbor","Breach,Raze,Cypher,Sova,Omen"
Ascent,Team Liquid Brazil,RENEGADAS,13,3,9,3,0,4,"Sova,Killjoy,Omen,Jett,KAY/O","Raze,Viper,Omen,Fade,Gekko"
Lotus,MIBR GC,REVOADA,13,3,3,1,2,10,"Raze,Killjoy,Viper,Omen,Fade","Raze,Killjoy,Viper,Omen,Skye"
Ascent,mesos millionaires,friends GC,11,13,4,8,5,7,"Sova,Killjoy,Omen,Jett,KAY/O","Sova,Killjoy,Omen,Jett,KAY/O"
Icebox,U4RIA Magnolia,Teddy Tactics,1,13,1,11,2,0,"Sova,Killjoy,Viper,Sage,Reyna","Sova,Killjoy,Viper,Jett,Harbor"
Split,Alliance Angels,OKAY,2,13,2,10,3,0,"Raze,Cypher,Viper,Omen,Skye","Raze,Cypher,Viper,Omen,Skye"
Sunset,Passion Project,C4C Flare,13,4,3,2,2,10,"Phoenix,Sage,Reyna,Omen,Gekko","Breach,Raze,Cypher,Omen,Fade"
Ascent,STARFIRE,Equinox GC,4,13,1,4,9,3,"Sova,Killjoy,Omen,Jett,KAY/O","Sova,Killjoy,Omen,Jett,KAY/O"
Breeze,Labyrinth White,Supernova x Pals,1,13,1,11,2,0,"Cypher,Sova,Viper,Jett,KAY/O","Cypher,Sova,Viper,Jett,KAY/O"
Ascent,42C Crayola Pack,Skyline Dreamers GC,13,6,10,2,4,3,"Sova,Killjoy,Omen,Jett,KAY/O","Sova,Killjoy,Omen,Jett,KAY/O"
Breeze,LOUD GC,DreamMax GC,13,3,9,3,0,4,"Cypher,Sova,Viper,Jett,KAY/O","Cypher,Sova,Viper,Jett,KAY/O"
Sunset,TBS GC,Team Leveling,6,13,2,5,8,4,"Cypher,Sova,Omen,Neon,Gekko","Breach,Raze,Cypher,Omen,Fade"
Ascent,MIBR GC,REVOADA,13,3,4,0,3,9,"Sova,Killjoy,Omen,Jett,KAY/O","Sova,Killjoy,Omen,Jett,KAY/O"
Icebox,Team Liquid Brazil,RENEGADAS,13,5,8,4,1,5,"Killjoy,Viper,KAY/O,Harbor,Gekko","Sova,Killjoy,Viper,Reyna,Harbor"
Sunset,Prospects Amethyst,Van Lyn Frost,7,13,3,9,4,4,"Breach,Raze,Cypher,Omen,Gekko","Breach,Raze,Cypher,Omen,Gekko"
Bind,Bumble Bees,Synergy GC,13,10,7,5,5,6,"Raze,Viper,Brimstone,Skye,Yoru","Raze,Cypher,Viper,Brimstone,Skye"
Split,All Knights,Furious Gaming,13,4,2,3,1,11,"Raze,Killjoy,Viper,Skye,Astra","Raze,Viper,Jett,Skye,Astra"
Sunset,Catnappers,SaD FROST,13,9,7,3,6,6,"Viper,Sage,Omen,KAY/O,Gekko","Raze,Viper,Omen,KAY/O,Gekko"
Lotus,STARFIRE,Equinox GC,1,13,0,2,11,1,"Breach,Raze,Sova,Killjoy,Omen","Raze,Cypher,Omen,Jett,Skye"
Lotus,Reformed GC,Loafing Cats,13,6,9,3,3,4,"Raze,Killjoy,Viper,Omen,Gekko","Breach,Raze,Cypher,Omen,Gekko"
Split,minions united GC,ASTANE GC,7,13,6,6,7,1,"Breach,Raze,Cypher,Omen,Skye","Raze,Cypher,Viper,Omen,Skye"
Split,Passion Project,C4C Flare,13,3,10,2,1,3,"Raze,Cypher,Skye,Yoru,Astra","Raze,Killjoy,Sage,Omen,Gekko"
Lotus,U4RIA Magnolia,Teddy Tactics,5,13,3,9,4,2,"Raze,Killjoy,Viper,Omen,Fade","Killjoy,Viper,Omen,Neon,Gekko"
Sunset,Alliance Angels,OKAY,4,13,3,9,4,1,"Raze,Cypher,Viper,Omen,Gekko","Raze,Cypher,Sova,Viper,Omen"
Lotus,mesos millionaires,friends GC,7,13,7,5,8,0,"Breach,Raze,Killjoy,Omen,Gekko","Raze,Cypher,Omen,KAY/O,Gekko"
Lotus,Labyrinth White,Supernova x Pals,4,13,3,9,4,1,"Raze,Killjoy,Viper,Omen,Skye","Raze,Killjoy,Viper,Omen,Fade"
Sunset,All Knights,Furious Gaming,13,8,7,5,3,6,"Raze,Cypher,Viper,Omen,Fade","Raze,Viper,Omen,Skye,Chamber"
Sunset,A One Man Army,Esports Team Twente,13,9,3,7,2,10,"Raze,Cypher,Omen,KAY/O,Gekko","Raze,Omen,Jett,Gekko,Deadlock"
Bind,404 Multigaming,DREAMED WORLD,13,11,9,3,8,4,"Raze,Cypher,Viper,Brimstone,Skye","Raze,Viper,Brimstone,Yoru,Fade"
Lotus,Dortmund Esports,MÄNNER WIE WIR,13,11,8,4,7,5,"Raze,Viper,Yoru,Harbor,Gekko","Raze,Killjoy,Omen,Neon,Gekko"
Breeze,IRREGULARS,Permitta Unicorns,13,15,3,11,4,10,"Cypher,Sova,Viper,Reyna,Jett","Cypher,Sova,Viper,Reyna,Jett"
Bind,Royal Family eSports,BLX CORP X BCG,13,11,8,4,7,5,"Raze,Viper,Brimstone,Skye,Gekko","Raze,Brimstone,Jett,Skye,Deadlock"
Icebox,XPERION NXT,Novita Esports,13,9,8,2,7,5,"Sova,Killjoy,Viper,Jett,Harbor","Killjoy,Viper,Reyna,Jett,Gekko"
Lotus,BUCHCLUB,IRON COMPANY,13,7,7,5,2,6,"Breach,Raze,Killjoy,Omen,Gekko","Raze,Viper,Omen,Chamber,Fade"
Bind,SOS Affenalarm,Lootcifer,11,13,6,6,7,5,"Brimstone,Sage,Jett,Skye,Yoru","Raze,Viper,Phoenix,Omen,KAY/O"
Ascent,404 Multigaming,DREAMED WORLD,13,11,6,6,5,7,"Sova,Killjoy,Omen,Jett,KAY/O","Sova,Killjoy,Omen,Jett,KAY/O"
Ascent,Babos Gaming,TeamOrangeGaming,9,13,5,5,8,4,"Sova,Viper,Omen,Jett,KAY/O","Raze,Viper,Astra,Fade,Gekko"
Icebox,Pingu E-Sports,J4,13,8,8,4,4,5,"Sova,Killjoy,Viper,Reyna,Jett","Sova,Killjoy,Viper,Reyna,Jett"
Split,Five Media Clan,Case Esports,4,13,1,4,9,3,"Breach,Raze,Cypher,Omen,Skye","Raze,Viper,Omen,Skye,Yoru"
Breeze,Dortmund Esports,MÄNNER WIE WIR,9,13,3,7,6,6,"Cypher,Sova,Viper,Yoru,Chamber","Cypher,Sova,Viper,Jett,Yoru"
Split,IRREGULARS,Permitta Unicorns,9,13,3,7,6,6,"Raze,Cypher,Viper,Omen,Skye","Raze,Cypher,Omen,Jett,Fade"
Sunset,SNOOZE Esports,Siko Esports,10,13,4,7,6,6,"Cypher,Omen,Yoru,Chamber,Fade","Viper,Brimstone,Chamber,Neon,Gekko"
Sunset,Babos Gaming,TeamOrangeGaming,3,13,1,3,10,2,"Breach,Cypher,Omen,Neon,Gekko","Breach,Raze,Cypher,Omen,Fade"
Ascent,Pingu E-Sports,J4,13,3,9,3,0,4,"Breach,Raze,Cypher,Sova,Omen","Sova,Killjoy,Omen,Jett,KAY/O"
Ascent,BUCHCLUB,IRON COMPANY,13,7,8,4,3,5,"Sova,Killjoy,Omen,Jett,KAY/O","Sova,Killjoy,Omen,Jett,KAY/O"
Breeze,XPERION NXT,Novita Esports,13,10,8,3,7,5,"Sova,Viper,Skye,Neon,Harbor","Cypher,Sova,Viper,Jett,Yoru"
Lotus,404 Multigaming,DREAMED WORLD,10,13,7,4,9,3,"Raze,Killjoy,Viper,Omen,Fade","Breach,Raze,Killjoy,Viper,Omen"
Lotus,SOS Affenalarm,Lootcifer,8,13,6,6,7,2,"Breach,Raze,Killjoy,Omen,Jett","Breach,Raze,Killjoy,Omen,KAY/O"
Sunset,Five Media Clan,Case Esports,9,13,6,6,7,3,"Breach,Raze,Cypher,Omen,Gekko","Raze,Cypher,Omen,KAY/O,Gekko"
Lotus,Five Media Clan,Case Esports,2,13,0,3,10,2,"Breach,Raze,Cypher,Omen,Fade","Raze,Killjoy,Viper,Omen,Fade"
Sunset,ONE Team Esports,Oblivion Force,13,7,5,3,4,8,"Raze,Cypher,Viper,Omen,Gekko","Breach,Raze,Cypher,Sova,Omen"
Lotus,ONE Team Esports,Oblivion Force,13,10,7,4,6,6,"Raze,Killjoy,Viper,Omen,Gekko","Raze,Killjoy,Viper,Omen,Fade"
Sunset,ALG,RIMA GC,13,15,8,6,9,5,"Breach,Raze,Cypher,Omen,Gekko","Raze,Cypher,Phoenix,Omen,Gekko"
Lotus,PAPA ESPORTS,Hungkuang Falcon,13,9,7,3,6,6,"Breach,Raze,Killjoy,Omen,Jett","Raze,Killjoy,Viper,Omen,Gekko"
Breeze,ALG,RIMA GC,13,8,9,3,5,4,"Cypher,Sova,Viper,Jett,Yoru","Cypher,Sova,Viper,Jett,Yoru"
Ascent,PAPA ESPORTS,Hungkuang Falcon,13,7,10,2,5,3,"Sova,Killjoy,Omen,Jett,KAY/O","Sova,Killjoy,Omen,Jett,KAY/O"
Icebox,PAPA ESPORTS,Hungkuang Falcon,4,13,2,3,10,2,"Sova,Viper,Sage,Jett,Chamber","Raze,Killjoy,Viper,Reyna,Gekko"
Bind,ALG,RIMA GC,11,13,6,6,7,5,"Raze,Viper,Skye,Astra,Fade","Breach,Cypher,Brimstone,Yoru,Gekko"
Sunset,Mommy's Kittens,AURA DIFFERENTIAL,4,13,3,9,4,1,"Breach,Raze,Cypher,Omen,Gekko","Raze,Cypher,Reyna,Omen,Skye"
Lotus,Mommy's Kittens,AURA DIFFERENTIAL,4,13,0,5,8,4,"Raze,Killjoy,Omen,Chamber,Gekko","Raze,Killjoy,Viper,Omen,Skye"
Lotus,OK Gaming,Bon Bon Bum Contra GC,10,13,5,7,6,5,"Raze,Killjoy,Viper,Omen,Skye","Breach,Raze,Killjoy,Viper,Omen"
Icebox,Legiowon Puff,Ragnus Esports,7,13,1,7,6,6,"Sova,Killjoy,Viper,Reyna,Jett","Viper,Jett,Skye,Harbor,Gekko"
Icebox,OK Gaming,Bon Bon Bum Contra GC,13,8,4,5,3,9,"Sova,Killjoy,Viper,Jett,KAY/O","Sova,Killjoy,Viper,Jett,Deadlock"
Ascent,New Combat Line GC,NTH,13,7,8,4,3,5,"Sova,Killjoy,Omen,Jett,KAY/O","Sova,Killjoy,Omen,Jett,KAY/O"
Bind,Legiowon Puff,Ragnus Esports,11,13,7,5,8,4,"Raze,Viper,Brimstone,Reyna,Skye","Raze,Cypher,Brimstone,Skye,Yoru"
Bind,Northwest Vista College,NM State Crimson,13,8,6,6,2,7,"Raze,Viper,Brimstone,Skye,Gekko","Raze,Cypher,Viper,Brimstone,Skye"
Ascent,WKU Hilltoppers RED,Akron Esports,8,13,4,8,5,4,"Breach,Sova,Killjoy,Omen,Jett","Sova,Killjoy,Omen,Jett,KAY/O"
Ascent,OK Gaming,Bon Bon Bum Contra GC,5,13,4,8,5,1,"Sova,Killjoy,Omen,Jett,KAY/O","Breach,Raze,Sova,Killjoy,Omen"
Bind,RENEGADAS,Unity GC,13,9,5,5,4,8,"Raze,Brimstone,Sage,Chamber,Gekko","Raze,Cypher,Brimstone,Skye,Gekko"
Lotus,New Combat Line GC,NTH,14,12,7,6,6,7,"Breach,Raze,Killjoy,Viper,Omen","Breach,Raze,Cypher,Omen,Skye"
Lotus,Legiowon Puff,Ragnus Esports,13,8,7,2,6,6,"Breach,Raze,Omen,Chamber,Gekko","Breach,Raze,Cypher,Phoenix,Omen"
Icebox,FURIA GC,REVOADA,5,13,2,4,9,3,"Sova,Killjoy,Viper,Sage,Jett","Sova,Killjoy,Viper,Sage,Jett"
Sunset,Northwest Vista College,NM State Crimson,13,9,6,6,3,7,"Cypher,Viper,Omen,Yoru,Gekko","Breach,Raze,Cypher,Omen,Fade"
Lotus,TBS GC,BLOOD Stars,13,3,3,1,2,10,"Raze,Killjoy,Viper,Omen,Fade","Raze,Killjoy,Omen,Fade,Iso"
Sunset,WKU Hilltoppers RED,Akron Esports,7,13,4,4,9,3,"Cypher,Brimstone,Omen,Jett,Skye","Breach,Raze,Cypher,Sova,Omen"
Breeze,MIBR GC,pensa num nome legal,13,4,8,4,0,5,"Cypher,Sova,Viper,Jett,KAY/O","Cypher,Sova,Viper,Jett,Gekko"
Split,donas da bala,DreamMax GC,6,13,5,7,6,1,"Breach,Raze,Viper,Omen,Skye","Raze,Cypher,Viper,Omen,Skye"
Ascent,TBS GC,BLOOD Stars,13,1,11,1,0,2,"Breach,Cypher,Omen,Jett,KAY/O","Sova,Killjoy,Omen,Jett,KAY/O"
Sunset,MIBR GC,pensa num nome legal,13,0,12,0,0,1,"Raze,Cypher,Omen,Fade,Gekko","Cypher,Sova,Phoenix,Omen,Gekko"
Icebox,RENEGADAS,Unity GC,13,11,7,5,6,6,"Sova,Killjoy,Viper,Reyna,Harbor","Killjoy,Viper,Jett,KAY/O,Gekko"
Icebox,LOUD GC,Tapa desemprego,13,1,11,1,0,2,"Sova,Killjoy,Viper,Jett,Harbor","Sova,Killjoy,Viper,Reyna,Gekko"
Lotus,FURIA GC,REVOADA,13,11,7,5,6,6,"Raze,Killjoy,Viper,Omen,Skye","Raze,Killjoy,Viper,Omen,Skye"
Sunset,Team Leveling,curralzinho,13,4,10,2,2,3,"Breach,Raze,Cypher,Omen,Fade","Breach,Raze,Cypher,Omen,Gekko"
Ascent,donas da bala,DreamMax GC,10,13,4,8,5,6,"Sova,Killjoy,Omen,Jett,KAY/O","Sova,Killjoy,Omen,Jett,KAY/O"
Ascent,Team Liquid Brazil,AXKRUM GC,13,1,12,0,1,1,"Sova,Killjoy,Omen,Jett,KAY/O","Sova,Killjoy,Omen,Jett,KAY/O"
Lotus,LOUD GC,Tapa desemprego,13,1,11,1,0,2,"Raze,Killjoy,Viper,Omen,Fade","Raze,Killjoy,Omen,Jett,Gekko"
Bind,bom dia sofia e amigas,BLOOD Stars,8,13,2,7,6,6,"Cypher,Phoenix,Brimstone,Jett,Skye","Raze,Viper,Brimstone,Skye,Gekko"
Sunset,OXEN GC,Deagle Ravagers,5,13,3,9,4,2,"Breach,Raze,Cypher,Omen,Gekko","Breach,Raze,Cypher,Omen,Fade"
Breeze,Clove-Flor,pensa num nome legal,8,13,5,7,6,3,"Cypher,Sova,Viper,Jett,KAY/O","Cypher,Sova,Viper,Jett,Gekko"
Split,Bellakitas,Malecient Parasside,13,10,7,4,6,6,"Breach,Cypher,Omen,Jett,Gekko","Breach,Raze,Cypher,Omen,Skye"
Bind,FURIA GC,REVOADA,7,13,3,9,4,4,"Raze,Viper,Brimstone,Sage,Skye","Raze,Viper,Brimstone,Skye,Gekko"
Lotus,Team Liquid Brazil,AXKRUM GC,13,0,12,0,0,1,"Raze,Killjoy,Viper,Omen,Fade","Raze,Killjoy,Viper,Omen,Fade"
Split,Reformed Team,Dasein Club GC,13,3,9,3,0,4,"Breach,Cypher,Jett,Skye,Astra","Raze,Cypher,Viper,Omen,Skye"
Split,Team Leveling,curralzinho,13,8,8,4,4,5,"Raze,Viper,Omen,Jett,Skye","Raze,Cypher,Viper,Omen,Skye"
Sunset,donas da bala,DreamMax GC,13,6,5,2,4,8,"Raze,Cypher,Omen,KAY/O,Gekko","Raze,Cypher,Omen,KAY/O,Gekko"
Bind,Unity GC,YOSO GC,13,10,4,8,2,9,"Raze,Cypher,Brimstone,Skye,Gekko","Raze,Cypher,Sova,Omen,Jett"
Sunset,Clove-Flor,pensa num nome legal,6,13,3,4,9,3,"Breach,Raze,Cypher,Omen,Fade","Cypher,Sova,Phoenix,Omen,Gekko"
Ascent,OXEN GC,Deagle Ravagers,4,13,3,9,4,1,"Sova,Killjoy,Omen,Jett,KAY/O","Sova,Killjoy,Omen,Jett,KAY/O"
Ascent,SEN amigas,Tapa desemprego,7,13,6,6,7,1,"Sova,Killjoy,Omen,Jett,KAY/O","Sova,Killjoy,Reyna,Omen,Jett"
Icebox,Bellakitas,Malecient Parasside,13,5,5,1,4,8,"Killjoy,Viper,Reyna,Jett,Gekko","Sova,Killjoy,Viper,Reyna,Jett"
Ascent,bom dia sofia e amigas,BLOOD Stars,15,13,8,6,7,7,"Sova,Killjoy,Omen,Jett,KAY/O","Sova,Killjoy,Omen,Jett,KAY/O"
Bind,Reformed Team,Dasein Club GC,13,3,3,1,2,10,"Breach,Viper,Brimstone,Jett,Gekko","Breach,Raze,Cypher,Sova,Brimstone"
Lotus,Athena's e-Sports,RENEGADAS,11,13,5,7,6,6,"Breach,Raze,Killjoy,Omen,Fade","Raze,Cypher,Omen,Jett,Skye"
Lotus,TBS GC,Krysme e amigas,13,1,2,0,1,11,"Raze,Killjoy,Viper,Omen,Fade","Raze,Killjoy,Viper,Omen,Fade"
Ascent,TRINITY GC,AXKRUM GC,4,13,3,9,4,1,"Killjoy,Viper,Omen,Jett,KAY/O","Sova,Killjoy,Omen,Jett,KAY/O"
Icebox,FURIA GC,Higashi nine,13,0,1,0,0,12,"Sova,Killjoy,Viper,Sage,Jett","Killjoy,Viper,Jett,KAY/O,Gekko"
Sunset,Team Leveling,Equestria Girls,13,0,12,0,0,1,"Breach,Raze,Cypher,Omen,Fade","Raze,Cypher,Sova,Omen,Gekko"
Lotus,donas da bala,Buchas de Mel,13,2,10,2,0,3,"Raze,Killjoy,Viper,Omen,Fade","Raze,Killjoy,Omen,Jett,Skye"
Ascent,DreamMax GC,Truedata GC,13,2,10,2,0,3,"Sova,Killjoy,Omen,Jett,KAY/O","Sova,Killjoy,Omen,Jett,KAY/O"
Icebox,LOUD GC,RKT pANcaDELAS,13,2,12,0,2,1,"Sova,Killjoy,Viper,Jett,Harbor","Sova,Killjoy,Viper,Reyna,KAY/O"
Breeze,MIBR GC,Variants GC,13,0,12,0,0,1,"Cypher,Sova,Viper,Jett,KAY/O","Cypher,Sova,Viper,Jett,KAY/O"
Ascent,Team Liquid Brazil,Capevaras,13,0,12,0,0,1,"Sova,Killjoy,Omen,Jett,KAY/O","Breach,Cypher,Phoenix,Brimstone,KAY/O"
Split,REVOADA,Camarujes,13,0,12,0,0,1,"Raze,Cypher,Viper,Omen,Skye","Raze,Cypher,Viper,Skye,Astra"
Lotus,FURIA GC,Higashi nine,13,2,10,2,0,3,"Raze,Killjoy,Viper,Omen,Skye","Raze,Cypher,Omen,Fade,Gekko"
Breeze,TBS GC,Krysme e amigas,13,3,10,2,1,3,"Cypher,Sova,Viper,Jett,Yoru","Cypher,Sova,Viper,Jett,KAY/O"
Icebox,Team Leveling,Equestria Girls,13,1,11,1,0,2,"Sova,Killjoy,Viper,Jett,Gekko","Sova,Killjoy,Viper,Sage,Jett"
Ascent,Athena's e-Sports,RENEGADAS,5,13,4,8,5,1,"Sova,Killjoy,Omen,Jett,KAY/O","Raze,Viper,Omen,Fade,Gekko"
Split,DreamMax GC,Truedata GC,13,3,2,2,1,11,"Raze,Cypher,Viper,Omen,Skye","Breach,Raze,Cypher,Omen,Skye"
Bind,LOUD GC,RKT pANcaDELAS,13,1,11,1,0,2,"Raze,Viper,Brimstone,Fade,Gekko","Breach,Raze,Viper,Brimstone,Skye"
Bind,Clove-Flor,pensa num nome legal,14,12,7,6,6,7,"Raze,Viper,Brimstone,Skye,Gekko","Raze,Cypher,Brimstone,Jett,Skye"
Split,Team Liquid Brazil,Capevaras,13,1,1,1,0,12,"Breach,Raze,Viper,Omen,Skye","Breach,Raze,Cypher,Omen,Gekko"
Bind,MIBR GC,Variants GC,13,0,12,0,0,1,"Raze,Viper,Brimstone,Fade,Gekko","Raze,Viper,Skye,Harbor,Gekko"
Ascent,REVOADA,Camarujes,13,1,11,1,0,2,"Sova,Killjoy,Omen,Jett,KAY/O","Sova,Killjoy,Viper,Jett,Astra"
Split,Unity GC,YOSO GC,16,14,8,7,7,8,"Raze,Viper,Astra,Fade,Gekko","Raze,Cypher,Viper,Omen,Gekko"
Lotus,bom dia sofia e amigas,BLOOD Stars,9,13,4,8,5,5,"Breach,Raze,Killjoy,Omen,Gekko","Raze,Killjoy,Viper,Omen,Fade"
Bind,donas da bala,Buchas de Mel,13,3,2,2,1,11,"Breach,Viper,Phoenix,Brimstone,Gekko","Raze,Killjoy,Viper,Brimstone,Skye"
Breeze,SEN amigas,Tapa desemprego,9,13,2,8,5,7,"Cypher,Sova,Viper,Reyna,Jett","Cypher,Sova,Viper,Reyna,Jett"
Split,TRINITY GC,AXKRUM GC,5,13,4,8,5,1,"Cypher,Viper,Omen,Jett,Skye","Raze,Cypher,Viper,Omen,Skye"
Icebox,UCAM Esports Club,Barça eSports,13,4,5,0,4,8,"Sova,Killjoy,Viper,Reyna,Harbor","Killjoy,Viper,Jett,KAY/O,Gekko"
Bind,NASR Esports,R8 Esports,7,13,3,5,8,4,"Raze,Cypher,Viper,Brimstone,Skye","Raze,Cypher,Viper,Brimstone,Skye"
Split,UCAM Esports Club,Barça eSports,8,13,7,5,8,1,"Breach,Raze,Cypher,Omen,Fade","Raze,Viper,Sage,Skye,Astra"
Ascent,404 Multigaming,eSports Cologne,3,13,1,3,10,2,"Sova,Killjoy,Omen,Jett,KAY/O","Sova,Killjoy,Omen,Jett,KAY/O"
Icebox,NASR Esports,R8 Esports,7,13,4,8,5,3,"Sova,Killjoy,Viper,Jett,KAY/O","Sova,Killjoy,Viper,Sage,Jett"
Sunset,HOWL Esports,Istanbul Wildcats,13,7,8,4,3,5,"Breach,Raze,Cypher,Sova,Omen","Breach,Cypher,Omen,Neon,Fade"
Lotus,UCAM Esports Club,Barça eSports,13,11,7,5,6,6,"Raze,Killjoy,Viper,Omen,Fade","Raze,Killjoy,Viper,Omen,Fade"
Split,NASR Esports,R8 Esports,2,13,2,10,3,0,"Breach,Raze,Cypher,Sova,Omen","Raze,Cypher,Viper,Omen,Skye"
Sunset,404 Multigaming,eSports Cologne,13,11,8,4,7,5,"Breach,Raze,Sova,Omen,Jett","Raze,Killjoy,Viper,Astra,Fade"
Ascent,MÄNNER WIE WIR,Sissi State Punks,4,13,2,3,10,2,"Sova,Killjoy,Omen,Jett,KAY/O","Sova,Killjoy,Omen,Jett,KAY/O"
Sunset,UCAM Esports Club,Barça eSports,13,2,10,2,0,3,"Breach,Raze,Cypher,Sova,Omen","Raze,Cypher,Omen,KAY/O,Gekko"
Sunset,MÄNNER WIE WIR,Sissi State Punks,9,13,6,6,7,3,"Raze,Cypher,Viper,Omen,Gekko","Breach,Cypher,Omen,Jett,Yoru"
Lotus,404 Multigaming,eSports Cologne,8,13,4,5,8,4,"Raze,Killjoy,Viper,Omen,Fade","Raze,Killjoy,Viper,Astra,Fade"
Ascent,HOWL Esports,Istanbul Wildcats,13,11,5,7,4,8,"Cypher,Sova,Omen,Jett,KAY/O","Breach,Cypher,Omen,Neon,Gekko"
Ascent,UCAM Esports Club,Barça eSports,10,13,7,4,9,3,"Raze,Viper,Reyna,Harbor,Gekko","Killjoy,Viper,Omen,Jett,Skye"
Sunset,RIZON Sugar,FOKUS Sakura,13,9,10,2,7,3,"Breach,Raze,Cypher,Sova,Omen","Breach,Cypher,Omen,Jett,Gekko"
Sunset,Papara SuperMassive,Galakticos,12,14,4,9,5,8,"Breach,Raze,Cypher,Sova,Omen","Breach,Sova,Viper,Omen,Neon"
Lotus,RIZON Sugar,FOKUS Sakura,13,7,5,3,4,8,"Breach,Raze,Killjoy,Omen,Deadlock","Breach,Raze,Cypher,Omen,Skye"
Breeze,Papara SuperMassive,Galakticos,8,13,3,6,7,5,"Cypher,Sova,Viper,Jett,KAY/O","Cypher,Sova,Viper,Omen,Yoru"
Sunset,RIMA GC,Dangerous Rose,13,5,10,2,3,3,"Raze,Cypher,Phoenix,Omen,Gekko","Raze,Cypher,Sova,Phoenix,Omen"
Bind,BOBA,ALG,13,7,6,2,5,7,"Breach,Brimstone,Sage,Chamber,Deadlock","Raze,Viper,Skye,Astra,Fade"
Split,BOBA,ALG,13,4,4,1,3,9,"Breach,Raze,Cypher,Omen,Jett","Raze,Skye,Astra,Gekko,Iso"
Breeze,RIMA GC,Dangerous Rose,13,10,8,3,7,5,"Cypher,Sova,Viper,Jett,Yoru","Cypher,Sova,Viper,Jett,Yoru"
Split,Cicadas Gaming,Colors Esport,13,11,8,4,7,5,"Raze,Reyna,Skye,Astra,Chamber","Breach,Raze,Viper,Omen,Skye"
Breeze,AURA DIFFERENTIAL,LILITH (TH),13,4,5,0,4,8,"Cypher,Sova,Viper,Reyna,Jett","Cypher,Sova,Viper,Jett,Gekko"
Lotus,Xipto Esports,Mommy's Kittens,13,4,4,1,3,9,"Raze,Cypher,Reyna,Omen,Skye","Raze,Killjoy,Omen,Chamber,Gekko"
Breeze,Cicadas Gaming,Colors Esport,7,13,1,7,6,6,"Cypher,Sova,Viper,Jett,Yoru","Cypher,Sova,Viper,Jett,KAY/O"
Bind,AURA DIFFERENTIAL,LILITH (TH),13,6,9,3,3,4,"Raze,Viper,Brimstone,Skye,Yoru","Raze,Cypher,Brimstone,Reyna,Skye"
Icebox,Xipto Esports,Mommy's Kittens,13,1,2,0,1,11,"Killjoy,Viper,Jett,KAY/O,Gekko","Sova,Killjoy,Viper,Reyna,Jett"
Bind,Cicadas Gaming,Colors Esport,13,4,9,3,1,4,"Breach,Cypher,Sova,Brimstone,Yoru","Raze,Viper,Skye,Astra,Gekko"
Split,Legiowon Puff,OK Gaming,10,13,6,5,8,4,"Breach,Raze,Cypher,Omen,Deadlock","Raze,Viper,Omen,Jett,Skye"
Icebox,Bon Bon Bum Contra GC,New Combat Line GC,13,8,7,2,6,6,"Sova,Killjoy,Viper,Jett,Deadlock","Sova,Killjoy,Viper,Jett,Gekko"
Ascent,NTH,Genbu Gaming GC,13,6,9,3,3,4,"Sova,Killjoy,Omen,Jett,KAY/O","Raze,Killjoy,Jett,Skye,Astra"
Lotus,Duality Esports GC,Ragnus Esports,6,13,3,4,9,3,"Raze,Killjoy,Omen,Jett,Skye","Breach,Raze,Cypher,Phoenix,Omen"
Icebox,Legiowon Puff,OK Gaming,12,14,4,9,5,8,"Sova,Killjoy,Viper,Reyna,Jett","Sova,Killjoy,Viper,Jett,KAY/O"
Ascent,Bon Bon Bum Contra GC,New Combat Line GC,13,8,6,3,5,7,"Breach,Raze,Sova,Killjoy,Omen","Sova,Killjoy,Omen,Jett,KAY/O"
Split,NTH,Genbu Gaming GC,13,4,4,1,3,9,"Raze,Cypher,Reyna,Omen,Skye","Raze,Killjoy,Viper,Skye,Astra"
Bind,Duality Esports GC,Ragnus Esports,4,13,0,5,8,4,"Raze,Viper,Brimstone,Reyna,Skye","Raze,Cypher,Brimstone,Skye,Yoru"
