Map Name,Team 1 Name,Team 2 Name,Team 1 Score,Team 2 Score,Team 1 Attacking Wins,Team 1 Attacking Losses,Team 2 Attacking Wins,Team 2 Attacking Losses,Team 1 Agents,Team 2 Agents
Split,Delight,IGZIST,13,3,3,1,2,10,"Raze,Skye,Astra,Deadlock","Breach,Raze,Astra,Neon"
Abyss,BABO,AXELERATE,13,0,12,0,0,1,"Cypher,Sova,Omen,Jett,KAY/O","Sova,Omen,Jett,Astra,KAY/O"
Sunset,Striders,ASNA,13,4,10,2,2,3,"Breach,Cypher,Omen,Neon,Fade","Omen,Chamber,Neon,Fade"
Sunset,RIDDLE ORDER,FAV gaming,13,10,7,4,6,6,"Cypher,Sova,Omen,KAY/O,Neon","Breach,Cypher,Sova,Omen,Neon"
Haven,Delight,IGZIST,9,13,5,7,6,4,"Breach,Cypher,Sova,Omen,Neon","Breach,Cypher,Sova,Omen,Neon"
Bind,BABO,AXELERATE,13,6,8,4,2,5,"Raze,Viper,Brimstone,Fade,Gekko","Raze,Cypher,Viper,Brimstone,Skye"
Abyss,Striders,ASNA,13,9,6,4,5,7,"Omen,Jett,Yoru,Astra,Gekko","Sova,Omen,Yoru,Astra,Iso"
Sunset,BC SWELL,Team SEIBI,13,10,8,4,6,5,"Omen,Jett,Neon,Fade,Clove","Breach,Cypher,Omen,Neon,Fade"
Pearl,Striders,ASNA,7,13,2,6,7,5,"Killjoy,Astra,KAY/O,Neon,Fade","Yoru,Astra,Neon,Fade,Harbor"
Haven,BABO,AXELERATE,12,14,8,5,9,4,"Breach,Cypher,Sova,Omen,Neon","Breach,Cypher,Sova,Omen,Neon"
Abyss,BC SWELL,Team SEIBI,13,3,2,2,1,11,"Sova,Omen,Astra,Neon,Iso","Cypher,Sova,Omen,Jett,KAY/O"
Sunset,Delight,IGZIST,13,7,5,3,4,8,"Breach,Cypher,Sova,Omen,Neon","Cypher,Sova,Omen,KAY/O,Neon"
Split,YFP Gaming,Blue Otter,13,10,4,8,2,9,"Breach,Raze,Cypher,Skye,Astra","Raze,Cypher,Viper,Skye,Astra"
Split,FUSION,Six Karma,6,13,0,7,6,6,"Raze,Omen,Jett,Skye,Deadlock","Breach,Cypher,Astra,KAY/O,Neon"
Sunset,YFP Gaming,Blue Otter,13,10,5,7,3,8,"Breach,Cypher,Sova,Omen,Neon","Breach,Cypher,Sova,Omen,Neon"
Haven,FUSION,Six Karma,12,14,8,5,9,4,"Breach,Cypher,Sova,Omen,Jett","Breach,Cypher,Sova,Omen,Neon"
Ascent,YFP Gaming,Blue Otter,9,13,3,7,6,6,"Cypher,Sova,Omen,Jett,Deadlock","Cypher,Sova,Omen,Yoru,Deadlock"
Sunset,FUSION,Six Karma,13,11,4,8,3,9,"Cypher,Sova,Omen,Neon,Deadlock","Cypher,Sova,Omen,KAY/O,Neon"
Abyss,YFP Gaming,SaD Esports,13,9,5,7,2,8,"Cypher,Sova,Jett,Astra,KAY/O","Cypher,Sova,Viper,Yoru,Astra"
Bind,FUSION,Six Karma,13,11,7,5,6,6,"Raze,Brimstone,Sage,Skye,Deadlock","Viper,Brimstone,Yoru,Fade,Gekko"
Sunset,Nightblood Gaming,RANKERS,8,13,3,6,7,5,"Breach,Cypher,Omen,Neon,Fade","Cypher,Sova,Yoru,Iso,Clove"
Sunset,YFP Gaming,SaD Esports,13,10,7,4,6,6,"Breach,Cypher,Sova,Omen,Neon","Breach,Cypher,Sova,Omen,Neon"
Ascent,FUSION,Six Karma,7,13,5,3,10,2,"Cypher,Sova,Omen,Jett,Deadlock","Cypher,Sova,Omen,Jett,KAY/O"
Ascent,Winthrop University,Blue Otter,12,14,8,5,9,4,"Cypher,Sova,Reyna,Omen,Jett","Cypher,Sova,Omen,Yoru,Deadlock"
Bind,Nightblood Gaming,RANKERS,9,13,7,5,8,2,"Viper,Brimstone,Skye,Neon,Deadlock","Cypher,Skye,Yoru,Iso,Clove"
Haven,YFP Gaming,SaD Esports,11,13,4,8,5,7,"Breach,Cypher,Sova,Omen,Neon","Breach,Cypher,Sova,Omen,Neon"
Sunset,Winthrop University,Blue Otter,9,13,5,7,6,4,"Breach,Cypher,Sova,Omen,Neon","Breach,Cypher,Sova,Omen,Neon"
Haven,esports team αD,Striders,13,8,5,4,4,8,"Breach,Cypher,Sova,Omen,Jett","Breach,Cypher,Sova,Omen,Neon"
Sunset,RIDDLE ORDER,BC SWELL,13,8,8,4,4,5,"Cypher,Sova,Omen,KAY/O,Neon","Omen,Jett,Neon,Fade,Clove"
Pearl,RIDDLE ORDER,BC SWELL,13,2,10,2,0,3,"Sova,Killjoy,Astra,KAY/O,Neon","Sova,Astra,KAY/O,Chamber,Neon"
Haven,REJECT,Delight,7,13,4,4,9,3,"Breach,Cypher,Sova,Omen,Neon","Breach,Cypher,Sova,Omen,Neon"
Split,esports team αD,Striders,10,13,5,7,6,5,"Raze,Cypher,Omen,Jett,Skye","Raze,Cypher,Viper,Omen,Skye"
Split,REJECT,Delight,5,13,1,11,2,4,"Raze,Cypher,Omen,Skye","Raze,Skye,Astra,Deadlock"
Ascent,RIDDLE ORDER,BC SWELL,11,13,5,7,6,6,"Sova,Killjoy,Omen,Jett,KAY/O","Cypher,Sova,Omen,Jett,KAY/O"
Abyss,esports team αD,Striders,13,11,7,5,6,6,"Cypher,Sova,Omen,Jett,Clove","Omen,Jett,Yoru,Astra,Gekko"
Split,Sengoku Gaming,BABO,7,13,1,7,6,6,"Breach,Raze,Cypher,Omen,Skye","Breach,Raze,Viper,Omen,Fade"
Ascent,Crest Gaming ZST,IGZIST,13,15,5,9,6,8,"Cypher,Sova,Omen,Jett,Deadlock","Sova,Killjoy,Omen,Jett,KAY/O"
Haven,Sengoku Gaming,BABO,8,13,4,8,5,4,"Breach,Cypher,Sova,Omen,Neon","Breach,Cypher,Sova,Omen,Neon"
Abyss,FAV gaming,Team SEIBI,15,17,6,10,7,9,"Sova,Omen,Jett,Astra,KAY/O","Cypher,Sova,Omen,Jett,KAY/O"
Bind,BLUE BEES.ESP,ASNA,13,10,6,5,5,7,"Cypher,Brimstone,Skye,Neon,Deadlock","Raze,Yoru,Astra,Fade,Clove"
Bind,FAV gaming,Team SEIBI,13,2,10,2,0,3,"Breach,Yoru,Astra,Neon,Fade","Raze,Viper,Astra,Fade,Gekko"
Abyss,Crest Gaming ZST,IGZIST,13,9,4,6,3,9,"Cypher,Sova,Omen,Jett,KAY/O","Cypher,Sova,Omen,Yoru,Astra"
Ascent,BLUE BEES.ESP,ASNA,6,13,4,8,5,2,"Sova,Killjoy,Omen,Jett,KAY/O","Sova,Killjoy,Omen,Jett,KAY/O"
Sunset,NOEZ FOXX,AXELERATE,13,10,8,4,6,5,"Omen,Yoru,KAY/O,Neon","Sova,Phoenix,Sage,Omen,Clove"
Sunset,FAV gaming,Team SEIBI,10,13,4,7,6,6,"Breach,Cypher,Sova,Omen,Neon","Breach,Cypher,Omen,Neon,Fade"
Abyss,BLUE BEES.ESP,ASNA,13,5,4,2,3,9,"Cypher,Sova,Jett,Astra,KAY/O","Sova,Omen,Yoru,Astra,Iso"
Ascent,NOEZ FOXX,AXELERATE,13,2,10,2,0,3,"Sova,Omen,Neon,Iso","Sova,Killjoy,Omen,Jett,KAY/O"
Split,Crest Gaming ZST,IGZIST,9,13,1,9,4,8,"Raze,Cypher,Viper,Omen,Skye","Breach,Raze,Astra,Neon"
Pearl,Funhavers,SaD Esports,5,13,3,3,10,2,"Sova,Killjoy,Astra,KAY/O,Neon","Cypher,Sova,Astra,KAY/O,Neon"
Split,YFP Gaming,RANKERS,2,13,2,10,3,0,"Raze,Viper,Skye,Astra","Cypher,Viper,Yoru,Iso,Clove"
Sunset,Antares Esports,Six Karma,8,13,3,9,4,5,"Cypher,Sova,Omen,KAY/O,Neon","Cypher,Sova,Omen,KAY/O,Neon"
Ascent,TSM,Blue Otter,9,13,3,7,6,6,"Cypher,Sova,Omen,Jett,KAY/O","Cypher,Sova,Omen,Yoru,Deadlock"
Haven,Funhavers,SaD Esports,9,13,3,9,4,6,"Breach,Cypher,Sova,Omen,Neon","Breach,Cypher,Sova,Omen,Neon"
Ascent,Winthrop University,Nightblood Gaming,10,13,3,8,5,7,"Cypher,Sova,Omen,Jett,Deadlock","Cypher,Sova,Omen,Yoru,Deadlock"
Ascent,YFP Gaming,RANKERS,13,8,7,5,3,6,"Cypher,Sova,Omen,Jett,Deadlock","Cypher,Sova,Jett,Yoru,Clove"
Ascent,Antares Esports,Six Karma,3,13,3,9,4,0,"Sova,Killjoy,Omen,Jett,KAY/O","Cypher,Sova,Omen,Jett,KAY/O"
Sunset,YFP Gaming,RANKERS,5,13,5,7,6,0,"Breach,Cypher,Sova,Omen,Neon","Cypher,Sova,Yoru,Iso,Clove"
Bind,TSM,Blue Otter,8,13,6,6,7,2,"Raze,Viper,Brimstone,Skye,Deadlock","Raze,Viper,Brimstone,Skye,Gekko"
Abyss,Winthrop University,Nightblood Gaming,11,13,3,9,4,8,"Cypher,Sova,Jett,Astra,Gekko","Cypher,Sova,Omen,Yoru"
Sunset,Funhavers,SaD Esports,13,11,4,8,3,9,"Breach,Cypher,Sova,Omen,Neon","Breach,Cypher,Sova,Omen,Neon"
Split,E-Xolos LAZER,FUSION,13,2,10,2,0,3,"Breach,Raze,Cypher,Omen,Skye","Raze,Sage,Omen,Skye,Deadlock"
Sunset,RANKERS,Blue Otter,13,7,4,4,3,9,"Cypher,Sova,Yoru,Neon,Clove","Breach,Sova,Sage,Omen,Neon"
Haven,E-Xolos LAZER,FUSION,13,8,7,2,6,6,"Breach,Cypher,Sova,Omen,Neon","Cypher,Sova,Omen,Jett,KAY/O"
Bind,Winthrop University,Funhavers,13,11,10,2,9,3,"Raze,Viper,Brimstone,Skye,Deadlock","Raze,Cypher,Omen,Yoru,Deadlock"
Ascent,YFP Gaming,TSM,13,11,5,7,4,8,"Cypher,Sova,Omen,Jett,Deadlock","Cypher,Sova,Omen,Jett,KAY/O"
Pearl,SaD Esports,Nightblood Gaming,5,13,3,9,4,2,"Cypher,Sova,Astra,KAY/O,Neon","Killjoy,Astra,KAY/O,Neon,Fade"
Bind,E-Xolos LAZER,FUSION,6,13,3,9,4,3,"Raze,Brimstone,Skye,KAY/O","Raze,Brimstone,Sage,Skye,Deadlock"
Ascent,RANKERS,Blue Otter,16,14,7,8,6,9,"Cypher,Sova,Jett,Yoru,Clove","Cypher,Sova,Omen,Yoru,Deadlock"
Pearl,Winthrop University,Funhavers,13,11,7,5,6,6,"Sova,Astra,KAY/O,Chamber,Neon","Sova,Killjoy,Astra,KAY/O,Neon"
Sunset,YFP Gaming,TSM,13,7,7,5,2,6,"Breach,Cypher,Sova,Omen,Neon","Breach,Cypher,Omen,Neon,Fade"
Haven,RANKERS,Blue Otter,7,13,5,7,6,2,"Cypher,Sova,Yoru,Neon,Clove","Breach,Cypher,Sova,Omen,Neon"
Bind,SaD Esports,Nightblood Gaming,9,13,5,5,8,4,"Raze,Cypher,Viper,Brimstone,Skye","Viper,Brimstone,Skye,Neon,Deadlock"
Sunset,Winthrop University,Funhavers,6,13,4,8,5,2,"Breach,Cypher,Sova,Omen,Neon","Breach,Cypher,Sova,Omen,Neon"
Split,Crest Gaming ZST,Delight,14,16,9,6,10,5,"Raze,Cypher,Viper,Omen,Skye","Raze,Skye,Astra,Deadlock"
Pearl,BLUE BEES.ESP,Striders,14,16,7,8,8,7,"Sova,Killjoy,Jett,Astra,KAY/O","Killjoy,Astra,KAY/O,Neon,Fade"
Sunset,NOEZ FOXX,BABO,10,13,3,9,4,7,"Omen,Yoru,KAY/O,Neon","Cypher,Sova,Omen,KAY/O,Neon"
Sunset,Crest Gaming ZST,Delight,13,8,5,4,4,8,"Breach,Raze,Cypher,Brimstone,KAY/O","Breach,Cypher,Sova,Omen,Neon"
Abyss,FAV gaming,BC SWELL,6,13,3,9,4,3,"Sova,Omen,Jett,Astra,KAY/O","Sova,Omen,Astra,Neon,Iso"
Haven,BLUE BEES.ESP,Striders,12,14,7,6,8,5,"Breach,Cypher,Sova,Omen,Neon","Breach,Cypher,Sova,Omen,Neon"
Haven,NOEZ FOXX,BABO,13,6,5,2,4,8,"Cypher,Sova,Omen,Neon,Iso","Breach,Cypher,Sova,Omen,Neon"
Bind,Crest Gaming ZST,Delight,10,13,3,9,4,7,"Raze,Cypher,Brimstone,KAY/O,Fade","Brimstone,Yoru,Neon,Fade,Clove"
Pearl,FAV gaming,BC SWELL,9,13,4,6,7,5,"Breach,Cypher,Sova,Astra,Neon","Sova,Astra,KAY/O,Chamber,Neon"
Abyss,BLUE BEES.ESP,Striders,13,5,4,2,3,9,"Cypher,Sova,Jett,Astra,KAY/O","Omen,Jett,Yoru,Astra,Gekko"
Abyss,NOEZ FOXX,BABO,13,15,6,8,7,7,"Cypher,Sova,Yoru,Astra,Neon","Cypher,Sova,Omen,Jett,KAY/O"
Haven,REJECT,IGZIST,8,13,5,4,9,3,"Breach,Cypher,Sova,Omen,Neon","Breach,Cypher,Sova,Omen,Neon"
Bind,FAV gaming,BC SWELL,13,9,6,6,3,7,"Breach,Yoru,Astra,Neon,Fade","Raze,Cypher,Viper,Brimstone,Skye"
Ascent,esports team αD,ASNA,13,7,7,5,2,6,"Cypher,Sova,Omen,Jett,KAY/O","Sova,Killjoy,Omen,Jett,KAY/O"
Ascent,Sengoku Gaming,AXELERATE,13,9,7,5,4,6,"Sova,Killjoy,Omen,Jett,KAY/O","Sova,Killjoy,Omen,Jett,KAY/O"
Sunset,REJECT,IGZIST,10,13,4,8,5,6,"Cypher,Sova,Omen,Yoru,Neon","Cypher,Sova,Omen,KAY/O,Neon"
Split,RIDDLE ORDER,Team SEIBI,13,3,9,3,0,4,"Raze,Viper,Omen,Jett,Skye","Breach,Raze,Cypher,Omen,Neon"
Split,Sengoku Gaming,AXELERATE,13,7,6,6,1,7,"Breach,Raze,Cypher,Omen,Skye","Breach,Raze,Cypher,Omen,Skye"
Abyss,esports team αD,ASNA,16,14,7,8,6,9,"Cypher,Sova,Omen,Jett,Clove","Sova,Omen,Yoru,Astra,Iso"
Sunset,RIDDLE ORDER,Team SEIBI,13,4,5,0,4,8,"Cypher,Sova,Omen,KAY/O,Neon","Breach,Cypher,Omen,Neon,Fade"
Split,REJECT,IGZIST,13,5,5,1,4,8,"Raze,Cypher,Omen,Skye","Breach,Raze,Astra,Neon"
Bind,Six Karma,FUSION,4,13,3,9,4,1,"Viper,Yoru,Astra,Fade,Gekko","Raze,Brimstone,Sage,Skye,Deadlock"
Ascent,Six Karma,FUSION,9,13,2,8,5,7,"Cypher,Sova,Omen,Jett,KAY/O","Cypher,Sova,Omen,Jett,Deadlock"
Haven,E-Xolos LAZER,Antares Esports,13,5,3,3,2,10,"Breach,Cypher,Sova,Omen,Neon","Cypher,Sova,Omen,Yoru,Iso"
Ascent,E-Xolos LAZER,Antares Esports,13,3,4,0,3,9,"Cypher,Sova,Omen,Jett,KAY/O","Sova,Killjoy,Omen,Jett,KAY/O"
Split,JiJieHao Bonkers,FOCUSGG,13,8,4,5,3,9,"Raze,Cypher,Viper,Omen,Skye","Breach,Raze,Astra,Neon"
Abyss,JiJieHao Bonkers,FOCUSGG,15,13,6,8,5,9,"Sova,Omen,Jett,Yoru,Astra","Cypher,Sova,Omen,Neon,Clove"
Sunset,JiJieHao Bonkers,FOCUSGG,3,13,0,4,9,3,"Breach,Cypher,Omen,Neon,Fade","Breach,Raze,Cypher,Omen,Neon"
Haven,JiJieHao Bonkers,FOCUSGG,13,10,7,4,6,6,"Breach,Cypher,Sova,Omen,Neon","Breach,Sova,Killjoy,Neon,Clove"
Bind,Kebab Clan,FOCUSGG,13,15,3,11,4,10,"Raze,Cypher,Brimstone,Skye,Yoru","Raze,Cypher,Brimstone,Skye,Neon"
Ascent,Kebab Clan,FOCUSGG,12,14,6,7,7,6,"Cypher,Sova,Omen,Jett,KAY/O","Cypher,Sova,Reyna,Omen,Jett"
Sunset,Kebab Clan,FOCUSGG,11,13,5,7,6,6,"Cypher,Sova,Omen,KAY/O,Neon","Breach,Raze,Cypher,Omen,Neon"
Sunset,マジスク学園卓球部,VoL,12,14,6,7,7,6,"Breach,Raze,Cypher,Sova,Omen","Raze,Cypher,Sova,Omen,Gekko"
Haven,マジスク学園卓球部,VoL,13,8,7,2,6,6,"Breach,Cypher,Sova,Omen,Jett","Breach,Sova,Killjoy,Omen,Jett"
Ascent,マジスク学園卓球部,VoL,7,13,3,5,8,4,"Sova,Killjoy,Phoenix,Omen,Jett","Sova,Killjoy,Omen,Jett,KAY/O"
Sunset,Hornswogglers,FOCUSGG,3,13,1,3,10,2,"Breach,Raze,Cypher,Omen,Neon","Breach,Raze,Cypher,Omen,Neon"
Abyss,Hornswogglers,FOCUSGG,5,13,1,5,8,4,"Cypher,Sova,Jett,Yoru,Astra","Cypher,Sova,Omen,Neon,Clove"
Sunset,VoL,男が先に前出ろ,13,9,5,5,4,8,"Raze,Cypher,Sova,Omen,Gekko","Sova,Phoenix,Omen,Jett,Chamber"
Abyss,Kebab Clan,JiJieHao Bonkers,7,13,4,8,5,3,"Breach,Cypher,Sova,Yoru,Astra","Sova,Omen,Jett,Yoru,Astra"
Bind,VoL,男が先に前出ろ,13,4,8,4,0,5,"Raze,Cypher,Brimstone,Jett,Skye","Raze,Yoru,Chamber,Gekko,Clove"
Haven,Kebab Clan,JiJieHao Bonkers,6,13,3,4,9,3,"Breach,Cypher,Sova,Omen,Neon","Breach,Cypher,Sova,Omen,Neon"
Sunset,彡(ﾟ)(ﾟ) グエー新団子,男が先に前出ろ,10,13,4,7,6,6,"Breach,Cypher,Sova,Omen,Jett","Sova,Phoenix,Omen,Jett,Chamber"
Bind,彡(ﾟ)(ﾟ) グエー新団子,男が先に前出ろ,13,11,3,9,2,10,"Raze,Viper,Brimstone,Skye,Gekko","Raze,Yoru,Chamber,Gekko,Clove"
Haven,彡(ﾟ)(ﾟ) グエー新団子,男が先に前出ろ,9,13,2,8,5,7,"Breach,Sova,Killjoy,Jett,Astra","Breach,Sova,Omen,Jett,Chamber"
Sunset,マジスク学園卓球部,VoL,17,15,12,4,11,5,"Breach,Raze,Cypher,Sova,Omen","Raze,Cypher,Sova,Omen,Gekko"
Bind,マジスク学園卓球部,VoL,13,11,7,5,6,6,"Raze,Cypher,Phoenix,Omen,Skye","Raze,Cypher,Brimstone,Jett,Skye"
Split,FOCUSGG,Vatles Esports,13,8,8,4,4,5,"Breach,Raze,Omen,Neon","Breach,Raze,Cypher,Jett,Astra"
Pearl,マジスク学園卓球部,VoL,11,13,6,6,7,5,"Killjoy,Phoenix,Jett,Astra,Fade","Killjoy,Reyna,Jett,Astra,Fade"
Ascent,FOCUSGG,Vatles Esports,13,2,10,2,0,3,"Cypher,Sova,Reyna,Omen,Neon","Cypher,Sova,Reyna,Omen,Jett"
Sunset,FOCUSGG,Vatles Esports,11,13,5,7,6,6,"Breach,Raze,Cypher,Omen,Neon","Breach,Raze,Cypher,Omen,Neon"
Sunset,彡(ﾟ)(ﾟ) グエー新団子,マジスク学園卓球部,9,13,4,6,7,5,"Breach,Cypher,Sova,Omen,Jett","Breach,Raze,Cypher,Sova,Omen"
Split,男が先に前出ろ,VoL,10,13,5,7,6,5,"Raze,Reyna,Omen,Jett,Chamber","Breach,Raze,Cypher,Omen,Skye"
Bind,Arena Internet Cafe,Hornswogglers,5,13,3,9,4,2,"Raze,Viper,Brimstone,Skye,Gekko","Raze,Brimstone,Omen,Skye,Deadlock"
Sunset,男が先に前出ろ,VoL,13,8,9,3,5,4,"Sova,Phoenix,Omen,Jett,Chamber","Raze,Cypher,Sova,Omen,Gekko"
Haven,彡(ﾟ)(ﾟ) グエー新団子,マジスク学園卓球部,13,11,9,3,8,4,"Breach,Sova,Killjoy,Jett,Astra","Breach,Cypher,Sova,Omen,Jett"
Split,彡(ﾟ)(ﾟ) グエー新団子,マジスク学園卓球部,1,13,1,11,2,0,"Raze,Cypher,Skye,Astra,Iso","Raze,Cypher,Omen,Jett,Skye"
Haven,Arena Internet Cafe,Hornswogglers,8,13,6,3,10,2,"Breach,Cypher,Sova,Omen,Neon","Breach,Cypher,Sova,Omen,Neon"
Bind,男が先に前出ろ,VoL,7,13,1,7,6,6,"Raze,Yoru,Chamber,Gekko,Clove","Raze,Cypher,Brimstone,Jett,Skye"
Haven,Blue Otter,Trust In Plug,15,13,7,7,6,8,"Breach,Cypher,Sova,Omen,Neon","Breach,Sova,Omen,Chamber,Neon"
Sunset,Blue Otter,Trust In Plug,13,9,5,5,4,8,"Breach,Cypher,Sova,Omen,Neon","Breach,Cypher,Omen,Neon,Gekko"
Bind,Blue Otter,SaD Esports,13,9,6,6,3,7,"Raze,Cypher,Viper,Brimstone,Skye","Raze,Viper,Brimstone,Skye,Gekko"
Split,KTANA Esports,FUSION,13,11,5,7,4,8,"Raze,Cypher,Omen,Fade,Deadlock","Omen,Skye,Neon,Deadlock"
Haven,Blue Otter,SaD Esports,15,17,11,5,12,4,"Breach,Cypher,Sova,Omen,Neon","Breach,Cypher,Sova,Omen,Neon"
Sunset,Trust In Plug,ROSE,13,10,7,5,5,6,"Breach,Cypher,Omen,Neon,Gekko","Breach,Cypher,Omen,Neon,Fade"
Bind,KTANA Esports,FUSION,13,11,7,5,6,6,"Raze,Cypher,Brimstone,Skye,Deadlock","Brimstone,Skye,Neon,Fade,Deadlock"
Abyss,Blue Otter,SaD Esports,13,10,7,4,6,6,"Cypher,Sova,Viper,Yoru,Astra","Sova,Omen,Jett,Astra,KAY/O"
Bind,Trust In Plug,ROSE,14,12,5,8,4,9,"Raze,Viper,Brimstone,Skye,Deadlock","Raze,Skye,Astra,Gekko,Deadlock"
Haven,Antares Esports,Illicit Gaming,13,11,10,2,9,3,"Cypher,Sova,Omen,Yoru,Iso","Cypher,Sova,Viper,Omen,Yoru"
Split,SaD Esports,ROSE,13,9,6,6,3,7,"Raze,Yoru,Astra,Fade,Deadlock","Raze,Viper,Skye,Astra,Neon"
Haven,Trust In Plug,Blue Otter,8,13,5,7,6,3,"Breach,Sova,Omen,Chamber,Neon","Breach,Cypher,Sova,Omen,Neon"
Pearl,SaD Esports,ROSE,13,0,12,0,0,1,"Cypher,Sova,Astra,KAY/O,Neon","Killjoy,Yoru,Astra,Neon,Fade"
Sunset,Trust In Plug,Blue Otter,13,5,3,3,2,10,"Breach,Cypher,Omen,Neon,Gekko","Breach,Cypher,Sova,Omen,Neon"
Ascent,Antares Esports,Illicit Gaming,13,8,9,3,5,4,"Sova,Killjoy,Omen,Jett,KAY/O","Cypher,Sova,Omen,Jett,Deadlock"
Abyss,SaD Esports,ROSE,11,13,9,3,10,2,"Cypher,Sova,Viper,Yoru,Astra","Sova,Jett,Yoru,Astra,Deadlock"
Ascent,Trust In Plug,Blue Otter,8,13,1,8,5,7,"Cypher,Sova,Omen,Yoru,Deadlock","Cypher,Sova,Omen,Yoru,Deadlock"
Haven,Nightblood Gaming,QoR,13,10,6,5,5,7,"Breach,Cypher,Sova,Omen,Neon","Breach,Cypher,Sova,Omen,Neon"
Split,Nightblood Gaming,QoR,12,14,6,7,7,6,"Cypher,Viper,Reyna,Omen,Skye","Yoru,Astra,Neon,Fade,Deadlock"
Ascent,Nightblood Gaming,QoR,13,7,7,5,2,6,"Cypher,Sova,Omen,Yoru,Deadlock","Cypher,Sova,Omen,Yoru,Deadlock"
Ascent,RANKERS,Nightblood Gaming,13,5,9,3,2,4,"Cypher,Sova,Jett,Yoru,Clove","Cypher,Sova,Omen,Yoru,Deadlock"
Split,Turtle Troop,QoR,11,13,7,5,8,4,"Raze,Viper,Omen,Jett,Skye","Yoru,Astra,Neon,Fade,Deadlock"
Sunset,RANKERS,Nightblood Gaming,13,5,8,4,1,5,"Cypher,Sova,Yoru,Neon,Clove","Breach,Cypher,Omen,Neon,Fade"
Pearl,Turtle Troop,QoR,11,13,7,5,8,4,"Breach,Sova,Killjoy,Astra,Neon","Killjoy,Astra,KAY/O,Neon,Fade"
Bind,MYVRA,Antares Esports,3,13,3,9,4,0,"Raze,Viper,Brimstone,Skye","Brimstone,Skye,Neon,Gekko,Deadlock"
Bind,RANKERS,Nightblood Gaming,14,16,8,7,9,6,"Raze,Skye,Yoru,Deadlock,Clove","Viper,Brimstone,Skye,Neon,Deadlock"
Abyss,Turtle Troop,QoR,13,5,8,4,1,5,"Sova,Omen,Jett,Astra","Cypher,Sova,Omen,Yoru,Deadlock"
Pearl,MYVRA,Antares Esports,9,13,6,6,7,3,"Cypher,Astra,KAY/O,Neon,Fade","Killjoy,Astra,KAY/O,Neon,Fade"
Sunset,QoR,Nightblood Gaming,9,13,2,10,3,7,"Breach,Cypher,Omen,Neon,Fade","Breach,Cypher,Omen,Neon,Fade"
Sunset,Chivas Esports,Illicit Gaming,7,13,2,6,7,5,"Breach,Cypher,Sova,Omen,Neon","Breach,Cypher,Omen,KAY/O,Neon"
Pearl,QoR,Nightblood Gaming,13,10,6,6,4,7,"Killjoy,Astra,KAY/O,Neon,Fade","Killjoy,Astra,KAY/O,Neon,Fade"
Haven,Chivas Esports,Illicit Gaming,13,15,6,8,7,7,"Breach,Viper,Omen,Neon,Deadlock","Cypher,Sova,Viper,Omen,Yoru"
Ascent,Turtle Troop,RANKERS,7,13,5,7,6,2,"Cypher,Sova,Omen,Yoru,Deadlock","Sova,Killjoy,Jett,Yoru,Clove"
Haven,Turtle Troop,RANKERS,2,13,0,3,10,2,"Breach,Cypher,Sova,Omen,Neon","Cypher,Sova,Yoru,Iso,Clove"
Ascent,QoR,Nightblood Gaming,11,13,3,9,4,8,"Cypher,Sova,Omen,Yoru,Deadlock","Cypher,Sova,Omen,Yoru,Deadlock"
Haven,Cloud9,T1,6,13,2,5,8,4,"Breach,Cypher,Sova,Omen,Neon","Breach,Cypher,Sova,Omen,Neon"
Bind,Cloud9,T1,8,13,2,7,6,6,"Raze,Cypher,Viper,Brimstone,Skye","Raze,Brimstone,KAY/O,Gekko"
Pearl,Cloud9,T1,13,8,7,5,3,6,"Cypher,Sova,Astra,KAY/O,Neon","Sova,Killjoy,Yoru,Astra,Neon"
Abyss,Cloud9,T1,10,13,5,6,7,5,"Sova,Omen,Jett,Astra,KAY/O","Breach,Cypher,Sova,Yoru,Astra"
Ascent,T1,FUT Esports,13,10,7,4,6,6,"Sova,Killjoy,Omen,Jett,KAY/O","Sova,Killjoy,Omen,Yoru,KAY/O"
Pearl,T1,FUT Esports,3,13,3,9,4,0,"Sova,Killjoy,Yoru,Astra,Neon","Killjoy,Omen,Yoru,Fade"
Bind,T1,FUT Esports,13,5,6,0,5,7,"Raze,Brimstone,KAY/O,Gekko","Breach,Raze,Viper,Omen,Gekko"
Pearl,Moist x Shopify,Funhavers,9,13,5,7,6,4,"Omen,Yoru,Astra,Fade,Deadlock","Sova,Killjoy,Astra,KAY/O,Neon"
Split,Moist x Shopify,Funhavers,13,8,7,5,3,6,"Raze,Cypher,Viper,Omen,Skye","Raze,Cypher,Viper,Omen,Skye"
Bind,Moist x Shopify,Funhavers,12,14,2,11,3,10,"Raze,Viper,Astra,Fade,Gekko","Raze,Cypher,Omen,Yoru,Deadlock"
Haven,FUSION,E-Xolos LAZER,11,13,6,6,7,5,"Breach,Sova,Killjoy,Omen,Neon","Breach,Cypher,Sova,Omen,Neon"
Split,Moist x Shopify,YFP Gaming,15,17,8,8,9,7,"Raze,Cypher,Viper,Omen,Skye","Raze,Viper,Skye,Astra"
Bind,FUSION,E-Xolos LAZER,9,13,3,7,6,6,"Brimstone,Skye,Neon,Fade,Deadlock","Raze,Brimstone,Skye,KAY/O"
Abyss,Moist x Shopify,YFP Gaming,11,13,7,5,8,4,"Sova,Omen,Yoru,Astra,Deadlock","Cypher,Sova,Jett,Astra,KAY/O"
Sunset,Funhavers,Maryville University,13,4,10,2,2,3,"Breach,Cypher,Sova,Omen,Neon","Breach,Cypher,Sova,Omen,Neon"
Pearl,Six Karma,KTANA Esports,13,7,6,6,1,7,"Breach,Cypher,Astra,Neon,Gekko","Cypher,Yoru,Astra,Fade,Deadlock"
Pearl,Funhavers,Maryville University,13,4,4,1,3,9,"Sova,Killjoy,Astra,KAY/O,Neon","Cypher,Astra,KAY/O,Neon,Fade"
Ascent,Moist x Shopify,YFP Gaming,13,10,2,9,1,11,"Cypher,Sova,Omen,Yoru,Deadlock","Cypher,Sova,Omen,Jett,Deadlock"
Haven,Six Karma,KTANA Esports,11,13,7,5,8,4,"Breach,Sova,Killjoy,Astra,Neon","Breach,Cypher,Sova,Omen,Neon"
Bind,Six Karma,KTANA Esports,13,4,4,1,3,9,"Viper,Yoru,Astra,Fade,Gekko","Raze,Cypher,Brimstone,Skye,Deadlock"
Pearl,Moist x Shopify,Funhavers,13,10,5,6,4,8,"Omen,Yoru,Astra,Fade,Deadlock","Sova,Killjoy,Astra,KAY/O,Neon"
Haven,YFP Gaming,Maryville University,15,13,11,3,10,4,"Breach,Cypher,Sova,Omen,Neon","Breach,Cypher,Sova,Omen,Neon"
Bind,YFP Gaming,Maryville University,13,3,11,1,2,2,"Raze,Viper,Brimstone,Skye,Gekko","Raze,Cypher,Brimstone,Skye,Deadlock"
Haven,Moist x Shopify,Funhavers,13,5,7,5,0,6,"Breach,Cypher,Sova,Omen,Neon","Breach,Cypher,Sova,Omen,Neon"
Pearl,G2 Esports,Cloud9,4,13,0,5,8,4,"Sova,Killjoy,Astra,KAY/O,Neon","Cypher,Sova,Astra,KAY/O,Neon"
Sunset,G2 Esports,Cloud9,5,13,5,7,6,0,"Breach,Cypher,Omen,Neon,Fade","Breach,Cypher,Omen,Neon,Fade"
Bind,FNATIC,G2 Esports,2,13,2,10,3,0,"Raze,Viper,Astra,Fade,Gekko","Raze,Viper,Brimstone,Skye,Gekko"
Haven,FNATIC,G2 Esports,9,13,4,8,5,5,"Cypher,Sova,Omen,Yoru,Iso","Breach,Cypher,Sova,Omen,Neon"
Ascent,Ambrosia,TSM,5,13,3,9,4,2,"Cypher,Sova,Viper,Omen,Yoru","Sova,Killjoy,Omen,Jett,KAY/O"
Sunset,Ambrosia,TSM,14,16,10,5,11,4,"Breach,Raze,Cypher,Omen,Deadlock","Breach,Cypher,Omen,Neon,Fade"
Bind,FUSION,Illicit Gaming,13,11,7,5,6,6,"Brimstone,Skye,Neon,Fade,Deadlock","Raze,Cypher,Brimstone,Skye,Deadlock"
Haven,Winthrop University,Ambrosia,13,5,5,1,4,8,"Breach,Cypher,Sova,Omen,Neon","Sova,Killjoy,Viper,Omen,Yoru"
Sunset,TSM,Lemonade Stand,13,8,4,5,3,9,"Breach,Cypher,Omen,Neon,Fade","Sova,Viper,Omen,Yoru"
Sunset,Winthrop University,Ambrosia,13,8,6,3,5,7,"Breach,Cypher,Sova,Omen,Neon","Breach,Raze,Cypher,Omen,Deadlock"
Sunset,FUSION,Illicit Gaming,13,11,5,7,4,8,"Breach,Cypher,Omen,Neon,Fade","Breach,Cypher,Omen,KAY/O,Neon"
Haven,TSM,Lemonade Stand,13,2,12,0,2,1,"Breach,Sova,Killjoy,Jett,Astra","Breach,Cypher,Sova,Omen,Neon"
Abyss,Antares Esports,E-Xolos LAZER,6,13,0,7,6,6,"Cypher,Sova,Omen,Jett,Gekko","Sova,Omen,Jett,Astra"
Abyss,Winthrop University,Ambrosia,16,14,9,6,8,7,"Sova,Omen,Jett,Yoru,Astra","Cypher,Sova,Jett,Astra,Gekko"
Bind,TSM,Lemonade Stand,9,13,3,7,6,6,"Raze,Viper,Brimstone,Sage,Skye","Raze,Viper,Brimstone,Skye,Gekko"
Haven,TSM,Winthrop University,7,13,5,7,6,2,"Breach,Sova,Killjoy,Jett,Astra","Breach,Cypher,Sova,Omen,Neon"
Sunset,Ambrosia,Lemonade Stand,13,11,5,7,4,8,"Breach,Raze,Cypher,Omen,Deadlock","Sova,Viper,Omen,Yoru"
Sunset,TSM,Winthrop University,11,13,6,6,7,5,"Breach,Cypher,Omen,Neon,Fade","Breach,Cypher,Sova,Omen,Neon"
Haven,FNATIC,FOKUS,13,4,10,2,2,3,"Cypher,Sova,Omen,Yoru,Iso","Breach,Sova,Killjoy,Omen,Neon"
Abyss,Ambrosia,Lemonade Stand,13,4,8,4,0,5,"Sova,Omen,Jett,Yoru,Astra","Sova,Omen,Yoru,Astra"
Haven,FUT Esports,Karmine Corp,13,5,8,4,1,5,"Breach,Cypher,Omen,KAY/O,Neon","Breach,Cypher,Sova,Astra,Neon"
Bind,G2 Esports,T1,11,13,4,8,5,7,"Raze,Viper,Brimstone,Skye,Gekko","Raze,Brimstone,KAY/O,Gekko"
Abyss,Team Heretics,Cloud9,11,13,8,4,9,3,"Breach,Sova,Astra,KAY/O,Neon","Sova,Omen,Jett,Astra,KAY/O"
Ascent,FUT Esports,T1,7,13,1,7,6,6,"Sova,Killjoy,Omen,Jett,KAY/O","Sova,Killjoy,Omen,Jett,KAY/O"
Haven,G2 Esports,Karmine Corp,13,7,6,2,5,7,"Breach,Cypher,Sova,Omen,Neon","Breach,Cypher,Sova,Astra,Neon"
Abyss,FNATIC,Cloud9,11,13,9,3,10,2,"Sova,Viper,Omen,Yoru,Iso","Sova,Omen,Jett,Astra,KAY/O"
Split,Team Heretics,FOKUS,13,11,4,8,3,9,"Breach,Raze,Astra,KAY/O,Fade","Raze,Cypher,Sage,Omen,Jett"
Sunset,Arena Internet Cafe,JiJieHao Bonkers,9,13,4,8,5,5,"Breach,Cypher,Sova,Omen,Neon","Breach,Cypher,Omen,Neon,Fade"
Split,Arena Internet Cafe,JiJieHao Bonkers,7,13,2,6,7,5,"Raze,Cypher,Omen,Skye,Neon","Raze,Cypher,Viper,Omen,Skye"
Ascent,Kebab Clan,FOCUSGG,13,11,7,5,6,6,"Cypher,Sova,Omen,Jett,KAY/O","Cypher,Sova,Omen,KAY/O,Neon"
Sunset,Kebab Clan,FOCUSGG,13,6,7,5,1,6,"Cypher,Sova,Omen,KAY/O,Neon","Breach,Raze,Cypher,Omen,Neon"
Bind,Six Karma,MYVRA,13,10,4,8,2,9,"Viper,Yoru,Astra,Fade,Gekko","Raze,Viper,Brimstone,Skye"
Haven,Six Karma,MYVRA,13,4,4,1,3,9,"Breach,Sova,Killjoy,Astra,Neon","Breach,Cypher,Sova,Omen,Neon"
Pearl,Chivas Esports,KTANA Esports,4,13,4,8,5,0,"Sova,Killjoy,Yoru,Astra,Iso","Cypher,Yoru,Astra,Fade,Deadlock"
Split,Chivas Esports,KTANA Esports,4,13,2,10,3,2,"Raze,Omen,Skye,Astra","Raze,Cypher,Omen,Fade,Deadlock"
Split,Rub n' Pug,Vatles Esports,12,14,8,5,9,4,"Raze,Cypher,Omen,Jett,Skye","Raze,Cypher,Omen,Jett,Skye"
Ascent,Rub n' Pug,Vatles Esports,13,7,6,6,1,7,"Cypher,Sova,Omen,Jett,Deadlock","Cypher,Sova,Omen,Jett,Deadlock"
Haven,Rub n' Pug,Vatles Esports,5,13,2,10,3,3,"Cypher,Sova,Phoenix,Omen,Neon","Cypher,Sova,Omen,Jett,Neon"
Ascent,Koopa Troopas,Hornswogglers,9,13,3,7,6,6,"Sova,Killjoy,Omen,Jett,KAY/O","Sova,Killjoy,Omen,Jett,KAY/O"
Abyss,Koopa Troopas,Hornswogglers,8,13,7,5,8,1,"Sova,Omen,Jett,Astra,KAY/O","Cypher,Sova,Jett,Yoru,Astra"
Pearl,Koopa Troopas,Hornswogglers,13,5,6,0,5,7,"Sova,Killjoy,Astra,KAY/O,Neon","Sova,Killjoy,Phoenix,Jett,Astra"
Abyss,JiJieHao Bonkers,Vatles Esports,13,3,11,1,2,2,"Sova,Omen,Jett,Yoru,Astra","Cypher,Sova,Jett,Astra,Neon"
Abyss,JiJieHao Bonkers,Vatles Esports,13,3,11,1,2,2,"Sova,Omen,Jett,Yoru,Astra","Cypher,Sova,Jett,Astra,Neon"
Bind,Arena Internet Cafe,Rub n' Pug,13,11,8,4,7,5,"Raze,Viper,Brimstone,Skye,Gekko","Raze,Viper,Reyna,Skye,Clove"
Haven,Arena Internet Cafe,Rub n' Pug,13,2,10,2,0,3,"Breach,Cypher,Sova,Omen,Neon","Cypher,Sova,Phoenix,Omen,Neon"
Ascent,FOCUSGG,Hornswogglers,13,8,7,5,3,6,"Cypher,Sova,Reyna,Omen,Neon","Sova,Killjoy,Omen,Jett,KAY/O"
Pearl,FOCUSGG,Hornswogglers,13,5,10,2,3,3,"Cypher,Phoenix,Skye,Astra,Neon","Sova,Killjoy,Phoenix,Astra,Neon"
Split,Kebab Clan,Koopa Troopas,13,4,9,3,1,4,"Raze,Cypher,Omen,Jett,Skye","Raze,Cypher,Viper,Omen,Skye"
Ascent,Kebab Clan,Koopa Troopas,13,8,3,6,2,10,"Cypher,Sova,Omen,Jett,KAY/O","Sova,Killjoy,Omen,Jett,KAY/O"
Bind,FOCUSGG,Arena Internet Cafe,11,13,6,6,7,5,"Raze,Cypher,Brimstone,Skye,Neon","Raze,Viper,Brimstone,Skye,Gekko"
Pearl,FOCUSGG,Arena Internet Cafe,7,13,4,8,5,3,"Cypher,Phoenix,Skye,Astra,Neon","Sova,Killjoy,Phoenix,Jett,Astra"
Sunset,FOCUSGG,Arena Internet Cafe,13,11,6,6,5,7,"Breach,Raze,Cypher,Omen,Neon","Breach,Cypher,Sova,Omen,Neon"
Haven,JiJieHao Bonkers,Arena Internet Cafe,11,13,9,3,10,2,"Breach,Cypher,Sova,Omen,Neon","Breach,Cypher,Sova,Omen,Neon"
Abyss,JiJieHao Bonkers,Arena Internet Cafe,14,16,7,8,8,7,"Sova,Omen,Jett,Yoru,Astra","Cypher,Sova,Jett,Yoru,Astra"
Sunset,G2 Gozen,MIBR GC,1,13,0,2,11,1,"Breach,Cypher,Omen,Neon,Fade","Breach,Raze,Cypher,Omen,Gekko"
Bind,G2 Gozen,MIBR GC,10,13,2,10,3,8,"Breach,Raze,Viper,Omen,Fade","Raze,Viper,Brimstone,Fade,Gekko"
Abyss,G2 Gozen,MIBR GC,9,13,6,6,7,3,"Cypher,Sova,Omen,Jett,KAY/O","Cypher,Sova,Jett,Astra,KAY/O"
Sunset,Xipto Esports,MIBR GC,5,13,1,5,8,4,"Cypher,Sova,Omen,KAY/O,Neon","Breach,Raze,Cypher,Omen,Gekko"
Split,Xipto Esports,MIBR GC,13,6,9,3,3,4,"Raze,Cypher,Omen,Skye,Neon","Breach,Raze,Viper,Omen,Skye"
Bind,Xipto Esports,MIBR GC,4,13,3,2,11,1,"Raze,Viper,Brimstone,Fade,Gekko","Raze,Viper,Brimstone,Fade,Gekko"
Haven,G2 Gozen,Shopify Rebellion,12,14,6,7,7,6,"Breach,Cypher,Sova,Omen,Neon","Breach,Cypher,Sova,Omen,Neon"
Abyss,G2 Gozen,Shopify Rebellion,15,17,10,6,11,5,"Cypher,Sova,Omen,Jett,KAY/O","Cypher,Sova,Omen,Jett,KAY/O"
Pearl,Xipto Esports,KRÜ BLAZE,13,9,5,5,4,8,"Jett,Astra,Neon,Fade,Harbor","Cypher,Sova,Astra,KAY/O,Neon"
Abyss,Xipto Esports,KRÜ BLAZE,13,10,9,2,8,4,"Sova,Brimstone,Jett,Astra,KAY/O","Cypher,Sova,Omen,Jett,KAY/O"
Haven,Xipto Esports,KRÜ BLAZE,6,13,4,8,5,2,"Breach,Cypher,Sova,Omen,Neon","Breach,Cypher,Sova,Omen,Neon"
Sunset,MIBR GC,ZETA DIVISION GC,13,3,9,3,0,4,"Breach,Raze,Cypher,Omen,Gekko","Breach,Raze,Cypher,Sova,Omen"
Ascent,MIBR GC,ZETA DIVISION GC,13,0,1,0,0,12,"Sova,Killjoy,Omen,Jett,KAY/O","Sova,Killjoy,Omen,Jett,KAY/O"
Bind,TEAM YATSUKA,TEAM CAEDYE,13,10,8,3,7,5,"Cypher,Brimstone,Neon,Fade,Deadlock","Raze,Cypher,Brimstone,Skye,Deadlock"
Haven,TEAM YATSUKA,TEAM CAEDYE,16,18,11,6,12,5,"Cypher,Viper,Omen,Iso,Clove","Cypher,Sova,Reyna,Neon,Clove"
Split,TEAM YATSUKA,TEAM CAEDYE,13,6,7,5,1,6,"Breach,Raze,Cypher,Neon,Clove","Raze,Cypher,Omen,Jett,Skye"
Sunset,Shopify Rebellion,Xipto Esports,13,11,8,4,7,5,"Breach,Cypher,Sova,Omen,Neon","Cypher,Sova,Omen,KAY/O,Neon"
Pearl,Shopify Rebellion,Xipto Esports,13,8,6,6,2,7,"Sova,Killjoy,Jett,Astra,KAY/O","Jett,Astra,Neon,Fade,Harbor"
Sunset,G2 Gozen,MIBR GC,13,4,3,2,2,10,"Breach,Cypher,Omen,Neon,Fade","Breach,Raze,Cypher,Omen,Gekko"
Split,G2 Gozen,MIBR GC,13,8,5,4,4,8,"Raze,Cypher,Omen,Skye,Deadlock","Breach,Raze,Viper,Omen,Skye"
Bind,G2 Gozen,MIBR GC,8,13,6,6,7,2,"Raze,Cypher,Brimstone,Fade,Gekko","Raze,Viper,Brimstone,Fade,Gekko"
Split,KRÜ BLAZE,GIANTX GC,13,9,6,4,5,7,"Raze,Viper,Omen,Skye,Astra","Raze,Viper,Jett,Skye,Astra"
Bind,KRÜ BLAZE,GIANTX GC,14,12,7,6,6,7,"Viper,Brimstone,Skye,Yoru,Neon","Raze,Viper,Sage,Skye,Harbor"
Haven,Team Falcons Vega,ZETA DIVISION GC,7,13,4,8,5,3,"Cypher,Sova,Omen,Neon,Iso","Breach,Cypher,Sova,Omen,Neon"
Ascent,Team Falcons Vega,ZETA DIVISION GC,8,13,0,9,4,8,"Cypher,Sova,Omen,Yoru,Iso","Sova,Killjoy,Omen,Jett,KAY/O"
Ascent,Randoms (OCE),Dreams To Legends (OCE),18,16,7,10,6,11,"Sova,Killjoy,Omen,Yoru,Clove","Sova,Killjoy,Omen,Jett,KAY/O"
Pearl,Randoms (OCE),Dreams To Legends (OCE),13,4,3,2,2,10,"Sova,Astra,Chamber,Neon,Gekko","Breach,Killjoy,Astra,Neon,Fade"
Ascent,GIANTX GC,Ambitious Legend Gaming GC,13,1,2,0,1,11,"Sova,Killjoy,Omen,Jett,KAY/O","Sova,Killjoy,Omen,Jett,KAY/O"
Haven,GIANTX GC,Ambitious Legend Gaming GC,13,10,7,4,6,6,"Breach,Killjoy,Viper,Omen,Yoru","Breach,Cypher,Sova,Omen,Jett"
Ascent,FlyQuest RED,ZETA DIVISION GC,6,13,3,9,4,3,"Cypher,Sova,Omen,Jett,Deadlock","Sova,Killjoy,Omen,Jett,KAY/O"
Sunset,FlyQuest RED,ZETA DIVISION GC,10,13,5,6,7,5,"Breach,Cypher,Sova,Omen,Neon","Breach,Raze,Cypher,Sova,Omen"
Haven,FlyQuest RED,ZETA DIVISION GC,13,6,8,4,2,5,"Breach,Cypher,Sova,Omen,Neon","Breach,Cypher,Sova,Omen,Neon"
Lotus,esports team αD,REJECT,11,13,5,7,6,6,"Breach,Omen,Chamber,Neon,Fade","Cypher,Reyna,Omen,Jett,Fade"
Ascent,esports team αD,REJECT,3,13,3,9,4,0,"Sova,Killjoy,Omen,Jett,KAY/O","Sova,Killjoy,Omen,Jett,KAY/O"
Sunset,Arena Internet Cafe,BOBO,13,9,5,7,2,8,"Breach,Cypher,Sova,Omen,Neon","Raze,Cypher,Sova,Omen,Gekko"
Haven,Arena Internet Cafe,BOBO,13,2,10,2,0,3,"Breach,Cypher,Sova,Omen,Neon","Breach,Cypher,Sova,Omen,Jett"
Pearl,Arena Internet Cafe,BOBO,6,13,4,8,5,2,"Sova,Killjoy,Phoenix,Jett,Astra","Sova,Killjoy,Jett,Skye,Astra"
Sunset,FOCUSGG,JiJieHao Bonkers,13,7,8,4,3,5,"Breach,Raze,Cypher,Omen,Neon","Breach,Cypher,Omen,Neon,Fade"
Ascent,FOCUSGG,JiJieHao Bonkers,13,4,8,4,0,5,"Cypher,Sova,Reyna,Omen,Neon","Sova,Killjoy,Omen,Jett,KAY/O"
Ascent,Kebab Clan,BOBO,11,13,5,7,6,6,"Sova,Killjoy,Omen,Jett,KAY/O","Sova,Killjoy,Omen,Jett,KAY/O"
Ascent,Arena Internet Cafe,Hornswogglers,13,9,7,5,4,6,"Sova,Killjoy,Omen,Jett,KAY/O","Sova,Killjoy,Omen,Jett,KAY/O"
Sunset,Kebab Clan,BOBO,12,14,6,7,7,6,"Cypher,Sova,Omen,KAY/O,Neon","Raze,Cypher,Sova,Omen,Gekko"
Split,FOCUSGG,JiJieHao Bonkers,13,15,9,5,10,4,"Breach,Raze,Omen,Yoru,Neon","Raze,Cypher,Viper,Omen,Skye"
Pearl,Arena Internet Cafe,Hornswogglers,13,4,4,1,3,9,"Sova,Killjoy,Phoenix,Jett,Astra","Killjoy,Phoenix,Astra,Neon,Fade"
Ascent,Shopify Rebellion,Team Falcons Vega,13,7,10,2,5,3,"Cypher,Sova,Omen,Yoru,Deadlock","Cypher,Sova,Omen,Yoru,Iso"
Haven,Shopify Rebellion,Team Falcons Vega,13,4,9,3,1,4,"Breach,Cypher,Sova,Omen,Neon","Cypher,Sova,Omen,Neon,Iso"
Abyss,G2 Gozen,KRÜ BLAZE,13,11,9,3,8,4,"Cypher,Sova,Omen,Jett,KAY/O","Cypher,Sova,Omen,Jett,KAY/O"
Sunset,G2 Gozen,KRÜ BLAZE,13,9,6,4,5,7,"Breach,Cypher,Omen,Neon,Fade","Breach,Cypher,Sova,Omen,Neon"
Haven,G2 Gozen,KRÜ BLAZE,8,13,3,6,7,5,"Breach,Cypher,Sova,Omen,Neon","Breach,Cypher,Sova,Omen,Neon"
Sunset,GIANTX GC,MIBR GC,4,13,1,4,9,3,"Cypher,Sova,Omen,KAY/O,Neon","Breach,Raze,Cypher,Omen,Gekko"
Pearl,GIANTX GC,MIBR GC,10,13,7,4,9,3,"Cypher,Sova,Jett,Astra,KAY/O","Killjoy,Viper,Jett,Skye,Astra"
Haven,REJECT,PARON,13,8,6,6,2,7,"Breach,Cypher,Sova,Omen,Neon","Breach,Cypher,Sova,Omen,Neon"
Sunset,REJECT,PARON,13,8,8,4,4,5,"Breach,Cypher,Sova,Omen,Neon","Breach,Cypher,Sova,Omen,Neon"
Ascent,REJECT,PARON,11,13,4,8,5,7,"Sova,Killjoy,Omen,Jett,KAY/O","Sova,Killjoy,Omen,Jett,KAY/O"
Bind,ArcoBaleNO,PARON,8,13,3,6,7,5,"Raze,Viper,Brimstone,Fade,Gekko","Breach,Brimstone,Jett,Neon,Fade"
Lotus,REJECT,esports team αD,12,14,3,10,4,9,"Raze,Cypher,Omen,Jett,Skye","Breach,Omen,Chamber,Neon,Fade"
Sunset,Mejais Soulstealers,BOBO,4,13,1,4,9,3,"Cypher,Sova,Omen,Neon,Gekko","Raze,Cypher,Sova,Omen,Gekko"
Sunset,ArcoBaleNO,PARON,9,13,4,6,7,5,"Breach,Cypher,Sova,Omen,Neon","Breach,Cypher,Sova,Omen,Neon"
Ascent,REJECT,esports team αD,10,13,7,4,9,3,"Sova,Killjoy,Omen,Jett,KAY/O","Sova,Killjoy,Omen,Jett,KAY/O"
Sunset,Kebab Clan,JiJieHao Bonkers,7,13,1,7,6,6,"Cypher,Sova,Omen,KAY/O,Neon","Breach,Cypher,Omen,Neon,Fade"
Ascent,Arena Internet Cafe,FOCUSGG,5,13,0,6,7,5,"Sova,Killjoy,Omen,Jett,KAY/O","Cypher,Sova,Reyna,Omen,Neon"
Sunset,FOCUSGG,BOBO,14,12,10,3,9,4,"Breach,Raze,Cypher,Omen,Neon","Raze,Cypher,Sova,Omen,Gekko"
Haven,Arena Internet Cafe,iPGN,13,3,9,3,0,4,"Breach,Cypher,Sova,Omen,Neon","Cypher,Sova,Reyna,Omen,Jett"
Abyss,JiJieHao Bonkers,Rub n' Pug,13,3,4,0,3,9,"Sova,Omen,Jett,Yoru,Astra","Sova,Omen,Jett,KAY/O,Clove"
Split,Kebab Clan,Hornswogglers,13,6,4,3,3,9,"Raze,Cypher,Omen,Jett,Skye","Raze,Brimstone,Skye,Astra,Deadlock"
Split,FlyQuest RED,Xipto Esports,13,15,7,7,8,6,"Raze,Cypher,Omen,Skye,Deadlock","Raze,Cypher,Omen,Skye,Neon"
Sunset,FlyQuest RED,Xipto Esports,13,8,6,6,2,7,"Breach,Cypher,Sova,Omen,Neon","Cypher,Sova,Omen,KAY/O,Neon"
Pearl,FlyQuest RED,Xipto Esports,4,13,3,9,4,1,"Cypher,Sova,Phoenix,Astra,Neon","Jett,Astra,Neon,Fade,Harbor"
Split,Ambitious Legend Gaming GC,Team Falcons Vega,2,13,0,12,1,2,"Breach,Raze,Cypher,Omen,Skye","Cypher,Omen,Yoru,Fade,Deadlock"
Haven,Ambitious Legend Gaming GC,Team Falcons Vega,6,13,2,5,8,4,"Breach,Cypher,Sova,Omen,Jett","Cypher,Sova,Omen,Neon,Iso"
Ascent,KRÜ BLAZE,ZETA DIVISION GC,13,9,6,4,5,7,"Sova,Killjoy,Omen,Jett,KAY/O","Sova,Killjoy,Omen,Jett,KAY/O"
Bind,KRÜ BLAZE,ZETA DIVISION GC,13,9,6,4,5,7,"Viper,Brimstone,Skye,Yoru,Neon","Raze,Cypher,Viper,Brimstone,Skye"
Lotus,esports team αD,PARON,14,12,10,3,9,4,"Breach,Omen,Chamber,Neon,Fade","Breach,Cypher,Omen,Neon,Fade"
Haven,ArcoBaleNO,REJECT,8,13,4,5,8,4,"Breach,Cypher,Sova,Omen,Neon","Breach,Cypher,Sova,Omen,Neon"
Haven,esports team αD,PARON,13,10,3,8,2,10,"Breach,Cypher,Sova,Omen,Jett","Breach,Cypher,Sova,Omen,Neon"
Lotus,ArcoBaleNO,REJECT,5,13,2,4,9,3,"Breach,Omen,Neon,Fade,Clove","Raze,Cypher,Omen,Jett,Skye"
Sunset,REJECT,Chrysalis,13,3,9,3,0,4,"Breach,Cypher,Sova,Omen,Neon","Breach,Cypher,Sova,Omen,Neon"
Ascent,REJECT,Chrysalis,13,4,8,4,0,5,"Sova,Killjoy,Omen,Jett,KAY/O","Sova,Killjoy,Omen,Jett,KAY/O"
Split,Furious Gaming,RETA Esports,13,6,10,2,4,3,"Breach,Raze,Cypher,Skye,Astra","Breach,Raze,Cypher,Omen,Skye"
Pearl,Furious Gaming,RETA Esports,4,13,0,5,8,4,"Cypher,Astra,KAY/O,Neon,Fade","Cypher,Sova,Jett,Astra,KAY/O"
Haven,Furious Gaming,RETA Esports,12,14,2,11,3,10,"Breach,Cypher,Sova,Omen,Neon","Breach,Cypher,Sova,Omen,Neon"
Bind,Furious Gaming,RETA Esports,13,8,7,2,6,6,"Cypher,Brimstone,Skye,Neon,Iso","Raze,Viper,Brimstone,Skye,Gekko"
Sunset,Furious Gaming,RETA Esports,13,6,8,4,2,5,"Breach,Cypher,Sova,Omen,Neon","Breach,Cypher,Sova,Omen,Neon"
Pearl,RETA Esports,Rebirth Esports,13,9,6,4,5,7,"Sova,Jett,Astra,KAY/O,Chamber","Killjoy,Yoru,Astra,Fade,Harbor"
Haven,RETA Esports,Rebirth Esports,9,13,5,7,6,4,"Breach,Cypher,Sova,Omen,Neon","Breach,Cypher,Sova,Omen,Neon"
Bind,RETA Esports,Rebirth Esports,13,9,6,4,5,7,"Raze,Viper,Brimstone,Skye,Gekko","Raze,Viper,Brimstone,Fade,Gekko"
Ascent,RETA Esports,Rebirth Esports,13,5,9,3,2,4,"Sova,Killjoy,Omen,Jett,KAY/O","Cypher,Sova,Omen,Yoru,Deadlock"
Sunset,Rebirth Esports,Aura,13,8,6,6,2,7,"Breach,Cypher,Sova,Omen,Neon","Breach,Cypher,Sova,Omen,Neon"
Bind,Rebirth Esports,Aura,13,10,5,6,4,8,"Raze,Viper,Brimstone,Fade,Gekko","Raze,Viper,Brimstone,Skye,Gekko"
Haven,Furious Gaming,RETA Esports,13,9,5,5,4,8,"Breach,Cypher,Sova,Omen,Neon","Breach,Cypher,Sova,Omen,Neon"
Abyss,Furious Gaming,RETA Esports,13,11,6,6,5,7,"Cypher,Sova,Omen,Jett,Iso","Sova,Killjoy,Omen,Jett,Astra"
Ascent,DINGLE GOOGY and friends,Vatles Esports,3,13,2,10,3,1,"Sova,Killjoy,Omen,KAY/O,Neon","Cypher,Sova,Omen,Jett,KAY/O"
Ascent,BOBO,Koopa Troopas,8,13,4,8,5,4,"Sova,Killjoy,Omen,Jett,KAY/O","Sova,Killjoy,Omen,Jett,KAY/O"
Haven,DINGLE GOOGY and friends,Vatles Esports,5,13,1,5,8,4,"Breach,Cypher,Sova,Omen,Neon","Breach,Sova,Killjoy,Omen,Jett"
Abyss,Rub n' Pug,Balkan Tuah,13,8,9,3,5,4,"Sova,Omen,Jett,Yoru,Clove","Breach,Cypher,Jett,Neon,Clove"
Sunset,BOBO,Koopa Troopas,8,13,3,6,7,5,"Raze,Cypher,Sova,Omen,Gekko","Breach,Cypher,Sova,Omen,Neon"
Haven,Rub n' Pug,Balkan Tuah,13,8,6,6,2,7,"Cypher,Sova,Phoenix,Omen,Neon","Breach,Cypher,Jett,Neon,Clove"
Haven,Aura,RETA Esports,8,13,4,5,8,4,"Breach,Cypher,Sova,Omen,Neon","Breach,Cypher,Sova,Omen,Neon"
Abyss,Aura,RETA Esports,7,13,1,7,6,6,"Cypher,Sova,Jett,Astra,Gekko","Sova,Killjoy,Omen,Jett,Astra"
Bind,Aura,RETA Esports,13,9,6,4,5,7,"Raze,Viper,Brimstone,Skye,Gekko","Raze,Viper,Brimstone,Skye,Gekko"
Abyss,Furious Gaming,Rebirth Esports,13,3,9,3,0,4,"Cypher,Sova,Omen,Jett,Iso","Cypher,Sova,Jett,Yoru,Astra"
Bind,Furious Gaming,Rebirth Esports,13,7,5,3,4,8,"Raze,Cypher,Brimstone,Skye,Yoru","Raze,Viper,Brimstone,Fade,Gekko"
Bind,JiJieHao Bonkers,club penguin,13,9,6,6,3,7,"Raze,Viper,Skye,Astra,Chamber","Viper,Brimstone,Jett,Gekko,Deadlock"
Haven,JiJieHao Bonkers,club penguin,13,9,5,5,4,8,"Breach,Cypher,Sova,Omen,Neon","Breach,Sova,Omen,Jett"
Sunset,FOCUSGG,DINGLE GOOGY and friends,13,3,4,0,3,9,"Breach,Raze,Cypher,Omen,Neon","Cypher,Sova,Omen,Neon,Gekko"
Split,Vatles Esports,bamiel joon,13,6,5,2,4,8,"Raze,Cypher,Jett,Skye,Astra","Breach,Raze,Cypher,Omen,Skye"
Pearl,Hornswogglers,BOBO,13,11,6,6,5,7,"Killjoy,Phoenix,Astra,Neon,Fade","Sova,Killjoy,Viper,Jett,Astra"
Pearl,Nemesis (OCE),Koopa Troopas,5,13,1,5,8,4,"Killjoy,Yoru,Astra,Fade,Clove","Sova,Killjoy,Astra,KAY/O,Neon"
Abyss,Vatles Esports,bamiel joon,13,2,3,0,2,10,"Cypher,Sova,Jett,Astra,Clove","Sova,Omen,Jett,Astra"
Pearl,FOCUSGG,DINGLE GOOGY and friends,13,3,9,3,0,4,"Cypher,Phoenix,Skye,Astra,Neon","Sova,Killjoy,Astra,KAY/O,Neon"
Ascent,Randoms (OCE),Balkan Tuah,13,15,6,8,7,7,"Sova,Killjoy,Omen,Yoru,Clove","Sova,Killjoy,Jett,Iso,Clove"
Ascent,JiJieHao Bonkers,Rub n' Pug,13,7,10,2,5,3,"Sova,Killjoy,Omen,Jett,KAY/O","Cypher,Sova,Omen,Jett,Deadlock"
Sunset,Nemesis (OCE),Koopa Troopas,10,13,6,6,7,4,"Breach,Cypher,Neon,Fade,Clove","Breach,Cypher,Sova,Omen,Neon"
Haven,Randoms (OCE),Balkan Tuah,5,13,3,9,4,2,"Breach,Cypher,Reyna,Astra,Neon","Breach,Cypher,Jett,Neon,Clove"
Haven,Vatles Esports,bamiel joon,7,13,1,7,6,6,"Sova,Killjoy,Omen,Jett,Neon","Breach,Cypher,Sova,Omen,Jett"
Split,Hornswogglers,BOBO,14,12,7,6,6,7,"Raze,Brimstone,Skye,Astra,Deadlock","Raze,Cypher,Viper,Omen,Skye"
Ascent,Dreams To Legends (OCE),Nemesis (OCE),9,13,4,6,7,5,"Sova,Killjoy,Omen,Jett,KAY/O","Cypher,Sova,Omen,Yoru,Deadlock"
Bind,Dreams To Legends (OCE),Nemesis (OCE),13,11,8,4,7,5,"Raze,Cypher,Brimstone,Skye,Deadlock","Raze,Cypher,Brimstone,Yoru,Fade"
Ascent,BOBO,Vatles Esports,13,10,3,9,1,10,"Sova,Killjoy,Omen,Jett,KAY/O","Cypher,Sova,Reyna,Omen,Jett"
Abyss,Arena Internet Cafe,FOCUSGG,13,10,6,6,4,7,"Cypher,Sova,Jett,Yoru,Astra","Cypher,Sova,Omen,Neon,Clove"
Sunset,Kebab Clan,Rub n' Pug,13,4,3,2,2,10,"Cypher,Sova,Omen,KAY/O,Neon","Raze,Cypher,Omen,Neon,Fade"
Abyss,Peace & Love,Balkan Tuah,9,13,5,7,6,4,"Cypher,Sova,Omen,Jett,Iso","Breach,Cypher,Jett,Neon,Clove"
Pearl,JiJieHao Bonkers,Koopa Troopas,13,5,8,4,1,5,"Sova,Killjoy,Jett,Yoru,Astra","Sova,Killjoy,Astra,KAY/O,Neon"
Bind,Randoms (OCE),DINGLE GOOGY and friends,8,13,6,6,7,2,"Raze,Brimstone,Reyna,Harbor,Gekko","Cypher,Brimstone,KAY/O,Neon,Iso"
Bind,Kebab Clan,Rub n' Pug,13,7,3,5,2,10,"Raze,Viper,Brimstone,Fade,Gekko","Raze,Cypher,Skye,Yoru,Clove"
Abyss,JiJieHao Bonkers,Koopa Troopas,13,2,10,2,0,3,"Sova,Omen,Jett,Yoru,Astra","Cypher,Sova,Omen,Jett,KAY/O"
Sunset,BOBO,Vatles Esports,13,9,6,4,5,7,"Raze,Cypher,Sova,Omen,Gekko","Raze,Cypher,Sova,Omen,Neon"
Ascent,Arena Internet Cafe,FOCUSGG,13,9,5,7,2,8,"Sova,Killjoy,Omen,Jett,KAY/O","Cypher,Sova,Reyna,Omen,Neon"
Pearl,Dreams To Legends (OCE),Nemesis (OCE),11,13,6,6,7,5,"Killjoy,Astra,Neon,Fade,Gekko","Killjoy,Yoru,Astra,Fade,Clove"
Haven,Peace & Love,Balkan Tuah,8,13,5,4,9,3,"Cypher,Sova,Omen,Jett,KAY/O","Breach,Cypher,Jett,Neon,Clove"
Pearl,Randoms (OCE),DINGLE GOOGY and friends,7,13,6,6,7,1,"Breach,Astra,Chamber,Neon,Fade","Sova,Killjoy,Astra,KAY/O,Neon"
Bind,Hornswogglers,Rub n' Pug,11,13,5,7,6,6,"Raze,Omen,Skye,Deadlock,Clove","Raze,Cypher,Skye,Yoru,Clove"
Ascent,Kebab Clan,Vatles Esports,13,11,7,5,6,6,"Sova,Killjoy,Omen,Jett,KAY/O","Cypher,Sova,Reyna,Omen,Jett"
Pearl,JiJieHao Bonkers,Balkan Tuah,13,4,10,2,2,3,"Sova,Killjoy,Jett,Yoru,Astra","Cypher,Jett,Astra,Neon,Fade"
Sunset,FOCUSGG,BOBO,13,11,7,5,6,6,"Breach,Raze,Cypher,Omen,Neon","Raze,Cypher,Sova,Omen,Gekko"
Ascent,Randoms (OCE),Nemesis (OCE),13,6,7,5,1,6,"Sova,Killjoy,Omen,Yoru,Clove","Sova,Killjoy,Omen,Jett,KAY/O"
Pearl,Arena Internet Cafe,DINGLE GOOGY and friends,13,2,3,0,2,10,"Sova,Killjoy,Phoenix,Jett,Astra","Killjoy,Viper,Skye,Neon,Harbor"
Haven,Arena Internet Cafe,DINGLE GOOGY and friends,13,1,2,0,1,11,"Breach,Cypher,Sova,Omen,Neon","Breach,Cypher,Sova,Omen,Neon"
Ascent,JiJieHao Bonkers,Balkan Tuah,13,3,3,1,2,10,"Sova,Killjoy,Omen,Jett,KAY/O","Sova,Killjoy,Omen,Jett,Iso"
Ascent,FOCUSGG,BOBO,13,2,3,0,2,10,"Cypher,Sova,Reyna,Omen,Neon","Cypher,Sova,Omen,Jett,KAY/O"
Haven,Hornswogglers,Rub n' Pug,9,13,6,6,7,3,"Cypher,Sova,Jett,Yoru,Astra","Cypher,Sova,Phoenix,Omen,Neon"
Ascent,bamiel joon,Dreams To Legends (OCE),13,9,7,5,4,6,"Sova,Killjoy,Omen,Jett,KAY/O","Sova,Killjoy,Omen,Jett,KAY/O"
Ascent,bamiel joon,Dreams To Legends (OCE),13,9,7,5,4,6,"Sova,Killjoy,Omen,Jett,KAY/O","Sova,Killjoy,Omen,Jett,KAY/O"
Sunset,Kebab Clan,Vatles Esports,13,7,6,2,5,7,"Cypher,Sova,Omen,KAY/O,Neon","Raze,Cypher,Sova,Omen,Neon"
Abyss,Randoms (OCE),Nemesis (OCE),13,4,9,3,1,4,"Sova,Astra,Chamber,Neon,Gekko","Cypher,Sova,Viper,Yoru,Clove"
Bind,Rebirth Esports,Zen Esports,13,11,7,5,6,6,"Raze,Viper,Brimstone,Fade,Gekko","Viper,Skye,Astra,Chamber,Neon"
Pearl,Rebirth Esports,Zen Esports,13,9,10,0,9,3,"Killjoy,Yoru,Astra,Fade,Harbor","Sova,Killjoy,Astra,Neon,Gekko"
Ascent,OXEN,RETA Esports,5,13,0,6,7,5,"Sova,Killjoy,Omen,Jett,KAY/O","Sova,Killjoy,Omen,Jett,KAY/O"
Haven,OXEN,RETA Esports,12,14,7,6,8,5,"Breach,Cypher,Sova,Omen,Neon","Breach,Cypher,Sova,Omen,Neon"
Bind,The Ultimates,Onyx Ravens,13,7,10,2,5,3,"Raze,Viper,Brimstone,Skye,Gekko","Raze,Viper,Brimstone,Yoru,Gekko"
Bind,Qadsiah Esports,Twisted Minds Esports,13,11,6,6,5,7,"Raze,Viper,Brimstone,Skye,Gekko","Raze,Cypher,Brimstone,Skye,Deadlock"
Icebox,The Ultimates,Onyx Ravens,13,9,7,5,4,6,"Sova,Killjoy,Viper,Jett,KAY/O","Killjoy,Viper,Reyna,Jett,Gekko"
Sunset,Qadsiah Esports,Twisted Minds Esports,10,13,4,7,6,6,"Breach,Cypher,Sova,Omen,Neon","Cypher,Sova,Omen,KAY/O,Neon"
Abyss,The Ultimates,Onyx Ravens,13,4,4,1,3,9,"Cypher,Sova,Omen,Jett,KAY/O","Cypher,Sova,Jett,Astra,Gekko"
Haven,Qadsiah Esports,Twisted Minds Esports,15,13,8,6,7,7,"Breach,Cypher,Sova,Omen,Neon","Breach,Cypher,Sova,Omen,Jett"
Bind,FOCUSGG,bamiel joon,13,8,5,4,4,8,"Raze,Cypher,Brimstone,Skye,Neon","Breach,Cypher,Jett,Gekko,Clove"
Ascent,Peace & Love,DINGLE GOOGY and friends,4,13,2,10,3,2,"Sova,Killjoy,Omen,Jett,KAY/O","Sova,Killjoy,Omen,KAY/O,Neon"
Ascent,FOCUSGG,bamiel joon,13,3,4,0,3,9,"Cypher,Sova,Reyna,Omen,Neon","Sova,Killjoy,Phoenix,Omen,Jett"
Sunset,Arena Internet Cafe,Koopa Troopas,13,8,9,3,5,4,"Breach,Cypher,Sova,Omen,Neon","Breach,Cypher,Sova,Omen,Neon"
Abyss,Peace & Love,DINGLE GOOGY and friends,13,10,3,9,1,10,"Cypher,Sova,Omen,Jett,Iso","Cypher,Sova,Omen,Neon,Gekko"
Sunset,JiJieHao Bonkers,Vatles Esports,13,15,8,6,9,5,"Breach,Cypher,Omen,Neon,Fade","Raze,Cypher,Sova,Omen,Neon"
Haven,BOBO,Dreams To Legends (OCE),13,5,9,3,2,4,"Breach,Cypher,Sova,Omen,Jett","Breach,Cypher,Sova,Omen,Jett"
Ascent,Hornswogglers,Nemesis (OCE),2,13,0,3,10,2,"Sova,Killjoy,Omen,Jett,KAY/O","Sova,Killjoy,Omen,Jett,KAY/O"
Haven,Kebab Clan,Balkan Tuah,13,2,3,0,2,10,"Breach,Cypher,Sova,Omen,Neon","Cypher,Sova,Omen,Yoru,Iso"
Bind,Rub n' Pug,Randoms (OCE),13,10,7,5,5,6,"Raze,Cypher,Reyna,Skye,Clove","Raze,Brimstone,Reyna,Harbor,Gekko"
Haven,Arena Internet Cafe,Koopa Troopas,13,10,5,6,4,8,"Breach,Cypher,Sova,Omen,Neon","Breach,Cypher,Sova,Omen,Neon"
Sunset,Kebab Clan,Balkan Tuah,13,1,2,0,1,11,"Cypher,Sova,Omen,KAY/O,Neon","Cypher,Sova,Omen,Jett,Yoru"
Haven,Peace & Love,DINGLE GOOGY and friends,12,14,7,6,8,5,"Breach,Cypher,Sova,Omen,Jett","Breach,Cypher,Sova,Omen,Neon"
Pearl,Hornswogglers,Nemesis (OCE),6,13,3,4,9,3,"Killjoy,Yoru,Astra,Fade,Clove","Killjoy,Phoenix,Astra,Neon,Fade"
Ascent,BOBO,Dreams To Legends (OCE),13,4,4,1,3,9,"Sova,Killjoy,Omen,Jett,KAY/O","Sova,Killjoy,Omen,Jett,KAY/O"
Abyss,Rub n' Pug,Randoms (OCE),13,2,10,2,0,3,"Sova,Omen,Jett,Yoru,Clove","Cypher,Reyna,Astra,Neon,Gekko"
Haven,JiJieHao Bonkers,Vatles Esports,10,13,5,7,6,5,"Breach,Cypher,Sova,Astra,Neon","Sova,Killjoy,Omen,Jett,Neon"
Bind,Deagle Bull Beats,Rebirth Esports,1,13,0,2,11,1,"Raze,Brimstone,Omen,Skye,Deadlock","Raze,Viper,Brimstone,Fade,Gekko"
Sunset,Deagle Bull Beats,Rebirth Esports,7,13,5,7,6,2,"Breach,Cypher,Sova,Omen,Neon","Breach,Cypher,Sova,Omen,Neon"
Ascent,9z Team GC,Zen Esports,5,13,2,4,9,3,"Cypher,Sova,Omen,Jett,KAY/O","Sova,Killjoy,Omen,Jett,KAY/O"
Abyss,9z Team GC,Zen Esports,6,13,1,6,7,5,"Sova,Omen,Jett,Astra,KAY/O","Cypher,Sova,Jett,Astra,KAY/O"
Sunset,The Ultimates,Qadsiah Esports,13,4,4,1,3,9,"Breach,Cypher,Sova,Omen,Neon","Breach,Cypher,Sova,Omen,Neon"
Ascent,The Ultimates,Qadsiah Esports,13,7,8,4,3,5,"Cypher,Sova,Omen,Yoru,Deadlock","Cypher,Sova,Omen,Yoru,Deadlock"
Bind,Twisted Minds Esports,Onyx Ravens,5,13,5,7,6,0,"Raze,Cypher,Brimstone,Skye,Deadlock","Raze,Viper,Brimstone,Yoru,Gekko"
Bind,The Ultimates,Qadsiah Esports,13,7,6,2,5,7,"Raze,Viper,Brimstone,Skye,Gekko","Raze,Viper,Brimstone,Skye,Gekko"
Ascent,Twisted Minds Esports,Onyx Ravens,4,13,1,4,9,3,"Cypher,Sova,Omen,Jett,Deadlock","Cypher,Sova,Phoenix,Omen,Jett"
Abyss,The Ultimates,Qadsiah Esports,6,13,4,8,5,2,"Cypher,Sova,Omen,Jett,KAY/O","Cypher,Sova,Yoru,Astra,KAY/O"
Icebox,Twisted Minds Esports,Onyx Ravens,7,13,6,6,7,1,"Sova,Killjoy,Viper,Jett,Harbor","Killjoy,Viper,Reyna,Jett,Gekko"
Bind,Aura,OXEN,13,9,5,7,2,8,"Raze,Viper,Brimstone,Skye,Gekko","Raze,Viper,Brimstone,Skye,Gekko"
Abyss,Aura,OXEN,13,8,7,5,3,6,"Cypher,Sova,Jett,Astra,Gekko","Cypher,Sova,Omen,Jett,KAY/O"
Haven,Aura,OXEN,8,13,2,7,6,6,"Breach,Cypher,Sova,Omen,Neon","Breach,Cypher,Sova,Omen,Neon"
Bind,Furious Gaming,RETA Esports,13,10,3,9,1,10,"Breach,Brimstone,Neon,Fade,Iso","Raze,Viper,Brimstone,Skye,Gekko"
Haven,Qadsiah Esports,Twisted Minds Esports,13,4,10,2,2,3,"Breach,Cypher,Sova,Omen,Neon","Breach,Cypher,Sova,Omen,Jett"
Ascent,Furious Gaming,RETA Esports,9,13,3,7,6,6,"Cypher,Sova,Omen,Jett,KAY/O","Sova,Killjoy,Omen,Jett,KAY/O"
Abyss,Qadsiah Esports,Twisted Minds Esports,13,8,5,4,4,8,"Cypher,Sova,Yoru,Astra,KAY/O","Cypher,Sova,Jett,Astra,KAY/O"
Ascent,Onyx Ravens,XO Esports,13,7,7,1,6,6,"Cypher,Sova,Phoenix,Omen,Jett","Cypher,Sova,Omen,Jett"
Haven,Furious Gaming,RETA Esports,13,6,7,0,6,6,"Breach,Cypher,Sova,Omen,Neon","Breach,Cypher,Sova,Omen,Neon"
Bind,Qadsiah Esports,Twisted Minds Esports,11,13,7,5,8,4,"Raze,Viper,Brimstone,Skye,Gekko","Raze,Cypher,Brimstone,Skye,Deadlock"
Icebox,Onyx Ravens,XO Esports,18,16,8,9,7,10,"Killjoy,Viper,Reyna,Jett,Gekko","Sova,Killjoy,Viper,Jett,KAY/O"
Haven,Qadsiah Esports,Dragons Esports,9,13,6,4,9,3,"Breach,Cypher,Sova,Omen,Neon","Breach,Sova,Killjoy,Omen,Jett"
Icebox,Qadsiah Esports,Dragons Esports,9,13,4,8,5,5,"Sova,Killjoy,Viper,KAY/O,Chamber","Sova,Killjoy,Viper,Sage,Jett"
Ascent,The Ultimates,Onyx Ravens,13,7,6,2,5,7,"Cypher,Sova,Omen,Yoru,Deadlock","Cypher,Sova,Phoenix,Omen,Jett"
Haven,The Ultimates,Onyx Ravens,13,3,4,0,3,9,"Breach,Cypher,Sova,Omen,Neon","Breach,Cypher,Sova,Omen,Neon"
Bind,Qadsiah Esports,Dragons Esports,13,4,9,3,1,4,"Raze,Viper,Brimstone,Skye,Gekko","Raze,Cypher,Brimstone,Skye,Iso"
Icebox,Twisted Minds Esports,Dragons Esports,13,7,3,5,2,10,"Sova,Killjoy,Viper,Jett,Harbor","Sova,Killjoy,Viper,Sage,Jett"
Ascent,The Ultimates,XO Esports,13,1,2,0,1,11,"Cypher,Sova,Omen,Yoru,Deadlock","Sova,Killjoy,Omen,Jett"
Sunset,Twisted Minds Esports,Dragons Esports,13,9,7,5,4,6,"Cypher,Sova,Omen,KAY/O,Neon","Breach,Cypher,Sova,Omen,Neon"
Abyss,The Ultimates,XO Esports,13,9,7,3,6,6,"Cypher,Sova,Omen,Jett,KAY/O","Sova,Yoru,Astra,Chamber"
Lotus,Team SEIBI,PARON,13,9,7,3,6,6,"Breach,Cypher,Omen,Neon,Fade","Breach,Cypher,Omen,Neon,Fade"
Lotus,esports team αD,IGZIST,7,13,5,3,10,2,"Breach,Cypher,Sova,Omen,Neon","Raze,Cypher,Omen,Astra,Fade"
Haven,Team SEIBI,PARON,13,11,5,7,4,8,"Breach,Sova,Killjoy,Omen,Jett","Cypher,Sova,Omen,Neon,Iso"
Haven,esports team αD,IGZIST,9,13,4,8,5,5,"Breach,Cypher,Sova,Omen,Neon","Breach,Cypher,Sova,Omen,Jett"
Bind,Team SEIBI,PARON,11,13,5,7,6,6,"Raze,Cypher,Brimstone,Skye","Breach,Raze,Brimstone,Neon,Fade"
Sunset,Furious Gaming,9z Team GC,13,1,2,0,1,11,"Breach,Cypher,Sova,Omen,Neon","Breach,Cypher,Sova,Omen,Neon"
Ascent,Furious Gaming,9z Team GC,13,2,10,2,0,3,"Cypher,Sova,Omen,Jett,KAY/O","Cypher,Sova,Omen,Jett,KAY/O"
Ascent,Zen Esports,OXEN,6,13,5,7,6,1,"Sova,Killjoy,Omen,Jett,KAY/O","Sova,Killjoy,Omen,Jett,KAY/O"
Bind,Zen Esports,OXEN,9,13,6,4,9,3,"Viper,Skye,Astra,Chamber,Neon","Raze,Viper,Brimstone,Skye,Gekko"
Sunset,PARON,ArcoBaleNO,13,4,4,1,3,9,"Breach,Cypher,Sova,Omen,Neon","Cypher,Sova,Omen,KAY/O,Neon"
Sunset,esports team αD,ASNA,10,13,4,8,5,6,"Raze,Cypher,Sage,Omen,Fade","Omen,Chamber,Neon,Fade"
Lotus,PARON,ArcoBaleNO,11,13,8,4,9,3,"Cypher,Omen,Neon,Fade,Iso","Breach,Omen,Neon,Fade,Clove"
Ascent,Team SEIBI,AXELERATE,6,13,6,6,7,0,"Sova,Killjoy,Omen,Jett,KAY/O","Sova,Killjoy,Omen,Jett,KAY/O"
Ascent,Chrysalis,IGZIST,7,13,1,7,6,6,"Cypher,Sova,Omen,Yoru,Deadlock","Sova,Killjoy,Omen,Jett,KAY/O"
Sunset,Chrysalis,IGZIST,1,13,0,2,11,1,"Breach,Cypher,Sova,Omen,Neon","Cypher,Sova,Omen,KAY/O,Neon"
Bind,esports team αD,ASNA,12,14,6,7,7,6,"Raze,Cypher,Viper,Skye,Harbor","Raze,Yoru,Astra,Fade,Clove"
Bind,PARON,ArcoBaleNO,13,10,7,4,6,6,"Breach,Raze,Brimstone,Neon,Fade","Raze,Viper,Brimstone,Fade,Gekko"
Icebox,Team SEIBI,AXELERATE,8,13,3,6,7,5,"Sova,Killjoy,Viper,Jett,Clove","Sova,Killjoy,Viper,Jett,Harbor"
Ascent,Deagle Bull Beats,RETA Esports,2,13,0,3,10,2,"Sova,Killjoy,Omen,Jett,KAY/O","Sova,Killjoy,Omen,Jett,KAY/O"
Haven,Deagle Bull Beats,RETA Esports,13,10,7,4,6,6,"Breach,Cypher,Sova,Omen,Neon","Breach,Cypher,Sova,Omen,Neon"
Abyss,Deagle Bull Beats,RETA Esports,11,13,5,7,6,6,"Breach,Cypher,Sova,Omen,Jett","Sova,Killjoy,Omen,Jett,Astra"
Abyss,Rebirth Esports,Aura,3,13,0,4,9,3,"Sova,Viper,Jett,Yoru,Astra","Cypher,Sova,Jett,Astra,Gekko"
Bind,Rebirth Esports,Aura,11,13,7,5,8,4,"Raze,Viper,Brimstone,Fade,Gekko","Raze,Viper,Brimstone,Skye,Gekko"
Ascent,IGZIST,ASNA,10,13,5,7,6,5,"Sova,Killjoy,Omen,Jett,KAY/O","Sova,Killjoy,Omen,Jett,KAY/O"
Lotus,esports team αD,Chrysalis,13,10,7,4,6,6,"Breach,Cypher,Sova,Omen,Neon","Breach,Cypher,Sova,Omen,Neon"
Bind,IGZIST,ASNA,13,7,9,3,4,4,"Raze,Viper,Brimstone,Fade,Gekko","Raze,Yoru,Astra,Fade,Clove"
Icebox,ArcoBaleNO,AXELERATE,5,13,4,8,5,1,"Sova,Killjoy,Viper,Jett,Harbor","Sova,Killjoy,Viper,Jett,Harbor"
Sunset,esports team αD,Chrysalis,13,9,7,3,6,6,"Raze,Cypher,Sage,Omen,Fade","Breach,Cypher,Sova,Omen,Neon"
Ascent,PARON,Team SEIBI,8,13,2,7,6,6,"Sova,Sage,Omen,Jett,KAY/O","Sova,Killjoy,Omen,Jett,KAY/O"
Bind,ArcoBaleNO,AXELERATE,11,13,6,6,7,5,"Raze,Viper,Brimstone,Fade,Gekko","Raze,Cypher,Viper,Brimstone,Skye"
Haven,PARON,Team SEIBI,4,13,0,5,8,4,"Cypher,Sova,Omen,Neon,Iso","Breach,Sova,Killjoy,Omen,Jett"
Haven,esports team αD,Chrysalis,9,13,5,7,6,4,"Breach,Cypher,Sova,Omen,Neon","Breach,Cypher,Sova,Omen,Neon"
Sunset,IGZIST,ASNA,10,13,8,4,9,2,"Cypher,Sova,Omen,KAY/O,Neon","Omen,Chamber,Neon,Fade"
Haven,club penguin,BITEKI,13,9,8,4,5,5,"Breach,Sova,Omen,Neon","Cypher,Sova,Phoenix,Omen,Iso"
Sunset,club penguin,BITEKI,13,6,5,2,4,8,"Raze,Sova,Omen,Astra,Chamber","Raze,Cypher,Phoenix,Omen,Fade"
Bind,VOID (EU),Team Focus,1,13,1,11,2,0,"Raze,Viper,Brimstone,Fade,Gekko","Raze,Viper,Brimstone,Yoru,Fade"
Haven,TLS eSports,Fractious Esports,2,13,2,10,3,0,"Breach,Cypher,Omen,Jett,Fade","Breach,Cypher,Sova,Omen,Jett"
Icebox,Shopify Rebellion,FlyQuest RED,13,2,3,0,2,10,"Killjoy,Viper,Reyna,KAY/O,Gekko","Sova,Killjoy,Viper,Sage,Gekko"
Ascent,Shopify Rebellion,FlyQuest RED,13,6,4,3,3,9,"Cypher,Sova,Omen,Yoru,Deadlock","Cypher,Sova,Omen,Jett,Deadlock"
Haven,Shopify Rebellion,FlyQuest RED,13,10,7,5,5,6,"Breach,Cypher,Sova,Omen,Neon","Cypher,Phoenix,Astra,Fade,Gekko"
Ascent,Peluqueria Mariloli,1000rr club,6,13,0,7,6,6,"Sova,Killjoy,Omen,Jett,KAY/O","Cypher,Sova,Omen,Jett,Yoru"
Ascent,Universae,ADCeuta esports,13,5,3,3,2,10,"Breach,Sova,Killjoy,Omen,Neon","Cypher,Sova,Omen,Jett,KAY/O"
Abyss,Locked Esports,Tani Susano,13,11,4,8,3,9,"Cypher,Sova,Jett,Astra,KAY/O","Cypher,Sova,Jett,Astra,KAY/O"
Bind,Genesis eSports,CryZen,10,13,3,8,5,7,"Raze,Viper,Brimstone,Skye,Gekko","Raze,Omen,Skye,KAY/O,Clove"
Bind,T1,ZETA DIVISION,13,3,4,0,3,9,"Raze,Brimstone,KAY/O,Gekko","Cypher,Brimstone,Neon,Fade,Deadlock"
Sunset,T1,ZETA DIVISION,7,13,2,6,7,5,"Breach,Cypher,Sova,Omen,Neon","Cypher,Sova,Sage,Omen,Neon"
Ascent,T1,ZETA DIVISION,13,5,9,3,2,4,"Sova,Killjoy,Omen,Jett,KAY/O","Cypher,Sova,Omen,Jett,KAY/O"
Haven,T1,ZETA DIVISION,13,10,7,5,5,6,"Breach,Cypher,Sova,Omen,Jett","Breach,Cypher,Sova,Omen,Neon"
Abyss,Team RED ,Team BLUE,13,6,7,5,1,6,"Reyna,Jett,Neon,Clove","Cypher,Killjoy,Sage,Chamber,Deadlock"
Haven,ZETA DIVISION,DetonatioN FocusMe,15,13,9,5,8,6,"Breach,Cypher,Sova,Omen,Neon","Breach,Cypher,Sova,Omen,Neon"
Sunset,ZETA DIVISION,DetonatioN FocusMe,13,6,8,4,2,5,"Cypher,Sova,Sage,Omen,Neon","Cypher,Sova,KAY/O,Neon,Clove"
Ascent,ZETA DIVISION,DetonatioN FocusMe,7,13,2,6,7,5,"Cypher,Sova,Omen,Jett,KAY/O","Sova,Killjoy,Omen,Jett,KAY/O"
Lotus,FlyQuest RED,YFP X,13,6,9,3,3,4,"Raze,Omen,Fade,Deadlock,Clove","Raze,Cypher,Viper,Omen,Fade"
Abyss,FlyQuest RED,YFP X,11,13,5,7,6,6,"Sova,Viper,Jett,Yoru,Astra","Cypher,Sova,Omen,Jett,Harbor"
Bind,FlyQuest RED,YFP X,10,13,8,4,9,2,"Raze,Viper,Skye,Astra,Gekko","Raze,Cypher,Omen,Yoru,Gekko"
Icebox,FlyQuest RED,YFP X,13,3,9,3,0,4,"Sova,Killjoy,Viper,Sage,Gekko","Sova,Killjoy,Viper,Reyna,Clove"
Ascent,FlyQuest RED,YFP X,13,8,5,7,1,8,"Cypher,Sova,Omen,Jett,Deadlock","Cypher,Sova,Omen,Yoru,Deadlock"
Bind,Team Focus,Team GMask,6,13,4,8,5,2,"Raze,Viper,Brimstone,Yoru,Fade","Raze,Viper,Brimstone,Skye,Gekko"
Bind,zer0 club,DSYRE Academy,1,13,1,11,2,0,"Raze,Viper,Brimstone,Skye,Gekko","Raze,Cypher,Jett,Skye,Clove"
Bind,IAPEsports,1000rr club,3,13,1,11,2,2,"Breach,Raze,Cypher,Brimstone,Yoru","Raze,Cypher,Brimstone,Yoru,Fade"
Lotus,PANCADAO,Demons PUG,4,13,3,9,4,1,"Breach,Omen,Neon,Fade,Clove","Raze,Cypher,Viper,Omen,Fade"
Haven,LRNJ,timberknick,13,10,4,8,2,9,"Breach,Cypher,Sova,Omen,Neon","Breach,Cypher,Sova,Omen,Neon"
Icebox,PANCADAO,Demons PUG,2,13,1,11,2,1,"Killjoy,Viper,Jett,KAY/O,Gekko","Sova,Killjoy,Viper,Jett,Gekko"
Bind,zer0 club,Team GMask,2,13,2,10,3,0,"Raze,Viper,Brimstone,Skye,Gekko","Raze,Viper,Brimstone,Skye,Gekko"
Bind,1000rr club,CryZen,13,11,6,6,5,7,"Raze,Cypher,Brimstone,Yoru,Fade","Raze,Omen,Skye,KAY/O,Clove"
Bind,Team Focus,DSYRE Academy,13,4,10,2,2,3,"Raze,Viper,Brimstone,Yoru,Fade","Raze,Viper,Brimstone,Fade,Gekko"
Icebox,Rex Regum Qeon,T1,9,13,3,7,6,6,"Sova,Killjoy,Viper,Jett,KAY/O","Viper,Jett,KAY/O,Chamber,Gekko"
Ascent,Rex Regum Qeon,T1,3,13,0,4,9,3,"Sova,Killjoy,Omen,Jett,KAY/O","Sova,Killjoy,Omen,Jett,KAY/O"
Bind,T1,Crest Gaming ZST,13,10,5,7,3,8,"Raze,Brimstone,KAY/O,Gekko","Raze,Cypher,Brimstone,Jett,Skye"
Lotus,Talon Esports,DetonatioN FocusMe,10,13,7,4,9,3,"Breach,Cypher,Sova,Astra,Neon","Breach,Omen,Neon,Fade,Clove"
Lotus,ZETA DIVISION,T1,13,7,9,3,4,4,"Breach,Cypher,Omen,Neon,Fade","Raze,Omen,Chamber,Fade"
Sunset,Talon Esports,Rex Regum Qeon,13,11,5,7,4,8,"Breach,Cypher,Sova,Omen,Neon","Breach,Cypher,Sova,Omen,Neon"
Haven,ZETA DIVISION,Crest Gaming ZST,13,8,5,7,1,8,"Breach,Cypher,Sova,Omen,Neon","Cypher,Viper,Jett,Skye,Astra"
Haven,Rex Regum Qeon,DetonatioN FocusMe,13,10,4,8,2,9,"Breach,Cypher,Sova,Astra,Neon","Breach,Cypher,Sova,Omen,Neon"
Abyss,YFP X,Refrag,13,3,10,2,1,3,"Cypher,Sova,Omen,Jett,Harbor","Cypher,Sova,Omen,Jett,KAY/O"
Lotus,timberknick,DRACC,15,13,8,6,7,7,"Raze,Killjoy,Viper,Omen,Fade","Cypher,Omen,Skye,Neon,Iso"
Haven,YFP X,Refrag,13,11,5,7,4,8,"Breach,Cypher,Sova,Omen,Neon","Breach,Cypher,Sova,Omen,Jett"
Ascent,PANCADAO,Atlanta Esports,13,8,7,2,6,6,"Sova,Killjoy,Omen,Jett,KAY/O","Sova,Killjoy,Omen,Jett,KAY/O"
Bind,YFP X,Refrag,10,13,4,7,6,6,"Raze,Cypher,Omen,Yoru,Deadlock","Raze,Viper,Brimstone,Fade,Gekko"
Icebox,timberknick,DRACC,13,11,5,7,4,8,"Sova,Killjoy,Viper,Jett,Clove","Sova,Killjoy,Viper,Jett,Iso"
Abyss,Tropa do 99,Demons PUG,10,13,5,7,6,5,"Cypher,Jett,Astra,KAY/O,Iso","Sova,Viper,Jett,Yoru,Astra"
Abyss,PANCADAO,Atlanta Esports,7,13,3,5,8,4,"Cypher,Sova,Jett,Astra,KAY/O","Cypher,Sova,Jett,Astra,KAY/O"
Haven,LRNJ,Stellae Gaming Academy,13,11,5,7,4,8,"Breach,Cypher,Sova,Omen,Neon","Breach,Cypher,Sova,Omen,Neon"
Icebox,PANCADAO,Atlanta Esports,13,3,9,3,0,4,"Killjoy,Viper,Jett,KAY/O,Gekko","Sova,Killjoy,Viper,Jett,Harbor"
Icebox,Tropa do 99,Demons PUG,11,13,4,8,5,7,"Sova,Killjoy,Viper,Reyna,Iso","Sova,Killjoy,Viper,Reyna,Jett"
Bind,FlyQuest RED,Shopify Rebellion,10,13,6,6,7,4,"Raze,Viper,Skye,Astra,Gekko","Raze,Cypher,Viper,Brimstone,Skye"
Haven,timberknick,DRACC,15,17,4,12,5,11,"Breach,Cypher,Sova,Omen,Neon","Sova,Killjoy,Omen,Neon,Iso"
Sunset,LRNJ,Stellae Gaming Academy,13,8,6,6,2,7,"Breach,Cypher,Sova,Omen,Neon","Breach,Cypher,Sova,Omen,Neon"
Sunset,FlyQuest RED,Shopify Rebellion,9,13,5,7,6,4,"Raze,Cypher,Omen,Fade,Deadlock","Breach,Cypher,Sova,Omen,Neon"
Bind,YFP X,oomfies,13,11,5,7,4,8,"Raze,Cypher,Omen,Yoru,Gekko","Raze,Cypher,Viper,Brimstone,Skye"
Icebox,YFP X,oomfies,13,9,5,7,2,8,"Killjoy,Viper,Reyna,KAY/O,Gekko","Sova,Killjoy,Viper,Iso,Clove"
Ascent,YFP X,oomfies,13,15,3,11,4,10,"Cypher,Sova,Omen,Yoru,Deadlock","Cypher,Sova,Jett,Astra,Deadlock"
Lotus,Refrag,mesos millionaires,13,8,7,2,6,6,"Raze,Omen,Chamber,Fade,Deadlock","Breach,Raze,Killjoy,Omen,Fade"
Abyss,Refrag,mesos millionaires,13,9,8,2,7,5,"Cypher,Sova,Omen,Jett,KAY/O","Cypher,Sova,Omen,Jett,KAY/O"
Ascent,Linares eSports,El Barco Esports,13,4,3,2,2,10,"Sova,Killjoy,Omen,Jett,KAY/O","Breach,Sova,Killjoy,Jett,Astra"
Ascent,mesos millionaires,Teddy Tactics,13,11,6,6,5,7,"Sova,Killjoy,Jett,Astra,KAY/O","Breach,Cypher,Sova,Jett,Astra"
Ascent,YFP X,Shopify Rebellion,2,13,1,2,11,1,"Cypher,Sova,Omen,Jett,KAY/O","Cypher,Sova,Omen,Yoru,Deadlock"
Sunset,YFP X,Shopify Rebellion,2,13,0,3,10,2,"Raze,Cypher,Omen,Fade,Deadlock","Breach,Cypher,Sova,Omen,Neon"
Haven,mesos millionaires,Teddy Tactics,8,13,4,5,8,4,"Sova,Killjoy,Omen,Yoru,Iso","Breach,Cypher,Sova,Jett,Astra"
Abyss,mesos millionaires,Teddy Tactics,13,5,7,5,0,6,"Cypher,Sova,Omen,Jett,KAY/O","Cypher,Sova,Viper,Yoru,Astra"
Haven,YFP X,Shopify Rebellion,13,11,10,2,9,3,"Breach,Cypher,Sova,Omen,Neon","Breach,Cypher,Sova,Omen,Neon"
Lotus,Elation Vortex,oomfies,2,13,2,10,3,0,"Breach,Omen,Neon,Fade,Clove","Raze,Cypher,Fade,Deadlock,Clove"
Sunset,FlyQuest RED,Refrag,13,10,5,7,3,8,"Raze,Cypher,Omen,Fade,Deadlock","Breach,Raze,Cypher,Sova,Omen"
Ascent,Elation Vortex,oomfies,13,6,2,5,1,11,"Cypher,Sova,Omen,Jett","Cypher,Sova,Jett,Deadlock,Clove"
Bind,FlyQuest RED,Refrag,15,13,8,6,7,7,"Raze,Viper,Skye,Astra,Gekko","Raze,Cypher,Viper,Brimstone,Skye"
Abyss,Elation Vortex,oomfies,8,13,3,6,7,5,"Sova,Viper,Jett,Yoru,Astra","Cypher,Sova,Jett,Astra,Iso"
Haven,YFP X,mesos millionaires,13,4,5,0,4,8,"Breach,Cypher,Sova,Omen,Neon","Breach,Sova,Killjoy,Omen,Jett"
Icebox,Atlanta Esports,Curralzinho Wolves,13,6,7,5,1,6,"Sova,Killjoy,Viper,Jett,Harbor","Sova,Killjoy,Harbor,Iso,Clove"
Abyss,YFP X,mesos millionaires,14,12,8,5,7,6,"Cypher,Sova,Omen,Jett,Harbor","Cypher,Sova,Omen,Jett,KAY/O"
Abyss,Tropa do 99,UNIDUNITE,13,4,3,2,2,10,"Cypher,Jett,Astra,KAY/O,Iso","Cypher,Sova,Jett,Astra,KAY/O"
Ascent,Atlanta Esports,Curralzinho Wolves,9,13,5,5,8,4,"Sova,Killjoy,Omen,Jett,KAY/O","Sova,Killjoy,Omen,Jett,KAY/O"
Icebox,Shopify Rebellion,Teddy Tactics,13,2,3,0,2,10,"Killjoy,Viper,Reyna,KAY/O,Gekko","Sova,Killjoy,Viper,Jett,Gekko"
Ascent,Tropa do 99,UNIDUNITE,9,13,4,8,5,5,"Sova,Killjoy,Omen,Jett,KAY/O","Sova,Killjoy,Omen,Jett,KAY/O"
Bind,oomfies,Refrag,6,13,5,7,6,1,"Raze,Viper,Skye,Astra,Gekko","Raze,Viper,Brimstone,Fade,Gekko"
Haven,Shopify Rebellion,Teddy Tactics,13,2,10,2,0,3,"Breach,Cypher,Sova,Omen,Neon","Breach,Cypher,Sova,Jett,Astra"
Haven,Atlanta Esports,Curralzinho Wolves,13,5,9,3,2,4,"Breach,Cypher,Sova,Omen,Neon","Breach,Cypher,Sova,Omen,Neon"
Haven,Tropa do 99,UNIDUNITE,13,9,7,3,6,6,"Breach,Sova,Killjoy,Omen,Jett","Breach,Sova,Killjoy,Omen,Jett"
Ascent,oomfies,Refrag,13,5,7,5,0,6,"Cypher,Sova,Jett,Astra,Deadlock","Sova,Killjoy,Omen,Jett,KAY/O"
Bind,FlyQuest RED,Elation Vortex,13,1,11,1,0,2,"Raze,Viper,Skye,Astra,Gekko","Raze,Viper,Brimstone,Fade,Gekko"
Lotus,FlyQuest RED,Elation Vortex,13,4,9,3,1,4,"Raze,Omen,Fade,Deadlock,Clove","Breach,Omen,Neon,Fade,Clove"
Lotus,oomfies,Refrag,10,13,5,7,6,5,"Raze,Cypher,Fade,Deadlock,Clove","Raze,Killjoy,Omen,Fade,Deadlock"
Lotus,Curralzinho Wolves,PANCADAO,9,13,3,7,6,6,"Breach,Cypher,Omen,Neon,Fade","Breach,Omen,Neon,Fade,Clove"
Icebox,Atlanta Esports,Stellae Gaming Academy,6,13,3,9,4,3,"Sova,Killjoy,Viper,Jett,Harbor","Sova,Killjoy,Viper,Jett,KAY/O"
Haven,Atlanta Esports,Stellae Gaming Academy,2,13,0,3,10,2,"Breach,Sova,Killjoy,Jett,Astra","Breach,Cypher,Sova,Omen,Neon"
Bind,DRACC,NoOrg9,13,10,3,8,2,10,"Cypher,Brimstone,Skye,Neon,Gekko","Raze,Viper,Brimstone,Skye,Chamber"
Sunset,Curralzinho Wolves,PANCADAO,13,10,5,6,4,8,"Breach,Cypher,Sova,Omen,Neon","Cypher,Sova,Omen,KAY/O,Neon"
Abyss,Atlanta Esports,Stellae Gaming Academy,13,8,3,6,2,10,"Cypher,Sova,Jett,Astra,KAY/O","Cypher,Sova,Omen,Jett,KAY/O"
Icebox,DRACC,NoOrg9,13,10,6,6,4,7,"Sova,Killjoy,Viper,Jett,Iso","Sova,Killjoy,Astra,Chamber,Iso"
Icebox,Curralzinho Wolves,PANCADAO,5,13,4,8,5,1,"Sova,Killjoy,Harbor,Iso,Clove","Killjoy,Viper,Jett,KAY/O,Gekko"
Haven,Qルトガ,eArth bArce lAz,13,5,8,4,1,5,"Breach,Cypher,Sova,Omen,Neon","Breach,Cypher,Sova,Omen,Jett"
Lotus,Qルトガ,eArth bArce lAz,13,5,4,2,3,9,"Breach,Omen,Chamber,Neon,Fade","Breach,Raze,Killjoy,Omen,Fade"
Lotus,おにいちゃんといっしょ！,MeshTek,13,9,5,5,4,8,"Breach,Omen,Neon,Fade,Clove","Breach,Cypher,Omen,Neon,Fade"
Lotus,Qルトガ,おにいちゃんといっしょ！,11,13,7,5,8,4,"Breach,Omen,Chamber,Neon,Fade","Breach,Omen,Neon,Fade,Clove"
Ascent,MeshTek,eArth bArce lAz,10,13,7,5,8,3,"Sova,Killjoy,Reyna,Omen,Harbor","Sova,Killjoy,Omen,Jett,KAY/O"
Haven,Qルトガ,おにいちゃんといっしょ！,12,14,8,5,9,4,"Breach,Cypher,Sova,Omen,Neon","Breach,Cypher,Sova,Omen,Neon"
Lotus,MeshTek,eArth bArce lAz,8,13,4,8,5,4,"Breach,Cypher,Omen,Neon,Fade","Breach,Raze,Killjoy,Omen,Fade"
Ascent,MIBR GC,Team Liquid Brazil,13,4,3,2,2,10,"Sova,Killjoy,Omen,Jett,KAY/O","Sova,Killjoy,Omen,Jett,KAY/O"
Bind,MIBR GC,Team Liquid Brazil,10,13,6,6,7,4,"Raze,Viper,Brimstone,Fade,Gekko","Raze,Cypher,Viper,Brimstone,Skye"
Sunset,MIBR GC,Team Liquid Brazil,13,4,9,3,1,4,"Breach,Raze,Cypher,Omen,Gekko","Breach,Raze,Cypher,Omen,KAY/O"
Lotus,MIBR GC,Team Liquid Brazil,13,10,5,7,3,8,"Raze,Killjoy,Viper,Omen,Fade","Raze,Brimstone,Omen,Fade,Deadlock"
Ascent,AfroGames eSports,DRACC,12,14,5,8,6,7,"Cypher,Sova,Omen,Jett,Deadlock","Sova,Killjoy,Omen,Jett,Yoru"
Icebox,PANCADAO,Demons PUG,8,13,3,6,7,5,"Killjoy,Viper,Jett,KAY/O,Gekko","Sova,Killjoy,Viper,Reyna,Jett"
Lotus,LRNJ,Curralzinho Wolves,13,7,8,4,3,5,"Breach,Cypher,Omen,Neon,Fade","Breach,Cypher,Omen,Neon,Fade"
Split,Locked Esports,Team Focus,8,13,5,7,6,3,"Breach,Raze,Cypher,Reyna,Omen","Raze,Viper,Omen,Jett,Skye"
Abyss,Atlanta Esports,Tropa do 99,13,9,7,3,6,6,"Cypher,Sova,Jett,Astra,KAY/O","Cypher,Jett,Astra,KAY/O,Iso"
Haven,timberknick,Stellae Gaming Academy,13,8,6,3,5,7,"Breach,Cypher,Sova,Omen,Neon","Breach,Cypher,Sova,Omen,Neon"
Bind,AfroGames eSports,DRACC,14,16,5,10,6,9,"Raze,Viper,Brimstone,Skye,Gekko","Cypher,Brimstone,Skye,Neon,Gekko"
Haven,Peluqueria Mariloli,El Barco Esports,11,13,7,5,8,4,"Breach,Sova,Killjoy,Omen,Neon","Breach,Sova,Killjoy,Astra,Neon"
Sunset,Universae,Fractious Esports,7,13,5,3,10,2,"Breach,Raze,Cypher,Omen,Gekko","Breach,Cypher,Sova,Omen,Neon"
Ascent,Linares eSports,ADCeuta esports,13,7,5,3,4,8,"Sova,Killjoy,Omen,Jett,KAY/O","Sova,Killjoy,Omen,Jett,KAY/O"
Sunset,PANCADAO,Demons PUG,12,14,4,9,5,8,"Cypher,Sova,Omen,KAY/O,Neon","Breach,Cypher,Sova,Omen,Neon"
Pearl,Genesis eSports,Alliance Of Shadow,13,5,4,2,3,9,"Killjoy,Jett,Skye,Harbor,Deadlock","Cypher,Omen,Jett,Gekko,Iso"
Sunset,LRNJ,Curralzinho Wolves,13,2,10,2,0,3,"Breach,Cypher,Sova,Omen,Neon","Breach,Cypher,Sova,Omen,Neon"
Ascent,SLEIK Esports,CryZen,1,13,0,2,11,1,"Sova,Killjoy,Omen,Jett,KAY/O","Breach,Omen,Neon,Fade,Deadlock"
Ascent,Qルトガ,eArth bArce lAz,13,5,9,3,2,4,"Cypher,Sova,Omen,Neon,Deadlock","Sova,Killjoy,Omen,Jett,KAY/O"
Lotus,MeshTek,おにいちゃんといっしょ！,13,8,7,5,3,6,"Breach,Cypher,Omen,Neon,Fade","Breach,Omen,Neon,Fade,Clove"
Lotus,Qルトガ,eArth bArce lAz,13,6,7,5,1,6,"Breach,Omen,Chamber,Neon,Fade","Breach,Raze,Killjoy,Omen,Fade"
Haven,MeshTek,おにいちゃんといっしょ！,13,6,5,2,4,8,"Cypher,Sova,Omen,Yoru,Iso","Breach,Cypher,Sova,Omen,Neon"
Ascent,おにいちゃんといっしょ！,eArth bArce lAz,2,13,1,11,2,1,"Cypher,Sova,Omen,Jett,Deadlock","Sova,Killjoy,Omen,Jett,KAY/O"
Sunset,Team Z,Crest Gaming ZST,5,13,1,5,8,4,"Breach,Cypher,Sova,Omen,Neon","Breach,Raze,Cypher,Omen,Jett"
Haven,おにいちゃんといっしょ！,eArth bArce lAz,13,6,9,3,3,4,"Breach,Cypher,Sova,Omen,Neon","Breach,Cypher,Sova,Omen,Jett"
Lotus,Team Z,Crest Gaming ZST,13,15,8,6,9,5,"Breach,Omen,Neon,Fade,Clove","Raze,Killjoy,Viper,Omen,Fade"
Ascent,MeshTek,Qルトガ,7,13,3,5,8,4,"Sova,Killjoy,Reyna,Omen,Harbor","Cypher,Sova,Omen,Neon,Deadlock"
Haven,Team Z,Crest Gaming ZST,11,13,4,8,5,7,"Breach,Cypher,Sova,Omen,Neon","Cypher,Viper,Jett,Skye,Astra"
Haven,MeshTek,Qルトガ,7,13,5,7,6,2,"Cypher,Sova,Omen,Yoru,Iso","Breach,Cypher,Sova,Omen,Neon"
Sunset,FAV gaming,Sengoku Gaming,7,13,2,10,3,5,"Breach,Cypher,Sova,Omen,Neon","Cypher,Sova,Omen,KAY/O,Neon"
Ascent,FAV gaming,Sengoku Gaming,5,13,3,3,10,2,"Sova,Killjoy,Omen,Jett,KAY/O","Sova,Killjoy,Omen,Jett,KAY/O"
Haven,FAV gaming,Sengoku Gaming,13,11,7,5,6,6,"Breach,Cypher,Sova,Omen,Neon","Breach,Cypher,Sova,Omen,Neon"
Sunset,LOUD GC,Team Liquid Brazil,15,17,9,7,10,6,"Breach,Raze,Cypher,Sova,Omen","Breach,Raze,Cypher,Omen,KAY/O"
Haven,LOUD GC,Team Liquid Brazil,13,9,9,3,6,4,"Cypher,Sova,Omen,Yoru,Iso","Killjoy,Viper,Omen,Jett,Skye"
Bind,LOUD GC,Team Liquid Brazil,12,14,3,10,4,9,"Raze,Cypher,Brimstone,Skye,Deadlock","Raze,Cypher,Viper,Brimstone,Skye"
Abyss,LOUD GC,Team Liquid Brazil,7,13,2,10,3,5,"Cypher,Sova,Omen,Jett,KAY/O","Cypher,Sova,Omen,Jett,KAY/O"
Icebox,Team Focus,CryZen,9,13,4,8,5,5,"Sova,Killjoy,Viper,Jett,Gekko","Sova,Killjoy,Viper,Jett,KAY/O"
Icebox,SPACEGLID3RS,IAPEsports,8,13,7,5,8,1,"Sova,Killjoy,Viper,Jett,Clove","Sova,Killjoy,Viper,Jett,Neon"
Icebox,Team GMask,DSYRE Academy,8,13,5,7,6,3,"Sova,Killjoy,Viper,Jett,Gekko","Sova,Killjoy,Viper,Sage,Jett"
Icebox,GMBLERS Esports,1000rr club,4,13,3,9,4,1,"Sova,Killjoy,Viper,Sage,Jett","Sova,Viper,Reyna,Jett,Chamber"
Bind,1000rr club,KHORE GAMING,11,13,4,8,5,7,"Raze,Cypher,Brimstone,Yoru,Fade","Raze,Sova,Viper,Yoru,Clove"
Icebox,1000rr club,DSYRE Academy,6,13,4,8,5,2,"Sova,Killjoy,Viper,Jett,Yoru","Sova,Killjoy,Viper,Sage,Jett"
Icebox,Team Focus,bazinga esports,13,7,4,4,3,9,"Sova,Killjoy,Viper,Jett,Gekko","Sova,Killjoy,Viper,Reyna,Jett"
Icebox,GMBLERS Esports,CryZen,15,13,10,4,9,5,"Sova,Killjoy,Viper,Reyna,Jett","Sova,Killjoy,Viper,Jett,KAY/O"
Icebox,IAPEsports,Team GMask,10,13,6,5,8,4,"Sova,Killjoy,Viper,Reyna,Jett","Sova,Killjoy,Viper,Jett,Gekko"
Haven,Qルトガ,eArth bArce lAz,14,10,4,8,2,10,"Breach,Cypher,Sova,Omen,Neon","Breach,Cypher,Sova,Omen,Jett"
Haven,MeshTek,おにいちゃんといっしょ！,14,10,8,4,6,6,"Cypher,Sova,Omen,Yoru,Iso","Breach,Cypher,Sova,Omen,Neon"
Lotus,おにいちゃんといっしょ！,eArth bArce lAz,11,13,7,5,8,4,"Breach,Omen,Neon,Fade,Clove","Breach,Raze,Killjoy,Omen,Fade"
Lotus,MeshTek,Qルトガ,10,14,6,6,8,4,"Breach,Cypher,Omen,Neon,Fade","Breach,Omen,Chamber,Neon,Fade"
Ascent,Qルトガ,おにいちゃんといっしょ！,14,10,7,5,5,7,"Cypher,Sova,Omen,Neon,Deadlock","Cypher,Sova,Omen,Jett,Deadlock"
Ascent,MeshTek,eArth bArce lAz,16,8,6,6,2,10,"Sova,Killjoy,Reyna,Omen,Harbor","Sova,Killjoy,Omen,Jett,KAY/O"
Haven,Sengoku Gaming,Crest Gaming ZST,12,14,4,9,5,8,"Breach,Cypher,Sova,Omen,Neon","Cypher,Viper,Jett,Skye,Astra"
Bind,Sengoku Gaming,Crest Gaming ZST,13,11,3,9,2,10,"Raze,Viper,Brimstone,Fade,Gekko","Raze,Cypher,Brimstone,Jett,Skye"
Ascent,Sengoku Gaming,Crest Gaming ZST,10,13,5,7,6,5,"Sova,Killjoy,Omen,Jett,KAY/O","Sova,Killjoy,Omen,Jett,KAY/O"
Ascent,FAV gaming,Team Z,5,13,1,5,8,4,"Sova,Killjoy,Omen,Jett,KAY/O","Sova,Killjoy,Omen,Jett,KAY/O"
Sunset,FAV gaming,Team Z,8,13,4,8,5,4,"Breach,Cypher,Sova,Omen,Neon","Breach,Cypher,Sova,Omen,Neon"
Bind,MIBR GC,Team Liquid Brazil,13,10,4,8,2,9,"Raze,Viper,Brimstone,Fade,Gekko","Raze,Cypher,Viper,Brimstone,Skye"
Sunset,MIBR GC,Team Liquid Brazil,9,13,2,8,5,7,"Breach,Raze,Cypher,Omen,Gekko","Breach,Raze,Cypher,Omen,KAY/O"
Haven,AfroGames eSports,Tropa do 99,4,13,4,8,5,0,"Breach,Sova,Killjoy,Omen,Jett","Breach,Sova,Killjoy,Omen,Jett"
Haven,Demons PUG,Stellae Gaming Academy,15,13,7,7,6,8,"Breach,Cypher,Sova,Omen,Neon","Breach,Cypher,Sova,Omen,Neon"
Abyss,LRNJ,timberknick,13,6,3,4,2,10,"Cypher,Sova,Jett,Yoru,Astra","Cypher,Sova,Yoru,Astra,Iso"
Sunset,UNIDUNITE,PANCADAO,10,13,4,8,5,6,"Breach,Cypher,Sova,Omen,Neon","Cypher,Sova,Omen,KAY/O,Neon"
Ascent,Atlanta Esports,DRACC,13,7,4,4,3,9,"Sova,Killjoy,Omen,Jett,KAY/O","Sova,Killjoy,Omen,Jett,Neon"
Lotus,MIBR GC,Team Liquid Brazil,13,4,8,4,0,5,"Raze,Killjoy,Viper,Omen,Fade","Raze,Brimstone,Omen,Fade,Deadlock"
Ascent,Atlanta Esports,UNIDUNITE,10,13,4,7,6,6,"Sova,Killjoy,Omen,Jett,KAY/O","Sova,Killjoy,Omen,Jett,KAY/O"
Ascent,Curralzinho Wolves,Tropa do 99,13,11,8,4,7,5,"Sova,Killjoy,Omen,Jett,KAY/O","Sova,Killjoy,Omen,Jett,KAY/O"
Bind,LRNJ,AfroGames eSports,13,3,2,2,1,11,"Raze,Viper,Brimstone,Skye,Deadlock","Raze,Viper,Brimstone,Skye,Gekko"
Lotus,Demons PUG,DRACC,13,10,9,3,7,4,"Breach,Raze,Cypher,Omen,Fade","Cypher,Omen,Neon,Gekko,Iso"
Sunset,LOUD GC,TBS GC,13,11,2,10,1,11,"Breach,Raze,Cypher,Omen,Deadlock","Cypher,Sova,Omen,KAY/O,Neon"
Haven,LOUD GC,TBS GC,14,12,8,5,7,6,"Cypher,Sova,Omen,Yoru,Iso","Cypher,Sova,Omen,Yoru,Iso"
Lotus,LOUD GC,TBS GC,12,14,6,7,7,6,"Raze,Cypher,Omen,KAY/O,Deadlock","Breach,Cypher,Omen,Neon,Fade"
Abyss,VOID (EU),Tani Susano,13,7,6,2,5,7,"Sova,Jett,Astra,Harbor,Gekko","Cypher,Sova,Jett,Astra,KAY/O"
Lotus,MeshTek,おにいちゃんといっしょ！,6,18,3,9,9,3,"Breach,Cypher,Omen,Neon,Fade","Breach,Omen,Neon,Fade,Clove"
Ascent,Qルトガ,eArth bArce lAz,10,14,4,8,6,6,"Cypher,Sova,Omen,Neon,Deadlock","Sova,Killjoy,Omen,Jett,KAY/O"
Ascent,MeshTek,おにいちゃんといっしょ！,10,14,1,11,3,9,"Sova,Killjoy,Reyna,Omen,Harbor","Cypher,Sova,Omen,Jett,Deadlock"
Lotus,Qルトガ,eArth bArce lAz,13,12,9,3,9,4,"Breach,Omen,Chamber,Neon,Fade","Breach,Raze,Killjoy,Omen,Fade"
Haven,MeshTek,おにいちゃんといっしょ！,12,13,6,6,7,6,"Cypher,Sova,Omen,Yoru,Iso","Breach,Cypher,Sova,Omen,Neon"
Haven,Qルトガ,eArth bArce lAz,12,13,2,10,3,10,"Breach,Cypher,Sova,Omen,Neon","Breach,Cypher,Sova,Omen,Jett"
Ascent,Sengoku Gaming,IGZIST,13,11,7,5,6,6,"Sova,Killjoy,Omen,Jett,KAY/O","Sova,Killjoy,Omen,Jett,KAY/O"
Ascent,Crest Gaming ZST,ブリムの野望チャンネル,13,3,9,3,0,4,"Sova,Killjoy,Omen,Jett,KAY/O","Sova,Killjoy,Omen,Jett,KAY/O"
Lotus,Team Z,BLUE BEES.ESP,13,10,5,7,3,8,"Breach,Omen,Neon,Fade,Clove","Breach,Omen,Neon,Fade,Clove"
Haven,FAV gaming,Team SEIBI,13,3,9,3,0,4,"Breach,Cypher,Sova,Omen,Neon","Breach,Sova,Killjoy,Omen,Neon"
Haven,Team Z,ESR Selection,13,6,5,2,4,8,"Breach,Cypher,Sova,Omen,Neon","Breach,Cypher,Sova,Astra,Neon"
Sunset,Reignite Lily,IGZIST,1,13,1,11,2,0,"Cypher,Sova,Omen,KAY/O,Neon","Cypher,Sova,Omen,KAY/O,Neon"
Ascent,Sengoku Gaming,DBesports,13,3,10,2,1,3,"Sova,Killjoy,Omen,Jett,KAY/O","Sova,Killjoy,Omen,Jett,Iso"
Ascent,Chrysalis,Team SEIBI,4,13,3,9,4,1,"Cypher,Sova,Omen,Yoru,Deadlock","Sova,Killjoy,Omen,Jett,KAY/O"
Ascent,CLANUS,BLUE BEES.ESP,5,13,1,11,2,4,"Cypher,Sova,Omen,KAY/O,Clove","Sova,Killjoy,Omen,Jett,KAY/O"
Lotus,MeshTek,eArth bArce lAz,11,13,4,8,5,7,"Breach,Cypher,Omen,Neon,Fade","Breach,Raze,Killjoy,Omen,Fade"
Ascent,Qルトガ,おにいちゃんといっしょ！,13,11,6,6,5,7,"Cypher,Sova,Omen,Neon,Deadlock","Cypher,Sova,Omen,Jett,Deadlock"
Haven,MeshTek,eArth bArce lAz,8,16,3,9,7,5,"Breach,Cypher,Sova,Omen,Neon","Breach,Cypher,Sova,Omen,Jett"
Haven,Qルトガ,おにいちゃんといっしょ！,17,7,9,3,4,8,"Breach,Cypher,Sova,Omen,Neon","Breach,Cypher,Sova,Omen,Neon"
Lotus,Qルトガ,おにいちゃんといっしょ！,14,10,8,4,6,6,"Breach,Omen,Chamber,Neon,Fade","Breach,Omen,Neon,Fade,Clove"
Ascent,MeshTek,eArth bArce lAz,18,6,8,4,2,10,"Sova,Killjoy,Reyna,Omen,Harbor","Cypher,Sova,Omen,Jett,KAY/O"
Lotus,おにいちゃんといっしょ！,eArth bArce lAz,15,9,8,4,5,7,"Breach,Omen,Neon,Fade,Clove","Breach,Raze,Cypher,Omen,Fade"
Ascent,MeshTek,Qルトガ,8,16,0,12,4,8,"Sova,Killjoy,Omen,Jett,KAY/O","Cypher,Sova,Omen,Neon,Deadlock"
Haven,おにいちゃんといっしょ！,eArth bArce lAz,10,14,6,6,8,4,"Breach,Cypher,Sova,Omen,Neon","Breach,Cypher,Sova,Omen,Jett"
Lotus,MeshTek,Qルトガ,13,12,8,5,7,5,"Breach,Cypher,Omen,Neon,Fade","Breach,Omen,Chamber,Neon,Fade"
Ascent,おにいちゃんといっしょ！,eArth bArce lAz,13,11,7,5,6,6,"Cypher,Sova,Omen,Jett,Deadlock","Cypher,Sova,Omen,Jett,KAY/O"
Haven,MeshTek,Qルトガ,9,15,4,8,7,5,"Breach,Cypher,Sova,Omen,Neon","Breach,Cypher,Sova,Omen,Neon"
Haven,BC SWELL,Crest Gaming ZST,8,13,5,4,9,3,"Breach,Cypher,Sova,Omen,Neon","Cypher,Viper,Jett,Skye,Astra"
Lotus,BC SWELL,Crest Gaming ZST,13,15,7,7,8,6,"Breach,Killjoy,Omen,Neon,Fade","Raze,Killjoy,Viper,Omen,Fade"
Icebox,BC SWELL,Crest Gaming ZST,13,9,5,5,4,8,"Sova,Killjoy,Viper,Jett,Gekko","Killjoy,Viper,Jett,KAY/O,Clove"
Sunset,BC SWELL,Crest Gaming ZST,9,13,4,6,7,5,"Cypher,Sova,Omen,KAY/O,Neon","Breach,Raze,Cypher,Omen,Jett"
Icebox,Asterisk (IN),Mogo eSports,9,13,8,4,9,1,"Sova,Killjoy,Viper,Neon,Gekko","Sova,Killjoy,Viper,Jett,Gekko"
Abyss,Asterisk (IN),Mogo eSports,13,10,7,5,5,6,"Breach,Raze,Cypher,Astra,Gekko","Cypher,Sova,Jett,Astra,KAY/O"
Ascent,Asterisk (IN),Mogo eSports,13,15,5,9,6,8,"Breach,Sova,Omen,Jett","Cypher,Sova,Omen,Jett,Iso"
Icebox,Dupg Esports,Orangutan,4,13,2,3,10,2,"Sova,Killjoy,Viper,Jett,KAY/O","Sova,Killjoy,Viper,Jett,Gekko"
Ascent,Crest Gaming ZST,IGZIST,13,6,8,4,2,5,"Sova,Killjoy,Omen,Jett,KAY/O","Sova,Killjoy,Omen,Jett,KAY/O"
Ascent,Dupg Esports,Orangutan,6,13,3,9,4,3,"Sova,Killjoy,Omen,Jett,KAY/O","Cypher,Sova,Omen,Yoru,Deadlock"
Lotus,Crest Gaming ZST,IGZIST,13,7,8,4,3,5,"Raze,Killjoy,Viper,Omen,Fade","Raze,Cypher,Omen,Astra,Fade"
Sunset,Crest Gaming ZST,IGZIST,7,13,7,5,8,0,"Breach,Raze,Cypher,Omen,Jett","Cypher,Sova,Omen,KAY/O,Neon"
Lotus,NOEZ FOXX,BC SWELL,5,13,1,11,2,4,"Breach,Cypher,Omen,Neon,Fade","Breach,Killjoy,Omen,Neon,Fade"
Haven,NOEZ FOXX,BC SWELL,16,18,9,8,10,7,"Breach,Cypher,Sova,Omen,Neon","Breach,Cypher,Sova,Omen,Neon"
Sunset,Medal Esports,Reckoning Esports,5,13,2,4,9,3,"Breach,Raze,Cypher,Sova,Omen","Breach,Cypher,Sova,Omen,Neon"
Ascent,Medal Esports,Reckoning Esports,13,4,1,4,0,12,"Sova,Killjoy,Omen,Jett,KAY/O","Cypher,Sova,Omen,Jett,KAY/O"
Haven,Medal Esports,Reckoning Esports,10,13,7,5,8,3,"Breach,Cypher,Sova,Omen,Neon","Breach,Cypher,Sova,Omen,Neon"
Haven,REJECT,Crest Gaming ZST,26,28,8,19,9,18,"Breach,Cypher,Sova,Omen,Neon","Cypher,Viper,Skye,Astra,Neon"
Lotus,True Rippers,Niory Esports,9,13,2,10,3,7,"Breach,Raze,Killjoy,Omen,Gekko","Breach,Sova,Killjoy,Omen,Neon"
Bind,True Rippers,Niory Esports,8,13,1,8,5,7,"Raze,Omen,Skye,Gekko,Clove","Raze,Viper,Brimstone,Skye,Fade"
Lotus,REJECT,Crest Gaming ZST,16,14,6,9,5,10,"Raze,Killjoy,Viper,Omen,Fade","Raze,Killjoy,Viper,Omen,Fade"
Sunset,REJECT,Crest Gaming ZST,6,13,0,7,6,6,"Breach,Cypher,Sova,Omen,Neon","Breach,Raze,Cypher,Omen,Jett"
Sunset,Murash Gaming,IGZIST,4,13,2,3,10,2,"Cypher,Sova,Sage,Omen,Yoru","Cypher,Sova,Omen,KAY/O,Neon"
Ascent,Murash Gaming,IGZIST,13,15,5,9,6,8,"Sova,Killjoy,Yoru,Astra","Sova,Killjoy,Omen,Jett,KAY/O"
Abyss,Sengoku Gaming,BC SWELL,10,13,4,7,6,6,"Cypher,Sova,Omen,Jett,Harbor","Cypher,Sova,Jett,Astra,KAY/O"
Haven,Sengoku Gaming,BC SWELL,9,13,3,9,4,6,"Breach,Cypher,Sova,Omen,Neon","Breach,Cypher,Sova,Omen,Neon"
Ascent,FAV gaming,NOEZ FOXX,10,13,4,7,6,6,"Sova,Killjoy,Omen,Jett,KAY/O","Sova,Killjoy,Omen,Jett,KAY/O"
Haven,FAV gaming,NOEZ FOXX,10,13,4,7,6,6,"Breach,Cypher,Sova,Omen,Neon","Breach,Cypher,Sova,Omen,Neon"
Ascent,sou proplayer lixo?,Team Leveling,14,12,5,8,4,9,"Sova,Killjoy,Omen,Jett,KAY/O","Sova,Killjoy,Omen,Jett,KAY/O"
Haven,G2 Gozen,GIANTX GC,13,7,6,2,5,7,"Breach,Cypher,Sova,Omen,Neon","Breach,Killjoy,Viper,Omen,Yoru"
Haven,sou proplayer lixo?,Team Leveling,13,6,6,1,5,7,"Breach,Sova,Killjoy,Omen,Neon","Breach,Cypher,Sova,Omen,Neon"
Abyss,G2 Gozen,GIANTX GC,8,13,7,5,8,1,"Sova,Killjoy,Yoru,Astra,Harbor","Cypher,Sova,Omen,Jett,KAY/O"
Icebox,sou proplayer lixo?,Team Leveling,13,10,6,5,5,7,"Sova,Killjoy,Viper,Jett,Iso","Sova,Killjoy,Viper,Jett,Iso"
Sunset,G2 Gozen,GIANTX GC,13,8,5,4,4,8,"Breach,Cypher,Sova,Omen,Neon","Breach,Cypher,Sova,Omen,Neon"
Ascent,Reckoning Esports,Mogo eSports,11,13,9,3,10,2,"Cypher,Sova,Omen,Jett,KAY/O","Cypher,Sova,Omen,Jett,Iso"
Bind,Reckoning Esports,Mogo eSports,6,13,5,7,6,1,"Raze,Cypher,Brimstone,Skye,Gekko","Raze,Cypher,Viper,Brimstone,Gekko"
Lotus,G2 Gozen,GIANTX GC,13,10,7,5,5,6,"Raze,Cypher,Omen,Fade,Deadlock","Breach,Raze,Sova,Omen,Chamber"
Lotus,Orangutan,Niory Esports,13,7,5,3,4,8,"Cypher,Sage,Omen,Fade,Deadlock","Breach,Sova,Killjoy,Omen,Neon"
Icebox,Orangutan,Niory Esports,13,11,6,6,5,7,"Sova,Killjoy,Viper,Jett,Gekko","Sova,Killjoy,Viper,Jett,Iso"
Haven,Xipto Esports,ZETA DIVISION GC,13,5,10,2,3,3,"Killjoy,Viper,Omen,Jett,Skye","Breach,Cypher,Sova,Omen,Neon"
Icebox,Xipto Esports,ZETA DIVISION GC,13,2,3,0,2,10,"Killjoy,Viper,Jett,KAY/O,Gekko","Sova,Killjoy,Viper,Jett,KAY/O"
Sunset,Xipto Esports,ZETA DIVISION GC,13,8,6,6,2,7,"Cypher,Sova,Omen,KAY/O,Neon","Breach,Raze,Cypher,Sova,Omen"
Haven,Shopify Rebellion,oomfies,13,10,8,4,6,5,"Breach,Cypher,Sova,Omen,Neon","Cypher,Sova,Viper,Phoenix,Harbor"
Ascent,Shopify Rebellion,oomfies,13,6,6,1,5,7,"Cypher,Sova,Omen,Yoru,Deadlock","Cypher,Sova,Jett,Deadlock,Clove"
Sunset,Skout Esports,Cobweb eSports,13,7,7,1,6,6,"Cypher,Sova,Reyna,Omen,Jett","Breach,Cypher,Sova,Omen,Neon"
Lotus,oomfies,Teddy Tactics,13,5,6,0,5,7,"Raze,Cypher,Fade,Deadlock,Clove","Breach,Raze,Killjoy,Astra,Fade"
Icebox,Shopify Rebellion,Refrag,13,2,3,0,2,10,"Killjoy,Viper,Reyna,KAY/O,Gekko","Sova,Killjoy,Viper,Jett,Clove"
Lotus,Skout Esports,Cobweb eSports,2,13,2,10,3,0,"Breach,Raze,Killjoy,Omen,Neon","Breach,Killjoy,Viper,Omen,Neon"
Bind,Shopify Rebellion,Refrag,13,4,3,2,2,10,"Raze,Cypher,Viper,Brimstone,Skye","Raze,Viper,Brimstone,Gekko,Iso"
Haven,oomfies,Teddy Tactics,13,10,6,5,5,7,"Cypher,Sova,Viper,Phoenix,Harbor","Breach,Cypher,Sova,Jett,Astra"
Ascent,Skout Esports,Cobweb eSports,13,11,9,3,8,4,"Cypher,Sova,Phoenix,Omen,Jett","Sova,Killjoy,Omen,Jett,KAY/O"
Haven,Team Focus,1000rr club,7,13,2,6,7,5,"Cypher,Sova,Phoenix,Omen,Jett","Cypher,Sova,Omen,Jett,Yoru"
Abyss,TEAM VELAXIS,Tani Susano,10,13,7,5,8,3,"Breach,Cypher,Sova,Omen,Jett","Cypher,Sova,Jett,Astra,KAY/O"
Abyss,1000rr club,Genesis eSports,13,10,8,4,6,5,"Cypher,Sova,Jett,Yoru,Astra","Breach,Cypher,Sova,Omen,Jett"
Ascent,TEAM VELAXIS,SZK Academy,13,5,4,2,3,9,"Breach,Killjoy,Omen,Jett,KAY/O","Sova,Killjoy,Omen,Jett,KAY/O"
Pearl,Tani Susano,Team Orion,13,11,5,7,4,8,"Killjoy,Astra,KAY/O,Neon,Fade","Killjoy,Reyna,Jett,Astra,KAY/O"
Ascent,bazinga esports,DSYRE Academy,9,13,3,9,4,6,"Sova,Killjoy,Omen,Jett,KAY/O","Cypher,Sova,Omen,Yoru,Deadlock"
Ascent,Dimonis,CryZen,11,13,2,10,3,9,"Cypher,Sova,Reyna,Omen,Neon","Breach,Omen,Neon,Fade,Deadlock"
Ascent,Team Focus,Universae,13,11,5,7,4,8,"Cypher,Sova,Phoenix,Omen,Jett","Breach,Killjoy,Omen,Jett,Fade"
Bind,Vila das Flores,Team Leveling,4,13,2,3,10,2,"Raze,Cypher,Brimstone,Skye,Deadlock","Raze,Viper,Brimstone,Skye,Gekko"
Bind,AMBYS Team,Genesis eSports,8,13,4,5,8,4,"Raze,Cypher,Brimstone,Fade,Gekko","Raze,Viper,Brimstone,Skye,Gekko"
Split,SZK Academy,NGS ,13,4,11,1,3,2,"Breach,Raze,Cypher,Skye,Astra","Raze,Cypher,Omen,Skye"
Abyss,Tani Susano,Tani Amaterasu,13,3,9,3,0,4,"Cypher,Sova,Jett,Astra,KAY/O","Cypher,Sova,Omen,KAY/O,Neon"
Abyss,Arco de Jason Staham,TEAM VELAXIS,5,13,2,4,9,3,"Breach,Sova,Jett,Astra,Deadlock","Breach,Cypher,Sova,Omen,Jett"
Sunset,Universae,Waist EC,13,2,2,1,1,11,"Breach,Raze,Cypher,Omen,Gekko","Breach,Cypher,Sova,Omen,Neon"
Abyss,El Barco Esports,1000rr club,7,13,5,3,10,2,"Cypher,Sova,Jett,Astra,KAY/O","Cypher,Sova,Jett,Yoru,Astra"
Haven,Vila das Flores,Team Leveling,14,16,6,9,7,8,"Breach,Cypher,Sova,Omen,Neon","Breach,Cypher,Sova,Omen,Neon"
Ascent,Linares eSports,Team Focus,11,13,3,9,4,8,"Sova,Killjoy,Omen,Jett,KAY/O","Cypher,Sova,Phoenix,Omen,Jett"
Bind,Tani Susano,Avoid Esports,13,9,8,2,7,5,"Raze,Viper,Brimstone,Skye,Gekko","Raze,Brimstone,Reyna,Skye,Harbor"
Sunset,Monta Club Ace,Waist EC,2,13,0,3,10,2,"Breach,Cypher,Omen,Jett,Gekko","Breach,Cypher,Sova,Omen,Neon"
Sunset,El Pueblo,NGS ,11,13,9,3,10,2,"Breach,Raze,Cypher,Omen,Neon","Breach,Cypher,Sova,Omen,Neon"
Ascent,1000rr club,Burrote Seco,13,5,5,1,4,8,"Cypher,Sova,Reyna,Omen,Yoru","Sova,Killjoy,Phoenix,Omen,Jett"
Ascent,GMBLERS Esports,DSYRE Academy,13,10,8,4,6,5,"Raze,Killjoy,Phoenix,Omen,Jett","Cypher,Sova,Omen,Yoru,Deadlock"
Ascent,The giornalisti,Dimonis,4,13,2,10,3,2,"Cypher,Sova,Omen,Jett,KAY/O","Sova,Reyna,Omen,Neon,Deadlock"
Haven,SPH WASHED,Tani Amaterasu,6,13,1,6,7,5,"Breach,Killjoy,Reyna,Jett,Clove","Breach,Sova,Killjoy,Omen,Jett"
Bind,Arco de Jason Staham,Tani Tsukuyomi,13,10,6,6,4,7,"Raze,Brimstone,Skye,Chamber,Gekko","Omen,Skye,Yoru,Fade,Clove"
Abyss,CDC Valorant,Genesis eSports,10,13,4,7,6,6,"Cypher,Sova,Jett,Astra,Gekko","Breach,Cypher,Sova,Omen,Jett"
Ascent,El Barco Esports,Odyssey Gaming,13,1,2,0,1,11,"Breach,Sova,Killjoy,Jett,Astra","Cypher,Sova,Omen,Jett,KAY/O"
Ascent,nox gaming,SZK Academy,7,13,1,7,6,6,"Sova,Killjoy,Omen,Jett,KAY/O","Sova,Killjoy,Omen,Jett,KAY/O"
Ascent,ADCeuta esports,Team Orion,12,14,8,5,9,4,"Sova,Killjoy,Omen,Jett,KAY/O","Sova,Killjoy,Omen,Jett,KAY/O"
Ascent,AGMET3,Team Orion,12,14,8,5,9,4,"Sova,Killjoy,Omen,Jett,KAY/O","Sova,Killjoy,Omen,Jett,KAY/O"
Haven,Universae,Locked Esports,13,6,8,4,2,5,"Killjoy,Viper,Omen,Jett,Skye","Breach,Cypher,Sova,Astra,Neon"
Sunset,Linares eSports,Las Palmas Unity,13,4,5,0,4,8,"Breach,Cypher,Sova,Omen,Neon","Cypher,Omen,KAY/O,Neon,Gekko"
Bind,AMBYS Team,TLS eSports,13,9,5,5,4,8,"Raze,Cypher,Brimstone,Fade,Gekko","Raze,Cypher,Fade,Gekko,Clove"
Icebox,REVOADA,sou proplayer lixo?,8,13,5,4,9,3,"Sova,Killjoy,Viper,Jett,Gekko","Sova,Killjoy,Viper,Jett,Iso"
Split,Essence,Avoid Esports,9,13,3,7,6,6,"Raze,Viper,Jett,Skye,Astra","Raze,Cypher,Omen,Jett,Skye"
Haven,Tani Amaterasu,SC (Spain),13,1,2,0,1,11,"Breach,Sova,Killjoy,Omen,Jett","Breach,Brimstone,Sage,Jett,Chamber"
Bind,1000rr club,TzManiacs,14,12,4,9,3,10,"Raze,Cypher,Brimstone,Reyna,Fade","Raze,Viper,Omen,Skye,Fade"
Ascent,Golden Monkeys,Waist EC,13,15,5,9,6,8,"Sova,Killjoy,Omen,Jett,KAY/O","Sova,Killjoy,Omen,Jett,KAY/O"
Haven,God eSports,AMBYS Team,1,13,0,2,11,1,"Breach,Cypher,Omen,Neon,Gekko","Cypher,Skye,Neon,Iso,Clove"
Ascent,REVOADA,sou proplayer lixo?,5,13,5,7,6,0,"Sova,Killjoy,Omen,Jett,KAY/O","Sova,Killjoy,Omen,Jett,KAY/O"
Abyss,Zenturions,Tani Susano,5,13,3,9,4,2,"Cypher,Sova,Jett,Astra,KAY/O","Cypher,Sova,Jett,Astra,KAY/O"
Abyss,CDC Valorant,Guinea Pink Silkie,13,5,4,2,3,9,"Cypher,Sova,Jett,Astra,Gekko","Breach,Cypher,Jett,Astra,Gekko"
Bind,Mighty Meerkats,SPH WASHED,9,13,7,5,8,2,"Raze,Viper,Brimstone,Skye,Gekko","Breach,Raze,Cypher,Reyna,Clove"
Ascent,NGS ,Nick Hers,13,9,8,2,7,5,"Sova,Killjoy,Omen,Jett,KAY/O","Sova,Killjoy,Omen,Jett,KAY/O"
Sunset,Universae,vortex esports,13,5,5,1,4,8,"Breach,Raze,Cypher,Omen,Gekko","Breach,Cypher,Sova,Omen,Neon"
Ascent,AGMET3,Mirror Never SURRENDER,13,5,6,0,5,7,"Sova,Killjoy,Omen,Jett,KAY/O","Cypher,Sova,Omen,Jett,Deadlock"
Ascent,Visions eSports,ADCeuta esports,5,13,5,7,6,0,"Cypher,Sova,Omen,Jett,Deadlock","Sova,Killjoy,Omen,Jett,KAY/O"
Haven,5GY eSports,El Barco Esports,8,13,5,7,6,3,"Breach,Cypher,Sova,Omen,Neon","Breach,Sova,Killjoy,Astra,Neon"
Sunset,TEAM VELAXIS,Melilla Titans Aura,13,9,7,5,4,6,"Breach,Raze,Cypher,Omen,KAY/O","Breach,Cypher,Sova,Omen,Neon"
Pearl,Mirror Never SURRENDER,Cerox Esports,13,5,7,5,0,6,"Killjoy,Jett,Yoru,Astra,Gekko","Killjoy,Jett,KAY/O,Harbor,Gekko"
Ascent,Team Orion,Velaxis Academy,13,6,4,3,3,9,"Sova,Killjoy,Omen,Jett,KAY/O","Sova,Killjoy,Omen,Jett,KAY/O"
Ascent,Odyssey Gaming,XTEC Esports,13,4,4,1,3,9,"Cypher,Sova,Omen,Jett,KAY/O","Sova,Killjoy,Omen,Jett,KAY/O"
Split,SLEIK Esports,SZK Academy,9,13,4,6,7,5,"Breach,Raze,Cypher,Skye,Astra","Breach,Raze,Cypher,Skye,Astra"
Sunset,EREUS,Burrote Seco,5,13,3,9,4,2,"Breach,Raze,Cypher,Phoenix,Omen","Breach,Cypher,Omen,Neon,Gekko"
Ascent,Peluqueria Mariloli,Team Focus,10,13,3,8,5,7,"Sova,Killjoy,Omen,Jett,KAY/O","Cypher,Sova,Phoenix,Omen,Jett"
Sunset,Tani Tsukuyomi,VAY Academy,13,1,11,1,0,2,"Breach,Cypher,Sova,Neon,Harbor","Breach,Cypher,Sova,Omen,Jett"
Sunset,Arco de Jason Staham,wazaaaaaa,13,3,3,1,2,10,"Breach,Cypher,Sova,Omen,Neon","Breach,Raze,Cypher,Omen,Gekko"
Ascent,El Pueblo,MaskapalosAutenticoGuachupino,13,11,4,8,3,9,"Cypher,Sova,Omen,Jett,Deadlock","Sova,Killjoy,Phoenix,Omen,Jett"
Haven,La Banda del Patio,Linares eSports,5,13,2,4,9,3,"Breach,Sova,Killjoy,Omen,Jett","Breach,Cypher,Sova,Omen,Neon"
Lotus,Medal Esports,Asterisk (IN),5,13,2,4,9,3,"Breach,Cypher,Omen,Neon,Fade","Raze,Killjoy,Viper,Omen,Fade"
Haven,LOS CHAMBALES,Peluqueria Mariloli,3,13,1,3,10,2,"Sova,Killjoy,Reyna,Jett,Astra","Breach,Sova,Killjoy,Omen,Neon"
Haven,TLS eSports,KHORE GAMING,13,11,5,7,4,8,"Breach,Cypher,Omen,Jett,Fade","Sova,Viper,Yoru,Astra,Deadlock"
Sunset,Nexum EC,Locked Esports,3,13,1,3,10,2,"Cypher,Sova,Omen,KAY/O,Neon","Breach,Raze,Cypher,Omen,Gekko"
Sunset,AGMET3,RAVEN EXODUS,13,2,1,2,0,12,"Breach,Cypher,Sova,Omen,Neon","Breach,Cypher,Sova,Omen,Neon"
Ascent,Arctic Ninjas,Team Focus,0,13,0,12,1,0,"Sova,Omen,Jett,KAY/O,Deadlock","Cypher,Sova,Phoenix,Omen,Jett"
Abyss,Medal Esports,Asterisk (IN),6,13,4,8,5,2,"Cypher,Sova,Jett,Astra,Gekko","Breach,Raze,Cypher,Astra,Gekko"
Icebox,True Rippers,Dupg Esports,7,13,1,11,2,6,"Sova,Killjoy,Viper,Jett,KAY/O","Sova,Killjoy,Viper,Jett,KAY/O"
Ascent,True Rippers,Dupg Esports,11,13,4,8,5,7,"Sova,Killjoy,Omen,Jett","Cypher,Sova,Omen,Yoru,Deadlock"
Haven,True Rippers,Dupg Esports,13,11,5,7,4,8,"Breach,Cypher,Sova,Omen,Neon","Breach,Cypher,Sova,Omen,Neon"
Lotus,Mir Gaming GC,ZETA DIVISION GC,7,13,4,4,9,3,"Killjoy,Viper,Omen,Neon,Fade","Breach,Cypher,Omen,Neon,Fade"
Ascent,Mir Gaming GC,ZETA DIVISION GC,5,13,1,5,8,4,"Cypher,Sova,Omen,Jett,Deadlock","Sova,Killjoy,Omen,Jett,KAY/O"
Bind,Mir Gaming GC,ZETA DIVISION GC,13,10,5,7,3,8,"Raze,Viper,Brimstone,Skye,Gekko","Raze,Cypher,Viper,Brimstone,Skye"
Bind,Xipto Esports,sisu,13,6,9,3,3,4,"Raze,Viper,Brimstone,Fade,Gekko","Raze,Omen,Fade,Clove"
Sunset,Xipto Esports,sisu,13,8,6,6,2,7,"Cypher,Sova,Omen,KAY/O,Neon","Breach,Cypher,Sova,Omen,Neon"
Abyss,Xipto Esports,sisu,15,17,6,10,7,9,"Sova,Omen,Jett,Astra,KAY/O","Cypher,Sova,Jett,Astra,Gekko"
Sunset,SaD FROST,Teddy Tactics,6,13,6,6,7,0,"Breach,Raze,Cypher,Omen,Gekko","Breach,Raze,Cypher,Sova,Astra"
Abyss,SaD FROST,Teddy Tactics,13,10,6,5,5,7,"Cypher,Sova,Jett,Astra,Gekko","Sova,Killjoy,Viper,Jett,Astra"
Ascent,oomfies,Elation Vortex,13,5,7,5,0,6,"Cypher,Sova,Jett,Deadlock,Clove","Cypher,Sova,Omen,Jett"
Ascent,SaD FROST,Teddy Tactics,10,13,6,5,8,4,"Sova,Killjoy,Omen,Jett,KAY/O","Breach,Cypher,Sova,Jett,Astra"
Lotus,Refrag,Give Wingman 2 Nuclear Devices,13,5,4,2,3,9,"Cypher,Omen,Neon,Gekko,Iso","Raze,Cypher,Omen,Gekko,Clove"
Abyss,Shopify Rebellion,HyperSpeed Red,13,3,2,2,1,11,"Cypher,Sova,Yoru,Astra","Cypher,Sova,Jett,Astra,KAY/O"
Abyss,oomfies,Elation Vortex,12,14,6,7,7,6,"Sova,Jett,Yoru,Astra","Sova,Viper,Jett,Yoru,Astra"
Bind,Refrag,Give Wingman 2 Nuclear Devices,13,3,4,0,3,9,"Raze,Viper,Brimstone,Gekko,Iso","Raze,Skye,Astra,Chamber,Deadlock"
Ascent,Shopify Rebellion,HyperSpeed Red,13,3,3,1,2,10,"Cypher,Sova,Omen,Yoru,Deadlock","Sova,Killjoy,Omen,Jett,KAY/O"
Lotus,Teddy Tactics,Day By Day,14,12,6,7,5,8,"Breach,Raze,Killjoy,Astra,Fade","Raze,Cypher,Viper,Fade,Clove"
Sunset,oomfies,Elation Vortex,13,4,3,2,2,10,"Cypher,Sova,Neon,Deadlock,Clove","Breach,Cypher,Sova,Omen,Neon"
Bind,mesos millionaires,Give Wingman 2 Nuclear Devices,10,13,3,8,5,7,"Raze,Fade,Gekko,Deadlock,Clove","Raze,Skye,Astra,Chamber,Deadlock"
Icebox,Tenax GC,HyperSpeed Red,8,13,2,7,6,6,"Sova,Viper,Sage,Reyna,Chamber","Sova,Killjoy,Viper,Jett,Yoru"
Haven,Teddy Tactics,Day By Day,13,10,6,5,5,7,"Breach,Cypher,Sova,Jett,Astra","Breach,Cypher,Sova,Jett,Astra"
Bind,Refrag,Students of the Game,13,6,8,4,2,5,"Raze,Viper,Brimstone,Yoru,Gekko","Raze,Cypher,Reyna,Skye,Clove"
Abyss,SaD FROST, RITUAL RËAL,13,6,7,5,1,6,"Cypher,Sova,Jett,Astra,Gekko","Cypher,Sova,Jett,Astra,KAY/O"
Haven,oomfies,YDZ Black,13,7,5,3,4,8,"Cypher,Sova,Viper,Phoenix,Harbor","Breach,Sova,Killjoy,Omen,Jett"
Ascent,Tani Tsukuyomi,rustoria mondays,11,13,5,7,6,6,"Cypher,Sova,Omen,Jett,KAY/O","Sova,Killjoy,Omen,Jett,KAY/O"
Abyss,Elation Vortex,meowtastic,13,5,9,3,2,4,"Sova,Viper,Jett,Yoru,Astra","Breach,Cypher,Sova,Jett,Astra"
Icebox,Shopify Rebellion,Ominous Minions,13,3,4,0,3,9,"Killjoy,Viper,Reyna,KAY/O,Gekko","Sova,Killjoy,Viper,Reyna,Jett"
Bind,CryZen,Peluqueria Mariloli,13,11,8,4,7,5,"Raze,Omen,Skye,KAY/O,Clove","Raze,Sova,Brimstone,Skye,Chamber"
Icebox,mesos millionaires,Give Wingman 2 Nuclear Devices,6,13,5,7,6,1,"Sova,Killjoy,Viper,Jett,Gekko","Sova,Viper,Sage,Reyna,Chamber"
Sunset,oomfies,YDZ Black,13,4,9,3,1,4,"Sova,Reyna,Yoru,Chamber,Clove","Breach,Raze,Cypher,Omen,Gekko"
Ascent,Teddy Tactics,Day By Day,6,13,2,5,8,4,"Breach,Cypher,Sova,Jett,Astra","Cypher,Sova,Omen,Jett,Deadlock"
Icebox,Elation Vortex,meowtastic,13,2,10,2,0,3,"Sova,Killjoy,Viper,Jett,Harbor","Sova,Killjoy,Viper,Jett,KAY/O"
Sunset,SaD FROST, RITUAL RËAL,13,7,7,1,6,6,"Breach,Raze,Cypher,Omen,Gekko","Raze,Cypher,Omen,KAY/O,Gekko"
Lotus,Refrag,Students of the Game,13,6,6,1,5,7,"Raze,Cypher,Omen,Neon,Gekko","Raze,Killjoy,Viper,Omen,Fade"
Lotus,Tenax GC,HyperSpeed Red,10,13,6,6,7,4,"Breach,Killjoy,Omen,Neon,Fade","Breach,Killjoy,Omen,Neon,Fade"
Sunset,Shopify Rebellion,Ominous Minions,13,3,9,3,0,4,"Breach,Cypher,Sova,Omen,Neon","Breach,Raze,Cypher,Omen,Fade"
Abyss,CDC Valorant,Tani Tsukuyomi,12,14,7,6,8,5,"Cypher,Sova,Jett,Astra,Gekko","Breach,Cypher,Omen,Chamber,Gekko"
Haven,Universae,CryZen,11,13,6,6,7,5,"Killjoy,Viper,Omen,Jett,Skye","Breach,Sova,Killjoy,Omen,Jett"
Ascent,El Barco Esports,rustoria mondays,7,13,1,7,6,6,"Breach,Sova,Killjoy,Jett,Astra","Sova,Killjoy,Omen,Jett,KAY/O"
Sunset,Linares eSports,Peluqueria Mariloli,11,13,3,9,4,8,"Breach,Cypher,Sova,Omen,Neon","Breach,Cypher,Sova,Omen,Neon"
Ascent,rustoria mondays,Avoid Esports,13,3,4,0,3,9,"Sova,Killjoy,Omen,Jett,KAY/O","Sova,Killjoy,Omen,Jett,KAY/O"
Bind,Tani Tsukuyomi,Mighty Meerkats,13,7,7,5,2,6,"Omen,Skye,Yoru,Fade,Clove","Raze,Viper,Brimstone,Skye,Gekko"
Bind,CryZen,Las Palmas Unity,13,10,4,7,3,9,"Raze,Omen,Skye,KAY/O,Clove","Breach,Viper,Brimstone,Yoru,Fade"
Haven,vortex esports,El Barco Esports,9,13,5,5,8,4,"Breach,Sova,Killjoy,Omen,Neon","Breach,Sova,Killjoy,Astra,Neon"
Abyss,CDC Valorant,Monta Club Ace,14,12,9,4,8,5,"Cypher,Sova,Jett,Astra,Gekko","Breach,Cypher,Sova,Omen,Jett"
Bind,Peluqueria Mariloli,Tani Susano,13,4,3,2,2,10,"Raze,Sova,Brimstone,Skye,Chamber","Raze,Viper,Brimstone,Skye,Gekko"
Haven,Universae,Fractious Esports,13,11,7,5,6,6,"Killjoy,Viper,Omen,Jett,Skye","Breach,Cypher,Sova,Omen,Jett"
Split,Linares eSports,MaskapalosAutenticoGuachupino,19,17,8,10,7,11,"Breach,Raze,Cypher,Omen,Skye","Breach,Raze,Cypher,Omen,Jett"
Haven,AMBYS Team,rustoria mondays,8,13,5,4,9,3,"Breach,Cypher,Sova,Astra,Neon","Sova,Reyna,Omen,Jett,Chamber"
Sunset,RAVEN EXODUS,Las Palmas Unity,10,13,2,10,3,8,"Breach,Cypher,Sova,Omen,Neon","Cypher,Omen,KAY/O,Neon,Gekko"
Sunset,Locked Esports,vortex esports,9,13,4,6,7,5,"Breach,Raze,Cypher,Omen,Gekko","Breach,Cypher,Sova,Omen,Neon"
Sunset,Monta Club Ace,Team Focus,13,8,6,3,5,7,"Breach,Cypher,Omen,Neon,Gekko","Breach,Cypher,Sova,Omen,Neon"
Bind,Avoid Esports,ADCeuta esports,13,10,6,5,5,7,"Raze,Brimstone,Reyna,Skye,Harbor","Raze,Cypher,Brimstone,Skye,Gekko"
Ascent,Tani Tsukuyomi,TLS eSports,13,11,6,6,5,7,"Cypher,Sova,Omen,Jett,KAY/O","Killjoy,Viper,Omen,Jett,Skye"
Ascent,Visions eSports,El Barco Esports,5,13,4,8,5,1,"Cypher,Sova,Omen,Jett,Deadlock","Breach,Sova,Killjoy,Jett,Astra"
Bind,Arctic Ninjas,Tani Susano,2,13,2,10,3,0,"Raze,Viper,Skye,Astra,Chamber","Raze,Viper,Brimstone,Skye,Gekko"
Ascent,Cierzo Esports,CryZen,2,13,0,3,10,2,"Viper,Phoenix,Omen,Skye,Gekko","Breach,Omen,Neon,Fade,Deadlock"
Ascent,Peluqueria Mariloli,Guinea Pink Silkie,13,6,7,0,6,6,"Sova,KAY/O,Chamber,Iso,Clove","Sova,Killjoy,Omen,Jett,Gekko"
Haven,La Banda del Patio,MaskapalosAutenticoGuachupino,4,13,0,5,8,4,"Breach,Sova,Killjoy,Omen,Jett","Sova,Killjoy,Omen,Jett,Iso"
Haven,CDC Valorant,Velaxis Academy,13,7,4,4,3,9,"Breach,Cypher,Sova,Astra,Neon","Breach,Sova,Killjoy,Omen,Jett"
Sunset,KHORE GAMING,Universae,10,13,5,6,7,5,"Breach,Cypher,Sova,Omen,Neon","Breach,Raze,Cypher,Omen,Gekko"
Abyss,Fractious Esports,Tani Amaterasu,13,8,8,1,7,5,"Cypher,Sova,Jett,Astra,KAY/O","Cypher,Sova,Omen,KAY/O,Neon"
Sunset,Peluqueria Mariloli,SZK Academy,13,6,4,3,3,9,"Breach,Cypher,Sova,Omen,Neon","Breach,Cypher,Sova,Omen,Neon"
Sunset,XTirpeTeam,EREUS,13,7,5,3,4,8,"Breach,Cypher,Sova,Omen,Neon","Breach,Cypher,Sova,Omen,Neon"
Haven,eLionking Academy,rustoria mondays,2,13,1,11,2,1,"Breach,Sova,Killjoy,Jett,Astra","Breach,Killjoy,Reyna,Jett,Clove"
Ascent,Waist EC,El Barco Esports,2,13,2,10,3,0,"Sova,Killjoy,Omen,Jett,KAY/O","Breach,Sova,Killjoy,Jett,Astra"
Haven,TEAM VELAXIS,Locked Esports,8,13,3,9,4,5,"Breach,Sova,Killjoy,Omen,Jett","Breach,Cypher,Sova,Astra,Neon"
Haven,AMBYS Team,5GY eSports,13,11,2,10,1,11,"Breach,Cypher,Sova,Astra,Neon","Breach,Cypher,Sova,Omen,Neon"
Haven,Monta Club Ace,Nexum EC,14,12,6,7,5,8,"Breach,Cypher,Sova,Omen,Neon","Breach,Sova,Killjoy,Astra,Neon"
Haven,RAVEN EXODUS,VOID (EU),15,13,9,5,8,6,"Breach,Cypher,Sova,Omen,Neon","Breach,Sova,Killjoy,Omen,Neon"
Bind,Stray Wolves,Avoid Esports,10,13,6,6,7,4,"Raze,Brimstone,Omen,Gekko,Deadlock","Raze,Brimstone,Reyna,Skye,Harbor"
Sunset,Linares eSports,Genesis eSports,13,6,6,1,5,7,"Breach,Cypher,Sova,Omen,Neon","Breach,Cypher,Sova,Omen,Neon"
Ascent,KBT Gaming,TLS eSports,6,13,0,7,6,6,"Cypher,Sova,Omen,Jett,KAY/O","Killjoy,Viper,Omen,Jett,Skye"
Ascent,UnderDogs SYN,Tani Tsukuyomi,12,14,2,11,3,10,"Sova,Killjoy,Omen,Jett,KAY/O","Cypher,Sova,Omen,Jett,KAY/O"
Ascent,Team Ogmios,CryZen,7,13,3,9,4,4,"Cypher,Sova,Omen,Jett,Gekko","Breach,Omen,Neon,Fade,Deadlock"
Haven,MaskapalosAutenticoGuachupino,Arco de Jason Staham,13,7,8,0,7,5,"Sova,Killjoy,Omen,Jett,Iso","Breach,Sova,Killjoy,Omen,Jett"
Split,LINX Academy,La Banda del Patio,4,13,3,2,11,1,"Breach,Raze,Cypher,Omen,Fade","Breach,Raze,Cypher,Sage,Omen"
Bind,ADCeuta esports,Future Radiants ,13,6,5,2,4,8,"Raze,Cypher,Brimstone,Skye,Gekko","Raze,Viper,Brimstone,Reyna,Fade"
Haven,KHORE GAMING,El Pueblo,13,2,10,2,0,3,"Sova,Viper,Yoru,Astra,Deadlock","Breach,Cypher,Sova,Omen,Jett"
Haven,Divine eSports,vortex esports,2,13,1,11,2,1,"Breach,Cypher,Sova,Omen,Jett","Breach,Sova,Killjoy,Omen,Neon"
Pearl,Las Palmas Unity,Osprey Jade,13,3,10,2,1,3,"Viper,Jett,Astra,KAY/O,Fade","Cypher,Viper,Jett,Astra,KAY/O"
Sunset,Velaxis Academy,Guinea Pink Baldwin,13,7,4,4,3,9,"Breach,Cypher,Sova,Omen,Neon","Breach,Cypher,Sova,Omen,Neon"
Haven,SLEIK Esports,Fractious Esports,3,13,1,3,10,2,"Breach,Cypher,Sova,Omen,Jett","Breach,Cypher,Sova,Omen,Jett"
Bind,CDC Valorant,Dranwork,13,4,4,1,3,9,"Raze,Viper,Brimstone,Skye,Gekko","Raze,Cypher,Brimstone,Skye,Gekko"
Bind,Nick Hers,Tani Susano,3,13,0,4,9,3,"Breach,Cypher,Omen,Neon,Deadlock","Raze,Viper,Brimstone,Skye,Gekko"
Bind,Karasu Eaters,Universae,0,13,0,12,1,0,"Raze,Viper,Brimstone,Skye,Gekko","Viper,Omen,Skye,Neon,Fade"
Ascent,Nyx (SP),Cierzo Esports,6,13,6,6,7,0,"Cypher,Sova,Jett,KAY/O,Clove","Viper,Phoenix,Omen,Skye,Gekko"
Ascent,W2WG,Visions eSports,5,13,0,6,7,5,"Sova,Killjoy,Reyna,Omen,Jett","Cypher,Sova,Omen,Jett,Deadlock"
Haven,Team Focus,Cerox Esports,13,6,7,5,1,6,"Breach,Sova,Killjoy,Omen,Jett","Breach,Sova,Killjoy,Omen,Neon"
Lotus,ZETA DIVISION GC,BOBA,13,11,6,6,5,7,"Breach,Cypher,Omen,Neon,Fade","Killjoy,Viper,Omen,Neon,Fade"
Sunset,ZETA DIVISION GC,BOBA,15,13,8,6,7,7,"Breach,Raze,Cypher,Sova,Omen","Breach,Cypher,Sova,Omen,Neon"
Lotus,sisu,swaglord9000,13,7,6,2,5,7,"Omen,Chamber,Neon,Fade","Raze,Cypher,Omen,Fade,Deadlock"
Bind,sisu,swaglord9000,13,1,11,1,0,2,"Raze,Omen,Fade,Clove","Raze,Cypher,Viper,Brimstone,Skye"
Ascent,sisu,swaglord9000,8,13,4,5,8,4,"Sova,Killjoy,Omen,Jett,KAY/O","Cypher,Sova,Omen,Yoru,Deadlock"
Lotus,REVOADA,ygrenys,13,8,6,3,5,7,"Raze,Killjoy,Viper,Omen,Fade","Breach,Raze,Killjoy,Omen,Fade"
Haven,Vila das Flores,lend e amigas,13,9,6,6,3,7,"Breach,Cypher,Sova,Omen,Neon","Breach,Sova,Killjoy,Omen,Neon"
Sunset,Team Leveling,Tartarugas Pinga,13,3,2,2,1,11,"Cypher,Sova,Phoenix,Omen,Yoru","Cypher,Sova,Neon,Clove"
Ascent,sou proplayer lixo?,PS5Patas,13,2,3,0,2,10,"Sova,Killjoy,Omen,Jett,KAY/O","Sova,Killjoy,Omen,Jett,KAY/O"
Ascent,Vila das Flores,lend e amigas,13,9,4,8,1,9,"Cypher,Sova,Omen,Jett,Yoru","Sova,Killjoy,Omen,Jett,Iso"
Bind,REVOADA,ygrenys,13,8,8,4,4,5,"Raze,Viper,Skye,Deadlock,Clove","Raze,Viper,Brimstone,Skye,Gekko"
Haven,Team Leveling,Tartarugas Pinga,13,7,9,3,4,4,"Breach,Cypher,Sova,Astra,Neon","Breach,Sova,Killjoy,Omen,Neon"
Icebox,sou proplayer lixo?,PS5Patas,13,3,4,0,3,9,"Sova,Killjoy,Viper,Sage,Jett","Sova,Killjoy,Viper,Jett,Iso"
Lotus,BOBA,FENNEL GC,13,7,4,4,3,9,"Killjoy,Viper,Omen,Neon,Fade","Breach,Raze,Cypher,Omen,Fade"
Ascent,BOBA,FENNEL GC,13,10,5,6,4,8,"Cypher,Sova,Omen,Jett,Deadlock","Sova,Killjoy,Omen,Jett,KAY/O"
Icebox,Purr-fectionists,swaglord9000,12,14,8,5,9,4,"Sova,Killjoy,Viper,Jett,Gekko","Sova,Killjoy,Viper,Sage,Jett"
Bind,Purr-fectionists,swaglord9000,13,9,9,3,6,4,"Raze,Viper,Brimstone,Skye,Gekko","Raze,Cypher,Viper,Brimstone,Skye"
Ascent,Purr-fectionists,swaglord9000,3,13,3,9,4,0,"Sova,Killjoy,Reyna,Omen,Jett","Cypher,Sova,Omen,Yoru,Deadlock"
Bind,ZETA DIVISION GC,Xipto Esports,6,13,3,4,9,3,"Raze,Cypher,Viper,Brimstone,Skye","Raze,Viper,Brimstone,Fade,Gekko"
Ascent,ZETA DIVISION GC,Xipto Esports,5,13,5,7,6,0,"Sova,Killjoy,Omen,Jett,KAY/O","Cypher,Sova,Omen,Jett,KAY/O"
Sunset,TOTALE Talents,Tartarugas Pinga,10,13,4,7,6,6,"Breach,Raze,Cypher,Sova,Omen","Cypher,Sova,Omen,Neon"
Haven,lend e amigas,sem fazer careta,13,4,8,4,0,5,"Breach,Sova,Killjoy,Omen,Neon","Breach,Killjoy,Omen,Jett,Skye"
Lotus,ygrenys,Addictes GC,13,5,9,3,2,4,"Breach,Raze,Killjoy,Omen,Fade","Breach,Cypher,Omen,Neon,Gekko"
Haven,TOTALE Talents,Tartarugas Pinga,10,13,2,10,3,8,"Breach,Sova,Killjoy,Omen,Jett","Breach,Sova,Killjoy,Omen,Neon"
Haven,YDZ Black,Skyline Dreamers GC,13,5,5,1,4,8,"Breach,Sova,Killjoy,Omen,Jett","Cypher,Sova,Omen,Yoru,Iso"
Haven,sou proplayer lixo?,Miaww,13,1,11,1,0,2,"Cypher,Sova,Omen,Yoru,Iso","Breach,Raze,Killjoy,Omen,Fade"
Abyss,Vila das Flores,Ratas de Lan,13,4,4,1,3,9,"Cypher,Sova,Omen,Jett,Harbor","Breach,Raze,Cypher,Sova,Astra"
Ascent, RITUAL RËAL,Passionless Project,13,1,11,1,0,2,"Cypher,Sova,Omen,Jett,KAY/O","Sova,Killjoy,Omen,Jett,KAY/O"
Bind,REVOADA,aposentadas,13,2,2,1,1,11,"Raze,Skye,Chamber,Neon,Clove","Cypher,Brimstone,Skye,Fade,Iso"
Icebox,Team Leveling,PROCURADAS,13,11,5,7,4,8,"Sova,Killjoy,Viper,Jett,Iso","Sova,Killjoy,Viper,Jett,Gekko"
Icebox,PS5Patas,Shark Origin,13,1,11,1,0,2,"Sova,Killjoy,Viper,Jett,Iso","Killjoy,Viper,Sage,Jett,Gekko"
Icebox,sou proplayer lixo?,Miaww,13,0,1,0,0,12,"Sova,Killjoy,Viper,Jett,Iso","Sova,Killjoy,Viper,Reyna,Jett"
Icebox,lend e amigas,sem fazer careta,15,13,5,9,4,10,"Sova,Killjoy,Viper,Jett,Gekko","Sova,Killjoy,Viper,Reyna,Iso"
Bind,ygrenys,Addictes GC,14,12,8,5,7,6,"Raze,Viper,Brimstone,Skye,Gekko","Viper,Skye,Astra,Neon,Gekko"
Ascent,TOTALE Talents,Tartarugas Pinga,13,11,5,7,4,8,"Sova,Killjoy,Omen,Jett,KAY/O","Sova,Killjoy,Omen,Chamber,Neon"
Ascent,Vila das Flores,Ratas de Lan,13,4,4,1,3,9,"Cypher,Sova,Omen,Jett,Yoru","Sova,Killjoy,Omen,Jett,KAY/O"
Haven,REVOADA,aposentadas,13,4,3,2,2,10,"Sova,Killjoy,KAY/O,Neon,Clove","Breach,Raze,Sova,Killjoy,Omen"
Bind,PS5Patas,Shark Origin,13,3,4,0,3,9,"Raze,Cypher,Brimstone,Gekko,Iso","Raze,Brimstone,Astra,Gekko"
Abyss,Team Leveling,PROCURADAS,13,7,8,4,3,5,"Sova,Reyna,Omen,Jett,Deadlock","Breach,Cypher,Omen,Jett,Gekko"
Sunset,YDZ Black,Skyline Dreamers GC,13,11,7,5,6,6,"Breach,Raze,Cypher,Omen,Gekko","Breach,Raze,Cypher,Omen,Gekko"
Lotus, RITUAL RËAL,Passionless Project,6,13,1,6,7,5,"Raze,Cypher,Omen,Fade,Deadlock","Breach,Raze,Cypher,Omen,Gekko"
Haven,Day By Day,Nori X,13,6,4,3,3,9,"Cypher,Sova,Yoru,Astra,Iso","Breach,Cypher,Sova,Omen,Jett"
Icebox,HyperSpeed Red,Elite Dynasty GC,13,4,5,0,4,8,"Sova,Killjoy,Viper,Jett,Yoru","Sova,Killjoy,Viper,Jett,Harbor"
Sunset,Give Wingman 2 Nuclear Devices,SHU GC,14,12,9,4,8,5,"Breach,Sova,Omen,Chamber,Neon","Raze,Cypher,Astra,Fade,Gekko"
Bind,Ominous Minions,AURA Eclipse,13,8,7,5,3,6,"Raze,Viper,Brimstone,Fade,Gekko","Raze,Cypher,Viper,Brimstone,Skye"
Ascent,meowtastic,Erinite GC,13,8,7,5,3,6,"Sova,Killjoy,Omen,Jett,KAY/O","Sova,Killjoy,Omen,Jett,KAY/O"
Lotus,Day By Day,Nori X,13,2,11,1,1,2,"Cypher,Omen,Skye,Neon,Clove","Breach,Raze,Omen,Chamber,Gekko"
Lotus,YDZ Black,Skyline Dreamers GC,10,13,3,9,4,7,"Breach,Raze,Cypher,Omen,Fade","Breach,Killjoy,Neon,Gekko,Clove"
Bind,Give Wingman 2 Nuclear Devices,SHU GC,13,6,7,5,1,6,"Raze,Skye,Astra,Chamber,Deadlock","Raze,Viper,Brimstone,Fade,Gekko"
Lotus,HyperSpeed Red,Elite Dynasty GC,13,7,7,5,2,6,"Breach,Killjoy,Omen,Neon,Fade","Breach,Cypher,Sova,Omen,Neon"
Abyss, RITUAL RËAL,Passionless Project,13,10,4,7,3,9,"Cypher,Sova,Jett,Astra,KAY/O","Breach,Cypher,Sova,Jett,Astra"
Sunset,Ominous Minions,AURA Eclipse,13,4,4,1,3,9,"Breach,Raze,Cypher,Omen,Fade","Breach,Cypher,Sova,Omen,Neon"
Haven,meowtastic,Erinite GC,13,3,4,0,3,9,"Breach,Sova,Killjoy,Omen,Jett","Breach,Sova,Omen,Chamber,Neon"
Haven,Mir Gaming GC,sisu,14,12,6,7,5,8,"Breach,Sova,Killjoy,Omen,Jett","Breach,Sova,Killjoy,Astra,Neon"
Lotus,Mir Gaming GC,sisu,13,15,8,6,9,5,"Killjoy,Viper,Omen,Neon,Fade","Omen,Chamber,Neon,Fade"
Icebox,Mir Gaming GC,sisu,13,6,4,3,3,9,"Sova,Killjoy,Viper,Jett,Gekko","Sova,Killjoy,Viper,Jett,Harbor"
Haven,Xipto Esports,FENNEL GC,13,3,9,3,0,4,"Killjoy,Viper,Omen,Jett,Skye","Breach,Sova,Killjoy,Omen,Jett"
Sunset,Xipto Esports,FENNEL GC,13,9,5,5,4,8,"Cypher,Sova,Omen,KAY/O,Neon","Breach,Raze,Cypher,Omen,Fade"
Ascent,ZETA DIVISION GC,BOBA,13,11,10,2,9,3,"Sova,Killjoy,Omen,Jett,KAY/O","Cypher,Sova,Omen,Jett,Deadlock"
Abyss,ZETA DIVISION GC,BOBA,7,13,3,9,4,4,"Cypher,Sova,Jett,Astra,KAY/O","Cypher,Sova,Omen,Jett,KAY/O"
Haven,ZETA DIVISION GC,BOBA,13,10,8,3,7,5,"Breach,Cypher,Sova,Omen,Neon","Breach,Sova,Killjoy,Omen,Neon"
Abyss,Tenax GC,meowtastic,14,12,5,8,4,9,"Breach,Sova,Omen,Jett,Astra","Breach,Cypher,Sova,Jett,Astra"
Lotus,oomfies,Ominous Minions,13,4,3,2,2,10,"Sova,Sage,Reyna,Yoru,Clove","Sova,Reyna,Neon,Iso,Clove"
Ascent,oomfies,Ominous Minions,13,5,5,1,4,8,"Cypher,Sova,Yoru,Deadlock,Clove","Sova,Killjoy,Omen,Jett,KAY/O"
Icebox,Tenax GC,meowtastic,16,14,9,6,8,7,"Sova,Viper,Sage,Reyna,Chamber","Sova,Killjoy,Viper,Jett,KAY/O"
Abyss,Akave Esports Black,FUSION X,10,13,7,5,8,3,"Sova,Killjoy,Viper,Yoru,Astra","Cypher,Sova,Jett,Astra,Gekko"
Sunset,Shopify Rebellion,YDZ Black,13,0,12,0,0,1,"Breach,Cypher,Sova,Omen,Neon","Breach,Raze,Cypher,Omen,Gekko"
Haven,SaD FROST,Day By Day,13,10,7,4,6,6,"Breach,Cypher,Sova,Omen,Jett","Breach,Cypher,Sova,Omen,Jett"
Ascent,Tenax GC,meowtastic,6,13,3,4,9,3,"Sova,Killjoy,Omen,Yoru,Iso","Sova,Killjoy,Omen,Jett,KAY/O"
Bind,SHU GC,Purpose Gaming Sirens,13,6,7,0,6,6,"Raze,Viper,Brimstone,Fade,Gekko","Raze,Viper,Brimstone,Skye,Gekko"
Lotus,Refrag,Give Wingman 2 Nuclear Devices,13,3,3,1,2,10,"Breach,Raze,Cypher,Fade,Clove","Breach,Raze,Killjoy,Reyna,Omen"
Ascent,mesos millionaires, RITUAL RËAL,13,7,9,3,4,4,"Sova,Killjoy,Jett,Astra,KAY/O","Cypher,Sova,Omen,Jett,KAY/O"
Bind,Ominous Minions,AURA Eclipse,13,9,6,4,5,7,"Raze,Viper,Brimstone,Fade,Gekko","Raze,Cypher,Viper,Brimstone,Skye"
Icebox,Shopify Rebellion,YDZ Black,13,4,9,3,1,4,"Killjoy,Viper,Reyna,KAY/O,Gekko","Sova,Killjoy,Viper,KAY/O,Clove"
Ascent,Teddy Tactics,HyperSpeed Red,13,10,7,4,6,6,"Breach,Cypher,Sova,Jett,Astra","Sova,Killjoy,Omen,Jett,KAY/O"
Ascent,SaD FROST,Day By Day,13,8,6,3,5,7,"Sova,Killjoy,Omen,Jett,KAY/O","Cypher,Sova,Omen,Jett,KAY/O"
Lotus,BBB,Nori X,3,13,0,4,9,3,"Raze,Killjoy,Omen,Fade,Gekko","Breach,Raze,Omen,Chamber,Gekko"
Lotus,Akave Esports Black,FUSION X,13,1,11,1,0,2,"Raze,Killjoy,Viper,Omen,Fade","Breach,Raze,Cypher,Fade,Clove"
Lotus,Akave Esports Black,FUSION X,13,1,11,1,0,2,"Raze,Killjoy,Viper,Omen,Fade","Breach,Raze,Cypher,Fade,Clove"
Sunset,mesos millionaires, RITUAL RËAL,13,8,7,2,6,6,"Breach,Raze,Cypher,Sova,Clove","Raze,Cypher,Omen,KAY/O,Gekko"
Haven,SHU GC,Purpose Gaming Sirens,13,10,9,3,7,4,"Breach,Sova,Killjoy,Omen,Jett","Breach,Sova,Killjoy,Omen,Jett"
Icebox,Refrag,Give Wingman 2 Nuclear Devices,13,9,6,6,3,7,"Sova,Killjoy,Viper,Jett,Gekko","Sova,Viper,Sage,Reyna,Chamber"
Ascent,Erinite GC,meowtastic,6,13,2,10,3,4,"Sova,Killjoy,Omen,Jett,KAY/O","Sova,Killjoy,Omen,Jett,KAY/O"
Haven,Teddy Tactics,HyperSpeed Red,13,7,7,5,2,6,"Breach,Cypher,Sova,Jett,Astra","Breach,Sova,Killjoy,Omen,Neon"
Lotus,Ominous Minions,AURA Eclipse,12,14,4,9,5,8,"Breach,Raze,Omen,Fade,Clove","Breach,Neon,Deadlock,Clove"
Lotus,YDZ Black,Skyline Dreamers GC,13,6,5,2,4,8,"Breach,Raze,Cypher,Omen,Fade","Breach,Killjoy,Neon,Gekko,Clove"
Haven,Day By Day,Nori X,13,9,7,5,4,6,"Breach,Cypher,Sova,Omen,Jett","Breach,Cypher,Sova,Omen,Jett"
Lotus,Refrag,SHU GC,13,8,3,6,2,10,"Raze,Omen,Fade,Deadlock","Breach,Cypher,Omen,Neon,Fade"
Sunset,SaD FROST,BBB,13,2,10,2,0,3,"Breach,Raze,Cypher,Omen,Gekko","Breach,Raze,Cypher,Omen,Gekko"
Bind,Akave Esports Black,FUSION X,13,6,6,6,0,7,"Raze,Viper,Skye,Astra,Iso","Raze,Cypher,Brimstone,Skye,Gekko"
Haven,Erinite GC,meowtastic,13,5,7,5,0,6,"Breach,Sova,Omen,Chamber,Neon","Breach,Sova,Killjoy,Omen,Jett"
Lotus, RITUAL RËAL,Passionless Project,13,8,5,4,4,8,"Raze,Cypher,Omen,Fade,Deadlock","Breach,Raze,Cypher,Omen,Gekko"
Bind,Give Wingman 2 Nuclear Devices,Purpose Gaming Sirens,13,1,11,1,0,2,"Raze,Skye,Astra,Chamber,Deadlock","Raze,Viper,Brimstone,Skye,Gekko"
Lotus,HyperSpeed Red,Elite Dynasty GC,13,6,10,2,4,3,"Breach,Killjoy,Omen,Neon,Fade","Breach,Cypher,Sova,Omen,Neon"
Bind,Day By Day,Nori X,13,5,9,3,2,4,"Raze,Cypher,Viper,Brimstone,Skye","Raze,Viper,Brimstone,Chamber,Gekko"
Bind,Refrag,SHU GC,13,7,4,4,3,9,"Raze,Viper,Brimstone,Yoru,Gekko","Raze,Viper,Brimstone,Fade,Gekko"
Sunset,Ominous Minions,AURA Eclipse,13,9,9,3,6,4,"Breach,Raze,Cypher,Omen,Fade","Breach,Cypher,Sova,Omen,Neon"
Sunset,YDZ Black,Skyline Dreamers GC,13,8,10,2,6,3,"Breach,Raze,Cypher,Omen,Gekko","Breach,Raze,Cypher,Omen,Gekko"
Bind,SaD FROST,BBB,13,3,2,2,1,11,"Raze,Viper,Brimstone,Skye,Chamber","Raze,Brimstone,Jett,Skye,Gekko"
Haven,HyperSpeed Red,Elite Dynasty GC,13,2,10,2,0,3,"Breach,Sova,Killjoy,Omen,Neon","Breach,Cypher,Sova,Omen,Neon"
Haven, RITUAL RËAL,Passionless Project,13,2,3,0,2,10,"Breach,Cypher,Sova,Omen,Jett","Breach,Cypher,Sova,Omen,Neon"
Sunset,Give Wingman 2 Nuclear Devices,Purpose Gaming Sirens,13,3,11,1,2,2,"Breach,Cypher,Sova,Omen,Neon","Breach,Raze,Cypher,Omen,Gekko"
Icebox,Erinite GC,meowtastic,3,13,1,11,2,2,"Sova,Killjoy,Jett,Harbor,Clove","Sova,Killjoy,Viper,Jett,KAY/O"
Sunset,Möyhentäjät,wade,3,13,3,9,4,0,"Breach,Raze,Cypher,Sova,Brimstone","Breach,Cypher,Sova,Neon,Clove"
Lotus,Ahlman ,VIRMA,1,13,0,2,11,1,"Raze,Cypher,Omen,Gekko,Clove","Breach,Raze,Omen,Chamber,Deadlock"
Ascent,Möyhentäjät,wade,2,13,2,1,12,0,"Sova,Killjoy,Phoenix,Omen,Jett","Sova,Killjoy,Jett,KAY/O,Clove"
Ascent,Ahlman ,VIRMA,1,13,1,11,2,0,"Cypher,Omen,Jett,Yoru,KAY/O","Sova,Omen,Jett,KAY/O,Deadlock"
Lotus,SSalama,KAMK.GG,13,2,3,0,2,10,"Breach,Raze,Omen,Gekko","Viper,Chamber,Neon,Gekko,Clove"
Haven,SSalama,KAMK.GG,13,8,7,5,3,6,"Breach,Sova,Omen,Jett","Breach,Sova,Killjoy,Omen,Jett"
Sunset,Dupg Esports,Alternate Realities,13,2,11,1,1,2,"Breach,Cypher,Sova,Omen,Neon","Raze,Cypher,Omen,KAY/O,Gekko"
Bind,Dupg Esports,Alternate Realities,13,9,7,5,4,6,"Breach,Raze,Brimstone,Skye,Chamber","Raze,Viper,Brimstone,Fade,Gekko"
Ascent,Alternate Realities,Asterisk (IN),8,13,6,3,10,2,"Sova,Killjoy,Omen,Jett,KAY/O","Sova,Killjoy,Omen,Jett,KAY/O"
Icebox,Alternate Realities,Asterisk (IN),8,13,4,5,8,4,"Sova,Killjoy,Viper,Jett,Clove","Sova,Killjoy,Viper,Neon,Gekko"
Icebox,sisu,swaglord9000,13,10,7,4,6,6,"Sova,Killjoy,Viper,Jett,Harbor","Sova,Killjoy,Viper,Sage,Jett"
Haven,sisu,swaglord9000,13,4,5,0,4,8,"Breach,Sova,Killjoy,Astra,Neon","Cypher,Sova,Omen,Jett,Yoru"
Icebox,Mir Gaming GC,Purr-fectionists,13,11,7,5,6,6,"Sova,Killjoy,Viper,Jett,Gekko","Sova,Killjoy,Viper,Jett,Gekko"
Haven,Mir Gaming GC,Purr-fectionists,7,13,4,4,9,3,"Breach,Sova,Killjoy,Omen,Jett","Breach,Sova,Killjoy,Omen,Jett"
Lotus,Mir Gaming GC,Purr-fectionists,13,9,7,3,6,6,"Killjoy,Viper,Omen,Neon,Fade","Raze,Killjoy,Viper,Omen,Fade"
Sunset,KRÜ BLAZE,9z Team GC,13,9,7,5,4,6,"Breach,Cypher,Sova,Omen,Neon","Breach,Omen,Neon,Gekko,Deadlock"
Lotus,KRÜ BLAZE,9z Team GC,13,5,8,4,1,5,"Raze,Killjoy,Viper,Omen,Fade","Breach,Omen,Neon,Fade,Clove"
Bind,KRÜ BLAZE,9z Team GC,13,6,7,5,1,6,"Viper,Brimstone,Neon,Fade,Gekko","Astra,Neon,Fade,Gekko,Deadlock"
Lotus,Defient Esports,The Cult,13,6,3,4,2,10,"Breach,Raze,Cypher,Omen,Fade","Breach,Killjoy,Omen,Jett,Fade"
Sunset,Defient Esports,The Cult,13,4,4,1,3,9,"Breach,Cypher,Sova,Omen,Neon","Breach,Raze,Cypher,Gekko,Clove"
Lotus,KineTiX eSports X1,Blue Moon eSports,8,13,6,6,7,2,"Breach,Raze,Cypher,Omen,Fade","Breach,Raze,Killjoy,Omen,Fade"
Bind,KineTiX eSports X1,Blue Moon eSports,2,13,0,3,10,2,"Raze,Viper,Brimstone,Skye,Fade","Breach,Raze,Cypher,Brimstone,Fade"
Ascent,Dupg Esports,Niory Esports,10,13,4,7,6,6,"Cypher,Sova,Omen,Yoru,Deadlock","Sova,Killjoy,Omen,Jett,KAY/O"
Sunset,Dupg Esports,Niory Esports,9,13,6,6,7,3,"Breach,Cypher,Sova,Omen,Neon","Breach,Cypher,Sova,Omen,Neon"
Ascent,TBS GC,Vila das Flores,13,9,7,5,4,6,"Sova,Killjoy,Omen,Jett,KAY/O","Cypher,Sova,Omen,Jett,Yoru"
Abyss,TBS GC,Vila das Flores,13,9,9,3,6,4,"Cypher,Sova,Omen,Jett,KAY/O","Cypher,Sova,Omen,Jett,Harbor"
Bind,LOUD GC,REVOADA,13,3,11,1,2,2,"Raze,Cypher,Brimstone,Skye,Deadlock","Raze,Viper,Brimstone,Skye,Gekko"
Sunset,LOUD GC,REVOADA,13,6,7,5,1,6,"Raze,Cypher,Omen,KAY/O,Gekko","Breach,Cypher,Sova,Omen,Neon"
Lotus,LOUD GC,REVOADA,4,13,4,8,5,0,"Cypher,Omen,KAY/O,Neon,Fade","Raze,Killjoy,Viper,Omen,Fade"
Ascent,Imperium Gaming,Lotus Knights,6,13,3,9,4,3,"Sova,Killjoy,Reyna,Omen,Jett","Cypher,Sova,Omen,Jett,Deadlock"
Haven,Tap Tap Boom eSports,The Easy Crew,10,13,8,4,9,2,"Breach,Cypher,Sova,Omen,Jett","Breach,Cypher,Sova,Omen,Neon"
Haven,SZK Esports,LONETEAM,11,13,4,8,5,7,"Breach,Sova,Killjoy,Omen,Jett","Breach,Cypher,Sova,Omen,Jett"
Ascent,Tap Tap Boom eSports,The Easy Crew,15,13,5,9,4,10,"Sova,Killjoy,Omen,Jett,KAY/O","Cypher,Sova,Omen,Jett,KAY/O"
Lotus,NASR Ignite,GIANTX GC,11,13,6,6,7,5,"Raze,Cypher,Omen,KAY/O,Deadlock","Breach,Raze,Sova,Omen,Chamber"
Haven,TwentyStars,Dimonis,10,13,4,7,6,6,"Breach,Sova,Killjoy,Omen,Jett","Breach,Sova,Killjoy,Omen,Neon"
Abyss,Dark Horse Templars,Union Atta I,3,13,1,3,10,2,"Breach,Cypher,Sova,Astra,Neon","Sova,Omen,Neon,Gekko"
Sunset,Melilla Titans,SLTitans Esports,13,5,10,2,3,3,"Cypher,Sova,Omen,KAY/O,Neon","Cypher,Sova,Omen,KAY/O,Neon"
Abyss,NASR Ignite,GIANTX GC,13,9,7,5,4,6,"Cypher,Sova,Omen,Jett,KAY/O","Cypher,Sova,Jett,Astra,Gekko"
Ascent,Dark Horse Templars,Union Atta I,7,13,6,6,7,1,"Sova,Killjoy,Omen,Jett,KAY/O","Killjoy,Reyna,Omen,KAY/O"
Icebox,NASR Ignite,GIANTX GC,3,13,2,10,3,1,"Killjoy,Viper,Reyna,Gekko,Deadlock","Sova,Killjoy,Viper,Neon,Gekko"
Haven,Leça FC Esports,RTZN,13,8,5,4,4,8,"Cypher,Sova,Omen,Yoru,Iso","Breach,Cypher,Sova,Omen,Jett"
Abyss,ZINGERS,NoMercy,13,3,10,2,1,3,"Breach,Astra,Chamber,Neon,Harbor","Cypher,Sova,Omen,Jett,KAY/O"
Ascent,NASR Ignite,GIANTX GC,5,13,2,10,3,3,"Cypher,Sova,Omen,Jett,Deadlock","Sova,Killjoy,Omen,Jett,KAY/O"
Ascent,GMBLERS Esports,Team Galaga,13,6,4,3,3,9,"Sova,Killjoy,Omen,Jett,KAY/O","Sova,Killjoy,Omen,Jett,KAY/O"
Sunset,ZINGERS,NoMercy,13,8,5,7,1,8,"Breach,Cypher,Omen,Neon,Gekko","Breach,Cypher,Omen,Neon,Gekko"
Sunset,Las Cabras (EU),NewD,11,13,5,7,6,6,"Breach,Cypher,Sova,Omen,Neon","Breach,Cypher,Neon,Harbor,Gekko"
Bind,Sin Prisa Gaming,BOOM Esports,17,15,10,6,9,7,"Cypher,Brimstone,Skye,Neon,Deadlock","Raze,Cypher,Viper,Brimstone,Skye"
Haven,Las Cabras (EU),NewD,9,13,4,6,7,5,"Breach,Cypher,Sova,Omen,Neon","Breach,Cypher,Omen,Jett,Deadlock"
Haven,Sin Prisa Gaming,BOOM Esports,10,13,9,3,10,1,"Breach,Cypher,Sova,Omen,Neon","Cypher,Viper,Omen,Skye,Neon"
Haven,Pegasus Esports,TEAM BLINDSPOT,2,13,0,3,10,2,"Breach,Cypher,Sova,Omen,Neon","Breach,Cypher,Sova,Omen,Neon"
Lotus,Sin Prisa Gaming,BOOM Esports,12,14,6,7,7,6,"Cypher,Viper,Omen,Neon,Fade","Raze,Cypher,Viper,Omen,Fade"
Bind,Pegasus Esports,TEAM BLINDSPOT,3,13,3,9,4,0,"Raze,Viper,Fade,Harbor,Gekko","Raze,Viper,Brimstone,Skye,Gekko"
Icebox,Sin Prisa Gaming,BOOM Esports,13,10,3,9,1,10,"Sova,Killjoy,Viper,Jett,Harbor","Sova,Killjoy,Viper,Jett,Harbor"
Sunset,Sin Prisa Gaming,BOOM Esports,13,6,9,3,3,4,"Breach,Cypher,Neon,Fade,Clove","Breach,Raze,Cypher,Omen,Gekko"
Haven,FUSION X,MYVRA GC,13,7,7,1,6,6,"Cypher,Sova,Astra,Gekko,Iso","Breach,Raze,Cypher,Astra,Fade"
Abyss,FUSION X,MYVRA GC,6,13,1,6,7,5,"Cypher,Sova,Jett,Astra,Gekko","Breach,Raze,Cypher,Sova,Astra"
Lotus,FUSION X,MYVRA GC,13,6,3,4,2,10,"Breach,Raze,Cypher,Fade,Clove","Breach,Raze,Cypher,Omen,Deadlock"
Ascent,FUSION X,MYVRA GC,13,8,4,5,3,9,"Raze,Sova,KAY/O,Iso,Clove","Sova,Killjoy,Jett,KAY/O,Clove"
Lotus,LOUD GC,Team Liquid Brazil,9,13,5,7,6,4,"Cypher,Omen,KAY/O,Neon,Fade","Raze,Brimstone,Omen,Fade,Deadlock"
Bind,FUSION X,MYVRA GC,2,13,0,3,10,2,"Raze,Viper,Astra,Fade,Gekko","Raze,Brimstone,Fade,Deadlock"
Abyss,LOUD GC,Team Liquid Brazil,10,13,6,6,7,4,"Cypher,Sova,Omen,Jett,KAY/O","Cypher,Sova,Omen,Jett,KAY/O"
Bind,MIBR GC,TBS GC,13,7,5,3,4,8,"Raze,Viper,Brimstone,Fade,Gekko","Raze,Viper,Brimstone,Skye,Gekko"
Sunset,MIBR GC,TBS GC,13,4,10,2,2,3,"Breach,Raze,Cypher,Omen,Gekko","Cypher,Sova,Omen,KAY/O,Neon"
Ascent,Team Falcons Vega,GIANTX GC,8,13,5,7,6,3,"Sova,Jett,Astra,KAY/O,Fade","Sova,Killjoy,Omen,Jett,KAY/O"
Icebox,Team Galaga,LONETEAM,7,13,4,4,9,3,"Sova,Killjoy,Viper,Sage,Jett","Sova,Killjoy,Viper,Jett,Gekko"
Abyss,The giornalisti,EX0TIK GAMING,5,13,2,10,3,3,"Cypher,Sova,Omen,Jett,KAY/O","Cypher,Sova,Jett,Astra,KAY/O"
Abyss,Team GMask,Dimonis,8,13,5,7,6,3,"Cypher,Sova,Jett,Astra,KAY/O","Cypher,Sova,Jett,Astra,KAY/O"
Abyss,DSYRE Academy,CryZen,13,9,6,4,5,7,"Cypher,Sova,Yoru,Astra,Chamber","Omen,Jett,KAY/O,Fade,Deadlock"
Abyss,1000rr club,SLTitans Esports,13,11,8,4,7,5,"Cypher,Sova,Jett,Astra,Gekko","Cypher,Sova,Jett,Astra,KAY/O"
Haven,Team Falcons Vega,GIANTX GC,13,8,5,4,4,8,"Cypher,Sova,Omen,Neon,Iso","Breach,Killjoy,Viper,Omen,Yoru"
Ascent,Lotus Knights,RTZN,13,10,8,4,6,5,"Cypher,Sova,Omen,Jett,Deadlock","Cypher,Sova,Omen,Jett,KAY/O"
Icebox,Team Falcons Vega,GIANTX GC,2,13,1,11,2,1,"Sova,Killjoy,Viper,Jett,Gekko","Sova,Killjoy,Viper,Neon,Gekko"
Lotus,Melilla Titans,SZK Esports,4,13,1,4,9,3,"Breach,Cypher,Sova,Omen,Neon","Breach,Raze,Cypher,Omen,Fade"
Abyss,DSYRE Academy,EX0TIK GAMING,13,11,6,6,5,7,"Cypher,Sova,Yoru,Astra,Chamber","Cypher,Sova,Jett,Astra,KAY/O"
Abyss,1000rr club,Team Focus,13,8,5,4,4,8,"Cypher,Sova,Jett,Yoru,Astra","Cypher,Sova,Omen,Jett,KAY/O"
Abyss,The giornalisti,Team GMask,2,13,0,3,10,2,"Cypher,Sova,Omen,Yoru,Gekko","Cypher,Sova,Jett,Astra,KAY/O"
Abyss,CryZen,SLTitans Esports,15,16,9,7,9,6,"Omen,Jett,KAY/O,Fade,Deadlock","Cypher,Sova,Jett,Astra,KAY/O"
Sunset,G2 Gozen,NASR Ignite,13,8,9,3,5,4,"Breach,Cypher,Sova,Omen,Neon","Raze,Cypher,Sova,Omen,Deadlock"
Ascent,Velocity Gaming (EU),Blue Lock,8,13,5,7,6,3,"Sova,Killjoy,Omen,Jett,KAY/O","Sova,Killjoy,Omen,Jett,KAY/O"
Haven,Imperium Gaming,Dimonis,10,13,6,5,8,4,"Breach,Cypher,Sova,Omen,Jett","Breach,Sova,Killjoy,Omen,Neon"
Lotus,Velocity Gaming (EU),Blue Lock,9,13,4,6,7,5,"Breach,Killjoy,Omen,Neon,Fade","Breach,Raze,Killjoy,Viper,Omen"
Lotus,G2 Gozen,NASR Ignite,13,5,9,3,2,4,"Raze,Cypher,Omen,Fade,Deadlock","Raze,Cypher,Omen,KAY/O,Deadlock"
Abyss,GMBLERS Esports,SLTitans Esports,13,5,8,4,1,5,"Raze,Cypher,Sova,Omen,Astra","Cypher,Sova,Omen,Jett,KAY/O"
Bind,G2 Gozen,NASR Ignite,4,13,1,4,9,3,"Raze,Brimstone,Omen,Skye,Gekko","Raze,Cypher,Brimstone,Skye,Deadlock"
Haven,TwentyStars,Leça FC Esports,13,2,10,2,0,3,"Breach,Sova,Killjoy,Omen,Jett","Cypher,Sova,Omen,Yoru,Iso"
Ascent,WASP Elektra,Dark Horse Knights,13,8,8,4,4,5,"Cypher,Sova,Phoenix,Omen,Jett","Cypher,Sova,Omen,Jett,KAY/O"
Lotus,WASP Elektra,Dark Horse Knights,13,2,10,2,0,3,"Breach,Raze,Cypher,Omen,Neon","Raze,Cypher,Viper,Omen,Fade"
Icebox,Alternate Realities,Mogo eSports,5,13,2,4,9,3,"Sova,Killjoy,Viper,Jett,KAY/O","Sova,Killjoy,Viper,Jett,Gekko"
Icebox,Lost Dynasty,PANDEMONIUM,9,13,5,7,6,4,"Sova,Killjoy,Viper,Reyna,KAY/O","Sova,Killjoy,Viper,Jett,Harbor"
Haven,Alternate Realities,Mogo eSports,13,11,7,5,6,6,"Breach,Cypher,Sova,Omen,Neon","Breach,Cypher,Sova,Omen,Jett"
Haven,Lost Dynasty,PANDEMONIUM,7,13,4,8,5,3,"Breach,Sova,Killjoy,Omen,Jett","Cypher,Sova,Omen,Yoru,Iso"
Bind,Alternate Realities,Mogo eSports,10,13,6,6,7,4,"Raze,Viper,Brimstone,Fade,Gekko","Raze,Cypher,Viper,Brimstone,Gekko"
Sunset,FULL SENSE,BOOM Esports,9,13,5,7,6,4,"Breach,Cypher,Sova,Omen,Neon","Breach,Raze,Cypher,Omen,Gekko"
Ascent,Orangutan,Dupg Esports,13,8,6,6,2,7,"Cypher,Sova,Omen,Yoru,Deadlock","Cypher,Sova,Omen,Yoru,Deadlock"
Lotus,FULL SENSE,BOOM Esports,14,12,8,5,7,6,"Breach,Killjoy,Omen,Astra,Neon","Raze,Killjoy,Viper,Omen,Fade"
Icebox,Orangutan,Dupg Esports,13,0,1,0,0,12,"Sova,Killjoy,Viper,Jett,Gekko","Sova,Killjoy,Viper,Jett,KAY/O"
Abyss,FULL SENSE,BOOM Esports,9,13,3,7,6,6,"Breach,Cypher,Omen,Jett,Gekko","Cypher,Sova,Omen,Yoru,Clove"
Ascent,FULL SENSE,BOOM Esports,7,13,3,9,4,4,"Sova,Killjoy,Omen,Jett,KAY/O","Sova,Killjoy,Omen,Jett,KAY/O"
Bind,9z Team GC,Leviatán GC,13,9,7,5,4,6,"Raze,Astra,Fade,Gekko,Deadlock","Raze,Cypher,Viper,Brimstone,Skye"
Abyss,Team Leveling,Vila das Flores,5,13,4,8,5,1,"Sova,Omen,Astra,KAY/O,Neon","Cypher,Sova,Omen,Jett,Harbor"
Ascent,9z Team GC,Leviatán GC,8,13,2,7,6,6,"Sova,Killjoy,Omen,Jett,KAY/O","Cypher,Sova,Omen,Jett,Deadlock"
Bind,Team Leveling,Vila das Flores,14,12,9,4,8,5,"Raze,Viper,Brimstone,Skye,Gekko","Viper,Brimstone,Yoru,Neon,Fade"
Lotus,9z Team GC,Leviatán GC,13,6,5,2,4,8,"Breach,Omen,Neon,Fade,Clove","Raze,Killjoy,Viper,Omen,Fade"
Abyss,9z Team GC,Leviatán GC,13,10,8,3,7,5,"Cypher,Sova,Jett,Astra,Harbor","Cypher,Sova,Omen,Jett,Yoru"
Haven,Team Leveling,Vila das Flores,12,14,3,10,4,9,"Breach,Cypher,Sova,Omen,Neon","Breach,Cypher,Sova,Omen,Neon"
Lotus,PS5Patas,REVOADA,7,13,2,6,7,5,"Killjoy,Viper,Omen,Neon,Fade","Raze,Killjoy,Viper,Omen,Fade"
Haven,PS5Patas,REVOADA,3,13,3,9,4,0,"Breach,Sova,Killjoy,Astra,Neon","Breach,Sova,Killjoy,Omen,Jett"
Ascent,TwentyStars,Imperium Gaming,14,12,8,5,7,6,"Breach,Sova,Killjoy,Omen,Jett","Sova,Killjoy,Omen,Jett,KAY/O"
Ascent,Melilla Titans,GMBLERS Esports,6,13,5,7,6,1,"Sova,Killjoy,Omen,Jett,KAY/O","Sova,Killjoy,Omen,Jett,KAY/O"
Haven,HEROIC Valkyries,GIANTX GC,8,13,1,8,5,7,"Cypher,Sova,Omen,Yoru,Iso","Breach,Killjoy,Viper,Omen,Yoru"
Sunset,RTZN,Dimonis,13,9,10,2,7,3,"Breach,Cypher,Sova,Omen,Neon","Cypher,Sova,Omen,KAY/O,Neon"
Icebox,HEROIC Valkyries,GIANTX GC,3,13,3,9,4,0,"Sova,Killjoy,Viper,Jett,Iso","Sova,Killjoy,Viper,Neon,Gekko"
Sunset,LONETEAM,SLTitans Esports,9,13,7,5,8,2,"Breach,Cypher,Sova,Omen,Neon","Cypher,Sova,Omen,KAY/O,Neon"
Haven,Team Falcons Vega,Valiant GC,13,2,1,2,0,12,"Cypher,Sova,Omen,Neon,Iso","Breach,Sova,Killjoy,Omen,Neon"
Sunset,Leça FC Esports,Lotus Knights,3,13,2,2,11,1,"Cypher,Sova,Omen,KAY/O,Neon","Breach,Cypher,Sova,Omen,Neon"
Bind,Team Falcons Vega,Valiant GC,13,1,11,1,0,2,"Raze,Viper,Brimstone,Skye,Gekko","Raze,Viper,Brimstone,Fade,Gekko"
Haven,Team Galaga,SZK Esports,13,9,6,6,3,7,"Breach,Sova,Killjoy,Omen,Jett","Breach,Cypher,Sova,Omen,Jett"
Lotus,Team Serenity,Niory Esports,8,13,6,6,7,2,"Breach,Omen,Neon,Gekko,Iso","Breach,Sova,Killjoy,Omen,Neon"
Lotus,Asterisk (IN),Perfectionists,13,6,5,2,4,8,"Raze,Killjoy,Viper,Omen,Fade","Breach,Raze,Omen,Chamber,Fade"
Abyss,Asterisk (IN),Perfectionists,13,4,5,0,4,8,"Breach,Raze,Cypher,Astra,Gekko","Sova,Omen,Jett,Astra,Gekko"
Haven,Team Serenity,Niory Esports,8,13,3,6,7,5,"Killjoy,Viper,Omen,Jett,Skye","Breach,Sova,Killjoy,Omen,Neon"
Abyss,RIDDLE ORDER,BOOM Esports,3,13,0,4,9,3,"Cypher,Sova,Omen,Jett,KAY/O","Cypher,Sova,Omen,Yoru,Clove"
Sunset,BLUE BEES.ESP,IGZIST,10,13,2,9,4,8,"Breach,Raze,Cypher,Omen,Gekko","Cypher,Sova,Omen,KAY/O,Neon"
Lotus,NOEZ FOXX,Delight,13,9,7,5,4,6,"Breach,Cypher,Omen,Neon,Fade","Breach,Cypher,Sova,Omen,Neon"
Lotus,RIDDLE ORDER,BOOM Esports,15,17,10,6,11,5,"Breach,Omen,Neon,Fade,Clove","Raze,Killjoy,Viper,Omen,Fade"
Lotus,BLUE BEES.ESP,IGZIST,9,13,4,8,5,5,"Breach,Omen,Neon,Fade,Clove","Raze,Cypher,Omen,Astra,Fade"
Lotus,Sumthin Dumplin,BC SWELL,8,13,2,7,6,6,"Raze,Phoenix,Omen,Chamber,Fade","Breach,Killjoy,Omen,Neon,Fade"
Haven,NOEZ FOXX,Delight,13,4,5,0,4,8,"Breach,Cypher,Sova,Omen,Neon","Breach,Cypher,Sova,Omen,Neon"
Lotus,Crest Gaming ZST,BABO,13,5,8,4,1,5,"Raze,Killjoy,Viper,Omen,Fade","Raze,Killjoy,Viper,Omen,Fade"
Abyss,Sumthin Dumplin,BC SWELL,9,13,6,6,7,3,"Cypher,Sova,Phoenix,Omen,Jett","Cypher,Sova,Jett,Astra,KAY/O"
Ascent,BLUE BEES.ESP,IGZIST,13,10,9,2,8,4,"Sova,Killjoy,Omen,Jett,KAY/O","Sova,Killjoy,Omen,Jett,KAY/O"
Sunset,NOEZ FOXX,Delight,8,13,5,4,9,3,"Breach,Cypher,Sova,Omen,Neon","Cypher,Sova,Omen,KAY/O,Neon"
Bind,Crest Gaming ZST,BABO,13,4,9,3,1,4,"Raze,Cypher,Brimstone,Jett,Skye","Raze,Cypher,Brimstone,Skye,Deadlock"
Haven,Sin Prisa Gaming,FULL SENSE,13,0,12,0,0,1,"Breach,Cypher,Sova,Omen,Neon","Breach,Sova,Killjoy,Omen,Neon"
Bind,Sin Prisa Gaming,FULL SENSE,13,6,9,3,3,4,"Cypher,Brimstone,Neon,Fade,Deadlock","Raze,Viper,Brimstone,Fade,Gekko"
Ascent,Team Liquid Brazil,Vila das Flores,13,4,9,3,1,4,"Sova,Killjoy,Omen,Jett,KAY/O","Cypher,Sova,Phoenix,Omen,Jett"
Lotus,Team Liquid Brazil,Vila das Flores,13,9,4,8,1,9,"Raze,Killjoy,Viper,Omen,Fade","Breach,Cypher,Omen,Neon,Fade"
Bind,LOUD GC,Team Leveling,13,1,11,1,0,2,"Raze,Cypher,Brimstone,Skye,Deadlock","Raze,Viper,Brimstone,Skye,Gekko"
Sunset,ALTERNATE aTTaX Ruby,SK Nebula,8,13,4,8,5,4,"Breach,Cypher,Sova,Omen,Neon","Cypher,Sova,Omen,KAY/O,Neon"
Ascent,LOUD GC,Team Leveling,7,13,6,6,7,1,"Cypher,Sova,Omen,Jett,KAY/O","Sova,Killjoy,Omen,Jett,KAY/O"
Lotus,ALTERNATE aTTaX Ruby,SK Nebula,13,5,4,2,3,9,"Breach,Raze,Cypher,Omen,Fade","Raze,Cypher,Viper,Omen,Fade"
Sunset,FOKUS Sakura,SSP Numina,13,5,9,3,2,4,"Breach,Cypher,Omen,Neon,Fade","Breach,Cypher,Sova,Omen,Neon"
Haven,ALTERNATE aTTaX Ruby,SK Nebula,3,13,0,4,9,3,"Breach,Cypher,Sova,Omen,Jett","Breach,Cypher,Sova,Jett,Astra"
Sunset,LONETEAM,GMBLERS Esports,4,13,3,9,4,1,"Breach,Cypher,Sova,Omen,Neon","Breach,Sova,Killjoy,Astra,Neon"
Abyss,LOUD GC,Team Leveling,13,11,9,3,8,4,"Cypher,Sova,Omen,Jett,KAY/O","Sova,Omen,Astra,KAY/O,Neon"
Ascent,Reveal Multigaming Jushimori,Veni eSports Venom,7,13,6,6,7,1,"Sova,Killjoy,Phoenix,Omen,Jett","Sova,Omen,Jett,KAY/O,Chamber"
Ascent,TOG Kitsune,Permitta Unicorns GC,11,13,5,7,6,6,"Sova,Killjoy,Omen,Jett,KAY/O","Sova,Killjoy,Omen,Jett,KAY/O"
Ascent,FOKUS Sakura,SSP Numina,16,14,11,4,10,5,"Sova,Killjoy,Omen,Jett,Iso","Sova,Killjoy,Omen,Jett,KAY/O"
Sunset,Dimonis,Leça FC Esports,13,9,8,2,7,5,"Cypher,Sova,Omen,KAY/O,Neon","Cypher,Sova,Omen,KAY/O,Neon"
Abyss,Team Falcons Vega,NASR Ignite,6,13,4,8,5,2,"Cypher,Sova,Omen,Jett,KAY/O","Cypher,Sova,Omen,Jett,KAY/O"
Sunset,Dortmund eSports Dynasty,Entropy Azúcar,6,13,5,7,6,1,"Breach,Raze,Cypher,Omen,Fade","Raze,Cypher,Sage,Jett,Astra"
Ascent,NEON BLADE,teamhoppers,13,10,7,5,5,6,"Sova,Killjoy,Omen,Jett,KAY/O","Sova,Killjoy,Omen,Jett,KAY/O"
Sunset,ROA SYNC,LVENGERS,8,13,4,8,5,4,"Breach,Cypher,Sova,Neon,Clove","Breach,Raze,Cypher,Sova,Omen"
Haven,TOG Kitsune,Permitta Unicorns GC,13,3,4,0,3,9,"Breach,Cypher,Sova,Omen,Jett","Breach,Cypher,Sova,Jett,Astra"
Ascent,Scald eSport GC,RIZON Sugar,6,13,3,9,4,3,"Sova,Killjoy,Omen,Jett,Yoru","Sova,Killjoy,Omen,Jett,Neon"
Bind,Reveal Multigaming Jushimori,Veni eSports Venom,15,13,8,6,7,7,"Breach,Raze,Cypher,Brimstone,Fade","Raze,Brimstone,Chamber,Fade,Gekko"
Haven,Blindspot Kunai,Silly Seals,4,13,1,4,9,3,"Breach,Sova,Killjoy,Omen,Jett","Breach,Cypher,Sova,Omen,Neon"
Haven,Melilla Titans,Team Galaga,13,9,6,6,3,7,"Breach,Cypher,Sova,Omen,Jett","Breach,Sova,Killjoy,Omen,Jett"
Ascent,Team Falcons Vega,NASR Ignite,10,13,2,9,4,8,"Sova,Jett,Astra,KAY/O,Fade","Cypher,Sova,Omen,Jett,Deadlock"
Bind,ROA SYNC,LVENGERS,4,13,1,4,9,3,"Breach,Raze,Cypher,Brimstone,Skye","Breach,Raze,Cypher,Brimstone,Gekko"
Lotus,Blindspot Kunai,Silly Seals,1,13,0,2,11,1,"Breach,Killjoy,Omen,Jett,Gekko","Breach,Raze,Killjoy,Omen,Fade"
Abyss,NEON BLADE,teamhoppers,13,9,6,4,5,7,"Cypher,Sova,Omen,Jett,Gekko","Sova,Sage,Jett,Astra,KAY/O"
Sunset,Scald eSport GC,RIZON Sugar,8,13,3,9,4,5,"Breach,Cypher,Sova,Omen,Neon","Breach,Raze,Cypher,Sova,Omen"
Haven,Dortmund eSports Dynasty,Entropy Azúcar,10,13,7,5,8,3,"Breach,Sova,Killjoy,Omen,Jett","Breach,Sova,Killjoy,Omen,Jett"
Lotus,Reveal Multigaming Jushimori,Veni eSports Venom,5,13,3,9,4,2,"Breach,Raze,Killjoy,Omen,Fade","Breach,Omen,Chamber,Neon,Gekko"
Sunset,TOG Kitsune,Permitta Unicorns GC,7,13,1,7,6,6,"Breach,Cypher,Sova,Omen,Yoru","Breach,Raze,Cypher,Sova,Omen"
Sunset,TwentyStars,Lotus Knights,3,13,0,4,9,3,"Breach,Cypher,Sova,Omen,Neon","Breach,Cypher,Sova,Omen,Neon"
Ascent,SSalama,Valoja Päälle?,13,3,3,1,2,10,"Raze,Sova,Reyna,Clove","Brimstone,Omen,Fade,Gekko"
Bind,G2 Gozen,HEROIC Valkyries,14,12,7,6,6,7,"Raze,Brimstone,Omen,Skye,Gekko","Raze,Viper,Skye,Astra,Iso"
Bind,SZK Esports,SLTitans Esports,13,10,7,5,5,6,"Raze,Viper,Brimstone,Skye,Fade","Raze,Omen,Skye,Gekko,Deadlock"
Sunset,SSalama,Valoja Päälle?,13,0,12,0,0,1,"Breach,Sova,Omen,Jett","Cypher,Brimstone,Sage,KAY/O,Clove"
Abyss,G2 Gozen,HEROIC Valkyries,13,6,5,2,4,8,"Sova,Killjoy,Yoru,Astra,Harbor","Breach,Cypher,Sova,Jett,Astra"
Lotus,RTZN,Imperium Gaming,6,13,5,7,6,1,"Breach,Raze,Cypher,Omen,Fade","Breach,Killjoy,Omen,Neon,Fade"
Bind,Delight,Team SEIBI,13,9,8,4,5,5,"Raze,Viper,Omen,Skye,Yoru","Raze,Viper,Brimstone,Skye,Gekko"
Haven,Delight,Team SEIBI,10,13,6,5,8,4,"Breach,Cypher,Sova,Omen,Neon","Breach,Cypher,Sova,Omen,Jett"
Sunset,BC SWELL,WICKED,13,8,7,5,3,6,"Cypher,Sova,Omen,KAY/O,Neon","Breach,Cypher,Sova,Omen,Neon"
Abyss,Striders,IGZIST,8,13,3,9,4,5,"Cypher,Sova,Omen,Jett,KAY/O","Cypher,Sova,Omen,Yoru,Astra"
Abyss,BABO,ConTeNt Soul Gaming,13,6,7,5,1,6,"Cypher,Sova,Jett,Astra,KAY/O","Breach,Cypher,Sova,Jett,Astra"
Haven,BC SWELL,WICKED,13,3,2,2,1,11,"Breach,Cypher,Sova,Omen,Neon","Breach,Sova,Killjoy,Omen,Jett"
Sunset,Striders,IGZIST,5,13,2,4,9,3,"Cypher,Sova,Omen,KAY/O,Neon","Cypher,Sova,Omen,KAY/O,Neon"
Haven,BABO,ConTeNt Soul Gaming,13,2,3,0,2,10,"Breach,Cypher,Sova,Omen,Neon","Killjoy,Sage,Omen,Jett,KAY/O"
Lotus,Delight,Team SEIBI,13,9,5,7,2,8,"Breach,Cypher,Sova,Omen,Neon","Raze,Killjoy,Viper,Omen,Fade"
Haven,SCARZ,Sumthin Dumplin,5,13,1,5,8,4,"Cypher,Sova,Omen,Yoru,Iso","Cypher,Sova,Phoenix,Omen,Jett"
Bind,Perfectionists,Team Ruthless,13,8,6,6,2,7,"Raze,Viper,Brimstone,Fade,Gekko","Raze,Viper,Brimstone,Fade,Gekko"
Haven,Asterisk (IN),AIRAVATA ESPORTS,14,12,8,5,7,6,"Breach,Sova,Killjoy,Omen,Jett","Breach,Cypher,Phoenix,Omen,Yoru"
Haven,NOEZ FOXX,ASNA,13,5,3,3,2,10,"Breach,Cypher,Sova,Omen,Neon","Breach,Sova,Killjoy,Jett,Astra"
Ascent,Crest Gaming ZST,SCARZ Youth,13,8,8,4,4,5,"Sova,Killjoy,Omen,Jett,KAY/O","Raze,Viper,Reyna,Skye,Clove"
Ascent,SCARZ,Sumthin Dumplin,14,12,7,6,6,7,"Cypher,Sova,Omen,Jett,Deadlock","Sova,Killjoy,Phoenix,Omen,Jett"
Haven,Perfectionists,Team Ruthless,13,9,11,1,8,2,"Breach,Cypher,Sova,Omen,Jett","Sova,Killjoy,Reyna,Omen,Jett"
Lotus,Asterisk (IN),AIRAVATA ESPORTS,13,5,4,2,3,9,"Raze,Killjoy,Viper,Omen,Fade","Raze,Omen,Yoru,Chamber,Fade"
Sunset,BLUE BEES.ESP,OECU esports,13,1,2,0,1,11,"Cypher,Sova,Jett,Iso,Clove","Breach,Raze,Cypher,Sova,Omen"
Bind,Crest Gaming ZST,SCARZ Youth,13,6,8,4,2,5,"Raze,Cypher,Brimstone,Jett,Skye","Raze,Viper,Reyna,Skye,Clove"
Ascent,NOEZ FOXX,ASNA,13,8,5,4,4,8,"Sova,Killjoy,Omen,Jett,KAY/O","Sova,Killjoy,Omen,Jett,KAY/O"
Haven,BLUE BEES.ESP,OECU esports,13,1,2,0,1,11,"Breach,Sova,Killjoy,Omen,Jett","Breach,Sova,Killjoy,Omen,Jett"
Abyss,SCARZ,Sumthin Dumplin,4,13,3,9,4,1,"Sova,Viper,Jett,Yoru,Astra","Cypher,Sova,Phoenix,Omen,Jett"
Sunset,Bon Bon Bum Contra GC,MYVRA GC,8,13,6,6,7,2,"Breach,Sova,Sage,Omen,Gekko","Cypher,Sova,Phoenix,Astra"
Ascent,Bon Bon Bum Contra GC,MYVRA GC,13,3,2,2,1,11,"Sova,Killjoy,Phoenix,Omen,Jett","Sova,Killjoy,Jett,KAY/O,Clove"
Lotus,Bon Bon Bum Contra GC,MYVRA GC,9,13,3,9,4,6,"Breach,Raze,Cypher,Omen,Neon","Breach,Raze,Cypher,Omen,Deadlock"
Haven,Bon Bon Bum Contra GC,MYVRA GC,8,13,5,4,9,3,"Breach,Cypher,Sova,Omen,Chamber","Breach,Raze,Cypher,Astra,Fade"
Sunset,TBS GC,REVOADA,13,7,3,5,2,10,"Cypher,Sova,Omen,KAY/O,Neon","Breach,Cypher,Sova,Omen,Neon"
Haven,TBS GC,REVOADA,13,2,3,0,2,10,"Cypher,Sova,Omen,Yoru,Iso","Breach,Sova,Killjoy,Omen,Jett"
Bind,MIBR GC,PS5Patas,13,2,10,2,0,3,"Raze,Viper,Brimstone,Fade,Gekko","Raze,Brimstone,Skye,Yoru,Chamber"
Ascent,MIBR GC,PS5Patas,13,4,3,2,2,10,"Sova,Killjoy,Omen,Jett,KAY/O","Sova,Killjoy,Omen,Jett,KAY/O"
Ascent,Leça FC Esports,Imperium Gaming,3,13,0,4,9,3,"Breach,Sova,Astra,Neon","Sova,Killjoy,Omen,Jett,KAY/O"
Bind,SZK Esports,GMBLERS Esports,13,7,7,5,2,6,"Raze,Viper,Brimstone,Skye,Fade","Raze,Viper,Brimstone,Fade,Gekko"
Ascent,Odd 1 OUT,GIANTX GC,10,13,5,7,6,5,"Sova,Killjoy,Omen,Jett,KAY/O","Sova,Killjoy,Omen,Jett,KAY/O"
Sunset,Dimonis,Lotus Knights,2,13,0,3,10,2,"Cypher,Sova,Omen,KAY/O,Neon","Breach,Cypher,Sova,Omen,Neon"
Haven,Odd 1 OUT,GIANTX GC,2,13,0,3,10,2,"Breach,Cypher,Sova,Omen,Jett","Breach,Killjoy,Viper,Omen,Yoru"
Sunset,SLTitans Esports,Team Galaga,13,8,5,4,4,8,"Cypher,Sova,Omen,KAY/O,Neon","Raze,Cypher,Omen,KAY/O,Gekko"
Bind,Hampter,ISOSIMO,7,13,3,5,8,4,"Cypher,Phoenix,Reyna,Astra,Fade","Breach,Raze,Skye,Chamber,Clove"
Ascent,Hampter,ISOSIMO,5,13,3,9,4,2,"Sova,Killjoy,Phoenix,Reyna,Omen","Sova,Killjoy,Omen,Jett,KAY/O"
Haven,Valiant GC,Karmine Corp GC,13,8,8,4,4,5,"Breach,Sova,Killjoy,Omen,Neon","Breach,Sova,Killjoy,Omen,Neon"
Sunset,Melilla Titans,LONETEAM,7,13,2,6,7,5,"Cypher,Sova,Omen,KAY/O,Neon","Breach,Cypher,Sova,Omen,Neon"
Lotus,Valiant GC,Karmine Corp GC,13,5,4,2,3,9,"Breach,Cypher,Sova,Omen,Neon","Breach,Cypher,Omen,Neon,Fade"
Lotus,Black Flag,Team Serenity,8,13,5,4,9,3,"Breach,Cypher,Omen,Neon,Fade","Breach,Neon,Gekko,Iso,Clove"
Lotus,Niory Esports,Team Accelerate,13,4,10,2,2,3,"Breach,Sova,Killjoy,Omen,Neon","Breach,Cypher,Omen,Neon,Fade"
Haven,Black Flag,Team Serenity,7,13,3,9,4,4,"Breach,Sova,Killjoy,Omen,Jett","Killjoy,Viper,Omen,Jett,Skye"
Ascent,Niory Esports,Team Accelerate,13,2,3,0,2,10,"Sova,Killjoy,Omen,Jett,KAY/O","Sova,Killjoy,Omen,Yoru,Harbor"
Haven,Alternate Realities,Perfectionists,13,6,7,5,1,6,"Breach,Cypher,Sova,Omen,Neon","Breach,Cypher,Sova,Omen,Jett"
Bind,Mogo eSports,Asterisk (IN),13,9,6,4,5,7,"Raze,Cypher,Viper,Brimstone,Gekko","Raze,Viper,Brimstone,Fade,Gekko"
Lotus,Alternate Realities,Perfectionists,6,13,1,6,7,5,"Raze,Killjoy,Viper,Omen,Fade","Breach,Raze,Omen,Chamber,Fade"
Sunset,Alternate Realities,Perfectionists,13,5,9,3,2,4,"Raze,Cypher,Omen,KAY/O,Gekko","Breach,Raze,Cypher,Omen,Gekko"
Haven,Mogo eSports,Asterisk (IN),13,10,5,6,4,8,"Breach,Cypher,Sova,Omen,Jett","Breach,Sova,Killjoy,Omen,Jett"
Lotus,SCARZ Youth,Chrysalis,14,12,6,7,5,8,"Raze,Viper,Reyna,Skye,Clove","Breach,Cypher,Sova,Omen,Neon"
Ascent,SCARZ Youth,Chrysalis,13,9,6,6,3,7,"Raze,Viper,Reyna,Skye,Clove","Cypher,Sova,Omen,Yoru,Deadlock"
Bind,FiRePOWER GC,Leviatán GC,8,13,4,8,5,4,"Raze,Viper,Brimstone,Skye,Gekko","Raze,Cypher,Viper,Brimstone,Skye"
Abyss,FiRePOWER GC,Leviatán GC,4,13,1,4,9,3,"Sova,Yoru,Astra,Chamber,Harbor","Cypher,Sova,Omen,Jett,Yoru"
Ascent,FiRePOWER GC,Leviatán GC,6,13,6,6,7,0,"Sova,Killjoy,Omen,Jett,KAY/O","Cypher,Sova,Omen,Jett,Deadlock"
Haven,TOG Kitsune,RIZON Sugar,9,13,7,5,8,2,"Breach,Cypher,Sova,Omen,Jett","Sova,Killjoy,Omen,Neon,Iso"
Sunset,ALTERNATE aTTaX Ruby,Scald eSport GC,13,9,9,1,8,4,"Breach,Cypher,Sova,Omen,Neon","Breach,Cypher,Omen,Neon,Gekko"
Sunset,TOG Kitsune,RIZON Sugar,8,13,3,6,7,5,"Breach,Cypher,Sova,Omen,Yoru","Breach,Raze,Cypher,Sova,Omen"
Ascent,FOKUS Sakura,SK Nebula,13,9,6,6,3,7,"Sova,Killjoy,Omen,Jett,Iso","Sova,Killjoy,Omen,Jett,KAY/O"
Lotus,ALTERNATE aTTaX Ruby,Scald eSport GC,13,4,8,4,0,5,"Breach,Raze,Cypher,Omen,Fade","Breach,Raze,Killjoy,Omen,Jett"
Lotus,Reveal Multigaming Jushimori,Silly Seals,6,13,2,10,3,4,"Breach,Raze,Killjoy,Omen,Fade","Breach,Raze,Killjoy,Omen,Fade"
Haven,SSP Numina,Permitta Unicorns GC,10,13,3,8,5,7,"Breach,Sova,Killjoy,Omen,Jett","Breach,Cypher,Sova,Jett,Astra"
Abyss,HEROIC Valkyries,Karmine Corp GC,13,5,8,4,1,5,"Breach,Cypher,Sova,Jett,Astra","Cypher,Sova,Omen,Jett,KAY/O"
Bind,NEON BLADE,Entropy Azúcar,13,3,10,2,1,3,"Raze,Viper,Brimstone,Reyna,Skye","Raze,Viper,Brimstone,Skye,Fade"
Haven,Reveal Multigaming Jushimori,Silly Seals,9,13,5,5,8,4,"Breach,Sova,Killjoy,Omen,Jett","Breach,Cypher,Sova,Omen,Neon"
Sunset,SSP Numina,Permitta Unicorns GC,3,13,0,4,9,3,"Breach,Cypher,Sova,Omen,Neon","Breach,Raze,Cypher,Sova,Omen"
Sunset,FOKUS Sakura,SK Nebula,2,13,2,10,3,0,"Breach,Cypher,Omen,Neon,Fade","Cypher,Sova,Omen,KAY/O,Neon"
Sunset,ROA SYNC,teamhoppers,11,13,5,7,6,6,"Breach,Cypher,Sova,Neon,Clove","Breach,Raze,Cypher,Sova,Astra"
Haven,NEON BLADE,Entropy Azúcar,13,8,6,6,2,7,"Breach,Sova,Killjoy,Omen,Jett","Breach,Sova,Killjoy,Omen,Jett"
Abyss,ROA SYNC,teamhoppers,4,13,1,4,9,3,"Breach,Cypher,Sova,Jett,Astra","Sova,Sage,Jett,Astra,KAY/O"
Lotus,FOKUS Sakura,SK Nebula,13,6,10,2,4,3,"Raze,Cypher,Omen,Neon,Fade","Raze,Cypher,Viper,Omen,Fade"
Haven,HEROIC Valkyries,Karmine Corp GC,15,13,6,8,5,9,"Cypher,Sova,Omen,Yoru,Iso","Breach,Sova,Killjoy,Omen,Neon"
Ascent,SSP Numina,Permitta Unicorns GC,13,8,6,6,2,7,"Sova,Killjoy,Omen,Jett,KAY/O","Sova,Killjoy,Omen,Jett,KAY/O"
Bind,Reveal Multigaming Jushimori,Silly Seals,13,9,8,2,7,5,"Breach,Raze,Cypher,Brimstone,Fade","Raze,Viper,Astra,Fade,Gekko"
Abyss,wombat123,SKIPIDI,13,15,6,8,7,7,"Cypher,Sova,Jett,Astra,Gekko","Cypher,Sova,Omen,Jett,Gekko"
Haven,KAMK.GG,VIRMA,5,13,2,4,9,3,"Breach,Cypher,Sova,Omen,Jett","Breach,Cypher,Omen,Jett,Yoru"
Bind,KAMK.GG,VIRMA,3,13,1,3,10,2,"Raze,Viper,Brimstone,Reyna,Skye","Breach,Raze,Brimstone,Chamber,Deadlock"
Icebox,wombat123,SKIPIDI,13,9,8,2,7,5,"Sova,Killjoy,Viper,Jett,Iso","Sova,Killjoy,Viper,Jett,Chamber"
Icebox,G2 Gozen,Valiant GC,13,8,6,3,5,7,"Sova,Killjoy,Viper,Jett,Gekko","Sova,Killjoy,Viper,Sage,Jett"
Ascent,Ahlman ,wade,4,13,1,11,2,3,"Cypher,Reyna,Omen,KAY/O,Chamber","Sova,Killjoy,Jett,KAY/O,Clove"
Bind,wombat123,SKIPIDI,6,13,5,7,6,1,"Raze,Viper,Gekko,Deadlock,Clove","Raze,Viper,Brimstone,Chamber,Fade"
Lotus,Ahlman ,wade,3,13,1,3,10,2,"Raze,Cypher,Omen,Gekko,Clove","Breach,Raze,Killjoy,Neon,Clove"
Sunset,G2 Gozen,Valiant GC,13,4,5,0,4,8,"Breach,Cypher,Sova,Omen,Neon","Breach,Cypher,Sova,Omen,Neon"
Haven,Black Flag,Dupg Esports,4,13,1,4,9,3,"Breach,Sova,Killjoy,Omen,Jett","Breach,Cypher,Sova,Omen,Neon"
Sunset,Orangutan,Niory Esports,13,10,6,5,5,7,"Breach,Cypher,Sova,Omen,Neon","Breach,Cypher,Sova,Omen,Neon"
Ascent,Orangutan,Niory Esports,13,1,11,1,0,2,"Cypher,Sova,Omen,Yoru,Deadlock","Sova,Killjoy,Omen,Jett,KAY/O"
Bind,BOOM Esports,Disguised,14,12,3,10,2,11,"Raze,Cypher,Viper,Brimstone,Skye","Raze,Viper,Omen,Yoru,Gekko"
Icebox,BOOM Esports,Disguised,6,13,4,3,10,2,"Killjoy,Viper,Jett,KAY/O,Gekko","Sova,Killjoy,Viper,Reyna,Jett"
Lotus,BOOM Esports,Disguised,14,12,4,9,3,10,"Raze,Killjoy,Viper,Omen,Fade","Raze,Cypher,Omen,Neon,Fade"
Haven,Kebab Clan,RIDDLE ORDER,9,13,4,8,5,5,"Breach,Cypher,Sova,Omen,Neon","Killjoy,Viper,Omen,Jett,Skye"
Sunset,Kebab Clan,RIDDLE ORDER,1,13,0,2,11,1,"Breach,Raze,Cypher,Omen,Neon","Cypher,Sova,Omen,KAY/O,Neon"
Lotus,Berzerkers Moon,Washed Warriors,13,6,8,4,2,5,"Omen,KAY/O,Neon,Fade,Clove","Raze,Cypher,Omen,Skye,Fade"
Ascent,Shifty505,reddot's retirement home,10,13,2,9,4,8,"Sova,Killjoy,Omen,Jett,KAY/O","Cypher,Sova,Omen,Jett,KAY/O"
Lotus,Shifty505,reddot's retirement home,6,13,4,8,5,2,"Raze,Killjoy,Viper,Omen,Fade","Killjoy,Viper,Omen,Neon,Fade"
Sunset,Berzerkers Moon,Washed Warriors,13,11,9,3,8,4,"Cypher,Sova,Omen,Yoru,Clove","Raze,Cypher,Omen,Skye,Gekko"
Haven,1anddone,HyperSpeed Violet,11,13,6,6,7,5,"Breach,Cypher,Sova,Omen,Neon","Sova,Killjoy,Omen,Yoru,Neon"
Lotus,FLUFFY AIMERS,Shifty505,13,9,5,7,2,8,"Raze,Cypher,Viper,Omen,Fade","Raze,Killjoy,Viper,Omen,Fade"
Sunset,Blue Otter,kellogs cereal,13,10,6,6,4,7,"Breach,Cypher,Sova,Omen,Neon","Breach,Raze,Cypher,Gekko,Clove"
Lotus,FUSION X,Akave Esports Black,3,13,2,2,11,1,"Breach,Killjoy,Omen,Jett,Gekko","Raze,Killjoy,Viper,Omen,Fade"
Ascent,Washed Warriors,XD Gaming,15,13,5,9,4,10,"Cypher,Sova,Phoenix,Omen,Jett","Sova,Killjoy,Omen,Jett,Yoru"
Haven,Berzerkers,Siena Heights University,13,4,3,2,2,10,"Breach,Cypher,Sova,Omen,Neon","Breach,Skye,Astra,Neon,Clove"
Bind,Repose,reddot's retirement home,1,13,0,12,1,1,"Raze,Viper,Brimstone,Fade,Gekko","Jett,Skye,Deadlock,Iso,Clove"
Icebox,1anddone,HyperSpeed Violet,10,13,7,4,9,3,"Sova,Killjoy,Viper,Reyna,Jett","Sova,Killjoy,Viper,Jett,Yoru"
Ascent,FLUFFY AIMERS,Shifty505,13,3,9,3,0,4,"Cypher,Sova,Omen,Yoru","Sova,Killjoy,Omen,Jett,KAY/O"
Icebox,Blue Otter,kellogs cereal,13,8,9,3,5,4,"Sova,Killjoy,Viper,Jett,Gekko","Sova,Killjoy,Viper,Reyna,Jett"
Haven,washed,Berzerkers Moon,13,6,8,4,2,5,"Cypher,Sova,Phoenix,Omen,Jett","Breach,Cypher,Sova,Omen,Neon"
Sunset,Repose,reddot's retirement home,3,13,1,3,10,2,"Cypher,Sova,Omen,KAY/O,Neon","Breach,Cypher,Sova,Omen,Neon"
Bind,FUSION X,Akave Esports Black,8,13,3,6,7,5,"Cypher,Brimstone,Jett,Skye,Gekko","Raze,Viper,Skye,Astra,Iso"
Ascent,Siena Heights University,HyperSpeed Violet,13,3,9,3,0,4,"Sova,Killjoy,Omen,Jett,KAY/O","Sova,Killjoy,Omen,Jett,KAY/O"
Abyss,Washed Warriors,XD Gaming,13,10,6,5,5,7,"Cypher,Sova,Phoenix,Jett,Astra","Cypher,Sova,Omen,Yoru,Gekko"
Lotus,washed,Berzerkers Moon,13,4,3,2,2,10,"Cypher,Viper,Omen,Neon,Fade","Omen,KAY/O,Neon,Fade,Clove"
Lotus,Shifty505,reddot's retirement home,13,6,4,3,3,9,"Raze,Killjoy,Viper,Omen,Fade","Raze,Cypher,Astra,Fade,Gekko"
Sunset,kellogs cereal,UFO MINIONS,13,9,5,7,2,8,"Breach,Raze,Cypher,Gekko,Clove","Raze,Cypher,Sova,Omen,Gekko"
Ascent,FUSION X,Akave Esports Black,13,9,7,5,4,6,"Raze,Sova,KAY/O,Iso,Clove","Sova,Killjoy,Omen,Jett,KAY/O"
Haven,Siena Heights University,HyperSpeed Violet,11,13,3,9,4,8,"Breach,Skye,Astra,Neon,Clove","Killjoy,Omen,Jett,Yoru,Fade"
Ascent,Berzerkers Moon,XD Gaming,13,3,9,3,0,4,"Raze,Killjoy,Omen,KAY/O,Fade","Cypher,Sage,Yoru,Deadlock"
Icebox,washed,Washed Warriors,13,2,10,2,0,3,"Sova,Killjoy,Viper,Reyna,Yoru","Sova,Killjoy,Viper,Jett,Gekko"
Abyss,Berzerkers,1anddone,13,3,4,0,3,9,"Cypher,Sova,Omen,Yoru,Deadlock","Cypher,Sova,Jett,Astra,Gekko"
Sunset,Blue Otter,DonutBomb,13,4,10,2,2,3,"Breach,Cypher,Sova,Omen,Neon","Reyna,Omen,Skye,Chamber,Iso"
Lotus,Berzerkers Moon,XD Gaming,13,0,1,0,0,12,"Omen,KAY/O,Neon,Fade,Clove","Omen,Yoru,Chamber,Neon,Deadlock"
Bind,FLUFFY AIMERS,Repose,13,4,9,3,1,4,"Raze,Viper,Brimstone,Skye,Gekko","Raze,Viper,Brimstone,Fade,Gekko"
Bind,kellogs cereal,UFO MINIONS,13,6,7,5,1,6,"Raze,Cypher,Viper,Gekko,Clove","Raze,Skye,Gekko,Deadlock,Clove"
Lotus,washed,Washed Warriors,13,1,2,0,1,11,"Raze,Cypher,Viper,Omen,Fade","Breach,Raze,Cypher,Omen,Fade"
Sunset,Shifty505,reddot's retirement home,13,11,8,4,7,5,"Breach,Cypher,Sova,Omen,Neon","Breach,Cypher,Sova,Omen,Neon"
Lotus,Blue Otter,DonutBomb,13,0,12,0,0,1,"Breach,Cypher,Omen,Neon,Fade","Breach,Cypher,Reyna,Gekko,Clove"
Icebox,Siena Heights University,HyperSpeed Violet,13,8,7,5,3,6,"Sova,Killjoy,Viper,Reyna,Jett","Sova,Killjoy,Viper,Reyna,Jett"
Haven,Berzerkers,1anddone,13,4,11,1,3,2,"Breach,Cypher,Sova,Omen,Neon","Breach,Cypher,Sova,Omen,Neon"
Haven,FLUFFY AIMERS,Repose,13,0,12,0,0,1,"Cypher,Sova,Omen,Yoru,Iso","Breach,Cypher,Sova,Omen,Neon"
Haven,FUSION X,Akave Esports Black,8,13,4,5,8,4,"Cypher,Sova,Jett,Astra,Gekko","Breach,Cypher,Sova,Omen,Jett"
Sunset,Cobweb eSports,MouzKings eSports,9,13,4,6,7,5,"Breach,Cypher,Sova,Omen,Neon","Breach,Cypher,Sova,Omen,Neon"
Lotus,Cobweb eSports,MouzKings eSports,12,14,6,7,7,6,"Raze,Killjoy,Viper,Omen,Fade","Breach,Killjoy,Omen,Neon,Gekko"
Icebox,Blue Moon eSports,ZINGERS,9,13,6,4,9,3,"Raze,Sova,Killjoy,Viper,Iso","Sova,Killjoy,Viper,Omen,Gekko"
Abyss,Blue Moon eSports,ZINGERS,5,13,0,6,7,5,"Breach,Cypher,Sova,Jett,Astra","Breach,Astra,Chamber,Neon,Harbor"
Haven,LVENGERS,Veni eSports Venom,13,10,8,3,7,5,"Breach,Sova,Killjoy,Omen,Jett","Breach,Sova,Omen,Chamber,Neon"
Lotus,NASR Ignite,GIANTX GC,13,11,3,9,2,10,"Raze,Cypher,Omen,KAY/O,Deadlock","Breach,Raze,Sova,Omen,Chamber"
Ascent,LVENGERS,Veni eSports Venom,13,4,3,2,2,10,"Cypher,Sova,Omen,Yoru,Deadlock","Sova,Omen,Jett,KAY/O,Chamber"
Bind,Union Atta I,KineTiX eSports X1,13,3,4,0,3,9,"Breach,Omen,Neon,Fade,Deadlock","Raze,Cypher,Viper,Brimstone,Skye"
Ascent,NASR Ignite,GIANTX GC,13,11,7,5,6,6,"Cypher,Sova,Omen,Jett,Deadlock","Sova,Killjoy,Omen,Jett,KAY/O"
Sunset,Union Atta I,KineTiX eSports X1,13,3,10,2,1,3,"Breach,Cypher,Sova,Omen,Neon","Breach,Raze,Cypher,Sova,Omen"
Bind,Team Falcons Vega,Odd 1 OUT,13,9,4,6,3,9,"Raze,Viper,Brimstone,Skye,Gekko","Raze,Sova,Viper,Brimstone,Gekko"
Haven,Team Falcons Vega,Odd 1 OUT,13,9,5,7,2,8,"Cypher,Sova,Omen,Neon,Iso","Breach,Cypher,Sova,Omen,Jett"
Bind,AIRAVATA ESPORTS,Perfectionists,13,15,6,8,7,7,"Raze,Cypher,Omen,Skye,Yoru","Raze,Viper,Brimstone,Fade,Gekko"
Lotus,AIRAVATA ESPORTS,Perfectionists,13,6,4,3,3,9,"Raze,Omen,Yoru,Chamber,Fade","Breach,Raze,Killjoy,Omen,Fade"
Ascent,Disguised,Revenant Esports,13,5,4,2,3,9,"Cypher,Sova,Omen,Jett,Iso","Cypher,Sova,Omen,Yoru,Deadlock"
Ascent,Asterisk (IN),Team Ruthless,13,4,8,4,0,5,"Sova,Killjoy,Omen,Jett,KAY/O","Sova,Killjoy,Omen,Jett,KAY/O"
Ascent,AIRAVATA ESPORTS,Perfectionists,10,13,3,8,5,7,"Breach,Sova,Killjoy,Omen,Jett","Sova,Killjoy,Omen,Jett,KAY/O"
Bind,Disguised,Revenant Esports,13,5,9,3,2,4,"Raze,Viper,Omen,Yoru,Gekko","Raze,Viper,Brimstone,Fade,Gekko"
Lotus,Asterisk (IN),Team Ruthless,13,2,3,0,2,10,"Raze,Killjoy,Viper,Omen,Fade","Killjoy,Omen,Neon,Fade,Gekko"
Sunset,Niory Esports,Team Serenity,13,10,6,6,4,7,"Breach,Cypher,Sova,Omen,Neon","Breach,Cypher,Sova,Omen,Neon"
Lotus,Disguised,Revenant Esports,13,15,6,8,7,7,"Raze,Cypher,Omen,Neon,Fade","Raze,Viper,Omen,Chamber,Fade"
Bind,Niory Esports,Team Serenity,13,5,10,2,3,3,"Raze,Cypher,Brimstone,Skye,Clove","Breach,Brimstone,Neon,Gekko,Deadlock"
Ascent,Dupg Esports,Team Accelerate,13,6,10,2,4,3,"Cypher,Sova,Omen,Yoru,Deadlock","Sova,Killjoy,Omen,Yoru,Harbor"
Ascent,RIDDLE ORDER,NAOS Esports,13,11,5,7,4,8,"Sova,Killjoy,Omen,Jett,KAY/O","Sova,Killjoy,Omen,Jett,KAY/O"
Haven,Niory Esports,Team Serenity,7,13,5,7,6,2,"Breach,Sova,Killjoy,Omen,Jett","Killjoy,Viper,Omen,Jett,Skye"
Bind,Dupg Esports,Team Accelerate,13,4,10,2,2,3,"Breach,Raze,Brimstone,Skye,Chamber","Raze,Viper,Brimstone,Skye,Yoru"
Lotus,RIDDLE ORDER,NAOS Esports,13,3,11,1,2,2,"Breach,Omen,Neon,Fade,Clove","Raze,Killjoy,Viper,Omen,Fade"
Haven,RIDDLE ORDER,NAOS Esports,15,17,7,9,8,8,"Killjoy,Viper,Omen,Jett,Skye","Cypher,Sova,Omen,Yoru,Iso"
Lotus,FULL SENSE,Kebab Clan,13,9,6,4,5,7,"Breach,Killjoy,Omen,Astra,Neon","Breach,Omen,Neon,Fade,Clove"
Ascent,FULL SENSE,Kebab Clan,13,8,5,7,1,8,"Sova,Killjoy,Omen,Jett,KAY/O","Cypher,Sova,Omen,Jett,Iso"
Haven,KRÜ BLAZE,9z Team GC,13,3,3,1,2,10,"Breach,Cypher,Sova,Omen,Neon","Breach,Cypher,Sova,Omen,Neon"
Ascent,KRÜ BLAZE,9z Team GC,9,13,4,6,7,5,"Sova,Killjoy,Omen,Jett,KAY/O","Sova,Killjoy,Omen,Jett,KAY/O"
Bind,KRÜ BLAZE,9z Team GC,13,4,4,1,3,9,"Viper,Brimstone,Neon,Fade,Gekko","Raze,Brimstone,Skye,Gekko,Deadlock"
Lotus,KRÜ BLAZE,9z Team GC,13,6,7,5,1,6,"Raze,Killjoy,Viper,Omen,Fade","Breach,Omen,Neon,Fade,Clove"
Icebox,KRÜ BLAZE,9z Team GC,11,13,5,7,6,6,"Sova,Killjoy,Harbor,Iso,Clove","Sova,Killjoy,Viper,Jett,Harbor"
Haven,The Easy Crew,Defient Esports,13,15,8,6,9,5,"Breach,Cypher,Sova,Astra,Neon","Breach,Cypher,Sova,Omen,Neon"
Sunset,2strong,Skout Esports,13,4,11,1,3,2,"Breach,Cypher,Sova,Omen,Neon","Raze,Cypher,Omen,Neon,Gekko"
Lotus,The Easy Crew,Defient Esports,4,13,2,10,3,2,"Raze,Killjoy,Viper,Omen,Fade","Breach,Raze,Cypher,Omen,Fade"
Bind,2strong,Skout Esports,11,13,4,8,5,7,"Breach,Raze,Cypher,Omen,Gekko","Breach,Raze,Cypher,Brimstone,Neon"
Haven,2strong,Skout Esports,13,3,3,1,2,10,"Breach,Sova,Killjoy,Omen,Neon","Cypher,Sova,Jett,Yoru,Astra"
Sunset,NoMercy,Dark Horse Templars,13,8,8,4,4,5,"Breach,Cypher,Omen,Neon,Gekko","Raze,Cypher,Omen,KAY/O,Gekko"
Ascent,NoMercy,Dark Horse Templars,13,8,6,3,5,7,"Sova,Killjoy,Omen,Jett,KAY/O","Sova,Killjoy,Omen,Jett,KAY/O"
Ascent,PANDEMONIUM,WASP Elektra,13,10,6,6,4,7,"Sova,Killjoy,Omen,Jett","Breach,Sova,Killjoy,Omen,Neon"
Haven,PANDEMONIUM,WASP Elektra,13,7,6,2,5,7,"Cypher,Sova,Omen,Yoru,Iso","Breach,Cypher,Sova,Omen,Neon"
Haven,NewD,Pegasus Esports,13,7,7,5,2,6,"Breach,Cypher,Omen,Jett,Deadlock","Breach,Sova,Killjoy,Omen,Jett"
Bind,NewD,Pegasus Esports,13,4,9,3,1,4,"Breach,Cypher,Viper,Brimstone,Yoru","Viper,Omen,Yoru,KAY/O,Gekko"
Icebox,Sin Prisa Gaming,BOOM Esports,13,9,9,3,6,4,"Sova,Killjoy,Viper,Jett,Harbor","Killjoy,Viper,Jett,KAY/O,Gekko"
Lotus,Sin Prisa Gaming,BOOM Esports,13,3,11,1,2,2,"Cypher,Viper,Omen,Neon,Fade","Raze,Killjoy,Viper,Omen,Fade"
Haven,Rapid Lofi,Revenant Esports,3,13,1,3,10,2,"Breach,Cypher,Phoenix,Omen,Neon","Cypher,Sova,Omen,Yoru,Iso"
Bind,Rapid Lofi,Revenant Esports,3,13,0,4,9,3,"Raze,Viper,Brimstone,Fade,Gekko","Raze,Viper,Brimstone,Fade,Gekko"
Lotus,NAOS Esports,Oblivion Force,13,7,4,4,3,9,"Raze,Killjoy,Viper,Omen,Fade","Raze,Cypher,Viper,Omen,Fade"
Icebox,NAOS Esports,Oblivion Force,13,10,5,6,4,8,"Sova,Killjoy,Viper,Jett,Harbor","Killjoy,Viper,Jett,KAY/O,Deadlock"
Bind,2Game Esports,M80,13,6,10,2,4,3,"Raze,Viper,Brimstone,Skye,Gekko","Raze,Viper,Brimstone,Skye,Gekko"
Haven,2Game Esports,M80,13,7,9,3,4,4,"Cypher,Sova,Omen,Yoru,Iso","Breach,Sova,Killjoy,Omen,Jett"
Abyss,2Game Esports,M80,8,13,7,5,8,1,"Cypher,Sova,Omen,Jett,KAY/O","Cypher,Sova,Omen,Jett,KAY/O"
Ascent,Veni eSports Venom,Silly Seals,13,7,9,3,4,4,"Sova,Killjoy,Omen,Jett,KAY/O","Sova,Killjoy,Omen,Jett,KAY/O"
Icebox,2Game Esports,M80,7,13,4,8,5,3,"Sova,Killjoy,Viper,Jett,KAY/O","Killjoy,Viper,Omen,KAY/O,Gekko"
Lotus,Veni eSports Venom,Silly Seals,14,12,7,6,6,7,"Breach,Omen,Chamber,Neon,Gekko","Breach,Raze,Killjoy,Omen,Fade"
Lotus,The giornalisti,DSYRE Academy,10,13,7,4,9,3,"Breach,Raze,Killjoy,Omen,Fade","Raze,Killjoy,Viper,Omen,Fade"
Lotus,Team Focus,GMBLERS Esports,9,13,5,7,6,4,"Breach,Omen,Neon,Fade,Clove","Breach,Raze,Cypher,Phoenix,Astra"
Lotus,Capacitanes,Team GMask,9,13,7,5,8,2,"Raze,Cypher,Omen,Fade,Gekko","Breach,Cypher,Omen,Neon,Gekko"
Lotus,RevenantVAL,bazinga esports,13,5,8,4,1,5,"Breach,Raze,Killjoy,Omen,Fade","Raze,Killjoy,Viper,Omen,Fade"
Lotus,CryZen,Poverineeh,13,4,4,1,3,9,"Breach,Killjoy,Omen,Neon,Fade","Killjoy,Omen,Jett,KAY/O,Gekko"
Lotus,Dimonis,EX0TIK GAMING,13,6,7,5,1,6,"Breach,Killjoy,Omen,Neon,Fade","Breach,Cypher,Omen,Neon,Fade"
Lotus,SLTitans Esports,IAPEsports,4,13,0,5,8,4,"Breach,Raze,Cypher,Omen,Iso","Breach,Omen,Neon,Fade,Clove"
Haven,Moon,Tap Tap Boom eSports,9,13,6,4,9,3,"Breach,Killjoy,Reyna,Omen,Jett","Breach,Cypher,Sova,Omen,Jett"
Sunset,2Game Esports,M80,13,5,5,1,4,8,"Breach,Cypher,Sova,Omen,Neon","Breach,Cypher,Omen,Yoru,Gekko"
Bind,Veni eSports Venom,Silly Seals,4,13,2,3,10,2,"Raze,Viper,Brimstone,Fade,Gekko","Raze,Viper,Astra,Fade,Gekko"
Lotus,Moon,Tap Tap Boom eSports,13,10,5,7,3,8,"Raze,Cypher,Viper,Omen,Fade","Breach,Omen,Neon,Fade,Clove"
Lotus,CryZen,The giornalisti,6,13,3,4,9,3,"Breach,Sova,Killjoy,Omen,Neon","Breach,Killjoy,Omen,Neon,Fade"
Lotus,Poverineeh,Melilla Titans Academy,15,13,4,10,3,11,"Raze,Killjoy,Viper,Omen,Fade","Breach,Raze,Cypher,Omen,Fade"
Lotus,SLTitans Esports,Dimonis,13,11,7,5,6,6,"Breach,Raze,Killjoy,Omen,Iso","Breach,Killjoy,Omen,Neon,Fade"
Lotus,EX0TIK GAMING,Team GMask,13,5,6,0,5,7,"Breach,Cypher,Omen,Neon,Fade","Breach,Cypher,Omen,Neon,Gekko"
Lotus,RevenantVAL,Team Focus,13,10,9,2,8,4,"Breach,Raze,Killjoy,Omen,Fade","Breach,Omen,Neon,Fade,Clove"
Lotus,bazinga esports,IAPEsports,14,16,7,8,8,7,"Raze,Killjoy,Viper,Omen,Fade","Breach,Omen,Neon,Fade,Clove"
Lotus,AMBYS Team,Capacitanes,7,13,0,8,5,7,"Breach,Raze,Omen,Fade,Clove","Raze,Cypher,Omen,Fade,Gekko"
Abyss,Velocity Gaming (EU),RYL | Royal Legion,7,13,4,8,5,3,"Cypher,Sova,Omen,Yoru,Astra","Cypher,Sova,Omen,Jett,Harbor"
Sunset,Velocity Gaming (EU),RYL | Royal Legion,11,13,8,4,9,3,"Breach,Cypher,Sova,Omen,Neon","Cypher,Sova,Omen,KAY/O,Neon"
Haven,Blue Lock,Lost Dynasty,18,16,9,8,8,9,"Breach,Sova,Killjoy,Omen,Jett","Breach,Sova,Killjoy,Omen,Jett"
Lotus,Blue Lock,Lost Dynasty,13,6,6,1,5,7,"Breach,Raze,Killjoy,Viper,Omen","Raze,Cypher,Omen,Fade,Deadlock"
Haven,Dark Horse Knights,TEAM BLINDSPOT,10,13,6,6,7,4,"Breach,Sova,Killjoy,Omen,Neon","Breach,Cypher,Sova,Omen,Neon"
Lotus,Dark Horse Knights,TEAM BLINDSPOT,5,13,1,5,8,4,"Raze,Killjoy,Viper,Omen,Fade","Omen,Chamber,Gekko,Clove"
Icebox,Disguised,FULL SENSE,12,14,8,5,9,4,"Sova,Killjoy,Viper,Reyna,Jett","Sova,Killjoy,Viper,Jett,Gekko"
Haven,Disguised,FULL SENSE,7,13,4,8,5,3,"Cypher,Sova,Omen,Jett,Neon","Breach,Sova,Killjoy,Omen,Neon"
Ascent,RIDDLE ORDER,Sin Prisa Gaming,9,13,4,6,7,5,"Sova,Killjoy,Omen,Jett,KAY/O","Brimstone,Yoru,Neon,Fade,Harbor"
Sunset,RIDDLE ORDER,Sin Prisa Gaming,12,14,7,6,8,5,"Cypher,Sova,Omen,KAY/O,Neon","Breach,Cypher,Neon,Fade,Clove"
Lotus,Kebab Clan,Rapid Lofi,13,8,9,3,5,4,"Breach,Omen,Neon,Fade,Clove","Raze,Killjoy,Omen,Fade,Clove"
Abyss,Good Career,UFO MINIONS,13,10,4,8,2,9,"Sova,Omen,Jett,Yoru,Astra","Cypher,Sova,Jett,Yoru,Astra"
Haven,Painguins,Lionheart eSports,13,6,6,1,5,7,"Breach,Cypher,Sova,Omen,Neon","Breach,Cypher,Sova,Omen,Neon"
Sunset,English or Spanish,silly kittens,14,12,8,5,7,6,"Breach,Raze,Cypher,Sova,Omen","Breach,Cypher,Sova,Omen,Neon"
Lotus,Painguins,Lionheart eSports,13,2,10,2,0,3,"Breach,Killjoy,Omen,Neon,Gekko","Breach,Cypher,Omen,Neon,Gekko"
Icebox,Kebab Clan,Rapid Lofi,13,3,9,3,0,4,"Sova,Killjoy,Viper,Jett,Iso","Sova,Killjoy,Viper,Sage,Jett"
Ascent,APX,Fractal Gaming,13,11,4,8,3,9,"Cypher,Sova,Omen,Jett,KAY/O","Sova,Killjoy,Omen,Jett,KAY/O"
Sunset,Good Career,UFO MINIONS,13,10,4,8,2,9,"Breach,Cypher,Sova,Omen,Neon","Raze,Cypher,Jett,Gekko,Clove"
Lotus,kellogs cereal,Void,13,7,7,5,2,6,"Breach,Raze,Cypher,Gekko,Clove","Raze,Cypher,Omen,Fade,Deadlock"
Lotus,Brimstone with a Fusion Bomb,Cyberia Esports,14,12,9,4,8,5,"Raze,Omen,Fade,Deadlock,Clove","Raze,Killjoy,Viper,Omen,Fade"
Sunset,Painguins,Lionheart eSports,3,13,0,4,9,3,"Breach,Cypher,Sova,Omen,Neon","Raze,Cypher,Sova,Omen,KAY/O"
Lotus,English or Spanish,silly kittens,13,11,5,7,4,8,"Breach,Raze,Omen,Chamber,Gekko","Raze,Cypher,Viper,Omen,Fade"
Haven,Cumberland Rising,Shifty505,11,13,6,6,7,5,"Breach,Cypher,Sova,Omen,Neon","Breach,Cypher,Sova,Omen,Jett"
Haven,Outlast Gaming,Dexterity Gaming,5,13,4,8,5,1,"Killjoy,Viper,Omen,Jett,Skye","Cypher,Sova,Sage,Omen,Jett"
Lotus,APX,Fractal Gaming,13,5,2,4,1,11,"Breach,Raze,Cypher,Omen,Gekko","Breach,Killjoy,Omen,Neon,Gekko"
Sunset,kellogs cereal,Void,13,5,9,3,2,4,"Breach,Raze,Cypher,Gekko,Clove","Cypher,Sova,Omen,KAY/O,Neon"
Ascent,Good Career,UFO MINIONS,9,13,1,9,4,8,"Sova,Killjoy,Omen,Jett,KAY/O","Cypher,Sova,Omen,Jett,Yoru"
Bind,Erinite Esports,Koala Pound,13,4,9,3,1,4,"Raze,Viper,Brimstone,Fade,Gekko","Raze,Viper,Brimstone,Skye,Fade"
Lotus,Siena Heights University,The Goon Goobers,13,4,9,3,1,4,"Breach,Omen,Neon,Fade,Clove","Breach,Raze,Killjoy,Omen,Gekko"
Sunset,Brimstone with a Fusion Bomb,Cyberia Esports,10,13,5,7,6,5,"Breach,Omen,KAY/O,Neon,Iso","Cypher,Sova,Omen,Neon,Gekko"
Haven,Elation Esports,Kiyoe's Fan Club,13,8,9,3,5,4,"Cypher,Sova,Omen,Yoru,Iso","Cypher,Sova,Reyna,Omen,Neon"
Haven,English or Spanish,silly kittens,7,13,6,6,7,1,"Breach,Cypher,Sova,Omen,Jett","Breach,Cypher,Sova,Omen,Jett"
Lotus,zZz,Antares Esports,13,10,6,5,5,7,"Breach,Cypher,Omen,Neon,Fade","Breach,Omen,Neon,Fade,Clove"
Lotus,Cumberland Rising,Shifty505,8,13,3,9,4,5,"Killjoy,Omen,Yoru,Neon,Fade","Raze,Killjoy,Viper,Omen,Fade"
Lotus,Berzerkers Moon,Seulgi Fanclub,13,9,8,2,7,5,"Omen,KAY/O,Neon,Fade,Clove","Viper,Brimstone,Omen,Harbor,Clove"
Ascent,Outlast Gaming,Dexterity Gaming,8,13,2,7,6,6,"Cypher,Sova,Omen,Yoru,Deadlock","Sova,Killjoy,Omen,Jett"
Abyss,Erinite Esports,Koala Pound,13,7,6,2,5,7,"Cypher,Sova,Omen,Jett,Gekko","Cypher,Sova,Reyna,Astra,Iso"
Haven,LazerrFreeks Mythic,Freak Nation,13,3,2,2,1,11,"Breach,Killjoy,Omen,Neon,Fade","Cypher,Sova,Omen,Skye,Neon"
Icebox,Big Hot Men,Lionheart eSports,6,13,1,6,7,5,"Sova,Killjoy,Viper,Jett,Yoru","Killjoy,Viper,KAY/O,Harbor,Gekko"
Lotus,Elation Esports,Kiyoe's Fan Club,13,6,10,2,4,3,"Breach,Cypher,Sova,Omen,Neon","Cypher,Omen,Jett,Neon,Fade"
Bind,Fractal Gaming,Globe's Mittens,14,12,8,5,7,6,"Raze,Cypher,Brimstone,Fade,Gekko","Raze,Cypher,Viper,Brimstone,Skye"
Ascent,Brimstone with a Fusion Bomb,Cyberia Esports,13,9,8,4,5,5,"Cypher,Sova,Omen,Jett,Yoru","Breach,Killjoy,Omen,Jett,KAY/O"
Ascent,Berzerkers Moon,Seulgi Fanclub,13,2,2,1,1,11,"Cypher,Sova,Reyna,Omen,Jett","Breach,Brimstone,Reyna,Jett,Neon"
Icebox,Siena Heights University,The Goon Goobers,13,8,7,2,6,6,"Sova,Killjoy,Viper,Reyna,Jett","Sova,Killjoy,Viper,Jett,Gekko"
Lotus,Nightblood Gaming,English or Spanish,13,8,5,4,4,8,"Breach,Cypher,Astra,Neon,Fade","Breach,Raze,Omen,Chamber,Gekko"
Haven,YDZ x Berzerkers,Good Career,13,11,4,8,3,9,"Breach,Cypher,Sova,Omen,Neon","Breach,Sova,Killjoy,Omen,Jett"
Icebox,Sexy Gang,Astane Anarchy,5,13,1,5,8,4,"Sova,Killjoy,Viper,Jett,KAY/O","Sova,Killjoy,Viper,Jett,KAY/O"
Icebox,zZz,Antares Esports,13,7,5,3,4,8,"Sova,Killjoy,Viper,Reyna,Jett","Sova,Killjoy,Viper,Neon,Gekko"
Bind,Rock Bottom,kellogs cereal,13,8,7,2,6,6,"Raze,Brimstone,Sage,Skye,Chamber","Raze,Cypher,Viper,Gekko,Clove"
Sunset,Berzerkers,Cumberland Rising,13,5,8,4,1,5,"Breach,Cypher,Sova,Omen,Neon","Breach,Cypher,Omen,Neon,Gekko"
Icebox,Lyrical's Daycare,Kryptic,16,14,6,9,5,10,"Sova,Viper,Sage,Chamber,Clove","Sova,Killjoy,Viper,Reyna,Jett"
Haven,Russian Mafia ,Shifty505,6,13,1,6,7,5,"Breach,Cypher,Sova,Omen,Neon","Breach,Cypher,Sova,Omen,Jett"
Haven,Big Hot Men,Lionheart eSports,13,5,6,0,5,7,"Cypher,Sova,Omen,Yoru,Iso","Breach,Cypher,Sova,Omen,Neon"
Abyss,SACKNUT,Outlast Gaming,13,4,10,2,2,3,"Sova,Omen,Jett,Yoru,Astra","Sova,Killjoy,Viper,Yoru,Astra"
Ascent,0-12 in parlays,UFO MINIONS,8,13,1,8,5,7,"Sova,Killjoy,Phoenix,Omen,Jett","Cypher,Sova,Omen,Jett,Yoru"
Bind,Siena Heights University,The Goon Goobers,4,13,4,8,5,0,"Raze,Cypher,Skye,Astra,Iso","Raze,Cypher,Omen,Fade,Gekko"
Ascent,glizzard wizards,Void,7,13,4,4,9,3,"Sova,Killjoy,Omen,Jett,KAY/O","Sova,Killjoy,Omen,Jett,KAY/O"
Bind,Kbull's Kittens,Dexterity Gaming,5,13,3,3,10,2,"Raze,Cypher,Skye,Clove","Viper,Brimstone,Skye,Yoru,Neon"
Lotus,LazerrFreeks Mythic,Freak Nation,13,11,4,8,3,9,"Killjoy,Viper,Omen,Neon,Fade","Raze,Cypher,Omen,Fade,Iso"
Sunset,silly kittens,The Barricade,13,5,6,0,5,7,"Breach,Cypher,Sova,Omen,Neon","Breach,Cypher,Astra,Neon,Gekko"
Sunset,Sexy Gang,Astane Anarchy,2,13,2,10,3,0,"Breach,Raze,Cypher,Sova,Clove","Breach,Raze,Cypher,Omen,Fade"
Abyss,FlyQuest RED,Erinite Esports,13,4,3,2,2,10,"Sova,Viper,Jett,Yoru,Astra","Cypher,Sova,Jett,Astra,Gekko"
Ascent,Nightblood Gaming,English or Spanish,13,6,7,5,1,6,"Sova,Killjoy,Omen,Jett,KAY/O","Sova,Killjoy,Omen,Jett,KAY/O"
Haven,Fractal Gaming,Globe's Mittens,13,10,8,3,7,5,"Breach,Sova,Killjoy,Omen,Jett","Breach,Cypher,Sova,Omen,Neon"
Sunset,SEN SHAHZAM,Kitten Shelter,13,6,9,3,3,4,"Cypher,Sova,Reyna,Omen,Jett","Breach,Cypher,Sova,Omen,Neon"
Ascent,mockings team,zZz,13,3,3,1,2,10,"Cypher,Sova,Omen,Jett,Clove","Cypher,Sova,Omen,Jett,Deadlock"
Lotus,Painguins,Cumberland Phoenix,13,15,4,10,5,9,"Breach,Killjoy,Omen,Neon,Gekko","Breach,Cypher,Omen,Neon,Fade"
Sunset,Team Image,Cyberia Esports,3,13,3,9,4,0,"Breach,Raze,Cypher,Sova,Omen","Cypher,Sova,Omen,Neon,Gekko"
Abyss,Gekko,Brimstone with a Fusion Bomb,13,6,8,4,2,5,"Sova,Viper,Yoru,Astra,Deadlock","Sova,Jett,Astra,Iso,Clove"
Icebox,Blue Otter,APX,13,1,2,0,1,11,"Sova,Killjoy,Viper,Jett,Gekko","Sova,Viper,Jett,Chamber,Harbor"
Haven,Antares Esports,HyperSpeed Violet,13,5,9,3,2,4,"Breach,Cypher,Sova,Omen,Jett","Breach,Cypher,Sova,Omen,Jett"
Haven,red,Elation Esports,13,10,6,5,5,7,"Cypher,Sova,Omen,Jett,Yoru","Cypher,Sova,Omen,Yoru,Iso"
Lotus,LOW9,Seulgi Fanclub,11,13,7,5,8,4,"Breach,Sova,Killjoy,Neon,Clove","Breach,Raze,Neon,Clove"
Lotus,Russian Mafia ,Shifty505,6,13,4,3,10,2,"Breach,Raze,Cypher,Omen,Fade","Raze,Killjoy,Viper,Omen,Fade"
Abyss,Rock Bottom,kellogs cereal,13,6,8,4,2,5,"Cypher,Sova,Yoru,Astra,Iso","Cypher,Sova,Jett,Astra,Deadlock"
Ascent,FLUFFY AIMERS,Berzerkers Moon,13,3,9,3,0,4,"Cypher,Sova,Omen,Yoru","Sova,Killjoy,Omen,Jett,KAY/O"
Abyss,Bentley Strike,Koala Pound,11,13,7,5,8,4,"Cypher,Sova,Yoru,Astra,Gekko","Sova,Yoru,Astra,Chamber,Neon"
Sunset,Big Hot Men,Lionheart eSports,5,13,3,9,4,2,"Breach,Cypher,Omen,KAY/O,Neon","Raze,Cypher,Sova,Omen,KAY/O"
Ascent,Lyrical's Daycare,Kryptic,13,8,8,4,4,5,"Cypher,Sova,Omen,Jett,Deadlock","Sova,Killjoy,Omen,Jett,KAY/O"
Ascent,SEN SHAHZAM,Kitten Shelter,13,1,11,1,0,2,"Sova,Killjoy,Reyna,Omen,Jett","Sova,Killjoy,Omen,Jett,KAY/O"
Haven,SACKNUT,Outlast Gaming,13,6,9,3,3,4,"Breach,Cypher,Sova,Omen,Neon","Killjoy,Viper,Omen,Jett,Skye"
Lotus,0-12 in parlays,UFO MINIONS,9,13,4,8,5,5,"Viper,Chamber,Neon,Gekko,Clove","Raze,Cypher,Omen,Jett,Gekko"
Haven,Berzerkers,Cumberland Rising,13,8,6,3,5,7,"Breach,Cypher,Sova,Omen,Neon","Breach,Cypher,Sova,Omen,Neon"
Lotus,YDZ x Berzerkers,Good Career,15,13,9,5,8,6,"Breach,Omen,Neon,Fade","Breach,Raze,Cypher,Omen,Gekko"
Sunset,Kbull's Kittens,Dexterity Gaming,8,13,6,3,10,2,"Breach,Cypher,Sova,Omen,Neon","Breach,Cypher,Sova,Omen,Neon"
Sunset,red,Elation Esports,13,1,2,0,1,11,"Cypher,Sova,Omen,Yoru,Neon","Breach,Raze,Cypher,Sova,Omen"
Sunset,MSU White,Astane Anarchy,3,13,3,9,4,0,"Breach,Cypher,Astra,KAY/O,Neon","Breach,Raze,Cypher,Omen,Fade"
Haven,Nightblood Gaming,English or Spanish,7,13,3,5,8,4,"Breach,Sova,Astra,Chamber,Neon","Breach,Cypher,Sova,Omen,Jett"
Sunset,glizzard wizards,Void,10,13,7,5,8,3,"Cypher,Sova,Omen,KAY/O,Neon","Cypher,Sova,Omen,KAY/O,Neon"
Sunset,KC and Friends,The Goon Goobers,7,13,4,8,5,3,"Breach,Cypher,Sova,Omen,Neon","Breach,Raze,Cypher,Sova,Omen"
Haven,Blue Otter,APX,13,4,3,2,2,10,"Breach,Cypher,Sova,Omen,Neon","Breach,Cypher,Sova,Jett,Astra"
Abyss,LOW9,Seulgi Fanclub,13,3,9,3,0,4,"Cypher,Sova,Jett,Yoru,Clove","Breach,Reyna,Yoru,Astra,Neon"
Lotus,Non-Verbal,LazerrFreeks Mythic,13,11,7,5,6,6,"Raze,Killjoy,Viper,Omen,Fade","Killjoy,Viper,Omen,Neon,Fade"
Haven,silly kittens,The Barricade,13,11,5,7,4,8,"Breach,Cypher,Sova,Omen,Jett","Breach,Cypher,Sova,Jett,Astra"
Lotus,Fractal Gaming,Globe's Mittens,11,13,6,6,7,5,"Breach,Killjoy,Omen,Neon,Gekko","Breach,Killjoy,Omen,KAY/O,Neon"
Ascent,Painguins,Cumberland Phoenix,10,13,5,6,7,5,"Cypher,Sova,Omen,Yoru,Chamber","Sova,Killjoy,Omen,Jett,KAY/O"
Bind,FlyQuest RED,Erinite Esports,13,11,6,6,5,7,"Raze,Viper,Skye,Astra,Gekko","Raze,Viper,Brimstone,Fade,Gekko"
Icebox,mockings team,zZz,15,13,5,9,4,10,"Killjoy,Viper,Jett,KAY/O,Gekko","Sova,Killjoy,Viper,Reyna,Jett"
Haven,Gekko,Brimstone with a Fusion Bomb,13,6,8,4,2,5,"Breach,Cypher,Sova,Omen,Jett","Cypher,Sova,Omen,Yoru,Iso"
Ascent,Team Image,Cyberia Esports,5,13,2,4,9,3,"Sova,Killjoy,Omen,Jett,KAY/O","Breach,Killjoy,Omen,Jett,KAY/O"
Haven,washed,Siena Heights University,13,4,9,3,1,4,"Breach,Cypher,Sova,Omen,Jett","Breach,Skye,Astra,Neon,Clove"
Sunset,Freak Nation,Missouri ST Gold,13,8,7,2,6,6,"Breach,Raze,Cypher,Sova,Omen","Breach,Cypher,Sova,Omen,Neon"
Lotus,Antares Esports,HyperSpeed Violet,13,10,4,7,3,9,"Breach,Omen,Neon,Fade,Clove","Raze,Killjoy,Omen,Fade,Gekko"
Bind,Sexy Gang,YDZ Esports,2,13,0,3,10,2,"Raze,Brimstone,Skye,Chamber,Fade","Raze,Viper,Brimstone,Fade,Gekko"
Haven,Bentley Strike,Koala Pound,5,13,1,5,8,4,"Sova,Killjoy,Viper,Omen,Yoru","Cypher,Sova,Omen,Yoru,Iso"
Icebox,Tempers,Kiyoe's Fan Club,8,13,4,8,5,4,"Sova,Killjoy,Viper,Reyna,Jett","Sova,Killjoy,Viper,Reyna,Jett"
Sunset,Shopify Rebellion,SEN SHAHZAM,13,9,7,5,4,6,"Breach,Cypher,Sova,Omen,Neon","Raze,Cypher,Reyna,Gekko,Clove"
Sunset,Avalon,Kryptic,8,13,4,8,5,4,"Breach,Cypher,Sova,Omen,Neon","Breach,Cypher,Sova,Omen,Neon"
Lotus,Screw's Angels,Kitten Shelter,5,13,2,4,9,3,"Raze,Killjoy,Omen,Fade,Gekko","Raze,Omen,Yoru,Chamber,Fade"
Sunset,Shifty505,Cumberland Rising,8,13,6,6,7,2,"Breach,Raze,Cypher,Sova,Omen","Breach,Cypher,Omen,Neon,Gekko"
Bind,KC and Friends,The Goon Goobers,6,13,1,6,7,5,"Raze,Cypher,Brimstone,Fade,Gekko","Raze,Cypher,Brimstone,Skye,Gekko"
Icebox,ROSE,Lyrical's Daycare,13,6,7,5,1,6,"Sova,Killjoy,Viper,Astra,Iso","Sova,Killjoy,Viper,Jett,Harbor"
Ascent,LOW9,Seulgi Fanclub,9,13,4,6,7,5,"Sova,Viper,Sage,Omen,Iso","Breach,Brimstone,Reyna,Jett,Neon"
Lotus,washed,Siena Heights University,13,2,10,2,0,3,"Raze,Cypher,Viper,Omen,Fade","Breach,Omen,Neon,Fade,Clove"
Lotus,FLUFFY AIMERS,Berzerkers Moon,14,12,5,8,4,9,"Raze,Cypher,Viper,Omen,Fade","Omen,KAY/O,Neon,Fade,Clove"
Haven,Dexterity Gaming,Outlast Gaming,9,13,3,9,4,6,"Breach,Cypher,Sova,Omen,Neon","Killjoy,Viper,Omen,Jett,Skye"
Haven,MSU White,Astane Anarchy,8,13,4,5,8,4,"Breach,Cypher,Sova,Jett,Astra","Breach,Cypher,Sova,Omen,Jett"
Haven,Sexy Gang,YDZ Esports,2,13,1,11,2,1,"Breach,Cypher,Sova,Jett,Astra","Breach,Cypher,Sova,Omen,Neon"
Haven,YDZ x Berzerkers,0-12 in parlays,13,7,6,2,5,7,"Breach,Cypher,Sova,Omen,Neon","Cypher,Sova,Omen,Yoru,Iso"
Sunset,Non-Verbal,LazerrFreeks Mythic,13,5,8,4,1,5,"Breach,Cypher,Sova,Omen,Neon","Breach,Cypher,Omen,Neon,Fade"
Lotus,Freak Nation,Missouri ST Gold,13,7,4,4,3,9,"Breach,Omen,Neon,Fade,Clove","Breach,Raze,Cypher,Omen,Fade"
Haven,Rock Bottom,glizzard wizards,13,2,3,0,2,10,"Breach,Sova,Killjoy,Omen,Jett","Breach,Cypher,Sova,Omen,Neon"
Sunset,Cumberland Phoenix,Lionheart eSports,13,6,6,6,0,7,"Breach,Cypher,Sova,Omen,Neon","Breach,Cypher,Sova,Omen,Neon"
Sunset,Nightblood Gaming,silly kittens,13,7,4,4,3,9,"Breach,Cypher,Sova,Omen,Neon","Breach,Cypher,Omen,KAY/O,Neon"
Abyss,APX,Globe's Mittens,13,7,4,4,3,9,"Sova,Jett,Astra,KAY/O","Cypher,Sova,Omen,Neon,Harbor"
Ascent,red,Elation Esports,16,18,7,10,8,9,"Raze,Sova,Killjoy,Omen,Yoru","Cypher,Sova,Omen,Jett,KAY/O"
Lotus,Team Image,Cyberia Esports,13,9,8,2,7,5,"Raze,Killjoy,Viper,Omen,Fade","Breach,Raze,Killjoy,Omen,Fade"
Haven,Void,kellogs cereal,11,13,3,9,4,8,"Breach,Cypher,Sova,Omen,Jett","Breach,Cypher,Sova,Omen,Jett"
Haven,Tempers,Kiyoe's Fan Club,6,13,3,9,4,3,"Cypher,Sova,Omen,Yoru,Iso","Cypher,Sova,Reyna,Omen,Neon"
Haven,Shopify Rebellion,SEN SHAHZAM,13,3,11,1,2,2,"Breach,Cypher,Sova,Omen,Neon","Breach,Sova,Killjoy,Jett,Astra"
Haven,Avalon,Kryptic,4,13,2,3,10,2,"Breach,Sova,Killjoy,Omen,Neon","Breach,Sova,Killjoy,Omen,Jett"
Lotus,ROSE,Lyrical's Daycare,13,2,10,2,0,3,"Raze,Killjoy,Viper,Omen,Fade","Raze,Cypher,Omen,Fade,Deadlock"
Lotus,Gekko,Brimstone with a Fusion Bomb,13,15,5,9,6,8,"Breach,Omen,Neon,Fade,Clove","Raze,Cypher,Omen,Fade,Clove"
Lotus,Erinite Esports,Koala Pound,13,9,9,3,6,4,"Breach,Raze,Cypher,Omen,Fade","Breach,Cypher,Omen,Neon,Gekko"
Sunset,Screw's Angels,Kitten Shelter,6,13,3,4,9,3,"Raze,Cypher,Sova,Omen,Gekko","Breach,Cypher,Sova,Omen,Neon"
Lotus,Good Career,UFO MINIONS,13,8,5,7,1,8,"Breach,Raze,Omen,Chamber,Gekko","Raze,Cypher,Omen,Jett,Gekko"
Icebox,HyperSpeed Violet,zZz,13,15,6,8,7,7,"Sova,Killjoy,Viper,Jett,Gekko","Sova,Killjoy,Viper,Reyna,Jett"
Haven,Shifty505,Cumberland Rising,7,13,5,7,6,2,"Breach,Sova,Killjoy,Omen,Jett","Breach,Cypher,Sova,Omen,Neon"
Bind,Rock Bottom,glizzard wizards,13,2,10,2,0,3,"Raze,Cypher,Viper,Brimstone,Skye","Raze,Viper,Brimstone,Skye,Gekko"
Haven,FLUFFY AIMERS,LOW9,13,4,4,1,3,9,"Cypher,Sova,Omen,Yoru,Iso","Cypher,Sova,Omen,Jett,Iso"
Sunset,Non-Verbal,Freak Nation,13,7,5,7,0,8,"Breach,Cypher,Sova,Omen,Neon","Breach,Cypher,Sova,Omen,Neon"
Lotus,YDZ Esports,Astane Anarchy,13,9,4,6,3,9,"Breach,Cypher,Neon,Gekko,Clove","Breach,Cypher,Omen,Neon,Fade"
Lotus,Dexterity Gaming,Outlast Gaming,10,13,5,6,7,5,"Raze,Killjoy,Viper,Omen,Fade","Raze,Killjoy,Viper,Omen,Fade"
Abyss,M80,All Knights,13,6,4,3,3,9,"Cypher,Sova,Omen,Jett,KAY/O","Cypher,Sova,Omen,Jett,KAY/O"
Abyss,Cumberland Phoenix,Lionheart eSports,13,6,8,4,2,5,"Sova,Jett,Astra,Deadlock","Cypher,Sova,Viper,Omen,Yoru"
Ascent,The Goon Goobers,Siena Heights University,11,13,4,8,5,7,"Sova,Killjoy,Omen,Jett,KAY/O","Sova,Killjoy,Omen,Jett,KAY/O"
Ascent,YDZ x Berzerkers,0-12 in parlays,11,13,2,10,3,9,"Sova,Killjoy,Omen,Jett,KAY/O","Sova,Killjoy,Reyna,Omen,Jett"
Ascent,Painguins,Big Hot Men,13,1,2,0,1,11,"Cypher,Sova,Omen,Yoru,Chamber","Sova,Killjoy,Omen,Jett,KAY/O"
Abyss,SACKNUT,Kbull's Kittens,2,13,2,10,3,0,"Breach,Sova,Jett,Astra,Deadlock","Sova,Omen,Jett,Yoru,Astra"
Ascent,Nightblood Gaming,silly kittens,13,7,4,4,3,9,"Sova,Killjoy,Omen,Jett,KAY/O","Cypher,Sova,Omen,Yoru,Deadlock"
Sunset,English or Spanish,The Barricade,13,10,6,5,5,7,"Breach,Raze,Cypher,Sova,Omen","Breach,Cypher,Astra,Neon,Gekko"
Lotus,mockings team,Antares Esports,13,5,8,4,1,5,"Sova,Killjoy,Omen,Jett,Clove","Breach,Omen,Neon,Fade,Clove"
Sunset,washed,KC and Friends,13,7,9,3,4,4,"Breach,Raze,Cypher,Omen,Gekko","Raze,Cypher,Sova,Omen,Gekko"
Haven,APX,Globe's Mittens,13,11,10,2,9,3,"Breach,Cypher,Sova,Omen,Jett","Breach,Cypher,Sova,Omen,Neon"
Abyss,FlyQuest RED,Bentley Strike,13,4,10,2,2,3,"Sova,Viper,Jett,Yoru,Astra","Cypher,Sova,Yoru,Astra,Gekko"
Ascent,Void,kellogs cereal,13,7,3,5,2,10,"Sova,Killjoy,Omen,Jett,KAY/O","Sova,Killjoy,Omen,Jett,KAY/O"
Sunset,Blue Otter,Fractal Gaming,13,2,10,2,0,3,"Breach,Cypher,Sova,Omen,Neon","Breach,Raze,Cypher,Omen,Gekko"
Lotus,Elation Esports,Kiyoe's Fan Club,13,11,4,8,3,9,"Breach,Cypher,Sova,Omen,Neon","Cypher,Reyna,Omen,Neon,Fade"
Icebox,Sexy Gang,MSU White,13,5,4,2,3,9,"Sova,Viper,Jett,KAY/O,Chamber","Sova,Killjoy,Viper,Jett,Harbor"
Sunset,ROSE,Avalon,13,2,3,0,2,10,"Raze,Cypher,Omen,Fade,Deadlock","Breach,Raze,Cypher,Sova,Omen"
Abyss,Gekko,Team Image,13,0,12,0,0,1,"Sova,Viper,Yoru,Deadlock,Clove","Cypher,Sova,Jett,Astra,KAY/O"
Abyss,Berzerkers,Russian Mafia ,13,4,8,4,0,5,"Cypher,Sova,Omen,Yoru,Deadlock","Cypher,Sova,Astra,Neon,Deadlock"
Ascent,Shopify Rebellion,Screw's Angels,13,4,9,3,1,4,"Cypher,Sova,Omen,Yoru,Deadlock","Sova,Killjoy,Omen,Jett,KAY/O"
Ascent,Lyrical's Daycare,Kryptic,13,3,2,2,1,11,"Cypher,Sova,Omen,Jett,Deadlock","Sova,Killjoy,Omen,Jett,KAY/O"
Lotus,red,Tempers,13,6,10,2,4,3,"Raze,Chamber,Gekko,Clove","Breach,Raze,Cypher,Omen,Fade"
Lotus,Berzerkers Moon,Seulgi Fanclub,13,3,12,0,3,1,"Omen,KAY/O,Neon,Fade,Clove","Raze,Cypher,Omen,Yoru,Fade"
Haven,Brimstone with a Fusion Bomb,Cyberia Esports,13,4,9,3,1,4,"Sova,Yoru,Astra,Chamber,Iso","Cypher,Sova,Reyna,Omen,Jett"
Bind,LazerrFreeks Mythic,Missouri ST Gold,13,5,8,4,1,5,"Raze,Viper,Brimstone,Fade,Gekko","Raze,Viper,Brimstone,Skye,Gekko"
Lotus,SEN SHAHZAM,Kitten Shelter,13,5,10,2,3,3,"Raze,Cypher,Astra,Fade,Deadlock","Raze,Cypher,Reyna,Astra,Gekko"
Sunset,SACKNUT,Kbull's Kittens,4,13,2,3,10,2,"Breach,Raze,Cypher,Omen,KAY/O","Breach,Cypher,Sova,Omen,Neon"
Sunset,Erinite Esports,Koala Pound,14,12,7,6,6,7,"Breach,Cypher,Sova,Omen,Yoru","Breach,Raze,Cypher,Omen,Gekko"
Sunset,Dexterity Gaming,Outlast Gaming,13,6,7,5,1,6,"Breach,Cypher,Sova,Omen,Neon","Breach,Raze,Cypher,Sova,Omen"
Lotus,YDZ x Berzerkers,0-12 in parlays,13,9,10,2,7,3,"Breach,Omen,Neon,Fade","Breach,Omen,Neon,Fade,Clove"
Icebox,mockings team,Antares Esports,13,3,4,0,3,9,"Sova,Killjoy,Reyna,Omen,Clove","Sova,Killjoy,Viper,Neon,Gekko"
Lotus,washed,KC and Friends,13,4,4,1,3,9,"Raze,Cypher,Viper,Omen,Fade","Breach,Raze,Cypher,Omen,Fade"
Lotus,Shifty505,Cumberland Rising,13,11,5,7,4,8,"Raze,Killjoy,Viper,Omen,Fade","Killjoy,Omen,Yoru,Neon,Fade"
Ascent,English or Spanish,The Barricade,13,2,3,0,2,10,"Sova,Killjoy,Omen,Jett,KAY/O","Cypher,Sova,Jett,Astra,Chamber"
Ascent,FLUFFY AIMERS,LOW9,13,5,10,2,3,3,"Cypher,Sova,Omen,Yoru","Cypher,Sova,Jett,Deadlock,Clove"
Sunset,Rock Bottom,glizzard wizards,9,13,7,5,8,2,"Breach,Cypher,Omen,Neon,Fade","Cypher,Sova,Omen,KAY/O,Neon"
Lotus,Berzerkers,Russian Mafia ,13,4,9,3,1,4,"Breach,Sova,Killjoy,Omen,Neon","Breach,Raze,Killjoy,Omen,Fade"
Haven,The Goon Goobers,Siena Heights University,7,13,2,6,7,5,"Breach,Cypher,Sova,Omen,Neon","Breach,Skye,Astra,Neon,Clove"
Abyss,ROSE,Avalon,13,2,10,2,0,3,"Sova,Jett,Yoru,Astra,Deadlock","Cypher,Sova,Omen,Jett"
Lotus,Gekko,Team Image,13,2,2,1,1,11,"Breach,Omen,Neon,Fade,Clove","Raze,Killjoy,Viper,Omen,Fade"
Sunset,Painguins,Big Hot Men,13,7,6,2,5,7,"Breach,Cypher,Sova,Omen,Neon","Breach,Cypher,Sova,Omen,Neon"
Icebox,Shopify Rebellion,Screw's Angels,13,0,12,0,0,1,"Killjoy,Viper,Reyna,KAY/O,Gekko","Sova,Killjoy,Viper,Reyna,Gekko"
Haven,Blue Otter,Fractal Gaming,13,4,5,0,4,8,"Breach,Cypher,Sova,Omen,Neon","Breach,Sova,Killjoy,Omen,Jett"
Haven,Cumberland Phoenix,Lionheart eSports,6,13,3,4,9,3,"Breach,Cypher,Sova,Omen,Jett","Breach,Cypher,Sova,Omen,Neon"
Ascent,Good Career,UFO MINIONS,14,12,4,9,3,10,"Sova,Killjoy,Omen,Jett,KAY/O","Sova,Omen,Jett,Yoru,Deadlock"
Ascent,red,Tempers,13,4,10,2,2,3,"Sova,Killjoy,Jett,Neon,Clove","Sova,Killjoy,Omen,Jett,KAY/O"
Lotus,APX,Globe's Mittens,9,13,2,8,5,7,"Raze,Cypher,Omen,Jett,Gekko","Breach,Killjoy,Omen,KAY/O,Neon"
Lotus,Non-Verbal,Freak Nation,15,13,4,10,3,11,"Raze,Killjoy,Viper,Omen,Fade","Breach,Raze,Cypher,Omen,Fade"
Sunset,Void,kellogs cereal,3,13,0,4,9,3,"Cypher,Sova,Omen,KAY/O,Neon","Breach,Raze,Cypher,Gekko,Clove"
Sunset,YDZ Esports,Astane Anarchy,13,11,2,10,1,11,"Breach,Cypher,Sova,Omen,Neon","Breach,Raze,Cypher,Omen,Fade"
Haven,FlyQuest RED,Bentley Strike,13,1,2,0,1,11,"Killjoy,Phoenix,Astra,Fade,Gekko","Sova,Killjoy,Viper,Omen,Yoru"
Sunset,Sexy Gang,MSU White,13,5,9,3,2,4,"Breach,Sova,Killjoy,Jett,Clove","Breach,Cypher,Astra,KAY/O,Neon"
Abyss,Berzerkers Moon,Seulgi Fanclub,13,3,9,3,0,4,"Cypher,Sova,Omen,Yoru,Astra","Cypher,Sova,Astra,Neon,Iso"
Lotus,Brimstone with a Fusion Bomb,Cyberia Esports,13,0,12,0,0,1,"Raze,Cypher,Omen,Fade,Clove","Breach,Raze,Killjoy,Omen,Fade"
Icebox,M80,All Knights,13,5,9,3,2,4,"Killjoy,Viper,Omen,KAY/O,Gekko","Sova,Killjoy,Viper,Gekko,Iso"
Haven,Nightblood Gaming,silly kittens,11,13,5,7,6,6,"Breach,Sova,Astra,Chamber,Neon","Breach,Cypher,Sova,Omen,Jett"
Sunset,LazerrFreeks Mythic,Missouri ST Gold,13,1,11,1,0,2,"Breach,Cypher,Omen,Neon,Fade","Breach,Cypher,Sova,Omen,Neon"
Lotus,Lyrical's Daycare,Kryptic,13,3,9,3,0,4,"Raze,Cypher,Omen,Fade,Deadlock","Raze,Killjoy,Viper,Omen,Fade"
Lotus,HyperSpeed Violet,zZz,15,17,9,7,10,6,"Raze,Killjoy,Omen,Fade,Gekko","Breach,Cypher,Omen,Neon,Fade"
Haven,Elation Esports,Kiyoe's Fan Club,13,5,9,3,2,4,"Cypher,Sova,Omen,Yoru,Iso","Breach,Cypher,Sova,Omen,Neon"
Haven,SEN SHAHZAM,Kitten Shelter,13,4,5,0,4,8,"Breach,Sova,Killjoy,Jett,Astra","Sova,Killjoy,Reyna,Omen,Jett"
Sunset,M80,All Knights,13,9,7,5,4,6,"Breach,Cypher,Omen,Yoru,Gekko","Breach,Cypher,Omen,Neon,Fade"
Lotus,M80,All Knights,4,13,3,9,4,1,"Cypher,Sage,Omen,Fade,Deadlock","Breach,Cypher,Omen,Neon,Fade"
Haven,M80,All Knights,3,13,0,4,9,3,"Breach,Sova,Killjoy,Omen,Jett","Breach,Cypher,Sova,Omen,Neon"
Lotus,NAOS Esports,BOOM Esports,7,13,3,5,8,4,"Raze,Killjoy,Viper,Omen,Fade","Raze,Killjoy,Viper,Omen,Fade"
Sunset,NAOS Esports,BOOM Esports,3,13,2,10,3,1,"Breach,Cypher,Sova,Omen,Neon","Breach,Raze,Cypher,Omen,Gekko"
Haven,FULL SENSE,Oblivion Force,13,3,4,0,3,9,"Breach,Sova,Killjoy,Omen,Neon","Breach,Cypher,Omen,Neon,Iso"
Sunset,FULL SENSE,Oblivion Force,13,6,3,4,2,10,"Breach,Cypher,Sova,Omen,Neon","Raze,Cypher,Omen,KAY/O,Gekko"
Icebox,Revenant Esports,Sin Prisa Gaming,5,13,0,6,7,5,"Sova,Killjoy,Viper,Yoru,Gekko","Sova,Killjoy,Viper,Jett,Harbor"
Bind,Revenant Esports,Sin Prisa Gaming,10,13,7,5,8,3,"Raze,Viper,Brimstone,Fade,Gekko","Cypher,Brimstone,Neon,Fade,Deadlock"
Ascent,M80,Galorys,14,12,4,9,3,10,"Cypher,Sova,Omen,Yoru,Deadlock","Cypher,Sova,Omen,Jett,Deadlock"
Sunset,M80,Galorys,13,9,8,4,5,5,"Breach,Cypher,Omen,Yoru,Gekko","Breach,Cypher,Sova,Omen,Neon"
Sunset,2Game Esports,All Knights,13,4,9,3,1,4,"Breach,Cypher,Sova,Omen,Neon","Breach,Cypher,Omen,Neon,Fade"
Lotus,Permitta Unicorns GC,RIZON Sugar,13,8,7,2,6,6,"Breach,Raze,Killjoy,Omen,Fade","Breach,Raze,Cypher,Omen,Fade"
Sunset,FOKUS Sakura,Scald eSport GC,13,5,9,3,2,4,"Breach,Cypher,Omen,Neon,Fade","Breach,Cypher,Omen,Neon,Gekko"
Lotus,2Game Esports,All Knights,12,14,5,8,6,7,"Breach,Cypher,Omen,Neon,Fade","Breach,Cypher,Omen,Neon,Fade"
Haven,Permitta Unicorns GC,RIZON Sugar,13,11,9,3,8,4,"Breach,Cypher,Sova,Omen,Jett","Cypher,Sova,Omen,Yoru,Iso"
Icebox,FOKUS Sakura,Scald eSport GC,13,7,6,2,5,7,"Sova,Killjoy,Viper,Reyna,Jett","Sova,Killjoy,Viper,Sage,Jett"
Lotus,Reveal Multigaming Jushimori,Dortmund eSports Dynasty,13,15,10,4,11,3,"Breach,Raze,Killjoy,Omen,Fade","Breach,Raze,Killjoy,Omen,Fade"
Abyss,2Game Esports,All Knights,13,9,7,3,6,6,"Cypher,Sova,Omen,Jett,KAY/O","Cypher,Sova,Omen,Jett,KAY/O"
Abyss,LVENGERS,teamhoppers,2,13,0,3,10,2,"Cypher,Sova,Omen,Jett,Harbor","Sova,Sage,Jett,Astra,KAY/O"
Ascent,ROA SYNC,Entropy Azúcar,13,8,6,6,2,7,"Cypher,Sova,Omen,Jett,KAY/O","Sova,Killjoy,Omen,Jett,KAY/O"
Sunset,Permitta Unicorns GC,RIZON Sugar,11,13,8,4,9,3,"Breach,Raze,Cypher,Sova,Omen","Breach,Raze,Cypher,Sova,Omen"
Bind,Reveal Multigaming Jushimori,Dortmund eSports Dynasty,13,10,9,3,7,4,"Breach,Raze,Cypher,Brimstone,Fade","Breach,Raze,Cypher,Brimstone,Fade"
Abyss,NEON BLADE,Blindspot Kunai,13,2,12,0,2,1,"Cypher,Sova,Omen,Jett,Gekko","Breach,Cypher,Jett,Astra,Gekko"
Ascent,SK Nebula,SSP Numina,13,3,10,2,1,3,"Sova,Killjoy,Omen,Jett,KAY/O","Sova,Killjoy,Omen,Jett,KAY/O"
Haven,TOG Kitsune,ALTERNATE aTTaX Ruby,8,13,6,6,7,2,"Breach,Cypher,Sova,Omen,Jett","Breach,Cypher,Sova,Omen,Jett"
Haven,LVENGERS,teamhoppers,7,13,6,6,7,1,"Breach,Sova,Killjoy,Omen,Jett","Raze,Killjoy,Viper,Skye,Astra"
Haven,NEON BLADE,Blindspot Kunai,13,3,10,2,1,3,"Breach,Sova,Killjoy,Omen,Jett","Breach,Sova,Killjoy,Omen,Jett"
Sunset,Reveal Multigaming Jushimori,Dortmund eSports Dynasty,5,13,1,5,8,4,"Breach,Raze,Cypher,Omen,Gekko","Breach,Raze,Cypher,Omen,Fade"
Lotus,ROA SYNC,Entropy Azúcar,13,10,7,4,6,6,"Breach,Raze,Killjoy,Gekko,Clove","Breach,Raze,Killjoy,Omen,Fade"
Haven,SK Nebula,SSP Numina,13,4,3,2,2,10,"Breach,Cypher,Sova,Jett,Astra","Breach,Sova,Killjoy,Omen,Jett"
Abyss,TOG Kitsune,ALTERNATE aTTaX Ruby,5,13,2,4,9,3,"Breach,Cypher,Sova,Jett,Astra","Sova,Sage,Jett,Astra,KAY/O"
Abyss,Team Serenity,Perfectionists,13,9,3,7,2,10,"Sova,Viper,Jett,Yoru,Astra","Sova,Jett,Astra,Harbor,Deadlock"
Sunset,Team Serenity,Perfectionists,13,7,7,5,2,6,"Breach,Cypher,Sova,Omen,Neon","Breach,Raze,Cypher,Omen,Gekko"
Haven,Team Serenity,Perfectionists,10,13,6,5,8,4,"Killjoy,Viper,Omen,Jett,Skye","Breach,Cypher,Sova,Omen,Jett"
Bind,All Knights,Galorys,14,12,10,3,9,4,"Raze,Cypher,Brimstone,Skye,Deadlock","Raze,Viper,Brimstone,Fade,Gekko"
Haven,All Knights,Galorys,13,9,8,2,7,5,"Breach,Cypher,Sova,Omen,Neon","Breach,Sova,Killjoy,Omen,Jett"
Icebox,M80,2Game Esports,7,13,4,8,5,3,"Killjoy,Viper,Omen,KAY/O,Gekko","Sova,Killjoy,Viper,Jett,KAY/O"
Sunset,M80,2Game Esports,8,13,5,4,9,3,"Breach,Cypher,Omen,Yoru,Gekko","Breach,Cypher,Sova,Omen,Neon"
Ascent,Reveal Multigaming Jushimori,NEON BLADE,6,13,6,6,7,0,"Breach,Sova,Killjoy,Omen,Jett","Sova,Killjoy,Omen,Jett,KAY/O"
Lotus,Reveal Multigaming Jushimori,NEON BLADE,11,13,7,5,8,4,"Breach,Raze,Killjoy,Omen,Fade","Breach,Raze,Killjoy,Omen,Fade"
Haven,FlyQuest RED,YFP X,10,13,8,4,9,2,"Killjoy,Phoenix,Astra,Fade,Gekko","Breach,Cypher,Sova,Omen,Jett"
Bind,FlyQuest RED,YFP X,10,13,6,6,7,4,"Raze,Viper,Skye,Astra,Gekko","Raze,Cypher,Omen,Skye,Yoru"
Sunset,FlyQuest RED,YFP X,13,2,3,0,2,10,"Raze,Cypher,Omen,Fade,Deadlock","Breach,Raze,Cypher,Sova,Omen"
Icebox,FlyQuest RED,Refrag,13,6,5,2,4,8,"Sova,Killjoy,Viper,Sage,Gekko","Sova,Killjoy,Viper,Reyna,Iso"
Haven,FlyQuest RED,Refrag,13,9,6,6,3,7,"Killjoy,Phoenix,Astra,Fade,Gekko","Cypher,Sova,Killjoy,Omen,Jett"
Lotus,FlyQuest RED,Refrag,6,13,4,8,5,2,"Raze,Omen,Fade,Deadlock,Clove","Raze,Omen,Fade,Deadlock"
Haven,Team Liquid Brazil,TBS GC,13,5,7,5,0,6,"Killjoy,Viper,Omen,Jett,Skye","Cypher,Sova,Omen,Yoru,Iso"
Abyss,Team Liquid Brazil,TBS GC,13,6,6,1,5,7,"Cypher,Sova,Omen,Jett,KAY/O","Sova,Reyna,Omen,Chamber,Iso"
Haven,YFP X,oomfies,13,8,7,5,3,6,"Breach,Cypher,Sova,Omen,Jett","Breach,Cypher,Sova,Omen,Jett"
Bind,Team Liquid Brazil,TBS GC,13,7,6,2,5,7,"Raze,Cypher,Viper,Brimstone,Skye","Raze,Viper,Brimstone,Skye,Gekko"
Sunset,YFP X,oomfies,13,7,4,4,3,9,"Breach,Raze,Cypher,Sova,Omen","Raze,Cypher,Sova,Omen,Iso"
Lotus,SSP Numina,RIZON Sugar,8,13,4,5,8,4,"Breach,Raze,Killjoy,Omen,Gekko","Breach,Raze,Cypher,Omen,Fade"
Lotus,Permitta Unicorns GC,ALTERNATE aTTaX Ruby,6,13,3,4,9,3,"Breach,Raze,Killjoy,Omen,Fade","Breach,Raze,Cypher,Omen,Fade"
Sunset,SSP Numina,RIZON Sugar,9,13,5,5,8,4,"Breach,Cypher,Sova,Omen,Neon","Breach,Raze,Cypher,Sova,Omen"
Sunset,Permitta Unicorns GC,ALTERNATE aTTaX Ruby,7,13,3,9,4,4,"Breach,Raze,Cypher,Sova,Omen","Breach,Raze,Cypher,Sova,Omen"
Haven,LVENGERS,Silly Seals,13,4,5,0,4,8,"Breach,Sova,Killjoy,Omen,Jett","Breach,Cypher,Sova,Omen,Neon"
Lotus,NASR Ignite,Karmine Corp GC,13,7,7,1,6,6,"Raze,Cypher,Omen,KAY/O,Deadlock","Breach,Cypher,Omen,Neon,Fade"
Ascent,FOKUS Sakura,TOG Kitsune,13,7,8,4,3,5,"Sova,Killjoy,Omen,Jett,Iso","Sova,Killjoy,Omen,Jett,KAY/O"
Bind,SK Nebula,Scald eSport GC,13,5,4,2,3,9,"Raze,Viper,Omen,Yoru,Fade","Breach,Raze,Cypher,Brimstone,Deadlock"
Lotus,teamhoppers,Entropy Azúcar,13,1,11,1,0,2,"Raze,Cypher,Omen,Fade,Deadlock","Breach,Raze,Killjoy,Omen,Fade"
Lotus,LVENGERS,Silly Seals,7,13,4,8,5,3,"Breach,Raze,Cypher,Omen,Fade","Breach,Raze,Killjoy,Omen,Fade"
Ascent,ROA SYNC,Blindspot Kunai,13,5,5,1,4,8,"Cypher,Sova,Omen,Jett,KAY/O","Sova,Killjoy,Omen,Jett,KAY/O"
Bind,NASR Ignite,Karmine Corp GC,13,9,6,6,3,7,"Raze,Cypher,Brimstone,Skye,Deadlock","Raze,Cypher,Brimstone,Omen,Skye"
Ascent,SK Nebula,Scald eSport GC,13,5,4,2,3,9,"Sova,Killjoy,Omen,Jett,KAY/O","Cypher,Sova,Omen,Jett,Yoru"
Sunset,FOKUS Sakura,TOG Kitsune,13,9,8,2,7,5,"Breach,Cypher,Omen,Neon,Fade","Breach,Cypher,Sova,Omen,Yoru"
Bind,LVENGERS,Silly Seals,13,3,2,2,1,11,"Breach,Raze,Brimstone,Harbor,Gekko","Raze,Viper,Astra,Fade,Gekko"
Haven,teamhoppers,Entropy Azúcar,13,8,8,1,7,5,"Raze,Killjoy,Viper,Skye,Astra","Breach,Sova,Killjoy,Omen,Jett"
Lotus,ROA SYNC,Blindspot Kunai,13,4,2,3,1,11,"Breach,Raze,Killjoy,Gekko,Clove","Breach,Killjoy,Omen,Jett,Gekko"
Lotus,The Rejects,Hampter,10,13,8,3,10,2,"Killjoy,Astra,Neon,Gekko","Raze,Reyna,Gekko,Deadlock,Clove"
Ascent,wade,KAMK.GG,18,16,8,9,7,10,"Cypher,Sova,Jett,KAY/O,Clove","Sova,Killjoy,Omen,Jett,KAY/O"
Lotus,VIRMA,Möyhentäjät,13,2,10,2,0,3,"Breach,Omen,Chamber,Neon,Gekko","Breach,Raze,Omen,Chamber,Harbor"
Ascent,GIANTX GC,Valiant GC,13,8,6,6,2,7,"Sova,Killjoy,Omen,Jett,KAY/O","Cypher,Sova,Omen,Jett,Deadlock"
Lotus,wade,KAMK.GG,13,2,3,0,2,10,"Breach,Raze,Killjoy,Neon,Clove","Breach,Reyna,Omen,Chamber,Neon"
Haven,SKIPIDI,Wintermint,4,13,3,9,4,1,"Sova,Killjoy,Reyna,Omen,Jett","Breach,Sova,Omen,Jett"
Haven,The Rejects,Hampter,9,13,7,5,8,2,"Raze,Cypher,Yoru,Astra,Gekko","Sage,Reyna,Skye,Deadlock,Clove"
Ascent,VIRMA,Möyhentäjät,13,0,12,0,0,1,"Cypher,Sova,Omen,Jett,KAY/O","Raze,Sova,Killjoy,Omen,Jett"
Lotus,Valoja Päälle?,Ahlman ,9,13,3,7,6,6,"Breach,Killjoy,Neon,Harbor,Clove","Raze,Cypher,Omen,Fade,Gekko"
Lotus,Pumppuhait,Monkey Momentum,2,13,0,3,10,2,"Raze,Cypher,Brimstone,Yoru,KAY/O","Breach,Killjoy,Omen,Jett,Gekko"
Lotus,SSalama,Rekka10,4,13,4,8,5,0,"Breach,Raze,Omen,Chamber,Fade","Raze,Cypher,Omen,Gekko,Deadlock"
Bind,wombat123,ISOSIMO,13,1,2,0,1,11,"Raze,Viper,Fade,Deadlock,Clove","Raze,Brimstone,Skye,Chamber,Fade"
Ascent,SKIPIDI,Wintermint,1,13,1,11,2,0,"Cypher,Sova,Omen,Jett,KAY/O","Sova,Killjoy,Omen,Jett,KAY/O"
Ascent,Pumppuhait,Monkey Momentum,4,13,2,3,10,2,"Killjoy,Phoenix,Brimstone,Reyna,KAY/O","Sova,Killjoy,Omen,Jett,KAY/O"
Haven,SSalama,Rekka10,2,13,1,11,2,1,"Breach,Cypher,Sova,Omen,Jett","Breach,Cypher,Sova,Omen,Jett"
Ascent,The Rejects,Hampter,13,10,8,4,6,5,"Cypher,Yoru,Astra,KAY/O,Neon","Sova,Killjoy,Phoenix,Omen,Jett"
Icebox,wombat123,ISOSIMO,13,4,8,4,0,5,"Sova,Killjoy,Viper,Reyna,Jett","Sova,Killjoy,Viper,Sage,Jett"
Lotus,GIANTX GC,Valiant GC,15,13,6,8,5,9,"Breach,Raze,Sova,Omen,Chamber","Breach,Killjoy,Omen,Neon,Fade"
Haven,Refrag,Teddy Tactics,13,7,3,5,2,10,"Breach,Cypher,Sova,Omen,Jett","Breach,Sova,Killjoy,Astra,Neon"
Bind,TBS GC,REVOADA,13,9,7,3,6,6,"Raze,Viper,Brimstone,Skye,Gekko","Raze,Cypher,Viper,Brimstone,Skye"
Haven,oomfies,mesos millionaires,13,4,9,3,1,4,"Cypher,Sova,Omen,Yoru,Iso","Breach,Sova,Killjoy,Omen,Neon"
Haven,FlyQuest RED,Give Wingman 2 Nuclear Devices,13,7,6,2,5,7,"Killjoy,Phoenix,Astra,Fade,Gekko","Breach,Cypher,Sova,Omen,Neon"
Lotus,Refrag,Teddy Tactics,13,1,11,1,0,2,"Raze,Cypher,Omen,Fade,Deadlock","Breach,Raze,Killjoy,Astra,Fade"
Haven,YFP X,Army National Guard,13,0,1,0,0,12,"Breach,Phoenix,Sage,KAY/O,Clove","Raze,Cypher,Phoenix,Omen,Gekko"
Bind,FlyQuest RED,Give Wingman 2 Nuclear Devices,13,4,8,4,0,5,"Raze,Viper,Skye,Astra,Gekko","Raze,Viper,Skye,Gekko,Clove"
Lotus,YFP X,Army National Guard,13,0,12,0,0,1,"Omen,Chamber,Neon,Gekko,Iso","Raze,Killjoy,Phoenix,Brimstone,Fade"
Bind,oomfies,mesos millionaires,13,7,6,2,5,7,"Raze,Viper,Brimstone,Fade,Gekko","Raze,Skye,Chamber,Deadlock,Clove"
Sunset,TBS GC,REVOADA,13,8,7,2,6,6,"Cypher,Sova,Omen,KAY/O,Neon","Breach,Raze,Cypher,Sova,Omen"
Ascent,Refrag,Teddy Tactics,6,13,2,5,8,4,"Sova,Killjoy,Omen,Jett,KAY/O","Breach,Sova,Killjoy,Jett,Astra"
Haven,TBS GC,REVOADA,10,13,5,7,6,5,"Cypher,Sova,Omen,Yoru,Iso","Breach,Sova,Killjoy,Omen,Jett"
Sunset,YFP X,Give Wingman 2 Nuclear Devices,13,6,9,3,3,4,"Breach,Raze,Cypher,Sova,Omen","Breach,Raze,Cypher,Omen,Gekko"
Ascent,Refrag,mesos millionaires,13,9,4,6,3,9,"Sova,Killjoy,Omen,Jett,KAY/O","Sova,Killjoy,Jett,Astra,KAY/O"
Icebox,FlyQuest RED,Teddy Tactics,13,3,9,3,0,4,"Sova,Killjoy,Viper,Sage,Gekko","Sova,Killjoy,Viper,Jett,Harbor"
Bind,oomfies,Army National Guard,13,1,11,1,0,2,"Raze,Cypher,Viper,Brimstone,Iso","Raze,Cypher,Phoenix,Brimstone,Gekko"
Bind,Give Wingman 2 Nuclear Devices,mesos millionaires,9,13,4,8,5,5,"Raze,Viper,Brimstone,Skye,Gekko","Raze,Skye,Chamber,Deadlock,Clove"
Haven,Refrag,YFP X,10,13,2,9,4,8,"Breach,Cypher,Sova,Omen,Jett","Breach,Cypher,Sova,Omen,Jett"
Haven,oomfies,FlyQuest RED,5,13,4,8,5,1,"Cypher,Sova,Omen,Yoru,Iso","Killjoy,Phoenix,Astra,Fade,Gekko"
Haven,Team Liquid Brazil,Vila das Flores,13,3,4,0,3,9,"Killjoy,Viper,Omen,Jett,Skye","Breach,Cypher,Sova,Omen,Neon"
Ascent,Teddy Tactics,Army National Guard,13,0,12,0,0,1,"Breach,Sova,Killjoy,Jett,Astra","Raze,Sova,Killjoy,Phoenix,Brimstone"
Haven,mesos millionaires,YFP X,7,13,4,8,5,3,"Breach,Sova,Killjoy,Omen,Neon","Breach,Cypher,Sova,Omen,Jett"
Lotus,Refrag,Give Wingman 2 Nuclear Devices,13,7,7,1,6,6,"Raze,Viper,Omen,Chamber,Fade","Killjoy,Viper,Omen,Neon,Gekko"
Haven,Army National Guard,FlyQuest RED,1,13,1,11,2,0,"Raze,Cypher,Phoenix,Omen,Gekko","Killjoy,Phoenix,Astra,Fade,Gekko"
Ascent,Team Liquid Brazil,Vila das Flores,13,7,5,3,4,8,"Sova,Killjoy,Omen,Jett,KAY/O","Cypher,Sova,Phoenix,Omen,Jett"
Bind,Veni eSports Venom,Dortmund eSports Dynasty,10,13,3,8,5,7,"Breach,Raze,Viper,Brimstone,Gekko","Breach,Raze,Cypher,Brimstone,Fade"
Bind,Valiant GC,BBL Queens,13,3,9,3,0,4,"Raze,Viper,Brimstone,Fade,Gekko","Breach,Raze,Cypher,Omen,Skye"
Haven,Veni eSports Venom,Dortmund eSports Dynasty,9,13,6,6,7,3,"Breach,Sova,Killjoy,Omen,Neon","Breach,Sova,Killjoy,Omen,Jett"
Lotus,Veni eSports Venom,Dortmund eSports Dynasty,13,9,8,2,7,5,"Breach,Omen,Chamber,Neon,Gekko","Breach,Raze,Killjoy,Omen,Fade"
Lotus,Valiant GC,BBL Queens,14,12,7,6,6,7,"Breach,Killjoy,Omen,Neon,Fade","Breach,Raze,Killjoy,Omen,Fade"
Bind,G2 Gozen,NASR Ignite,14,12,10,3,9,4,"Raze,Brimstone,Omen,Skye,Gekko","Raze,Cypher,Brimstone,Skye,Deadlock"
Haven,G2 Gozen,NASR Ignite,13,5,4,2,3,9,"Breach,Cypher,Sova,Omen,Neon","Breach,Cypher,Sova,Omen,Neon"
Sunset,All Knights,TSM,15,13,10,4,9,5,"Breach,Cypher,Sova,Omen,Neon","Breach,Cypher,Omen,Neon,Gekko"
Abyss,All Knights,TSM,13,6,9,3,3,4,"Cypher,Sova,Omen,Jett,KAY/O","Sova,Viper,Jett,Yoru,Astra"
Haven,All Knights,TSM,13,15,2,12,3,11,"Breach,Cypher,Sova,Omen,Neon","Breach,Cypher,Sova,Omen,Neon"
Sunset,Vila das Flores,Team Leveling,13,10,8,4,6,5,"Breach,Sova,Sage,Omen,Neon","Breach,Cypher,Sova,Omen,Neon"
Bind,Vila das Flores,Team Leveling,7,13,0,8,5,7,"Viper,Brimstone,Yoru,Neon,Fade","Raze,Viper,Brimstone,Skye,Gekko"
Sunset,2Game Esports,M80,14,16,5,10,6,9,"Breach,Cypher,Sova,Omen,Neon","Breach,Cypher,Omen,Yoru,Gekko"
Sunset,TBS GC,PS5Patas,13,2,10,2,0,3,"Cypher,Sova,Omen,KAY/O,Neon","Breach,Cypher,Sova,Omen,Neon"
Ascent,REVOADA,RocketggGC,13,2,10,2,0,3,"Sova,Killjoy,Omen,Jett,KAY/O","Sova,Killjoy,Omen,Jett,KAY/O"
Ascent,Team Liquid Brazil,PROCURADAS,13,1,2,0,1,11,"Sova,Killjoy,Omen,Jett,KAY/O","Sova,Killjoy,Omen,Jett,KAY/O"
Lotus,2Game Esports,M80,7,13,2,10,3,5,"Breach,Cypher,Omen,Neon,Fade","Breach,Cypher,Omen,Yoru,Fade"
Abyss,Vila das Flores,Team Leveling,13,11,7,5,6,6,"Cypher,Sova,Omen,Jett,Harbor","Sova,Omen,Astra,KAY/O,Neon"
Ascent,TBS GC,PS5Patas,13,8,7,2,6,6,"Sova,Killjoy,Omen,Jett,KAY/O","Sova,Killjoy,Omen,Jett,KAY/O"
Bind,REVOADA,RocketggGC,13,8,7,5,3,6,"Raze,Cypher,Viper,Brimstone,Skye","Raze,Cypher,Brimstone,Skye,Gekko"
Haven,Team Liquid Brazil,PROCURADAS,13,3,2,2,1,11,"Killjoy,Viper,Omen,Jett,Skye","Breach,Cypher,Sova,Omen,Jett"
Bind,RETA Esports,Galorys,4,13,3,9,4,1,"Raze,Viper,Brimstone,Skye,Gekko","Raze,Viper,Brimstone,Fade,Gekko"
Ascent,Apeks,PCIFIC Espor,13,4,8,4,0,5,"Cypher,Sova,Omen,Yoru,Deadlock","Cypher,Sova,Omen,Jett,KAY/O"
Sunset,Tap Tap Boom eSports,The Cult,4,13,2,10,3,2,"Raze,Viper,Omen,Chamber,Fade","Raze,Cypher,Skye,Gekko,Clove"
Lotus,Apeks,PCIFIC Espor,13,11,9,3,8,4,"Raze,Cypher,Omen,KAY/O,Deadlock","Breach,Cypher,Sova,Omen,Neon"
Ascent,RETA Esports,Galorys,11,13,4,8,5,7,"Sova,Killjoy,Omen,Jett,KAY/O","Cypher,Sova,Omen,Jett,Deadlock"
Lotus,TxT Gaming,COBWEB HYDRA,13,5,4,2,3,9,"Breach,Omen,Chamber,Neon,Fade","Breach,Cypher,Omen,Jett,Gekko"
Haven,Tap Tap Boom eSports,The Cult,14,12,7,6,6,7,"Breach,Cypher,Sova,Omen,Jett","Breach,Sova,Killjoy,Omen,Jett"
Bind,G2 Gozen,Odd 1 OUT,13,5,5,1,4,8,"Raze,Brimstone,Omen,Skye,Gekko","Raze,Viper,Brimstone,Fade,Gekko"
Haven,Apeks,PCIFIC Espor,11,13,9,3,10,2,"Breach,Sova,Killjoy,Omen,Jett","Breach,Sova,Killjoy,Omen,Jett"
Haven,TxT Gaming,COBWEB HYDRA,13,5,10,2,3,3,"Breach,Cypher,Sova,Omen,Neon","Breach,Sova,Killjoy,Omen,Neon"
Lotus,G2 Gozen,Odd 1 OUT,13,6,7,0,6,6,"Raze,Cypher,Omen,Fade,Deadlock","Breach,Cypher,Sova,Omen,Neon"
Ascent,Dark Horse Templars,ZINGERS,7,13,2,10,3,5,"Sova,Killjoy,Omen,Jett,KAY/O","Sova,Killjoy,Phoenix,Astra,Clove"
Abyss,Apeks,PCIFIC Espor,13,8,7,2,6,6,"Cypher,Sova,Omen,Yoru,Astra","Cypher,Sova,Omen,Jett,KAY/O"
Sunset,Top G,Linares eSports,9,13,5,5,8,4,"Breach,Cypher,Sova,Neon,Clove","Breach,Cypher,Sova,Omen,Neon"
Abyss,TxT Gaming,COBWEB HYDRA,11,13,8,4,9,3,"Cypher,Sova,Omen,Jett,Harbor","Cypher,Sova,Jett,Astra,Gekko"
Haven,Dark Horse Templars,ZINGERS,10,13,5,7,6,5,"Breach,Cypher,Sova,Omen,Neon","Breach,Killjoy,Omen,Jett,Iso"
Haven,Top G,Linares eSports,11,13,5,7,6,6,"Breach,Sova,Killjoy,Jett,Clove","Breach,Cypher,Sova,Omen,Jett"
Sunset,HEROIC Valkyries,GIANTX GC,13,5,8,4,1,5,"Breach,Raze,Cypher,Sova,Astra","Breach,Cypher,Sova,Omen,Neon"
Sunset,Apeks,PCIFIC Espor,6,13,3,9,4,3,"Cypher,Sova,Omen,KAY/O,Neon","Breach,Cypher,Sova,Omen,Neon"
Abyss,Top G,Linares eSports,13,8,6,3,5,7,"Cypher,Sova,Jett,Iso,Clove","Cypher,Sova,Jett,Astra,Gekko"
Lotus,Defient Esports,Moon,13,9,5,7,2,8,"Breach,Raze,Cypher,Omen,Fade","Breach,Raze,Killjoy,Skye,Clove"
Abyss,HEROIC Valkyries,GIANTX GC,13,11,7,5,6,6,"Breach,Cypher,Sova,Jett,Astra","Breach,Cypher,Jett,Astra,Gekko"
Icebox,Man I Love Fermin Trujin,Top G,5,13,3,3,10,2,"Sova,Killjoy,Viper,Sage,Jett","Sova,Killjoy,Viper,Reyna,Jett"
Haven,Linares eSports,meowmeowmeow,13,6,9,3,3,4,"Breach,Cypher,Sova,Omen,Jett","Breach,Cypher,Sova,Omen,Jett"
Abyss,Defient Esports,Moon,13,8,7,5,3,6,"Cypher,Sova,Jett,Astra,Gekko","Breach,Cypher,Omen,Jett,Deadlock"
Ascent,Man I Love Fermin Trujin,Top G,7,13,3,9,4,4,"Sova,Killjoy,Omen,Jett,KAY/O","Cypher,Sova,Reyna,Jett,Clove"
Bind,TEAM BLINDSPOT,PANDEMONIUM,5,13,3,3,10,2,"Raze,Viper,Brimstone,Fade,Gekko","Raze,Viper,Astra,Fade,Gekko"
Ascent,Linares eSports,meowmeowmeow,14,12,8,5,7,6,"Cypher,Sova,Omen,Jett,KAY/O","Sova,Killjoy,Phoenix,Omen,Jett"
Ascent,Team Accelerate,Team Ruthless,5,13,1,5,8,4,"Breach,Sova,Killjoy,Omen,Jett","Sova,Killjoy,Omen,Jett,KAY/O"
Sunset,TEAM BLINDSPOT,PANDEMONIUM,13,7,9,3,4,4,"Breach,Cypher,Omen,Neon,Gekko","Breach,Raze,Cypher,Omen,Gekko"
Haven,Team Accelerate,Team Ruthless,7,13,4,8,5,3,"Breach,Sova,Killjoy,Omen,Jett","Sova,Killjoy,Reyna,Omen,Jett"
Haven,Nexum EC,Linares eSports,4,13,0,5,8,4,"Breach,Viper,Omen,Neon","Breach,Cypher,Sova,Omen,Jett"
Abyss,Top G,Universae,14,12,7,6,6,7,"Cypher,Sova,Jett,Iso,Clove","Breach,Cypher,Sova,Jett,Astra"
Haven,meowmeowmeow,La Banda del Patio,13,4,3,2,2,10,"Breach,Cypher,Sova,Jett,Astra","Breach,Sova,Killjoy,Omen,Jett"
Ascent,VOID (EU),Man I Love Fermin Trujin,8,13,5,7,6,3,"Breach,Viper,Yoru,KAY/O,Clove","Sova,Killjoy,Omen,Jett,KAY/O"
Abyss,Las Cabras (EU),RYL | Royal Legion,12,14,5,8,6,7,"Cypher,Sova,Jett,Astra,Gekko","Cypher,Sova,Omen,Jett,Harbor"
Bind,Team Accelerate,Team Ruthless,13,9,6,4,5,7,"Raze,Viper,Brimstone,Skye,Yoru","Raze,Brimstone,Chamber,Fade,Gekko"
Ascent,kosomaks,Nexum EC,9,13,3,7,6,6,"Cypher,Sova,Omen,Jett,KAY/O","Breach,Omen,Neon,Fade,Deadlock"
Haven,Top G,Genesis eSports,13,3,2,2,1,11,"Breach,Sova,Killjoy,Omen,Jett","Breach,Sova,Killjoy,Omen,Jett"
Haven,La Banda del Patio,nox gaming,13,11,6,6,5,7,"Breach,Sova,Killjoy,Omen,Jett","Cypher,Sova,Omen,Yoru,Iso"
Haven,Las Cabras (EU),RYL | Royal Legion,9,13,3,7,6,6,"Breach,Cypher,Sova,Omen,Neon","Raze,Cypher,Omen,Yoru,Fade"
Haven,Linares eSports,MURCIA NO EXISTE,13,4,10,2,2,3,"Breach,Cypher,Sova,Omen,Jett","Breach,Cypher,Sova,Omen,Jett"
Haven,meowmeowmeow,KHORE GAMING,13,7,4,4,3,9,"Breach,Cypher,Sova,Jett,Clove","Breach,Cypher,Sova,Omen,Jett"
Haven,Universae,Locked Esports,13,5,4,2,3,9,"Breach,Sova,Killjoy,Omen,Jett","Cypher,Sova,Phoenix,Omen,Neon"
Icebox,UnderDogs Gaming,Man I Love Fermin Trujin,8,13,5,7,6,3,"Sova,Killjoy,Viper,Reyna,Jett","Sova,Killjoy,Viper,Sage,Jett"
Bind,Team B,VOID (EU),11,13,8,4,9,3,"Raze,Viper,Brimstone,Skye,Gekko","Raze,Viper,Brimstone,Fade,Gekko"
Abyss,AMBYS Team,kosomaks,3,13,2,2,11,1,"Sova,Viper,Jett,Yoru,Astra","Cypher,Sova,Omen,Jett,KAY/O"
Sunset,Linares eSports,Team Opio,13,1,2,0,1,11,"Breach,Cypher,Sova,Omen,Neon","Breach,Cypher,Sova,Omen,Neon"
Haven,Las Palmas Unity,Top G,8,13,4,8,5,4,"Breach,Cypher,Sova,Omen,Jett","Breach,Sova,Killjoy,Omen,Jett"
Sunset,Universae,napolitana,13,2,10,2,0,3,"Breach,Raze,Cypher,Omen,Gekko","Breach,Raze,Cypher,Sova,Omen"
Lotus,Monta Club Ace,KHORE GAMING,9,13,3,7,6,6,"Breach,Killjoy,Omen,Jett,Gekko","Breach,Raze,Killjoy,Omen,Gekko"
Ascent,Nexum EC,Divine eSports,13,2,3,0,2,10,"Breach,Omen,Neon,Fade,Deadlock","Sova,Killjoy,Omen,Jett,KAY/O"
Ascent,Sayonara eSports,Team B,2,13,2,10,3,0,"Sova,Killjoy,Omen,Jett,KAY/O","Cypher,Sova,Omen,Jett,KAY/O"
Ascent,SLEIK Esports,Man I Love Fermin Trujin,7,13,3,9,4,4,"Cypher,Sova,Omen,Jett,KAY/O","Sova,Killjoy,Omen,Jett,KAY/O"
Haven,Team GMask,meowmeowmeow,2,13,2,10,3,0,"Breach,Cypher,Sova,Jett,Astra","Breach,Cypher,Sova,Omen,Jett"
Sunset,Team Opio,GoodNights,13,4,8,4,0,5,"Breach,Cypher,Sova,Omen,Neon","Raze,Cypher,Sova,Omen,Gekko"
Icebox,Nyegit Aimers,Top G,6,13,2,5,8,4,"Sova,Killjoy,Viper,Reyna,Jett","Sova,Viper,Jett,Chamber,Iso"
Haven,VOID (EU),LyokFox,13,8,6,3,5,7,"Breach,Sova,Killjoy,Omen,Jett","Breach,Sova,Killjoy,Omen,Jett"
Haven,kosomaks,Team C,13,11,7,5,6,6,"Breach,Sova,Killjoy,Omen,Neon","Cypher,Sova,Omen,Jett,Yoru"
Lotus,Genesik Gaming,napolitana,8,13,2,7,6,6,"Breach,Raze,Killjoy,Omen,Fade","Breach,Raze,Killjoy,Omen,Fade"
Lotus,Cruasan,Man I Love Fermin Trujin,1,13,1,11,2,0,"Breach,Raze,Killjoy,Omen,Skye","Breach,Raze,Killjoy,Omen,Fade"
Haven,AUDIO PORFA,Team B,8,13,4,5,8,4,"Breach,Sova,Killjoy,Omen,Neon","Breach,Sova,Killjoy,Omen,Neon"
Bind,meowmeowmeow,Los Papus,13,1,2,0,1,11,"Reyna,Yoru,Chamber,Iso,Clove","Raze,Reyna,Omen,Skye,Deadlock"
Haven,M80,TSM,13,9,8,2,7,5,"Breach,Sova,Killjoy,Omen,Jett","Breach,Cypher,Sova,Omen,Neon"
Icebox,M80,TSM,13,6,5,2,4,8,"Killjoy,Viper,Omen,KAY/O,Gekko","Killjoy,Viper,Reyna,Omen,Gekko"
Sunset,M80,TSM,12,14,7,6,8,5,"Breach,Cypher,Omen,Yoru,Gekko","Breach,Cypher,Omen,Neon,Gekko"
Ascent,TBS GC,Fourth Wall,13,8,6,6,2,7,"Sova,Killjoy,Omen,Jett,KAY/O","Sova,Killjoy,Omen,Jett,KAY/O"
Haven,PS5Patas,TOTALE Talents,13,9,6,4,5,7,"Breach,Sova,Killjoy,Jett,Astra","Cypher,Sova,Omen,Yoru,Iso"
Bind,TBS GC,Fourth Wall,13,9,7,5,4,6,"Raze,Viper,Brimstone,Skye,Gekko","Raze,Cypher,Brimstone,Jett,Fade"
Icebox,2Game Esports,Galorys,4,13,4,8,5,0,"Sova,Killjoy,Viper,Jett,KAY/O","Sova,Killjoy,Viper,Sage,Jett"
Bind,Athena's e-Sports,RocketggGC,12,14,7,6,8,5,"Raze,Cypher,Brimstone,Skye,Gekko","Raze,Cypher,Brimstone,Skye,Gekko"
Abyss,PROCURADAS,Synergy BR,13,11,6,6,5,7,"Breach,Cypher,Omen,Jett,Gekko","Cypher,Sova,Omen,Jett,KAY/O"
Ascent,PS5Patas,TOTALE Talents,13,6,8,4,2,5,"Sova,Killjoy,Omen,Jett,KAY/O","Cypher,Sova,Omen,Jett,Deadlock"
Lotus,REVOADA,xurisco,13,3,3,1,2,10,"Raze,Killjoy,Viper,Omen,Fade","Raze,Killjoy,Omen,Chamber,Fade"
Sunset,Vila das Flores,indescritiveis,13,10,9,3,7,4,"Breach,Sova,Sage,Omen,Neon","Cypher,Omen,Neon,Gekko,Clove"
Icebox,TBS GC,Fourth Wall,9,13,5,7,6,4,"Sova,Killjoy,Viper,Jett,Gekko","Sova,Killjoy,Viper,Jett,Gekko"
Abyss,2Game Esports,Galorys,11,13,4,8,5,7,"Cypher,Sova,Omen,Jett,KAY/O","Cypher,Sova,Omen,Jett,Gekko"
Ascent,REVOADA,xurisco,13,3,3,1,2,10,"Sova,Killjoy,Omen,Jett,KAY/O","Sova,Killjoy,Omen,Jett,Chamber"
Icebox,PROCURADAS,Synergy BR,13,7,7,5,2,6,"Sova,Killjoy,Viper,Jett,Gekko","Sova,Killjoy,Viper,Jett,KAY/O"
Ascent,Vila das Flores,indescritiveis,13,0,1,0,0,12,"Cypher,Sova,Phoenix,Omen,Jett","Sova,Killjoy,Omen,Jett,KAY/O"
Sunset,Athena's e-Sports,RocketggGC,8,13,3,6,7,5,"Breach,Cypher,Omen,Neon,Gekko","Breach,Raze,Cypher,Omen,Gekko"
Icebox,PS5Patas,TOTALE Talents,10,13,2,9,4,8,"Killjoy,Viper,Jett,Gekko,Iso","Sova,Killjoy,Viper,Jett,Gekko"
Ascent,All Knights,RETA Esports,6,13,1,6,7,5,"Sova,Killjoy,Omen,Jett,KAY/O","Sova,Killjoy,Omen,Jett,KAY/O"
Sunset,Str1ve eSports,Cuban Raft Raiders,13,6,10,2,4,3,"Breach,Cypher,Sova,Omen,Neon","Breach,Cypher,Sova,Omen,Neon"
Sunset,AMBYS Team,The giornalisti,4,13,2,3,10,2,"Cypher,Sova,Omen,KAY/O,Neon","Raze,Cypher,Omen,Gekko,Iso"
Sunset,Poverineeh,Team Focus,9,13,4,8,5,5,"Breach,Cypher,Sova,Omen,Neon","Breach,Cypher,Sova,Omen,Jett"
Sunset,bazinga esports,KHORE GAMING,13,10,8,3,7,5,"Breach,Cypher,Sova,Omen","Cypher,Omen,Yoru,KAY/O,Neon"
Sunset,Team Galaga,Team GMask,13,2,3,0,2,10,"Raze,Cypher,Omen,KAY/O,Gekko","Breach,Raze,Cypher,Omen,Gekko"
Sunset,SLTitans Esports,EX0TIK GAMING,13,6,8,4,2,5,"Cypher,Omen,KAY/O,Neon,Iso","Breach,Raze,Cypher,Sova,Omen"
Sunset,1000rr club,InTenZive,6,13,1,6,7,5,"Breach,Raze,Cypher,Sova,Omen","Cypher,Sova,Omen,KAY/O,Neon"
Sunset,CryZen,Capacitanes,13,5,5,1,4,8,"Phoenix,KAY/O,Chamber,Harbor,Deadlock","Breach,Raze,Cypher,Omen,Gekko"
Sunset,DSYRE Academy,Dimonis,3,13,3,9,4,0,"Breach,Cypher,Sova,Omen,Neon","Cypher,Omen,KAY/O,Chamber,Gekko"
Sunset,Melilla Titans Academy,IAPEsports,1,13,1,11,2,0,"Breach,Cypher,Sova,Omen,Neon","Breach,Raze,Cypher,Omen,Yoru"
Sunset,Team Falcons Vega,BBL Queens,13,11,8,4,7,5,"Breach,Raze,Cypher,Omen,Gekko","Breach,Cypher,Sova,Omen,Neon"
Haven,Blindspot Academy,Blue Moon eSports,2,13,0,3,10,2,"Sova,Killjoy,Omen,Jett,KAY/O","Breach,Cypher,Sova,Jett,Astra"
Haven,All Knights,RETA Esports,9,13,1,9,4,8,"Breach,Cypher,Sova,Omen,Neon","Killjoy,Viper,Omen,Jett,Skye"
Abyss,Str1ve eSports,Cuban Raft Raiders,13,5,8,4,1,5,"Breach,Cypher,Sova,Jett,Astra","Cypher,Sova,Omen,Jett,KAY/O"
Bind,CGN Esports,PCIFIC Espor,8,13,7,5,8,1,"Raze,Sova,Viper,Brimstone,Sage","Raze,Viper,Brimstone,Fade,Gekko"
Lotus,Blindspot Academy,Blue Moon eSports,7,13,4,8,5,3,"Breach,Raze,Cypher,Omen,Gekko","Breach,Raze,Viper,Astra,Fade"
Icebox,Team Falcons Vega,BBL Queens,14,12,8,5,7,6,"Sova,Killjoy,Viper,Jett,Gekko","Sova,Killjoy,Viper,Jett,Iso"
Ascent,New Origins Esports,2strong,5,13,2,4,9,3,"Cypher,Sova,Omen,Jett,KAY/O","Sova,Killjoy,Phoenix,Omen,Jett"
Sunset,InTenZive,SLTitans Esports,5,13,0,6,7,5,"Raze,Cypher,Sova,Omen,Gekko","Cypher,Sova,Omen,KAY/O,Neon"
Sunset,Team GMask,CryZen,13,11,6,6,5,7,"Breach,Raze,Cypher,Omen,Gekko","Phoenix,KAY/O,Chamber,Harbor,Deadlock"
Sunset,EX0TIK GAMING,Team Galaga,13,11,7,5,6,6,"Breach,Raze,Cypher,Sova,Omen","Raze,Cypher,Omen,KAY/O,Gekko"
Sunset,RevenantVAL,1000rr club,8,13,5,7,6,3,"Breach,Cypher,Omen,Neon,Gekko","Breach,Raze,Cypher,Omen,Gekko"
Sunset,Dimonis,Capacitanes,13,9,6,6,3,7,"Raze,Cypher,Omen,KAY/O,Gekko","Raze,Cypher,Sova,Omen,Gekko"
Sunset,The Avengers,bazinga esports,9,13,6,6,7,3,"Breach,Cypher,Sova,Omen,Neon","Breach,Cypher,Sova,Omen,Neon"
Sunset,IAPEsports,DSYRE Academy,9,13,3,7,6,6,"Breach,Raze,Cypher,Omen,Yoru","Breach,Cypher,Sova,Omen,Neon"
Sunset,Melilla Titans Academy,The giornalisti,13,5,10,2,3,3,"Breach,Cypher,Sova,Omen,Neon","Breach,Cypher,Sova,Omen,Neon"
Sunset,AMBYS Team,Poverineeh,13,11,5,7,4,8,"Cypher,Sova,Omen,KAY/O,Neon","Breach,Cypher,Omen,Neon,Gekko"
Sunset,Velocity Gaming (EU),Lost Dynasty,13,3,10,2,1,3,"Breach,Cypher,Sova,Omen,Neon","Breach,Cypher,Sova,Omen,Neon"
Abyss,CGN Esports,PCIFIC Espor,9,13,5,7,6,4,"Cypher,Sova,Phoenix,Omen,Jett","Cypher,Sova,Omen,Jett,KAY/O"
Sunset,New Origins Esports,2strong,12,14,6,7,7,6,"Breach,Cypher,Sova,Omen,Neon","Breach,Cypher,Sova,Omen,Neon"
Bind,Team Falcons Vega,BBL Queens,13,15,9,5,10,4,"Raze,Viper,Brimstone,Skye,Gekko","Breach,Raze,Cypher,Omen,Skye"
Haven,Velocity Gaming (EU),Lost Dynasty,13,9,6,6,3,7,"Cypher,Sova,Omen,Yoru,Iso","Breach,Sova,Killjoy,Omen,Jett"
Lotus,CGN Esports,PCIFIC Espor,9,13,6,4,9,3,"Raze,Sova,Killjoy,Omen,Gekko","Breach,Cypher,Sova,Omen,Neon"
Haven,ALTERNATE aTTaX Ruby,Karmine Corp GC,2,13,0,3,10,2,"Breach,Cypher,Sova,Omen,Jett","Breach,Sova,Killjoy,Omen,Neon"
Sunset,ALTERNATE aTTaX Ruby,Karmine Corp GC,0,13,0,12,1,0,"Breach,Raze,Cypher,Sova,Omen","Breach,Cypher,Sova,Omen,Neon"
Haven,Pegasus Esports,Fruit Bowl,13,5,8,4,1,5,"Breach,Sova,Killjoy,Omen,Jett","Breach,Cypher,Sova,Omen,Neon"
Bind,Team Ruthless,Perfectionists,10,13,6,5,8,4,"Raze,Brimstone,Chamber,Fade,Gekko","Raze,Viper,Brimstone,Fade,Gekko"
Sunset,Pegasus Esports,Fruit Bowl,1,13,0,2,11,1,"Breach,Raze,Cypher,Sova,Omen","Raze,Cypher,Omen,KAY/O,Gekko"
Haven,Team Accelerate,Team Serenity,10,13,3,9,4,7,"Breach,Cypher,Sova,Omen,Jett","Sova,Killjoy,Omen,Jett,Iso"
Haven,Team Ruthless,Perfectionists,13,11,6,6,5,7,"Sova,Killjoy,Reyna,Omen,Jett","Breach,Cypher,Sova,Omen,Jett"
Bind,NewD,Dark Horse Knights,13,6,6,1,5,7,"Breach,Cypher,Viper,Brimstone,Yoru","Raze,Viper,Brimstone,Skye,Gekko"
Ascent,Team Ruthless,Perfectionists,9,13,6,6,7,3,"Sova,Killjoy,Omen,Jett,KAY/O","Sova,Killjoy,Omen,Jett,KAY/O"
Abyss,Team Accelerate,Team Serenity,10,13,6,6,7,4,"Breach,Cypher,Omen,Jett,Harbor","Sova,Viper,Jett,Yoru,Astra"
Haven,NewD,Dark Horse Knights,13,6,6,1,5,7,"Breach,Cypher,Omen,Jett,Deadlock","Breach,Sova,Killjoy,Omen,Jett"
Haven,Galorys,M80,12,14,7,6,8,5,"Breach,Sova,Killjoy,Omen,Jett","Breach,Sova,Killjoy,Omen,Jett"
Sunset,Galorys,M80,13,11,8,4,7,5,"Breach,Cypher,Sova,Omen,Neon","Breach,Cypher,Omen,Yoru,Gekko"
Icebox,Galorys,M80,11,13,6,6,7,5,"Sova,Killjoy,Viper,Sage,Jett","Killjoy,Viper,Omen,KAY/O,Gekko"
Bind,All Knights,2Game Esports,13,10,10,1,9,3,"Raze,Cypher,Brimstone,Skye,Deadlock","Raze,Viper,Brimstone,Skye,Gekko"
Abyss,All Knights,2Game Esports,13,7,6,6,1,7,"Cypher,Sova,Omen,Jett,KAY/O","Cypher,Sova,Omen,Jett,KAY/O"
Sunset,All Knights,2Game Esports,10,13,6,5,8,4,"Breach,Cypher,Sova,Omen,Neon","Breach,Cypher,Sova,Omen,Neon"
Haven,Odd 1 OUT,ALTERNATE aTTaX Ruby,13,11,4,8,3,9,"Breach,Sova,Killjoy,Omen,Jett","Breach,Cypher,Sova,Omen,Jett"
Sunset,Odd 1 OUT,ALTERNATE aTTaX Ruby,13,10,7,5,5,6,"Breach,Cypher,Sova,Omen,Neon","Breach,Raze,Cypher,Sova,Omen"
Haven,Team Falcons Vega,HEROIC Valkyries,7,13,3,5,8,4,"Breach,Cypher,Sova,Omen,Jett","Cypher,Sova,Omen,Yoru,Iso"
Abyss,Team Falcons Vega,HEROIC Valkyries,2,13,2,10,3,0,"Cypher,Sova,Omen,Jett,KAY/O","Breach,Cypher,Sova,Jett,Astra"
Icebox,RETA Esports,M80,9,13,3,7,6,6,"Sova,Killjoy,Viper,Jett,Harbor","Killjoy,Viper,Omen,KAY/O,Gekko"
Lotus,RETA Esports,M80,13,10,5,6,4,8,"Raze,Killjoy,Viper,Omen,Fade","Breach,Cypher,Omen,Yoru,Fade"
Haven,RETA Esports,M80,4,13,4,8,5,0,"Killjoy,Viper,Omen,Jett,Skye","Breach,Sova,Killjoy,Omen,Jett"
Abyss,TSM,2Game Esports,9,13,5,7,6,4,"Sova,Viper,Jett,Yoru,Astra","Cypher,Sova,Omen,Jett,KAY/O"
Bind,Permitta Unicorns GC,FOKUS Sakura,5,13,3,9,4,2,"Raze,Viper,Brimstone,Skye,Gekko","Raze,Viper,Brimstone,Yoru,Gekko"
Icebox,TSM,2Game Esports,11,13,6,6,7,5,"Killjoy,Viper,Reyna,Omen,Gekko","Sova,Killjoy,Viper,Jett,KAY/O"
Sunset,Veni eSports Venom,NEON BLADE,6,13,4,3,10,2,"Breach,Cypher,Sova,Omen,Neon","Breach,Raze,Cypher,Omen,Gekko"
Sunset,Permitta Unicorns GC,FOKUS Sakura,8,13,2,7,6,6,"Breach,Raze,Cypher,Sova,Omen","Breach,Cypher,Omen,Neon,Fade"
Sunset,TSM,2Game Esports,13,11,6,6,5,7,"Breach,Cypher,Omen,Neon,Gekko","Breach,Cypher,Sova,Omen,Neon"
Haven,Scald eSport GC,SSP Numina,5,13,4,8,5,1,"Breach,Killjoy,Omen,Jett,Fade","Breach,Sova,Killjoy,Omen,Jett"
Haven,Veni eSports Venom,NEON BLADE,8,13,4,5,8,4,"Breach,Sova,Killjoy,Omen,Neon","Breach,Sova,Killjoy,Omen,Jett"
Bind,Silly Seals,Dortmund eSports Dynasty,13,9,7,5,4,6,"Raze,Viper,Astra,Fade,Gekko","Breach,Raze,Cypher,Brimstone,Fade"
Abyss,teamhoppers,Blindspot Kunai,13,5,6,0,5,7,"Sova,Sage,Jett,Astra,KAY/O","Breach,Cypher,Omen,Neon,Gekko"
Haven,Entropy Azúcar,LVENGERS,12,14,4,9,5,8,"Breach,Sova,Killjoy,Omen,Jett","Breach,Sova,Killjoy,Omen,Jett"
Sunset,RIZON Sugar,ALTERNATE aTTaX Ruby,6,13,4,8,5,2,"Breach,Raze,Cypher,Omen,Fade","Breach,Raze,Cypher,Sova,Omen"
Bind,Scald eSport GC,SSP Numina,8,13,7,5,8,1,"Breach,Raze,Cypher,Brimstone,Deadlock","Raze,Cypher,Skye,Astra,Deadlock"
Bind,Entropy Azúcar,LVENGERS,8,13,6,6,7,2,"Raze,Viper,Brimstone,Skye,Fade","Breach,Raze,Brimstone,Yoru,Harbor"
Lotus,RIZON Sugar,ALTERNATE aTTaX Ruby,2,13,0,3,10,2,"Breach,Raze,Cypher,Omen,Fade","Breach,Raze,Cypher,Omen,Fade"
Haven,Silly Seals,Dortmund eSports Dynasty,13,11,7,5,6,6,"Breach,Cypher,Sova,Omen,Neon","Breach,Sova,Killjoy,Omen,Jett"
Lotus,Veni eSports Venom,NEON BLADE,14,12,9,4,8,5,"Breach,Omen,Chamber,Neon,Gekko","Raze,Killjoy,Astra,Chamber,Fade"
Haven,teamhoppers,Blindspot Kunai,13,7,6,2,5,7,"Raze,Killjoy,Viper,Skye,Astra","Breach,Sova,Killjoy,Omen,Jett"
Haven,Galorys,All Knights,7,13,5,3,10,2,"Breach,Sova,Killjoy,Omen,Jett","Breach,Cypher,Sova,Omen,Neon"
Sunset,Galorys,All Knights,13,15,8,6,9,5,"Breach,Cypher,Sova,Omen,Neon","Breach,Cypher,Sova,Omen,Neon"
Haven,TSM,RETA Esports,5,13,2,4,9,3,"Breach,Cypher,Sova,Omen,Neon","Killjoy,Viper,Omen,Jett,Skye"
Bind,TSM,RETA Esports,13,6,4,3,3,9,"Raze,Brimstone,Skye,Gekko,Deadlock","Raze,Viper,Brimstone,Skye,Gekko"
Icebox,TSM,RETA Esports,6,13,5,7,6,1,"Killjoy,Viper,Reyna,Omen,Gekko","Sova,Killjoy,Viper,Jett,Harbor"
Ascent,ROA SYNC,Reveal Multigaming Jushimori,5,13,3,9,4,2,"Cypher,Sova,Omen,Jett,KAY/O","Sova,Killjoy,Phoenix,Omen,Jett"
Bind,ROA SYNC,Reveal Multigaming Jushimori,6,13,1,6,7,5,"Breach,Raze,Cypher,Brimstone,Skye","Breach,Raze,Cypher,Brimstone,Fade"
Haven,Team Falcons Vega,GIANTX GC,13,7,4,4,3,9,"Breach,Cypher,Sova,Omen,Jett","Killjoy,Viper,Omen,Yoru,Gekko"
Sunset,Team Falcons Vega,GIANTX GC,3,13,0,4,9,3,"Breach,Raze,Cypher,Omen,Gekko","Breach,Cypher,Sova,Omen,Neon"
Abyss,Team Falcons Vega,GIANTX GC,13,8,9,3,5,4,"Cypher,Sova,Omen,Jett,KAY/O","Breach,Cypher,Jett,Astra,Gekko"
Icebox,M80,All Knights,15,13,6,8,5,9,"Killjoy,Viper,Omen,KAY/O,Gekko","Sova,Killjoy,Viper,Gekko,Iso"
Sunset,M80,All Knights,14,12,9,4,8,5,"Breach,Cypher,Omen,Yoru,Gekko","Breach,Cypher,Sova,Omen,Neon"
Abyss,Galorys,TSM,17,19,8,10,9,9,"Cypher,Sova,Omen,Jett,Gekko","Sova,Viper,Jett,Yoru,Astra"
Haven,Galorys,TSM,13,5,9,3,2,4,"Breach,Sova,Killjoy,Omen,Jett","Breach,Cypher,Sova,Omen,Jett"
Bind,Galorys,TSM,12,14,8,5,9,4,"Raze,Viper,Brimstone,Fade,Gekko","Raze,Brimstone,Skye,Gekko,Deadlock"
Sunset,RETA Esports,2Game Esports,7,13,3,5,8,4,"Breach,Cypher,Sova,Omen,Neon","Breach,Cypher,Sova,Omen,Neon"
Icebox,Scald eSport GC,TOG Kitsune,13,10,6,5,5,7,"Sova,Killjoy,Viper,Sage,Jett","Sova,Killjoy,Viper,Sage,Jett"
Ascent,SSP Numina,ALTERNATE aTTaX Ruby,8,13,4,8,5,4,"Sova,Killjoy,Omen,Jett,KAY/O","Sova,Killjoy,Omen,Jett,KAY/O"
Bind,RETA Esports,2Game Esports,2,13,0,3,10,2,"Raze,Viper,Brimstone,Skye,Gekko","Raze,Viper,Brimstone,Skye,Gekko"
Ascent,Entropy Azúcar,Blindspot Kunai,13,7,8,4,3,5,"Sova,Killjoy,Omen,Jett,KAY/O","Breach,Sova,Killjoy,Omen,Jett"
Ascent,LVENGERS,Dortmund eSports Dynasty,13,1,11,1,0,2,"Cypher,Sova,Omen,Yoru,Deadlock","Sova,Killjoy,Omen,Jett,KAY/O"
Bind,Scald eSport GC,TOG Kitsune,13,10,6,6,4,7,"Breach,Raze,Cypher,Brimstone,Deadlock","Raze,Cypher,Viper,Omen,Skye"
Sunset,SSP Numina,ALTERNATE aTTaX Ruby,1,13,0,2,11,1,"Breach,Raze,Cypher,Omen,Gekko","Breach,Raze,Cypher,Sova,Omen"
Lotus,Entropy Azúcar,Blindspot Kunai,13,9,8,4,5,5,"Breach,Raze,Killjoy,Omen,Fade","Breach,Raze,Killjoy,Omen,Gekko"
Lotus,LVENGERS,Dortmund eSports Dynasty,11,13,2,10,3,9,"Breach,Raze,Cypher,Omen,Fade","Breach,Raze,Killjoy,Omen,Fade"
Ascent,SK Nebula,Permitta Unicorns GC,13,7,6,6,1,7,"Sova,Killjoy,Omen,Jett,KAY/O","Sova,Killjoy,Omen,Jett,KAY/O"
Ascent,Veni eSports Venom,ROA SYNC,5,13,3,3,10,2,"Sova,Killjoy,Omen,Jett,KAY/O","Cypher,Sova,Omen,Jett,KAY/O"
Ascent,Silly Seals,NEON BLADE,4,13,0,12,1,4,"Sova,Killjoy,Omen,Jett,KAY/O","Sova,Killjoy,Omen,Jett,KAY/O"
Abyss,teamhoppers,Reveal Multigaming Jushimori,13,3,9,3,0,4,"Sova,Sage,Jett,Astra,KAY/O","Breach,Cypher,Jett,Astra"
Haven,RIZON Sugar,FOKUS Sakura,9,13,3,9,4,6,"Breach,Cypher,Omen,Yoru,Iso","Sova,Killjoy,Omen,Jett,Iso"
Haven,Silly Seals,NEON BLADE,2,13,0,3,10,2,"Breach,Sova,Killjoy,Omen,Neon","Breach,Sova,Killjoy,Omen,Jett"
Haven,SK Nebula,Permitta Unicorns GC,13,6,5,2,4,8,"Breach,Cypher,Sova,Omen,Jett","Breach,Cypher,Sova,Omen,Jett"
Haven,teamhoppers,Reveal Multigaming Jushimori,13,2,3,0,2,10,"Raze,Killjoy,Viper,Skye,Astra","Breach,Sova,Killjoy,Omen,Jett"
Haven,LVENGERS,Dortmund eSports Dynasty,13,11,8,4,7,5,"Breach,Sova,Killjoy,Omen,Jett","Breach,Sova,Killjoy,Omen,Jett"
Bind,Veni eSports Venom,ROA SYNC,6,13,4,8,5,2,"Breach,Raze,Viper,Brimstone,Gekko","Breach,Raze,Cypher,Brimstone,Skye"
Haven,Entropy Azúcar,Blindspot Kunai,14,16,8,7,9,6,"Breach,Sova,Killjoy,Omen,Jett","Breach,Sova,Killjoy,Omen,Jett"
Abyss,RIZON Sugar,FOKUS Sakura,0,13,0,12,1,0,"Cypher,Sova,Omen,Yoru,Astra","Breach,Cypher,Omen,Jett,Neon"
Sunset,Odd 1 OUT,NASR Ignite,10,13,6,6,7,4,"Breach,Cypher,Sova,Omen,Neon","Cypher,Sova,Omen,KAY/O,Neon"
Ascent,Odd 1 OUT,NASR Ignite,5,13,0,6,7,5,"Sova,Killjoy,Omen,Jett,KAY/O","Cypher,Sova,Omen,Jett,Deadlock"
Haven,Odd 1 OUT,NASR Ignite,13,9,5,5,4,8,"Breach,Sova,Killjoy,Omen,Jett","Breach,Cypher,Sova,Omen,Neon"
Haven,ZINGERS,KineTiX eSports X1,13,9,5,7,2,8,"Breach,Killjoy,Omen,Jett,Iso","Breach,Cypher,Sova,Jett,Astra"
Sunset,NASR Ignite,ALTERNATE aTTaX Ruby,5,13,1,5,8,4,"Cypher,Sova,Omen,KAY/O,Neon","Breach,Raze,Cypher,Sova,Omen"
Lotus,The Cult,Defient Esports,11,13,6,6,7,5,"Raze,Killjoy,Omen,Skye,Fade","Breach,Raze,Killjoy,Omen,Fade"
Abyss,NASR Ignite,ALTERNATE aTTaX Ruby,15,17,6,10,7,9,"Cypher,Sova,Omen,Jett,KAY/O","Sova,Sage,Jett,Astra,KAY/O"
Haven,The Cult,Defient Esports,9,13,6,6,7,3,"Breach,Raze,Cypher,Omen,Skye","Breach,Sova,Killjoy,Omen,Neon"
Sunset,Team Falcons Vega,Valiant GC,14,12,10,3,9,4,"Breach,Raze,Cypher,Omen,Gekko","Breach,Cypher,Sova,Omen,Neon"
Haven,Team Falcons Vega,Valiant GC,14,12,9,4,8,5,"Breach,Cypher,Sova,Omen,Jett","Breach,Sova,Killjoy,Omen,Jett"
Sunset,K7 Esports GC,New Combat Line GC,13,9,7,3,6,6,"Cypher,Omen,Jett,Gekko,Iso","Raze,Cypher,Sova,Omen,Iso"
Lotus,K7 Esports GC,New Combat Line GC,7,13,4,4,9,3,"Cypher,Omen,Jett,Gekko,Iso","Raze,Killjoy,Viper,Omen,Fade"
Haven,K7 Esports GC,New Combat Line GC,13,6,11,1,5,2,"Breach,Cypher,Sova,Omen,Jett","Breach,Sova,Killjoy,Phoenix,Omen"
Abyss,K7 Esports GC,New Combat Line GC,7,13,3,5,8,4,"Breach,Cypher,Sova,Omen,Jett","Breach,Cypher,Sova,Omen,Neon"
Ascent,K7 Esports GC,New Combat Line GC,13,9,6,6,3,7,"Sova,Killjoy,Omen,Jett,KAY/O","Sova,Killjoy,Omen,Jett,KAY/O"
Abyss,The Ultimates,PCIFIC Espor,7,13,4,8,5,3,"Cypher,Sova,Omen,Jett,KAY/O","Cypher,Sova,Omen,Jett,KAY/O"
Bind,Blue Moon eSports,Tap Tap Boom eSports,13,5,2,4,1,11,"Breach,Raze,Cypher,Brimstone,Fade","Raze,Viper,Brimstone,Fade,Gekko"
Ascent,GIANTX GC,BBL Queens,13,6,4,3,3,9,"Sova,Killjoy,Omen,Jett,KAY/O","Sova,Killjoy,Omen,Jett,KAY/O"
Bind,Team Liquid Brazil,TBS GC,13,4,3,2,2,10,"Raze,Cypher,Viper,Brimstone,Skye","Raze,Viper,Brimstone,Skye,Gekko"
Haven,Blue Moon eSports,Tap Tap Boom eSports,13,6,6,1,5,7,"Breach,Cypher,Sova,Jett,Astra","Breach,Cypher,Sova,Omen,Jett"
Haven,The Ultimates,PCIFIC Espor,11,13,8,4,9,3,"Cypher,Sova,Omen,Neon,Iso","Breach,Sova,Killjoy,Omen,Jett"
Sunset,GIANTX GC,BBL Queens,13,8,6,6,2,7,"Breach,Cypher,Sova,Omen,Neon","Cypher,Sova,Neon,Iso,Clove"
Sunset,Team Liquid Brazil,TBS GC,13,9,6,6,3,7,"Raze,Cypher,Omen,KAY/O,Gekko","Cypher,Sova,Omen,KAY/O,Neon"
Lotus,Moon,The Easy Crew,6,13,2,5,8,4,"Raze,Killjoy,Omen,Skye,Neon","Raze,Killjoy,Viper,Omen,Fade"
Sunset,Apeks,CGN Esports,13,9,8,2,7,5,"Cypher,Sova,Omen,KAY/O,Neon","Raze,Cypher,Sova,Phoenix,Omen"
Abyss,G2 Gozen,Karmine Corp GC,13,10,8,3,7,5,"Sova,Killjoy,Yoru,Astra,Harbor","Cypher,Sova,Omen,Jett,KAY/O"
Haven,Moon,The Easy Crew,8,13,3,6,7,5,"Breach,Sova,Killjoy,Omen,Jett","Killjoy,Viper,Omen,Jett,Skye"
Ascent,Team Liquid Brazil,TBS GC,14,12,6,7,5,8,"Sova,Killjoy,Omen,Jett,KAY/O","Sova,Killjoy,Omen,Jett,KAY/O"
Ascent,Apeks,CGN Esports,13,5,5,1,4,8,"Cypher,Sova,Omen,Yoru,Deadlock","Sova,Killjoy,Phoenix,Jett,Astra"
Bind,G2 Gozen,Karmine Corp GC,13,4,3,2,2,10,"Raze,Brimstone,Omen,Skye,Gekko","Raze,Viper,Astra,Fade,Gekko"
Ascent,Union Atta I,Blindspot Academy,13,6,5,2,4,8,"Killjoy,Omen,Jett,KAY/O","Sova,Killjoy,Omen,Jett,KAY/O"
Abyss,Union Atta I,Blindspot Academy,13,9,5,7,2,8,"Sova,Omen,Yoru,Gekko","Cypher,Sova,Omen,Jett,KAY/O"
Bind,ASNA,SCARZ Youth,12,14,4,9,5,8,"Raze,Viper,Brimstone,Fade,Gekko","Raze,Viper,Brimstone,Reyna,Fade"
Haven,ASNA,SCARZ Youth,7,13,3,9,4,4,"Breach,Sova,Killjoy,Omen,Jett","Sova,Killjoy,Reyna,Omen,Jett"
Ascent,ASNA,SCARZ Youth,13,8,5,7,1,8,"Sova,Killjoy,Omen,Jett,KAY/O","Sova,Killjoy,Omen,Jett,KAY/O"
Icebox,SCARZ Youth,Haven Liberty,13,7,8,4,3,5,"Sova,Killjoy,Viper,Reyna,Jett","Sova,Killjoy,Reyna,Jett,Clove"
Ascent,SCARZ Youth,Haven Liberty,13,6,8,4,2,5,"Sova,Killjoy,Reyna,Omen,Jett","Sova,Killjoy,Omen,Jett,KAY/O"
Lotus,SCARZ Youth,Haven Liberty,4,13,0,5,8,4,"Raze,Killjoy,Omen,Fade,Clove","Raze,Omen,Chamber,Fade,Clove"
Ascent,ASNA,RE ENDLESS,13,3,10,2,1,3,"Sova,Killjoy,Omen,Jett,KAY/O","Sova,Killjoy,Jett,Astra,KAY/O"
Haven,ASNA,RE ENDLESS,13,7,7,1,6,6,"Breach,Sova,Killjoy,Omen,Jett","Breach,Cypher,Sova,Jett,Astra"
Haven,Shopify Rebellion,YFP X,10,13,5,7,6,5,"Breach,Cypher,Sova,Omen,Jett","Breach,Cypher,Sova,Omen,Jett"
Ascent,Shopify Rebellion,YFP X,13,9,7,5,4,6,"Cypher,Sova,Omen,Jett,Deadlock","Cypher,Sova,Omen,Jett,Deadlock"
Sunset,Berzerkers,washed,13,15,6,8,7,7,"Breach,Cypher,Sova,Omen,Neon","Breach,Cypher,Sova,Omen,Neon"
Haven,Northwood University,Maryville University,11,13,6,6,7,5,"Sova,Jett,Astra,Deadlock,Iso","Breach,Sova,Killjoy,Omen,Neon"
Abyss,Shopify Rebellion,YFP X,9,13,6,6,7,3,"Cypher,Sova,Omen,Jett,KAY/O","Cypher,Sova,Omen,Jett,Harbor"
Haven,Zen eSports GC,Deagle Ravagers,13,8,6,3,5,7,"Breach,Sova,Killjoy,Omen,Jett","Breach,Sova,Killjoy,Omen,Jett"
Icebox,Berzerkers,Special Grade,13,9,9,3,6,4,"Sova,Killjoy,Viper,Reyna,Jett","Sova,Killjoy,Viper,Jett,Clove"
Sunset,Prime (NA),Northwood University,8,13,5,4,9,3,"Breach,Cypher,Sova,Neon,Clove","Breach,Raze,Cypher,Sova,Omen"
Sunset,Bolivian Brawlers,Maryville University,2,13,2,10,3,0,"Breach,Cypher,Sova,Omen,Neon","Breach,Raze,Cypher,Sova,Omen"
Sunset,Blinn Esports,washed,8,13,4,5,8,4,"Breach,Cypher,Omen,Neon,Gekko","Breach,Cypher,Sova,Omen,Neon"
Haven,YFP X,oomfies,13,8,5,7,1,8,"Breach,Cypher,Sova,Omen,Jett","Breach,Cypher,Sova,Omen,Neon"
Haven,Hebron High School,Special Grade,4,13,1,11,2,3,"Breach,Killjoy,Reyna,Omen,Yoru","Breach,Cypher,Sova,Omen,Jett"
Haven,Koala Pound,Maryville University,3,13,0,4,9,3,"Breach,Cypher,Sova,Omen,Neon","Breach,Sova,Killjoy,Omen,Neon"
Sunset,Northwood University,Boise State University,13,5,8,4,1,5,"Breach,Raze,Cypher,Sova,Omen","Cypher,Sova,Omen,Yoru,Neon"
Lotus,Zen eSports GC,Deagle Ravagers,13,9,9,3,6,4,"Raze,Killjoy,Viper,Omen,Fade","Raze,Killjoy,Viper,Omen,Fade"
Lotus,Prime (NA),SeanGares' Kittens,13,6,6,1,5,7,"Raze,Sova,Killjoy,Omen,Clove","Breach,Killjoy,Omen,Neon,Gekko"
Haven,Blinn Esports,Columbia College,13,5,4,2,3,9,"Breach,Sova,Omen,Chamber,Neon","Breach,Sova,Killjoy,Omen,Yoru"
Haven,SaD Purple,Berzerkers,17,19,6,12,7,11,"Breach,Sova,Killjoy,Omen,Jett","Cypher,Sova,Omen,Yoru,Iso"
Ascent,Bolivian Brawlers,Non-Verbal,13,9,8,4,5,5,"Sova,Killjoy,Omen,Jett,KAY/O","Cypher,Sova,Omen,Yoru,Deadlock"
Sunset,washed,Painguins,13,5,9,3,2,4,"Breach,Cypher,Sova,Omen,Neon","Cypher,Sova,Omen,KAY/O,Neon"
Ascent,Shopify Rebellion,mesos millionaires,13,3,9,3,0,4,"Cypher,Sova,Omen,Jett,Deadlock","Sova,Killjoy,Jett,Astra,KAY/O"
Bind,ES Esports,Blinn Esports,6,13,2,10,3,4,"Raze,Cypher,Brimstone,Gekko,Deadlock","Raze,Viper,Brimstone,Skye"
Sunset,UCSD Gold,Koala Pound,9,13,4,8,5,5,"Cypher,Sova,Omen,KAY/O,Neon","Breach,Raze,Cypher,Omen,Gekko"
Sunset,Dexterity Gaming,Maryville University,3,13,1,11,2,2,"Breach,Raze,Cypher,Viper,Omen","Breach,Raze,Cypher,Sova,Omen"
Bind,Forsaken Shadows,Boise State University,9,13,4,6,7,5,"Raze,Cypher,Sova,Brimstone,Yoru","Raze,Brimstone,Skye,Gekko,Deadlock"
Lotus,YFP X,oomfies,20,18,10,9,9,10,"Raze,Killjoy,Viper,Omen,Fade","Raze,Cypher,Brimstone,Omen,Fade"
Ascent,YDZ Esports,Painguins,6,13,3,9,4,3,"Sova,Killjoy,Omen,Jett,KAY/O","Cypher,Sova,Omen,Yoru,Deadlock"
Haven,Prime (NA),Cumberland Rising,13,11,7,5,6,6,"Sova,Killjoy,Viper,Omen,Jett","Breach,Cypher,Sova,Omen,Neon"
Bind,Shopify Rebellion,mesos millionaires,13,4,5,0,4,8,"Raze,Cypher,Viper,Brimstone,Skye","Raze,Viper,Skye,Chamber,Clove"
Haven,Hebron High School,Christians Rottweilers,13,6,7,5,1,6,"Breach,Killjoy,Omen,Yoru,Neon","Breach,Cypher,Sova,Omen,Jett"
Haven,washed,MYVRA GC,13,0,1,0,0,12,"Breach,Cypher,Sova,Omen,Neon","Breach,Raze,Killjoy,Astra,Fade"
Lotus,Bolivian Brawlers,West Virginia University,13,10,5,7,3,8,"Breach,Killjoy,Omen,Neon,Fade","Breach,Cypher,Sova,Astra,Neon"
Sunset,Lemonade Stand,Non-Verbal,10,13,8,4,9,2,"Cypher,Sova,Omen,KAY/O,Neon","Breach,Cypher,Sova,Omen,Neon"
Icebox,whats a pretzel,Berzerkers,2,13,2,10,3,0,"Sova,Killjoy,Viper,Reyna,Jett","Sova,Killjoy,Viper,Reyna,Jett"
Haven,SeanGares' Kittens,OC Eagles,13,7,5,3,4,8,"Breach,Cypher,Sova,Omen,Neon","Breach,Cypher,Sova,Omen,Neon"
Ascent,Northwood University,zZz,13,2,10,2,0,3,"Cypher,Sova,Omen,Jett,Deadlock","Sova,Killjoy,Omen,Jett"
Bind,CSP Val Blue,Columbia College,10,13,4,7,6,6,"Breach,Raze,Brimstone,Omen,Skye","Breach,Brimstone,Yoru,Fade,Deadlock"
Bind,kellogs cereal,ES Esports,9,13,7,3,10,2,"Raze,Cypher,Viper,Skye,Clove","Raze,Cypher,Brimstone,Gekko,Deadlock"
Ascent,Dexterity Gaming,Event Horizon,13,3,9,3,0,4,"Sova,Killjoy,Omen,Jett","Sova,Killjoy,Omen,Jett,KAY/O"
Sunset,Prime (NA),KU Esports,13,9,7,3,6,6,"Breach,Cypher,Sova,Neon,Clove","Breach,Cypher,Omen,KAY/O,Neon"
Sunset,Bolivian Brawlers,Prospects Hitmen,13,6,5,2,4,8,"Breach,Raze,Cypher,Omen,Gekko","Breach,Raze,Cypher,Sova,Omen"
Haven,Lemonade Stand,Atlas Esports,13,2,3,0,2,10,"Omen,Yoru,Fade,Deadlock,Clove","Breach,Cypher,Sova,Omen,Jett"
Haven,YDZ Esports,Moon (NA),13,9,5,5,4,8,"Breach,Cypher,Sova,Omen,Neon","Breach,Cypher,Sova,Omen,Neon"
Haven,Koala Pound,USeeEye,15,13,7,7,6,8,"Breach,Cypher,Sova,Omen,Neon","Breach,Cypher,Sova,Omen,Neon"
Lotus,Hebron Black,zZz,1,13,1,11,2,0,"Breach,Raze,Killjoy,Omen,Fade","Breach,Cypher,Sova,Omen,Neon"
Haven,SaD Purple,Mythos Wraiths,13,6,9,3,3,4,"Breach,Sova,Killjoy,Omen,Jett","Killjoy,Viper,Omen,Jett,Skye"
Lotus,Dropouts,Painguins,8,13,6,6,7,2,"Raze,Killjoy,Viper,Omen,Fade","Breach,Cypher,Omen,Neon,Gekko"
Lotus,Origin,Non-Verbal,2,13,2,10,3,0,"Raze,Cypher,Omen,Fade,Gekko","Raze,Cypher,Omen,Fade,Deadlock"
Icebox,Christians Rottweilers,sharkie,13,10,6,5,5,7,"Sova,Killjoy,Viper,Jett,KAY/O","Sova,Killjoy,Viper,Reyna,Jett"
Haven,Northwood University,Northeastern Gold,13,3,3,1,2,10,"Sova,Jett,Astra,Deadlock,Iso","Breach,Sova,Killjoy,Omen,Jett"
Sunset,Vila das Flores,TBS GC,4,13,1,4,9,3,"Breach,Sova,Sage,Omen,Neon","Cypher,Sova,Omen,KAY/O,Neon"
Sunset,Ibreon Esports Sapphire,West Virginia University,2,13,2,10,3,0,"Breach,Cypher,Sova,Omen,Neon","Breach,Cypher,Sova,Omen,Neon"
Sunset,TMU Blue,Boise State University,13,15,7,7,8,6,"Breach,Cypher,Sova,Omen,Neon","Cypher,Sova,Omen,Yoru,Neon"
Bind,OMNISCIENT,Hebron High School,9,13,5,5,8,4,"Raze,Cypher,Brimstone,Yoru,Fade","Raze,Cypher,Brimstone,Skye,Yoru"
Lotus,whats a pretzel,Utica Blue,13,6,8,4,2,5,"Raze,Viper,Fade,Deadlock,Clove","Breach,Raze,Cypher,Omen,Fade"
Haven,Berzerkers,Siena Heights University,13,8,6,3,5,7,"Cypher,Sova,Omen,Yoru,Iso","Breach,Skye,Astra,Neon,Clove"
Bind,SeanGares' Kittens,Penguin Platoon,13,3,4,0,3,9,"Raze,Cypher,Viper,Brimstone,Skye","Raze,Viper,Fade,Gekko,Clove"
Bind,Harrisburg University,MYVRA GC,12,14,7,6,8,5,"Raze,Cypher,Viper,Brimstone,Gekko","Raze,Cypher,Brimstone,Skye,Fade"
Haven,A Good Team,UCSD Gold,4,13,2,10,3,2,"Breach,Cypher,Sova,Omen,Jett","Cypher,Sova,Omen,Neon,Iso"
Sunset,Aspyre x Swarm,OC Eagles,8,13,3,6,7,5,"Breach,Cypher,Sova,Omen,Neon","Breach,Raze,Cypher,Omen,Gekko"
Ascent,Cumberland Rising,Goth Girl Sanctuary,13,4,9,3,1,4,"Sova,Killjoy,Omen,Jett,KAY/O","Sova,Killjoy,Omen,Jett,KAY/O"
Ascent,5NC,Blinn Esports,9,13,3,9,4,6,"Breach,Sova,Killjoy,Omen,Jett","Cypher,Sova,Omen,Yoru,Deadlock"
Ascent,Columbia College,Shifty505,13,3,11,1,2,2,"Cypher,Sova,Omen,Yoru","Sova,Killjoy,Omen,Jett,KAY/O"
Sunset,PCIFIC Espor,CGN Esports,5,13,3,9,4,2,"Breach,Raze,Cypher,Omen,Gekko","Raze,Cypher,Sova,Phoenix,Omen"
Haven,CSP Val Blue,Omnipotence,13,0,12,0,0,1,"Breach,Cypher,Sova,Omen,Neon","Breach,Sova,Killjoy,Omen,Neon"
Haven,Team Galaga,RevenantVAL,13,9,5,5,4,8,"Breach,Sova,Killjoy,Omen,Jett","Breach,Cypher,Sova,Omen,Jett"
Haven,CryZen,Odyssey Gaming,13,2,3,0,2,10,"Breach,Viper,Omen,Neon","Breach,Cypher,Sova,Omen,Jett"
Haven,EX0TIK GAMING,IAPEsports,13,8,4,5,3,9,"Breach,Cypher,Sova,Omen,Jett","Breach,Cypher,Sova,Omen,Jett"
Haven,The giornalisti,SLTitans Esports,7,13,6,2,11,1,"Cypher,Sova,Omen,Yoru,Iso","Breach,Sova,Killjoy,Omen,Jett"
Haven,DSYRE Academy,AMBYS Team,13,7,7,1,6,6,"Breach,Cypher,Sova,Omen,Jett","Cypher,Sova,Omen,Yoru,Iso"
Haven,Melilla Titans Academy,InTenZive,9,13,3,9,4,6,"Breach,Killjoy,Astra,Neon,Fade","Breach,Cypher,Sova,Omen,Neon"
Haven,1000rr club,Team GMask,13,6,7,5,1,6,"Breach,Sova,Killjoy,Omen,Jett","Breach,Cypher,Sova,Jett,Astra"
Haven,Poverineeh,Dimonis,4,13,2,3,10,2,"Breach,Cypher,Sova,Omen,Jett","Cypher,Sova,Jett,Iso,Clove"
Ascent,Vila das Flores,TBS GC,4,13,4,8,5,0,"Cypher,Sova,Phoenix,Omen,Jett","Sova,Killjoy,Omen,Jett,KAY/O"
Ascent,PCIFIC Espor,CGN Esports,8,13,4,5,8,4,"Cypher,Sova,Omen,Jett,KAY/O","Sova,Killjoy,Phoenix,Jett,Astra"
Lotus,G2 Gozen,ALTERNATE aTTaX Ruby,13,5,3,3,2,10,"Raze,Cypher,Omen,Fade,Deadlock","Breach,Raze,Cypher,Omen,Fade"
Bind,Team Liquid Brazil,REVOADA,13,6,5,2,4,8,"Raze,Cypher,Viper,Brimstone,Skye","Raze,Cypher,Viper,Brimstone,Skye"
Abyss,PCIFIC Espor,CGN Esports,13,11,5,7,4,8,"Cypher,Sova,Omen,Jett,KAY/O","Cypher,Sova,Phoenix,Omen,Jett"
Abyss,G2 Gozen,ALTERNATE aTTaX Ruby,13,4,3,2,2,10,"Sova,Killjoy,Yoru,Astra,Harbor","Sova,Sage,Jett,Astra,KAY/O"
Ascent,Team Liquid Brazil,REVOADA,13,2,11,1,1,2,"Sova,Killjoy,Omen,Jett,KAY/O","Sova,Killjoy,Omen,Jett,KAY/O"
Haven,Melilla Titans Academy,EX0TIK GAMING,9,13,6,6,7,3,"Breach,Killjoy,Astra,Neon,Fade","Breach,Sova,Killjoy,Omen,Jett"
Haven,Dimonis,Team Galaga,11,13,5,7,6,6,"Breach,Cypher,Sova,Omen,Jett","Breach,Sova,Killjoy,Omen,Jett"
Haven,RevenantVAL,DSYRE Academy,13,6,5,2,4,8,"Breach,Cypher,Sova,Omen,Jett","Breach,Cypher,Sova,Omen,Jett"
Haven,The giornalisti,Poverineeh,13,4,3,2,2,10,"Cypher,Sova,Omen,Yoru,Iso","Breach,Cypher,Sova,Omen,Yoru"
Haven,Odyssey Gaming,SLTitans Esports,2,13,2,1,12,0,"Cypher,Sova,Killjoy,Omen,Jett","Breach,Sova,Killjoy,Omen,Jett"
Haven,bazinga esports,Team GMask,7,13,3,5,8,4,"Breach,Cypher,Sova,Omen,Jett","Breach,Cypher,Sova,Jett,Astra"
Haven,InTenZive,Capacitanes,13,6,4,3,3,9,"Cypher,Sova,Omen,Chamber,Neon","Breach,Sova,Killjoy,Omen,Jett"
Haven,1000rr club,AMBYS Team,13,5,3,3,2,10,"Breach,Sova,Killjoy,Omen,Jett","Cypher,Sova,Omen,Yoru,Iso"
Haven,CryZen,IAPEsports,13,15,2,12,3,11,"Breach,Viper,Omen,Neon","Breach,Cypher,Sova,Omen,Jett"
Lotus,Apeks,The Ultimates,13,5,2,4,1,11,"Raze,Cypher,Omen,KAY/O,Deadlock","Raze,Killjoy,Viper,Omen,Fade"
Sunset,BBL Queens,HEROIC Valkyries,13,1,11,1,0,2,"Cypher,Sova,Neon,Iso,Clove","Breach,Raze,Cypher,Sova,Astra"
Haven,Team Liquid Brazil,REVOADA,8,13,5,7,6,3,"Killjoy,Viper,Omen,Jett,Skye","Breach,Sova,Killjoy,Omen,Jett"
Icebox,BBL Queens,HEROIC Valkyries,13,5,8,4,1,5,"Sova,Killjoy,Viper,Jett,Iso","Sova,Killjoy,Viper,Sage,Clove"
Sunset,Apeks,The Ultimates,13,9,6,4,5,7,"Cypher,Sova,Omen,KAY/O,Neon","Breach,Raze,Cypher,Omen,Gekko"
Lotus,BBL Queens,HEROIC Valkyries,9,13,3,7,6,6,"Breach,Raze,Killjoy,Omen,Fade","Raze,Viper,Omen,Chamber,Fade"
Bind,oomfies,Tenax GC,13,4,9,3,1,4,"Raze,Viper,Brimstone,Skye,Deadlock","Raze,Viper,Brimstone,Skye,Deadlock"
Haven,Shopify Rebellion,Everyone Really Misses,13,9,7,5,4,6,"Breach,Cypher,Sova,Omen,Jett","Breach,Cypher,Sova,Omen,Neon"
Sunset,oomfies,Tenax GC,13,11,8,4,7,5,"Cypher,Sova,Omen,KAY/O,Neon","Breach,Cypher,Omen,Neon,Fade"
Haven,Teddy Tactics,mesos millionaires,6,13,2,5,8,4,"Breach,Sova,Killjoy,Omen,Neon","Breach,Sova,Killjoy,Jett,Clove"
Abyss,Shopify Rebellion,Everyone Really Misses,13,2,10,2,0,3,"Cypher,Sova,Omen,Jett,KAY/O","Sova,Viper,Jett,Yoru,Astra"
Sunset,YFP X,SaD FROST,13,10,7,4,6,6,"Breach,Raze,Cypher,Sova,Omen","Breach,Cypher,Omen,Neon,Gekko"
Lotus,Give Wingman 2 Nuclear Devices,Tenax GC,8,13,6,6,7,2,"Breach,Raze,Cypher,Omen,Gekko","Breach,Killjoy,Omen,Neon,Fade"
Ascent,Teddy Tactics,mesos millionaires,11,13,2,10,3,9,"Sova,Killjoy,Omen,Jett,KAY/O","Sova,Killjoy,Jett,Astra,KAY/O"
Abyss,YFP X,SaD FROST,13,3,4,0,3,9,"Cypher,Sova,Omen,Jett,Harbor","Cypher,Sova,Omen,Jett,Harbor"
Bind,Refrag,Everyone Really Misses,8,13,5,4,9,3,"Raze,Viper,Brimstone,Jett,Skye","Raze,Viper,Brimstone,Fade,Gekko"
Haven,Shopify Rebellion,Event Horizon GC,13,4,3,2,2,10,"Breach,Cypher,Sova,Omen,Jett","Breach,Sova,Killjoy,Omen,Jett"
Haven,Team Leveling,Vila das Flores,14,16,5,10,6,9,"Breach,Cypher,Sova,Omen,Neon","Breach,Cypher,Sova,Omen,Neon"
Haven,Refrag,Everyone Really Misses,13,8,7,2,6,6,"Cypher,Sova,Reyna,Omen,Jett","Breach,Cypher,Sova,Omen,Neon"
Ascent,Teddy Tactics,Bumble Bees,13,4,4,1,3,9,"Sova,Killjoy,Omen,Jett,KAY/O","Sova,Killjoy,Omen,Jett,KAY/O"
Bind,Give Wingman 2 Nuclear Devices,Tenax GC,16,14,7,8,6,9,"Raze,Viper,Brimstone,Skye,Gekko","Raze,Viper,Brimstone,Skye,Deadlock"
Lotus,oomfies,Catnappers,13,2,3,0,2,10,"Raze,Cypher,Brimstone,Omen,Fade","Breach,Raze,Cypher,Fade,Clove"
Abyss,YFP X,Erinite GC,13,5,8,4,1,5,"Cypher,Sova,Omen,Jett,Harbor","Cypher,Sova,Omen,Jett,Iso"
Ascent,Day By Day,SaD FROST,7,13,2,10,3,5,"Cypher,Sova,Omen,Jett,KAY/O","Sova,Killjoy,Omen,Jett,KAY/O"
Sunset,TBS GC,FURIA GC,13,10,8,3,7,5,"Cypher,Sova,Omen,KAY/O,Neon","Breach,Raze,Cypher,Omen,Gekko"
Haven,REVOADA,PS5Patas,13,4,9,3,1,4,"Breach,Sova,Killjoy,Omen,Jett","Breach,Cypher,Sova,Omen,Jett"
Ascent,Team Liquid Brazil,Athena's e-Sports,13,9,4,8,1,9,"Sova,Killjoy,Omen,Jett,KAY/O","Breach,Raze,Sova,Omen,Deadlock"
Haven,mesos millionaires, RITUAL RËAL,13,8,7,5,3,6,"Breach,Sova,Killjoy,Jett,Clove","Breach,Cypher,Sova,Omen,Jett"
Icebox,Shopify Rebellion,Event Horizon GC,13,5,8,4,1,5,"Sova,Killjoy,Viper,Jett,Harbor","Sova,Killjoy,Viper,Jett,Gekko"
Ascent,Team Leveling,Vila das Flores,7,13,3,5,8,4,"Sova,Killjoy,Omen,Jett,KAY/O","Cypher,Sova,Phoenix,Omen,Jett"
Haven,YFP X,Erinite GC,13,3,11,1,2,2,"Breach,Cypher,Sova,Omen,Jett","Breach,Sova,Killjoy,Omen,Neon"
Abyss,Refrag,Everyone Really Misses,6,13,0,7,6,6,"Sova,Omen,Jett,Astra,KAY/O","Sova,Viper,Jett,Yoru,Astra"
Bind,TBS GC,FURIA GC,13,1,11,1,0,2,"Raze,Viper,Brimstone,Skye,Gekko","Raze,Brimstone,Reyna,Skye,Clove"
Ascent,REVOADA,PS5Patas,13,4,5,0,4,8,"Sova,Killjoy,Omen,Jett,KAY/O","Sova,Killjoy,Omen,Jett,KAY/O"
Haven,Teddy Tactics,Bumble Bees,13,11,3,9,2,10,"Breach,Cypher,Sova,Omen,Neon","Breach,Sova,Killjoy,Omen,Jett"
Bind,Team Liquid Brazil,Athena's e-Sports,13,0,1,0,0,12,"Raze,Cypher,Viper,Brimstone,Skye","Raze,Cypher,Brimstone,Skye,Gekko"
Haven,oomfies,Catnappers,13,2,3,0,2,10,"Breach,Cypher,Sova,Omen,Neon","Breach,Cypher,Sova,Omen,Jett"
Haven,Day By Day,SaD FROST,7,13,3,9,4,4,"Breach,Cypher,Sova,Omen,Neon","Breach,Cypher,Sova,Omen,Neon"
Ascent,mesos millionaires, RITUAL RËAL,13,2,1,2,0,12,"Sova,Killjoy,Jett,Astra,KAY/O","Cypher,Sova,Omen,Jett,KAY/O"
Ascent,HEROIC Valkyries,Valiant GC,7,13,3,9,4,4,"Sova,Killjoy,Omen,Jett,KAY/O","Cypher,Sova,Omen,Jett,Deadlock"
Icebox,HEROIC Valkyries,Valiant GC,9,13,5,5,8,4,"Sova,Killjoy,Viper,Sage,Clove","Sova,Killjoy,Viper,Sage,Jett"
Lotus,HEROIC Valkyries,Valiant GC,17,15,9,7,8,8,"Raze,Viper,Omen,Chamber,Fade","Breach,Killjoy,Omen,Neon,Fade"
Lotus,Karmine Corp GC,Odd 1 OUT,13,8,8,4,4,5,"Breach,Cypher,Omen,Neon,Fade","Breach,Cypher,Sova,Omen,Neon"
Haven,Karmine Corp GC,Odd 1 OUT,13,10,7,4,6,6,"Breach,Sova,Killjoy,Omen,Neon","Breach,Sova,Killjoy,Omen,Jett"
Ascent,Team Liquid Brazil,Kiwizitos,13,5,9,3,2,4,"Sova,Killjoy,Omen,Jett,KAY/O","Sova,Killjoy,Omen,Jett,KAY/O"
Haven,Team Leveling,PROCURADAS,13,3,4,0,3,9,"Breach,Cypher,Sova,Omen,Neon","Breach,Cypher,Sova,Omen,Jett"
Abyss,Team Leveling,PROCURADAS,13,5,10,2,3,3,"Sova,Omen,Astra,KAY/O,Neon","Breach,Cypher,Omen,Jett,Gekko"
Icebox,Team Liquid Brazil,Kiwizitos,13,6,6,1,5,7,"Sova,Killjoy,Viper,Sage,Jett","Sova,Killjoy,Viper,Jett,Clove"
Bind,Athena's e-Sports,TOTALE Talents,13,7,8,4,3,5,"Raze,Cypher,Brimstone,Skye,Gekko","Raze,Viper,Brimstone,Fade,Gekko"
Haven,FURIA GC,Synergy BR,13,5,5,1,4,8,"Breach,Sova,Killjoy,Omen,Jett","Breach,Cypher,Sova,Omen,Neon"
Abyss,PS5Patas,As Estagiarias,13,11,4,8,3,9,"Cypher,Sova,Omen,Jett,KAY/O","Cypher,Jett,Gekko,Deadlock,Clove"
Lotus,Vila das Flores,BLOOD Stars,13,5,7,5,0,6,"Breach,Cypher,Omen,Neon,Fade","Breach,Raze,Killjoy,Omen,Gekko"
Lotus,REVOADA,Tarja Preta AIM,13,4,10,2,2,3,"Raze,Killjoy,Viper,Omen,Fade","Breach,Killjoy,Omen,Jett,Iso"
Lotus,PS5Patas,As Estagiarias,13,6,9,3,3,4,"Raze,Killjoy,Viper,Omen,Gekko","Breach,Raze,Killjoy,Omen,Gekko"
Icebox,FURIA GC,Synergy BR,13,10,5,6,4,8,"Sova,Killjoy,Viper,Reyna,Jett","Sova,Killjoy,Viper,Jett,KAY/O"
Haven,Vila das Flores,BLOOD Stars,13,1,11,1,0,2,"Breach,Cypher,Sova,Omen,Neon","Breach,Sova,Killjoy,Omen,Neon"
Abyss,Athena's e-Sports,TOTALE Talents,13,6,6,1,5,7,"Cypher,Sova,Omen,Jett,Harbor","Cypher,Sova,Omen,Jett,Harbor"
Bind,REVOADA,Tarja Preta AIM,13,2,12,0,2,1,"Raze,Cypher,Viper,Brimstone,Skye","Raze,Viper,Jett,Fade,Clove"
Abyss,ASNA,AMORIS Vega,13,9,7,5,4,6,"Breach,Jett,Astra,Fade,Harbor","Cypher,Sova,Jett,Astra,Gekko"
Bind,ASNA,AMORIS Vega,14,12,9,4,8,5,"Raze,Viper,Brimstone,Fade,Gekko","Raze,Viper,Brimstone,Fade,Gekko"
Icebox,SCARZ Youth,ESR Selection,13,7,7,1,6,6,"Sova,Killjoy,Viper,Reyna,Jett","Sova,Killjoy,Viper,Jett,KAY/O"
Haven,ENFANT,RE ENDLESS,2,13,0,3,10,2,"Breach,Sova,Killjoy,Omen,Jett","Breach,Cypher,Sova,Jett,Astra"
Icebox,Reignite Lily,Haven Liberty,8,13,4,8,5,4,"Sova,Killjoy,Viper,Jett,Harbor","Sova,Killjoy,Jett,Iso,Clove"
Sunset,Reignite Lily,Haven Liberty,0,13,0,12,1,0,"Cypher,Sova,Omen,KAY/O,Neon","Raze,Cypher,Sova,Deadlock,Clove"
Ascent,ASNA,AMORIS Vega,7,13,3,9,4,4,"Sova,Killjoy,Omen,Jett,KAY/O","Sova,Killjoy,Omen,Jett,KAY/O"
Ascent,SCARZ Youth,ESR Selection,13,9,5,5,4,8,"Sova,Killjoy,Reyna,Omen,Jett","Sova,Killjoy,Omen,Jett,KAY/O"
Lotus,ENFANT,RE ENDLESS,8,13,7,5,8,1,"Raze,Killjoy,Omen,Astra,Fade","Breach,Raze,Omen,Chamber,Fade"
Ascent,KS Esports GC,MYVRA GC,10,13,2,9,4,8,"Cypher,Sova,Omen,Yoru,Deadlock","Sova,Killjoy,Jett,KAY/O,Clove"
Abyss,KS Esports GC,MYVRA GC,9,13,6,6,7,3,"Cypher,Sova,Omen,Jett,Astra","Breach,Raze,Cypher,Sova,Astra"
Lotus,Leviatán GC,FiRePOWER GC,10,13,3,8,5,7,"Breach,Cypher,Omen,Neon,Iso","Breach,Cypher,Omen,Neon,Fade"
Ascent,Bumble Bees,Skyline Dreamers GC,13,8,9,3,5,4,"Sova,Killjoy,Omen,Jett,KAY/O","Sova,Killjoy,Omen,Jett,KAY/O"
Haven,Leviatán GC,FiRePOWER GC,6,13,5,2,11,1,"Breach,Cypher,Sova,Omen,Neon","Breach,Sova,Killjoy,Omen,Neon"
Lotus,VO Blossoms, RITUAL RËAL,5,13,4,8,5,1,"Raze,Killjoy,Omen,Fade,Gekko","Raze,Cypher,Omen,Fade,Deadlock"
Bind,Bumble Bees,Skyline Dreamers GC,13,8,6,3,5,7,"Raze,Viper,Brimstone,Skye,Deadlock","Raze,Cypher,Brimstone,Skye,Yoru"
Lotus,Erinite GC,minions united GC,13,10,6,6,4,7,"Raze,Killjoy,Omen,Fade,Gekko","Breach,Raze,Omen,Fade,Clove"
Icebox,VO Blossoms, RITUAL RËAL,13,9,7,5,4,6,"Sova,Killjoy,Viper,Jett,KAY/O","Sova,Killjoy,Viper,Reyna,Jett"
Abyss,Tenax GC,U4RIA Magnolia,13,6,8,4,2,5,"Breach,Sova,Omen,Jett,Deadlock","Sova,Killjoy,Viper,Yoru,Astra"
Abyss,Leviatán GC,FiRePOWER GC,13,4,9,3,1,4,"Cypher,Sova,Omen,Jett,Yoru","Cypher,Sova,Omen,Jett,KAY/O"
Sunset,Everyone Really Misses,Envee Sapphire GC,13,9,5,5,4,8,"Breach,Cypher,Sova,Omen,Neon","Breach,Cypher,Sova,Omen,Neon"
Haven,SaD FROST,Scooby Snackers,13,3,9,3,0,4,"Breach,Cypher,Sova,Omen,Neon","Breach,Cypher,Sova,Omen,Jett"
Haven,Erinite GC,minions united GC,13,11,7,5,6,6,"Breach,Sova,Killjoy,Omen,Neon","Breach,Sova,Killjoy,Omen,Jett"
Ascent,VO Blossoms, RITUAL RËAL,6,13,3,4,9,3,"Sova,Killjoy,Jett,KAY/O,Clove","Cypher,Sova,Omen,Jett,KAY/O"
Bind,SaD FROST,Scooby Snackers,13,1,11,1,0,2,"Raze,Cypher,Brimstone,Skye,Yoru","Raze,Viper,Skye,Gekko,Clove"
Lotus,Bumble Bees,Skyline Dreamers GC,9,13,4,8,5,5,"Raze,Killjoy,Viper,Omen,Fade","Breach,Killjoy,Neon,Gekko,Clove"
Icebox,Everyone Really Misses,Envee Sapphire GC,13,2,10,2,0,3,"Sova,Killjoy,Viper,Jett,Harbor","Sova,Killjoy,Viper,Jett,Gekko"
Lotus,Tenax GC,U4RIA Magnolia,13,4,4,1,3,9,"Breach,Killjoy,Omen,Neon,Fade","Raze,Killjoy,Viper,Omen,Fade"
Haven,MOUZ,Joblife,13,10,9,2,8,4,"Breach,Cypher,Sova,Omen,Jett","Breach,Sova,Killjoy,Astra,Neon"
Haven,Apeks,Barça eSports,13,11,2,10,1,11,"Breach,Sova,Killjoy,Omen,Jett","Breach,Sova,Killjoy,Omen,Jett"
Bind,MOUZ,Joblife,7,13,1,7,6,6,"Raze,Omen,Skye,Gekko,Clove","Raze,Viper,Brimstone,Skye,Gekko"
Abyss,Apeks,Barça eSports,13,5,6,0,5,7,"Cypher,Sova,Omen,Yoru,Astra","Cypher,Sova,Omen,Jett,KAY/O"
Sunset,Apeks,Barça eSports,10,13,9,3,10,1,"Cypher,Sova,Omen,KAY/O,Neon","Cypher,Sova,Omen,KAY/O,Neon"
Lotus,MOUZ,Joblife,13,10,6,5,5,7,"Breach,Cypher,Omen,Yoru,Fade","Raze,Sova,Killjoy,Omen,Gekko"
Ascent,PCIFIC Espor,SAW,13,7,5,3,4,8,"Sova,Killjoy,Omen,Jett,KAY/O","Cypher,Sova,Omen,Jett,KAY/O"
Icebox,DSYRE,GoNext Esports,13,5,8,4,1,5,"Sova,Killjoy,Viper,Sage,Jett","Sova,Killjoy,Viper,Jett,KAY/O"
Lotus,DSYRE,GoNext Esports,13,1,2,0,1,11,"Raze,Killjoy,Viper,Omen,Fade","Breach,Cypher,Sova,Omen,Neon"
Abyss,PCIFIC Espor,SAW,13,6,10,2,4,3,"Cypher,Sova,Omen,Jett,KAY/O","Breach,Cypher,Sova,Jett,Astra"
Abyss,RE ENDLESS,ThorN,13,9,5,7,2,8,"Cypher,Sova,Jett,Astra,KAY/O","Cypher,Sova,Phoenix,Omen,Deadlock"
Ascent,RE ENDLESS,ThorN,13,11,9,3,8,4,"Sova,Killjoy,Jett,Astra,KAY/O","Sova,Killjoy,Reyna,Omen,Jett"
Ascent,Kou-Gaming,ESR Selection,6,13,1,6,7,5,"Sova,Killjoy,Omen,Jett,KAY/O","Sova,Killjoy,Omen,Jett,KAY/O"
Icebox,ExA,Haven Liberty,3,13,1,11,2,2,"Sova,Killjoy,Viper,Omen,Jett","Sova,Killjoy,Reyna,Jett,Clove"
Haven,RE ENDLESS,ThorN,9,13,5,7,6,4,"Breach,Cypher,Sova,Jett,Astra","Sova,Killjoy,Omen,Jett,Iso"
Lotus,Kou-Gaming,ESR Selection,7,13,6,6,7,1,"Breach,Raze,Killjoy,Omen,Neon","Raze,Killjoy,Viper,Omen,Fade"
Bind,ExA,Haven Liberty,3,13,2,10,3,1,"Raze,Sova,Viper,Brimstone,Gekko","Raze,Viper,Fade,Gekko,Clove"
Haven,Refrag,Tenax GC,13,9,6,4,5,7,"Cypher,Sova,Reyna,Omen,Jett","Breach,Sova,Killjoy,Omen,Neon"
Haven,Bon Bon Bum Contra GC,FUSION X,0,13,0,1,12,0,"Breach,Sova,Killjoy,Omen,Chamber","Cypher,Sova,Astra,Gekko,Iso"
Bind,Refrag,Tenax GC,13,11,5,7,4,8,"Raze,Viper,Brimstone,Skye,Yoru","Raze,Viper,Brimstone,Skye,Deadlock"
Bind,Everyone Really Misses,Day By Day,11,13,8,4,9,3,"Raze,Viper,Brimstone,Fade,Gekko","Raze,Viper,Skye,Gekko,Clove"
Lotus,Envee Sapphire GC,scc plus 1,9,13,4,6,7,5,"Killjoy,Omen,Jett,Skye,Gekko","Breach,Raze,Killjoy,Omen,Fade"
Ascent,Bon Bon Bum Contra GC,FUSION X,2,13,1,11,2,1,"Sova,Killjoy,Phoenix,Omen,Jett","Raze,Sova,KAY/O,Iso,Clove"
Icebox,Refrag,Tenax GC,7,13,5,3,10,2,"Sova,Killjoy,Viper,Jett,KAY/O","Sova,Viper,Sage,Reyna,Chamber"
Bind,Purpose Gaming Sirens,Scooby Snackers,4,13,2,10,3,2,"Raze,Cypher,Viper,Brimstone,Skye","Raze,Viper,Skye,Gekko,Clove"
Abyss,Everyone Really Misses,Day By Day,13,9,7,3,6,6,"Sova,Viper,Jett,Yoru,Astra","Cypher,Sova,Jett,Astra,Gekko"
Haven,Shopify Rebellion,Waffle House,13,0,1,0,0,12,"Breach,Cypher,Sova,Omen,Neon","Breach,Cypher,Sova,Omen,Neon"
Sunset,Envee Sapphire GC,scc plus 1,10,13,1,10,3,9,"Breach,Cypher,Sova,Omen,Neon","Breach,Cypher,Sova,Omen,Neon"
Ascent,Shopify Rebellion,Waffle House,13,0,1,0,0,12,"Cypher,Sova,Omen,Jett,Deadlock","Cypher,Sova,Omen,Jett,Deadlock"
Abyss,oomfies,LazerrFreeks Ivy,13,1,2,0,1,11,"Sova,Omen,Jett,Astra,KAY/O","Cypher,Sova,Omen,Jett,Deadlock"
Lotus,Zen eSports GC,KRÜ BLAZE,8,13,1,8,5,7,"Raze,Killjoy,Viper,Omen,Fade","Raze,Killjoy,Viper,Omen,Fade"
Icebox,U4RIA Magnolia,Tenax GC,5,13,3,9,4,2,"Sova,Killjoy,Viper,Sage,Jett","Sova,Viper,Sage,Reyna,Chamber"
Haven,YFP X,Bumble Bees,13,6,5,2,4,8,"Breach,Sova,Killjoy,Omen,Jett","Breach,Cypher,Sova,Omen,Jett"
Lotus,Everyone Really Misses,Day By Day,10,13,7,5,8,3,"Breach,Omen,Neon,Fade,Clove","Cypher,Viper,Omen,Skye,Neon"
Sunset,Purpose Gaming Sirens,Scooby Snackers,13,9,5,7,2,8,"Breach,Raze,Cypher,Omen,Gekko","Breach,Raze,Cypher,Omen,Fade"
Icebox,Give Wingman 2 Nuclear Devices,SaD FROST,14,12,7,6,6,7,"Sova,Killjoy,Viper,Sage,Jett","Sova,Killjoy,Viper,Reyna,Iso"
Ascent,Envee Sapphire GC,scc plus 1,13,9,7,3,6,6,"Sova,Killjoy,Omen,Jett,KAY/O","Sova,Killjoy,Omen,Jett,KAY/O"
Lotus,Teddy Tactics,VO Blossoms,13,7,5,3,4,8,"Raze,Killjoy,Viper,Omen,Fade","Raze,Killjoy,Omen,Fade,Gekko"
Ascent,Tea Guzzlers,minions united GC,3,13,0,4,9,3,"Sova,Killjoy,Omen,Jett,KAY/O","Sova,Killjoy,Omen,Jett,KAY/O"
Ascent,Divine GC, RITUAL RËAL,5,13,1,5,8,4,"Sova,Killjoy,Omen,Jett,KAY/O","Cypher,Sova,Omen,Jett,KAY/O"
Haven,Catnappers,Waffle House,7,13,1,7,6,6,"Cypher,Sova,Omen,Yoru,Iso","Breach,Cypher,Sova,Omen,Neon"
Haven,Waffle House,Catnappers,13,7,6,6,1,7,"Breach,Cypher,Sova,Omen,Neon","Cypher,Sova,Omen,Yoru,Iso"
Ascent,oomfies,LazerrFreeks Ivy,13,11,11,1,10,2,"Cypher,Sova,Omen,Jett,Deadlock","Sova,Killjoy,Omen,Jett,KAY/O"
Lotus,Tea Guzzlers,minions united GC,2,13,0,3,10,2,"Breach,Raze,Omen,Skye,Clove","Breach,Raze,Omen,Fade,Clove"
Sunset,YFP X,Bumble Bees,13,2,2,1,1,11,"Breach,Raze,Cypher,Sova,Omen","Breach,Raze,Cypher,Sova,Omen"
Ascent,Day By Day,scc plus 1,13,5,7,5,0,6,"Cypher,Sova,Omen,Jett,KAY/O","Sova,Killjoy,Omen,Jett,KAY/O"
Sunset,Give Wingman 2 Nuclear Devices,SaD FROST,13,8,5,4,4,8,"Breach,Raze,Cypher,Omen,Gekko","Raze,Cypher,Omen,KAY/O,Gekko"
Haven,Purpose Gaming Sirens,Scooby Snackers,8,13,3,6,7,5,"Breach,Sova,Killjoy,Omen,Jett","Breach,Cypher,Sova,Omen,Jett"
Ascent,U4RIA Magnolia,Tenax GC,14,16,4,11,5,10,"Cypher,Sova,Omen,Jett,Deadlock","Sova,Killjoy,Omen,Jett,KAY/O"
Icebox,Zen eSports GC,KRÜ BLAZE,13,11,5,7,4,8,"Sova,Killjoy,Viper,Reyna,Neon","Sova,Killjoy,Viper,Jett,Harbor"
Haven,Teddy Tactics,VO Blossoms,13,10,6,6,4,7,"Breach,Sova,Killjoy,Omen,Neon","Breach,Sova,Killjoy,Omen,Jett"
Lotus,Divine GC, RITUAL RËAL,8,13,5,7,6,3,"Breach,Raze,Killjoy,Omen,Fade","Raze,Cypher,Omen,Fade,Deadlock"
Abyss,Catnappers,Waffle House,9,13,3,7,6,6,"Cypher,Sova,Omen,Jett,KAY/O","Breach,Cypher,Sova,Omen,Jett"
Abyss,Waffle House,Catnappers,13,9,6,6,3,7,"Breach,Cypher,Sova,Omen,Jett","Cypher,Sova,Omen,Jett,KAY/O"
Lotus,Give Wingman 2 Nuclear Devices,Purpose Gaming Sirens,13,3,10,2,1,3,"Breach,Raze,Cypher,Omen,Gekko","Breach,Killjoy,Omen,Neon,Gekko"
Lotus,Day By Day,scc plus 1,13,7,10,2,5,3,"Cypher,Viper,Omen,Skye,Neon","Killjoy,Omen,Neon,Fade,Gekko"
Lotus,Event Horizon GC,LazerrFreeks Ivy,8,13,3,6,7,5,"Breach,Raze,Cypher,Omen,Fade","Raze,Killjoy,Omen,Fade,Gekko"
Lotus,LazerrFreeks Ivy,Event Horizon GC,13,8,7,5,3,6,"Raze,Killjoy,Omen,Fade,Gekko","Breach,Raze,Cypher,Omen,Fade"
Sunset,SaD FROST,Scooby Snackers,13,3,4,0,3,9,"Raze,Cypher,Omen,KAY/O,Gekko","Breach,Raze,Cypher,Omen,Fade"
Bind,mesos millionaires,Tea Guzzlers,13,4,11,1,3,2,"Raze,Skye,Chamber,Deadlock,Clove","Raze,Brimstone,Jett,Skye,Clove"
Haven,Zen eSports GC,KRÜ BLAZE,4,13,1,4,9,3,"Breach,Sova,Killjoy,Omen,Jett","Breach,Sova,Killjoy,Omen,Jett"
Bind,Bumble Bees,Skyline Dreamers GC,13,4,3,2,2,10,"Raze,Viper,Brimstone,Skye,Deadlock","Raze,Brimstone,Reyna,Skye,Harbor"
Sunset,minions united GC,Erinite GC,11,13,9,3,10,2,"Breach,Raze,Cypher,Omen,Gekko","Breach,Raze,Cypher,Sova,Omen"
Abyss,Everyone Really Misses,Envee Sapphire GC,13,2,3,0,2,10,"Sova,Viper,Jett,Yoru,Astra","Cypher,Sova,Astra,KAY/O,Harbor"
Sunset, RITUAL RËAL,VO Blossoms,8,13,5,7,6,3,"Breach,Cypher,Omen,Neon,Gekko","Breach,Raze,Cypher,Gekko,Clove"
Lotus,Teddy Tactics,Divine GC,13,7,3,5,2,10,"Raze,Killjoy,Viper,Omen,Fade","Breach,Raze,Killjoy,Gekko,Clove"
Sunset,Day By Day,scc plus 1,2,13,0,3,10,2,"Breach,Raze,Cypher,Sova,Omen","Breach,Cypher,Sova,Omen,Neon"
Bind,Give Wingman 2 Nuclear Devices,Purpose Gaming Sirens,13,7,8,4,3,5,"Raze,Viper,Brimstone,Skye,Gekko","Raze,Cypher,Viper,Brimstone,Skye"
Sunset,Event Horizon GC,LazerrFreeks Ivy,4,13,2,3,10,2,"Breach,Cypher,Sova,Omen,Neon","Raze,Cypher,Fade,Gekko,Clove"
Sunset,LazerrFreeks Ivy,Event Horizon GC,13,4,10,2,2,3,"Raze,Cypher,Fade,Gekko,Clove","Breach,Cypher,Sova,Omen,Neon"
Ascent,Catnappers,Waffle House,13,8,6,6,2,7,"Sova,Killjoy,Omen,Jett,KAY/O","Cypher,Sova,Omen,Jett,Deadlock"
Ascent,Waffle House,Catnappers,8,13,2,7,6,6,"Cypher,Sova,Omen,Jett,Deadlock","Sova,Killjoy,Omen,Jett,KAY/O"
Abyss,mesos millionaires,Tea Guzzlers,13,7,7,1,6,6,"Sova,Omen,Yoru,Astra,Deadlock","Cypher,Sova,Jett,Astra,Gekko"
Haven,SaD FROST,Scooby Snackers,13,4,2,3,1,11,"Breach,Cypher,Sova,Omen,Neon","Breach,Cypher,Sova,Omen,Jett"
Haven,U4RIA Magnolia,Tenax GC,18,16,9,8,8,9,"Sova,Killjoy,Viper,Omen,Yoru","Breach,Sova,Killjoy,Omen,Neon"
Lotus,Everyone Really Misses,Envee Sapphire GC,13,5,7,5,0,6,"Breach,Omen,Neon,Fade,Clove","Breach,Raze,Killjoy,Omen,Fade"
Haven,Bumble Bees,Skyline Dreamers GC,13,4,8,4,0,5,"Breach,Cypher,Sova,Omen,Jett","Breach,Sova,Killjoy,Omen,Jett"
Haven,minions united GC,Erinite GC,12,14,8,5,9,4,"Breach,Sova,Killjoy,Omen,Jett","Breach,Sova,Killjoy,Omen,Neon"
Haven, RITUAL RËAL,VO Blossoms,6,13,2,10,3,4,"Breach,Cypher,Sova,Omen,Jett","Breach,Sova,Killjoy,Omen,Jett"
Abyss,SAW,The Ultimates,4,13,4,8,5,0,"Breach,Cypher,Sova,Jett,Astra","Cypher,Sova,Omen,Jett,KAY/O"
Haven,SAW,The Ultimates,6,13,3,9,4,3,"Breach,Cypher,Sova,Omen,Jett","Cypher,Sova,Omen,Neon,Iso"
Ascent,SAW,The Ultimates,13,10,6,6,4,7,"Cypher,Sova,Omen,Jett,KAY/O","Sova,Killjoy,Omen,Jett,KAY/O"
Abyss,CGN Esports,GoNext Esports,13,6,10,2,4,3,"Cypher,Sova,Phoenix,Omen,Jett","Cypher,Sova,Jett,Astra,Gekko"
Sunset,DSYRE,Barça eSports,14,12,4,9,3,10,"Breach,Raze,Cypher,Omen,Gekko","Cypher,Sova,Omen,KAY/O,Neon"
Lotus,PCIFIC Espor,Joblife,13,3,3,1,2,10,"Breach,Cypher,Sova,Omen,Neon","Raze,Killjoy,Viper,Omen,Fade"
Haven,DSYRE,Barça eSports,13,10,6,6,4,7,"Cypher,Sova,Omen,Yoru,Iso","Breach,Cypher,Sova,Omen,Neon"
Ascent,PCIFIC Espor,Joblife,13,10,7,4,6,6,"Sova,Killjoy,Phoenix,Omen,Jett","Sova,Killjoy,Omen,Jett,KAY/O"
Ascent,DSYRE,Barça eSports,8,13,1,8,5,7,"Cypher,Sova,Omen,Jett,KAY/O","Killjoy,Viper,Omen,Jett,Skye"
Haven,K7 Esports GC,Akave Esports Black,3,13,1,3,10,2,"Breach,Raze,Cypher,Omen,Jett","Breach,Cypher,Sova,Omen,Jett"
Ascent,K7 Esports GC,Akave Esports Black,0,13,0,1,12,0,"Sova,Killjoy,Omen,Jett,KAY/O","Cypher,Sova,Omen,Jett,KAY/O"
Abyss,University War GC,9z Team GC,7,13,1,7,6,6,"Breach,Cypher,Sova,Omen,Jett","Cypher,Sova,Omen,Jett,Harbor"
Icebox,University War GC,9z Team GC,5,13,1,5,8,4,"Sova,Killjoy,Viper,Sage,Omen","Sova,Killjoy,Viper,Jett,Harbor"
Abyss,MOUZ,PCIFIC Espor,10,13,4,8,5,6,"Cypher,Sova,Jett,Astra,KAY/O","Cypher,Sova,Omen,Jett,KAY/O"
Haven,MOUZ,PCIFIC Espor,7,13,2,6,7,5,"Breach,Cypher,Sova,Omen,Jett","Breach,Sova,Killjoy,Omen,Jett"
Sunset,Apeks,DSYRE,13,9,5,7,2,8,"Cypher,Sova,Omen,KAY/O,Neon","Breach,Raze,Cypher,Omen,Gekko"
Haven,Apeks,DSYRE,13,7,8,0,7,5,"Breach,Sova,Killjoy,Omen,Jett","Cypher,Sova,Omen,Yoru,Iso"
Lotus,MOUZ,PCIFIC Espor,13,10,7,4,6,6,"Breach,Cypher,Omen,Yoru,Fade","Breach,Cypher,Sova,Omen,Neon"
Haven,The Ultimates,Joblife,12,14,8,5,9,4,"Cypher,Sova,Omen,Neon,Iso","Breach,Sova,Killjoy,Astra,Neon"
Haven,CGN Esports,Barça eSports,13,9,6,6,3,7,"Sova,Killjoy,Phoenix,Omen,Jett","Breach,Cypher,Sova,Omen,Neon"
Sunset,The Ultimates,Joblife,12,14,6,7,7,6,"Breach,Raze,Cypher,Omen,Gekko","Breach,Cypher,Sova,Omen,Neon"
Ascent,CGN Esports,Barça eSports,16,14,7,8,6,9,"Sova,Killjoy,Phoenix,Jett,Astra","Killjoy,Viper,Omen,Jett,Skye"
Bind,The Ultimates,Joblife,13,11,7,5,6,6,"Raze,Viper,Brimstone,Sage,Skye","Raze,Viper,Brimstone,Skye,Gekko"
Bind,CGN Esports,Barça eSports,8,13,7,5,8,1,"Raze,Viper,Phoenix,Brimstone,Fade","Viper,Brimstone,Yoru,Fade,Gekko"
Sunset,New Combat Line GC,No Sweat Blossom,13,2,10,2,0,3,"Breach,Raze,Cypher,Omen,Clove","Breach,Raze,Cypher,Omen,Gekko"
Haven,New Combat Line GC,No Sweat Blossom,13,8,6,6,2,7,"Breach,Sova,Killjoy,Omen,Jett","Breach,Cypher,Sova,Omen,Neon"
Ascent,YFP Gaming,Blinn Esports,13,11,4,8,3,9,"Cypher,Sova,Omen,Jett,Deadlock","Cypher,Sova,Omen,Yoru,Deadlock"
Ascent,New Combat Line GC,No Sweat Blossom,13,15,4,10,5,9,"Sova,Killjoy,Omen,Jett,KAY/O","Cypher,Sova,Omen,Yoru,Deadlock"
Haven,YFP Gaming,Blinn Esports,13,8,7,2,6,6,"Breach,Cypher,Sova,Omen,Jett","Breach,Cypher,Sova,Omen,Neon"
Ascent,YFP Gaming,Blue Otter,13,4,4,1,3,9,"Cypher,Sova,Omen,Jett,Deadlock","Sova,Killjoy,Omen,Jett,KAY/O"
Haven,Blinn Esports,Special Grade,13,8,5,7,1,8,"Breach,Cypher,Sova,Omen,Neon","Breach,Sova,Killjoy,Omen,Jett"
Haven,XSOUL GC,Deagle Ravagers,8,13,5,7,6,3,"Breach,Sova,Killjoy,Omen,Neon","Breach,Sova,Killjoy,Omen,Jett"
Haven,YFP Gaming,Blue Otter,13,8,7,5,3,6,"Breach,Sova,Killjoy,Omen,Jett","Breach,Cypher,Sova,Omen,Neon"
Icebox,Blinn Esports,Special Grade,13,8,6,6,2,7,"Sova,Killjoy,Viper,Reyna,Gekko","Sova,Killjoy,Viper,Jett,Clove"
Abyss,XSOUL GC,Deagle Ravagers,1,13,0,2,11,1,"Breach,Cypher,Sova,Astra,Neon","Cypher,Sova,Omen,Jett,KAY/O"
Ascent,Apinaorkesteri,Jabba Enjoyers,13,0,1,0,0,12,"Sova,Killjoy,Omen,Jett,KAY/O","Sova,Killjoy,Omen,Jett,KAY/O"
Abyss,GoNext Esports,Barça eSports,13,10,7,5,5,6,"Cypher,Sova,Jett,Astra,Gekko","Cypher,Sova,Omen,Jett,KAY/O"
Ascent,Blue Otter,ENVEE Esports,13,9,5,7,2,8,"Sova,Killjoy,Omen,Jett,KAY/O","Sova,Killjoy,Omen,Jett,KAY/O"
Sunset,FLUFFY AIMERS,Blinn Esports,11,13,8,4,9,3,"Breach,Raze,Cypher,Omen,Skye","Breach,Cypher,Omen,Neon,Gekko"
Sunset,TSM,YFP Gaming,13,15,4,10,5,9,"Breach,Cypher,Omen,Neon,Gekko","Breach,Raze,Cypher,Sova,Omen"
Lotus,Apinaorkesteri,Jabba Enjoyers,13,3,4,0,3,9,"Raze,Killjoy,Viper,Omen,Fade","Breach,Raze,Killjoy,Omen,Fade"
Icebox,GoNext Esports,Barça eSports,13,10,3,8,2,10,"Sova,Killjoy,Viper,Jett,KAY/O","Killjoy,Viper,Jett,KAY/O,Clove"
Bind,FLUFFY AIMERS,Blinn Esports,5,13,5,7,6,0,"Raze,Viper,Brimstone,Skye,Deadlock","Raze,Viper,Brimstone,Skye,Gekko"
Haven,FlyQuest RED,Special Grade,5,13,4,8,5,1,"Killjoy,Phoenix,Astra,Fade,Gekko","Breach,Sova,Killjoy,Omen,Jett"
Icebox,Blue Otter,ENVEE Esports,12,14,6,7,7,6,"Sova,Killjoy,Viper,Jett,Gekko","Sova,Killjoy,Viper,Reyna,Jett"
Lotus,TSM,YFP Gaming,9,13,0,10,3,9,"Breach,Raze,Cypher,Omen,Fade","Breach,Raze,Cypher,Omen,Fade"
Haven,GoNext Esports,Barça eSports,10,13,4,8,5,6,"Breach,Cypher,Sova,Omen,Jett","Breach,Cypher,Sova,Omen,Neon"
Sunset,Blue Otter,ENVEE Esports,13,10,7,5,5,6,"Breach,Cypher,Sova,Omen,Neon","Breach,Cypher,Sova,Omen,Neon"
Bind,TSM,YFP Gaming,13,11,10,2,9,3,"Raze,Cypher,Brimstone,Skye,Gekko","Raze,Viper,Brimstone,Skye,Gekko"
Icebox,FlyQuest RED,Special Grade,7,13,0,8,5,7,"Sova,Killjoy,Viper,Sage,Gekko","Sova,Killjoy,Viper,Jett,Clove"
Haven,FLUFFY AIMERS,Blinn Esports,14,12,4,9,3,10,"Breach,Sova,Killjoy,Jett,Astra","Breach,Sova,Omen,Chamber,Neon"
Bind,Jabba Enjoyers,Bitfix Gaming,13,11,5,7,4,8,"Raze,Viper,Brimstone,Fade,Gekko","Raze,Cypher,Brimstone,Skye,Deadlock"
Icebox,SAW,Joblife,9,13,4,8,5,5,"Sova,Killjoy,Viper,Jett,Gekko","Sova,Killjoy,Viper,Reyna,Jett"
Haven,Apeks,CGN Esports,14,12,7,6,6,7,"Breach,Sova,Killjoy,Omen,Jett","Sova,Killjoy,Phoenix,Omen,Jett"
Haven,SAW,Joblife,2,13,0,3,10,2,"Cypher,Sova,Omen,Yoru,Iso","Breach,Sova,Killjoy,Astra,Neon"
Lotus,Jabba Enjoyers,Bitfix Gaming,13,7,7,5,2,6,"Breach,Raze,Killjoy,Omen,Fade","Breach,Raze,Cypher,Omen,Deadlock"
Haven,Apinaorkesteri,Lootcifer,13,4,5,0,4,8,"Breach,Cypher,Sova,Omen,Jett","Breach,Sova,Killjoy,Omen,Neon"
Ascent,Jabba Enjoyers,Bitfix Gaming,7,13,3,9,4,4,"Sova,Killjoy,Omen,Jett,KAY/O","Cypher,Sova,Omen,Jett,Deadlock"
Lotus,Apeks,CGN Esports,9,13,3,7,6,6,"Raze,Cypher,Omen,KAY/O,Deadlock","Raze,Sova,Killjoy,Omen,Gekko"
Abyss,MOUZ,The Ultimates,2,13,0,3,10,2,"Cypher,Sova,Jett,Astra,KAY/O","Cypher,Sova,Omen,Jett,KAY/O"
Bind,Apinaorkesteri,Lootcifer,13,10,3,9,1,10,"Raze,Viper,Brimstone,Fade,Gekko","Breach,Cypher,Sova,Omen,Yoru"
Icebox,Formulation Gaming,Bitfix Gaming,6,13,2,5,8,4,"Sova,Killjoy,Viper,Jett,Gekko","Sova,Killjoy,Viper,Jett,Harbor"
Sunset,MOUZ,The Ultimates,11,13,6,6,7,5,"Raze,Cypher,Omen,KAY/O,Gekko","Breach,Raze,Cypher,Omen,Gekko"
Ascent,Apeks,CGN Esports,14,12,8,5,7,6,"Cypher,Sova,Omen,Yoru,Deadlock","Sova,Killjoy,Phoenix,Jett,Astra"
Lotus,Lootcifer,Requiem,13,8,7,5,3,6,"Breach,Cypher,Sova,Omen,Neon","Breach,Raze,Cypher,Omen,Fade"
Lotus,Formulation Gaming,Bitfix Gaming,13,15,6,8,7,7,"Raze,Killjoy,Viper,Omen,Fade","Breach,Raze,Cypher,Omen,Deadlock"
Icebox,Lootcifer,Requiem,16,14,9,6,8,7,"Sova,Killjoy,Viper,Jett,KAY/O","Sova,Killjoy,Viper,Jett,KAY/O"
Ascent,NEANLATIYONBOLM,Jabba Enjoyers,11,13,7,5,8,4,"Sova,Killjoy,Phoenix,Omen,Jett","Sova,Killjoy,Omen,Jett,KAY/O"
Sunset,Lootcifer,Requiem,5,13,5,7,6,0,"Raze,Cypher,Viper,Omen,Fade","Breach,Cypher,Sova,Omen,Neon"
Ascent,Formulation Gaming,Bitfix Gaming,13,8,7,5,3,6,"Sova,Killjoy,Omen,Jett,KAY/O","Cypher,Sova,Omen,Jett,Deadlock"
Haven,Next In Line,Apinaorkesteri,10,13,4,7,6,6,"Breach,Cypher,Sova,Omen,Jett","Breach,Cypher,Sova,Omen,Jett"
Bind,NEANLATIYONBOLM,Jabba Enjoyers,12,14,8,5,9,4,"Raze,Viper,Brimstone,Yoru,Deadlock","Raze,Viper,Brimstone,Fade,Gekko"
Sunset,Next In Line,Apinaorkesteri,10,13,5,7,6,5,"Breach,Raze,Cypher,Omen,Gekko","Cypher,Sova,Omen,KAY/O,Neon"
Lotus,Formulation Gaming,Hidden Horizon,13,5,10,2,3,3,"Raze,Killjoy,Viper,Omen,Fade","Raze,Killjoy,Viper,Omen,Fade"
Icebox,OnlyFins,Lootcifer,5,13,2,4,9,3,"Sova,Killjoy,Viper,Reyna,Jett","Sova,Killjoy,Viper,Jett,KAY/O"
Abyss,Jabba Enjoyers,REY eSports,13,6,8,4,2,5,"Sova,Killjoy,Viper,Yoru,Astra","Cypher,Sova,Omen,Jett,KAY/O"
Ascent,Lost Puppies,Bitfix Gaming,9,13,4,6,7,5,"Sova,Killjoy,Omen,Jett,KAY/O","Cypher,Sova,Omen,Jett,Deadlock"
Bind,Requiem,Twisted Saints Esports,13,7,3,5,2,10,"Raze,Cypher,Brimstone,Skye,Deadlock","Raze,Viper,Brimstone,Skye,Gekko"
Sunset,NEANLATIYONBOLM,NoTag,13,8,7,2,6,6,"Killjoy,Yoru,Astra,Neon,Gekko","Raze,Cypher,Gekko,Iso,Clove"
Ascent,Formulation Gaming,Hidden Horizon,13,10,5,6,4,8,"Sova,Killjoy,Omen,Jett,KAY/O","Sova,Killjoy,Phoenix,Jett,Astra"
Lotus,OnlyFins,Lootcifer,14,12,4,9,3,10,"Raze,Killjoy,Omen,Neon,Fade","Cypher,Viper,Omen,Neon,Fade"
Ascent,Apinaorkesteri,CTRL x YARI Esports,13,3,2,2,1,11,"Sova,Killjoy,Omen,Jett,KAY/O","Sova,Killjoy,Omen,Jett,KAY/O"
Abyss,Next In Line,Kingslayers,13,5,9,3,2,4,"Raze,Cypher,Sova,Yoru,Astra","Cypher,Sova,Jett,Astra,Iso"
Icebox,Jabba Enjoyers,REY eSports,13,3,10,2,1,3,"Sova,Killjoy,Viper,Jett,Deadlock","Sova,Killjoy,Viper,Reyna,Neon"
Icebox,Lost Puppies,Bitfix Gaming,5,13,2,4,9,3,"Sova,Killjoy,Viper,Jett,Gekko","Sova,Killjoy,Viper,Jett,Harbor"
Haven,Requiem,Twisted Saints Esports,13,8,7,5,3,6,"Breach,Cypher,Sova,Omen,Neon","Killjoy,Viper,Omen,Jett,Skye"
Haven,Formulation Gaming,Hidden Horizon,4,13,2,10,3,2,"Breach,Sova,Killjoy,Omen,Jett","Breach,Cypher,Sova,Omen,Neon"
Haven,Apinaorkesteri,CTRL x YARI Esports,13,5,3,3,2,10,"Breach,Cypher,Sova,Omen,Jett","Breach,Sova,Killjoy,Omen,Neon"
Bind,NEANLATIYONBOLM,NoTag,13,7,7,5,2,6,"Raze,Viper,Brimstone,Yoru,Deadlock","Raze,Cypher,Brimstone,Yoru,Gekko"
Haven,OnlyFins,Lootcifer,9,13,3,7,6,6,"Breach,Cypher,Sova,Jett,Clove","Breach,Sova,Killjoy,Omen,Neon"
Ascent,Next In Line,Kingslayers,13,2,3,0,2,10,"Sova,Killjoy,Omen,Jett,KAY/O","Sova,Killjoy,Omen,Jett,KAY/O"
Ascent,みそまにあ隊,Five Ace,2,13,0,3,10,2,"Sova,Killjoy,Omen,Jett,KAY/O","Sova,Killjoy,Omen,Jett,KAY/O"
Icebox,みそまにあ隊,Five Ace,7,13,4,8,5,3,"Sova,Killjoy,Viper,Jett,Gekko","Sova,Killjoy,Viper,Jett,Iso"
Haven,FBI,Five Ace,12,14,4,9,5,8,"Breach,Cypher,Omen,Jett,KAY/O","Breach,Sova,Killjoy,Omen,Jett"
Lotus,みそまにあ隊,Lv.5,13,10,6,6,4,7,"Breach,Raze,Killjoy,Omen,Fade","Breach,Raze,Killjoy,Omen,Fade"
Icebox,Paranoia Boys,Dropouts,13,6,8,4,2,5,"Sova,Killjoy,Viper,Jett,Gekko","Sova,Killjoy,Viper,Jett,Gekko"
Ascent,No Sweat Blossom,Infiriumz Gaming GC,13,5,2,4,1,11,"Cypher,Sova,Omen,Yoru,Deadlock","Sova,Killjoy,Omen,Jett,KAY/O"
Lotus,Paranoia Boys,Dropouts,13,7,11,1,6,2,"Breach,Raze,Killjoy,Omen,Gekko","Raze,Killjoy,Viper,Omen,Fade"
Sunset,Paranoia Boys,Dropouts,8,13,4,5,8,4,"Breach,Cypher,Sova,Omen,Neon","Breach,Cypher,Omen,Neon,Gekko"
Icebox,No Sweat Blossom,Infiriumz Gaming GC,13,10,8,3,7,5,"Sova,Killjoy,Viper,Jett,Iso","Sova,Killjoy,Omen,Jett,Harbor"
Lotus,TOADS,Dropouts,7,13,7,5,8,0,"Breach,Raze,Cypher,Omen,Fade","Raze,Killjoy,Viper,Omen,Fade"
Haven,Deagle Ravagers,Dasein Club GC,13,7,6,2,5,7,"Breach,Sova,Killjoy,Omen,Jett","Breach,Sova,Killjoy,Omen,Neon"
Haven,Paranoia Boys,Poseidon Esports,16,14,10,5,9,6,"Breach,Cypher,Sova,Omen,Jett","Breach,Cypher,Sova,Omen,Jett"
Ascent,Deagle Ravagers,Dasein Club GC,13,6,3,4,2,10,"Sova,Killjoy,Omen,Jett,KAY/O","Sova,Killjoy,Omen,Jett,KAY/O"
Ascent,TOADS,Bobasaur,14,12,6,7,5,8,"Sova,Killjoy,Omen,Jett,KAY/O","Sova,Killjoy,Omen,Jett,KAY/O"
Icebox,PCIFIC Espor,The Ultimates,13,6,8,4,2,5,"Sova,Killjoy,Viper,Jett,Gekko","Omen,Jett,KAY/O,Harbor,Gekko"
Icebox,Dropouts,Forsaken Shadows,13,3,2,2,1,11,"Sova,Killjoy,Viper,Jett,Gekko","Killjoy,Viper,Reyna,Jett,Gekko"
Sunset,Paranoia Boys,Eternal Focus Crimson,13,10,7,5,5,6,"Breach,Cypher,Sova,Omen,Neon","Breach,Cypher,Omen,Neon,Fade"
Haven,Poseidon Esports,Divine Valorant,13,10,7,5,5,6,"Breach,Cypher,Sova,Omen,Jett","Sova,Killjoy,Viper,Omen,Jett"
Sunset,DSYRE,CGN Esports,9,13,2,8,5,7,"Breach,Raze,Cypher,Omen,Gekko","Raze,Cypher,Sova,Phoenix,Omen"
Lotus,PCIFIC Espor,The Ultimates,13,1,11,1,0,2,"Breach,Cypher,Sova,Omen,Neon","Raze,Viper,Omen,Chamber,Gekko"
Bind,TOADS,Una Ludio,13,10,6,6,4,7,"Raze,Cypher,Skye,Yoru,Clove","Cypher,Brimstone,Skye,Yoru,Gekko"
Lotus,Dropouts,Radiance,13,5,4,2,3,9,"Raze,Killjoy,Viper,Omen,Fade","Breach,Raze,Cypher,Omen,Fade"
Haven,Outlast Gaming,Divine Valorant,4,13,3,2,11,1,"Killjoy,Viper,Omen,Jett,Skye","Sova,Killjoy,Viper,Omen,Jett"
Haven,Forsaken Shadows,Banana Corp,13,2,10,2,0,3,"Breach,Cypher,Omen,Jett,Neon","Breach,Sova,Killjoy,Omen,Jett"
Abyss,Bobasaur,Wet Napkins,14,12,7,6,6,7,"Cypher,Sova,Omen,Yoru,Gekko","Cypher,Sova,Viper,Astra,Iso"
Ascent,Natural Order,Eternal Focus Crimson,8,13,3,6,7,5,"Breach,Sova,Sage,Omen,Jett","Raze,Sova,Killjoy,Omen,Deadlock"
Haven,Harmony,Poseidon Esports,7,13,2,6,7,5,"Breach,Cypher,Sova,Omen,Neon","Breach,Cypher,Sova,Omen,Jett"
Ascent,DSYRE,CGN Esports,3,13,0,4,9,3,"Cypher,Sova,Omen,Jett,KAY/O","Sova,Killjoy,Phoenix,Jett,Astra"
Abyss,STAKERS,REY eSports,4,13,2,3,10,2,"Cypher,Sova,Omen,Jett,Astra","Cypher,Sova,Omen,Jett,KAY/O"
Haven,DSYRE,CGN Esports,13,11,7,5,6,6,"Cypher,Sova,Omen,Yoru,Iso","Sova,Phoenix,Omen,Jett,Deadlock"
Bind,PUX Esports,Twisted Saints Esports,7,13,6,6,7,1,"Raze,Cypher,Phoenix,Fade,Harbor","Raze,Viper,Brimstone,Skye,Gekko"
Sunset,MOUZ,SAW,20,18,11,8,10,9,"Raze,Cypher,Omen,KAY/O,Gekko","Breach,Raze,Cypher,Omen,Gekko"
Sunset,STAKERS,REY eSports,13,7,5,7,0,8,"Breach,Raze,Cypher,Sova,Omen","Breach,Raze,Cypher,Omen,Gekko"
Haven,Team Nice Shot,REH Gaming,13,2,1,2,0,12,"Sova,Killjoy,Viper,Astra,Neon","Breach,Cypher,Sova,Omen,Jett"
Haven,PUX Esports,Twisted Saints Esports,9,13,3,9,4,6,"Breach,Raze,Cypher,Harbor,Iso","Killjoy,Viper,Omen,Jett,Skye"
Abyss,Kingslayers,Gladius,13,4,4,1,3,9,"Cypher,Sova,Jett,Astra,Iso","Cypher,Sova,Jett,Yoru,Astra"
Abyss,Apeks,GoNext Esports,7,13,6,6,7,1,"Cypher,Sova,Omen,Yoru,Astra","Cypher,Sova,Jett,Astra,Gekko"
Lotus,Team Colt,Banggai Cardinal,13,1,2,0,1,11,"Breach,Omen,Neon,Fade,Iso","Raze,Sage,Omen,Jett,Chamber"
Icebox,MOUZ,SAW,11,13,5,7,6,6,"Sova,Killjoy,Viper,Sage,Jett","Sova,Killjoy,Viper,Jett,Gekko"
Sunset,Team Colt,Banggai Cardinal,13,1,2,0,1,11,"Breach,Cypher,Sova,Omen,Neon","Cypher,Sova,Omen,KAY/O,Neon"
Ascent,CTRL x YARI Esports,trashcan,13,10,7,4,6,6,"Sova,Killjoy,Omen,Jett,KAY/O","Sova,Killjoy,Omen,Jett,KAY/O"
Haven,Formulation Gaming GC,Project SOS,2,13,2,10,3,0,"Breach,Omen,Skye,Chamber,Neon","Sova,Killjoy,Omen,Jett,Yoru"
Lotus,Team Nice Shot,REH Gaming,13,10,7,4,6,6,"Killjoy,Viper,Omen,Neon,Fade","Breach,Raze,Omen,Chamber,Fade"
Lotus,Atake Esports,Bitfix Gaming,2,13,2,10,3,0,"Sova,Phoenix,Skye,Chamber,Clove","Breach,Raze,Cypher,Omen,Deadlock"
Sunset,Kingslayers,Gladius,13,8,7,2,6,6,"Breach,Raze,Cypher,Sova,Omen","Cypher,Sova,Omen,KAY/O,Neon"
Haven,Apeks,GoNext Esports,5,13,4,8,5,1,"Breach,Sova,Killjoy,Omen,Jett","Breach,Cypher,Sova,Omen,Jett"
Haven,ApesOnTour,Next In Line,8,13,3,6,7,5,"Breach,Cypher,Sova,Omen,Neon","Breach,Cypher,Sova,Omen,Jett"
Ascent,Coalesce,Sentient Esports (Inactive),13,5,5,1,4,8,"Sova,Killjoy,Omen,Jett,KAY/O","Sova,Killjoy,Omen,Jett,KAY/O"
Lotus,STAKERS,REY eSports,14,16,9,6,10,5,"Breach,Killjoy,Omen,Neon,Fade","Raze,Killjoy,Viper,Omen,Fade"
Abyss,Lost Puppies,SnuTek eSports,13,9,7,3,6,6,"Breach,Cypher,Sova,Jett,Astra","Cypher,Sova,Jett,Astra,KAY/O"
Haven,Ailurus eSports,Formulation Gaming,6,13,3,9,4,3,"Cypher,Sova,Omen,Yoru,Iso","Breach,Sova,Killjoy,Omen,Neon"
Ascent,Formulation Gaming GC,Project SOS,0,13,0,1,12,0,"Sova,Killjoy,Omen,Jett,KAY/O","Cypher,Sova,Omen,Jett,Deadlock"
Sunset,E-WOLVES,Lootcifer,5,13,4,8,5,1,"Breach,Cypher,Sova,Omen,Neon","Raze,Cypher,Viper,Omen,Skye"
Ascent,Atake Esports,Bitfix Gaming,3,13,2,10,3,1,"Sova,Killjoy,Omen,Jett,KAY/O","Cypher,Sova,Omen,Jett,Deadlock"
Bind,Colony Esports,NEANLATIYONBOLM,8,13,6,3,10,2,"Raze,Viper,Brimstone,Skye,Gekko","Raze,Viper,Brimstone,Yoru,Deadlock"
Haven,Kingslayers,Gladius,3,13,1,3,10,2,"Breach,Sova,Killjoy,Astra,Neon","Killjoy,Viper,Omen,Jett,Skye"
Sunset,RYL | Royal Legion,5STARS,2,13,2,1,12,0,"Raze,Cypher,Sova,Reyna,Omen","Breach,Cypher,Sova,Omen,Neon"
Haven,DSQ Esports,Orkadia,8,13,4,8,5,4,"Breach,Sova,Killjoy,Omen,Jett","Breach,Cypher,Sova,Omen,Neon"
Ascent,ApesOnTour,Next In Line,3,13,3,9,4,0,"Sova,Killjoy,Omen,Jett,KAY/O","Sova,Killjoy,Omen,Jett,KAY/O"
Icebox,Team Nice Shot,REH Gaming,8,13,4,8,5,4,"Sova,Killjoy,Viper,Sage,Iso","Sova,Killjoy,Viper,Reyna,Jett"
Lotus,Hidden Horizon,Sakura Breeze,13,5,6,0,5,7,"Raze,Killjoy,Viper,Omen,Fade","Raze,Cypher,Omen,Fade,Deadlock"
Haven,CTRL x YARI Esports,trashcan,16,14,5,10,4,11,"Breach,Sova,Killjoy,Omen,Neon","Breach,Sova,Killjoy,Omen,Jett"
Bind,Team Colt,Twisted Saints Esports,12,14,4,9,5,8,"Raze,Viper,Omen,Skye,Iso","Raze,Viper,Brimstone,Skye,Gekko"
Sunset,Ailurus eSports,Formulation Gaming,4,13,2,10,3,2,"Raze,Cypher,Sova,Omen,Gekko","Cypher,Sova,Omen,KAY/O,Neon"
Sunset,PUX Esports,Banggai Cardinal,14,16,7,8,8,7,"Raze,Cypher,Fade,Harbor,Iso","Cypher,Sova,Omen,KAY/O,Neon"
Lotus,Jabba Enjoyers,Grow uP eSports,13,8,7,5,3,6,"Breach,Raze,Killjoy,Omen,Fade","Raze,Viper,Omen,Chamber,Fade"
Lotus,Apeks,GoNext Esports,13,11,6,6,5,7,"Raze,Cypher,Omen,KAY/O,Deadlock","Breach,Sova,Killjoy,Omen,Neon"
Abyss,MOUZ,SAW,18,16,10,7,9,8,"Cypher,Sova,Jett,Astra,KAY/O","Breach,Cypher,Sova,Jett,Astra"
Lotus,Apinaorkesteri,Da Gangalang,13,7,5,7,0,8,"Raze,Omen,Neon,Fade,Clove","Raze,Yoru,Chamber,Deadlock,Clove"
Lotus,E-WOLVES,Lootcifer,7,13,4,8,5,3,"Raze,Killjoy,Viper,Omen,Fade","Cypher,Viper,Omen,Neon,Fade"
Lotus,Lost Puppies,SnuTek eSports,13,8,9,3,5,4,"Raze,Killjoy,Viper,Omen,Fade","Breach,Raze,Sova,Killjoy,Omen"
Ascent,Hidden Horizon DACH,OnlyFins,11,13,6,6,7,5,"Sova,Killjoy,Omen,Jett,KAY/O","Cypher,Sova,Jett,Deadlock,Clove"
Bind,Sakura Breeze Academy,InTenZive,4,13,1,4,9,3,"Raze,Cypher,Omen,Fade,Gekko","Reyna,Yoru,Chamber,Neon,Clove"
Haven,Team Vortex,Purge eSports,13,9,8,2,7,5,"Raze,Killjoy,Viper,Omen,Fade","Breach,Cypher,Omen,Jett,Gekko"
Bind,DSQ Esports,Orkadia,5,13,2,4,9,3,"Raze,Viper,Brimstone,Fade,Gekko","Raze,Viper,Brimstone,Fade,Gekko"
Ascent,Colony Esports,NEANLATIYONBOLM,10,13,5,7,6,5,"Cypher,Sova,Omen,Jett,KAY/O","Sova,Killjoy,Phoenix,Omen,Jett"
Sunset,OOT Esports,STAKERS,13,15,5,9,6,8,"Breach,Raze,Cypher,Omen,Gekko","Breach,Raze,Cypher,Sova,Omen"
Ascent,Hidden Horizon,Sakura Breeze,13,3,9,3,0,4,"Sova,Killjoy,Phoenix,Jett,Astra","Sova,Killjoy,Omen,Jett,KAY/O"
Icebox,Atake Esports,Coalesce,5,13,4,8,5,1,"Sova,Killjoy,Viper,Sage,Jett","Sova,Killjoy,Viper,Omen,Jett"
Sunset,Formulation Gaming GC,Project SOS,14,12,6,7,5,8,"Breach,Raze,Cypher,Omen,Gekko","Breach,Cypher,Sova,Omen,Neon"
Haven,Apinaorkesteri,Da Gangalang,13,1,11,1,0,2,"Breach,Cypher,Sova,Omen,Jett","Sova,Killjoy,Phoenix,Neon,Clove"
Lotus,Sentient Esports (Inactive),Bitfix Gaming,5,13,1,5,8,4,"Breach,Raze,Cypher,Omen,Gekko","Breach,Raze,Cypher,Omen,Deadlock"
Abyss,REH Gaming,Gladius,6,13,3,9,4,3,"Cypher,Sova,Omen,Jett,Yoru","Cypher,Sova,Jett,Yoru,Astra"
Lotus,NoTag,HUSK.GG Main,13,0,1,0,0,12,"Raze,Killjoy,Omen,Jett,Gekko","Breach,Raze,Killjoy,Omen,Gekko"
Haven,RYL | Royal Legion,5STARS,11,13,7,5,8,4,"Breach,Cypher,Sova,Omen,Jett","Breach,Cypher,Sova,Omen,Neon"
Icebox,CTRL x YARI Esports,trashcan,6,13,0,7,6,6,"Sova,Killjoy,Viper,Neon,Gekko","Sova,Killjoy,Viper,Jett,KAY/O"
Ascent,Sakura Breeze Academy,InTenZive,1,13,1,11,2,0,"Cypher,Sova,Omen,Jett,KAY/O","Cypher,Sova,Omen,Jett,KAY/O"
Abyss,UNIWAY,Requiem,3,13,1,3,10,2,"Cypher,Sova,Yoru,Astra,KAY/O","Cypher,Sova,Omen,Jett,Harbor"
Abyss,Kingslayers,Team Nice Shot,13,11,6,6,5,7,"Cypher,Sova,Jett,Astra,Iso","Cypher,Sova,Viper,Jett,Astra"
Lotus,Team Colt,Twisted Saints Esports,13,6,8,4,2,5,"Breach,Omen,Neon,Fade,Iso","Raze,Killjoy,Viper,Omen,Fade"
Bind,Munich Esports,Universae,1,13,0,2,11,1,"Raze,Viper,Brimstone,Skye,Gekko","Raze,Viper,Omen,Fade,Gekko"
Haven,PUX Esports,Banggai Cardinal,13,6,9,3,3,4,"Breach,Raze,Cypher,Harbor,Iso","Killjoy,Viper,Omen,Jett,Skye"
Abyss,Hidden Horizon DACH,OnlyFins,7,13,6,6,7,1,"Cypher,Sova,Omen,Jett,KAY/O","Cypher,Sova,Jett,Astra,KAY/O"
Sunset,NXS OGS,Adimpleo Esports,5,13,3,3,10,2,"Raze,Cypher,Neon,Gekko,Clove","Breach,Raze,Cypher,Omen,Gekko"
Icebox,Jabba Enjoyers,Grow uP eSports,13,9,7,5,4,6,"Sova,Killjoy,Viper,Jett,Deadlock","Killjoy,Viper,Omen,KAY/O,Gekko"
Bind,NoTag,HUSK.GG Main,13,2,11,1,1,2,"Raze,Cypher,Brimstone,Yoru,Gekko","Breach,Raze,Cypher,Brimstone,Gekko"
Bind,Team Vortex,Purge eSports,13,10,4,8,2,9,"Raze,Viper,Brimstone,Fade,Deadlock","Raze,Viper,Fade,Gekko,Clove"
Haven,SNOOZE Esports,ApesOnTour,10,13,4,8,5,6,"Breach,Sova,Killjoy,Omen,Jett","Breach,Cypher,Sova,Omen,Neon"
Sunset,Akatsuki,Lootcifer,7,13,6,6,7,1,"Breach,Cypher,Sova,Omen,Neon","Raze,Cypher,Viper,Omen,Skye"
Ascent,REY eSports,Hidden Horizon EAST,13,9,8,4,5,5,"Sova,Killjoy,Omen,Jett,KAY/O","Sova,Killjoy,Omen,Jett,KAY/O"
Sunset,Atake Esports,Coalesce,6,13,4,8,5,2,"Breach,Cypher,Sova,Omen,Neon","Breach,Cypher,Sova,Omen,Neon"
Sunset,REH Gaming,Gladius,3,13,1,3,10,2,"Raze,Cypher,Sova,Omen,Iso","Cypher,Sova,Omen,KAY/O,Neon"
Abyss,Sentient Esports (Inactive),Bitfix Gaming,5,13,2,4,9,3,"Breach,Sova,Jett,Astra,Harbor","Cypher,Sova,Omen,Jett,Harbor"
Lotus,OOT Esports,STAKERS,12,14,3,10,4,9,"Breach,Raze,Cypher,Omen,Fade","Breach,Killjoy,Omen,Neon,Fade"
Haven,Kingslayers,Team Nice Shot,2,13,0,3,10,2,"Breach,Sova,Killjoy,Astra,Neon","Sova,Killjoy,Viper,Astra,Neon"
Bind,Ailurus eSports,DSQ Esports,13,10,7,5,5,6,"Raze,Viper,Brimstone,Skye,Gekko","Raze,Viper,Brimstone,Fade,Gekko"
Ascent,SnuTek eSports,Glacial Guardians,8,13,4,8,5,4,"Sova,Killjoy,Omen,Jett,KAY/O","Sova,Killjoy,Omen,Jett,KAY/O"
Lotus,UNIWAY,Requiem,6,13,3,9,4,3,"Breach,Raze,Cypher,Omen,Fade","Breach,Cypher,Omen,Neon,Fade"
Haven,Sakura Breeze,Fellas in Paris,13,11,9,3,8,4,"Cypher,Omen,Yoru,Fade,Deadlock","Cypher,Sova,Omen,Yoru,Iso"
Sunset,Da Gangalang,5STARS,9,13,3,7,6,6,"Breach,Cypher,Reyna,Omen,Neon","Breach,Raze,Cypher,Sova,Omen"
Ascent,Derve Esports,Lost Puppies,2,13,0,3,10,2,"Sova,Killjoy,Omen,Jett,KAY/O","Sova,Killjoy,Omen,Jett,KAY/O"
Ascent,NXS OGS,Adimpleo Esports,1,13,1,11,2,0,"Sova,Killjoy,Omen,Jett,KAY/O","Sova,Killjoy,Omen,Jett,KAY/O"
Haven,Munich Esports,Universae,5,13,1,5,8,4,"Breach,Sova,Killjoy,Omen,Jett","Breach,Sova,Killjoy,Omen,Jett"
Lotus,RYL | Royal Legion,Apinaorkesteri,2,13,0,3,10,2,"Breach,Omen,Neon,Fade,Clove","Raze,Killjoy,Viper,Omen,Fade"
Haven,E-WOLVES,Siko Esports,10,13,8,4,9,2,"Killjoy,Viper,Omen,Jett,Skye","Breach,KAY/O,Harbor,Gekko,Iso"
Ascent,Orkadia,Formulation Gaming,4,13,0,5,8,4,"Sova,Killjoy,Omen,Jett,KAY/O","Sova,Killjoy,Omen,Jett,KAY/O"
Haven,Formulation Gaming GC,Colony Esports,12,14,8,5,9,4,"Breach,Omen,Skye,Chamber,Neon","Breach,Cypher,Sova,Omen,Neon"
Haven,NEANLATIYONBOLM,Project SOS,13,7,7,1,6,6,"Sova,Killjoy,Omen,Jett,Yoru","Sova,Killjoy,Viper,Omen,Yoru"
Abyss,Team Colt,Twisted Saints Esports,10,13,3,8,5,7,"Cypher,Sova,Jett,Yoru,Astra","Cypher,Sova,Jett,Astra,Gekko"
Bind,REY ACADEMY,HUSK.GG Main,13,2,3,0,2,10,"Raze,Viper,Brimstone,Fade,Gekko","Breach,Raze,Cypher,Brimstone,Gekko"
Bind,Derve Esports,Lost Puppies,0,13,0,12,1,0,"Raze,Viper,Brimstone,Fade,Gekko","Raze,Cypher,Brimstone,Skye,Deadlock"
Bind,PUX Esports,Banggai Cardinal,12,14,10,3,11,2,"Raze,Cypher,Phoenix,Fade,Harbor","Raze,Viper,Brimstone,Fade,Gekko"
Ascent,Team Vortex,Jabba Enjoyers,2,13,0,3,10,2,"Sova,Killjoy,Omen,Jett,KAY/O","Sova,Killjoy,Omen,Jett,KAY/O"
Haven,UNIWAY,NXS OGS,13,2,3,0,2,10,"Breach,Sova,Killjoy,Omen,Jett","Breach,Sova,Killjoy,Omen,Jett"
Haven,REH Gaming,Gladius,13,10,9,2,8,4,"Cypher,Sova,Omen,Neon,Iso","Killjoy,Viper,Omen,Jett,Skye"
Sunset,Ailurus eSports,DSQ Esports,13,6,10,2,4,3,"Raze,Cypher,Sova,Omen,Gekko","Breach,Cypher,Sova,Omen,Neon"
Sunset,OnlyFins,InTenZive,13,11,8,4,7,5,"Breach,Raze,Cypher,Sova,Clove","Raze,Cypher,Sova,Omen,Gekko"
Bind,OOT Esports,STAKERS,13,10,5,7,3,8,"Raze,Viper,Brimstone,Fade,Gekko","Raze,Viper,Brimstone,Fade,Gekko"
Sunset,RYL | Royal Legion,Apinaorkesteri,3,13,3,9,4,0,"Breach,Cypher,Sova,Omen,Neon","Cypher,Sova,Omen,KAY/O,Neon"
Haven,Akatsuki,Lootcifer,9,13,6,4,9,3,"Breach,Sova,Killjoy,Omen,Jett","Killjoy,Viper,Omen,Skye,Neon"
Haven,Grow uP eSports,Purge eSports,13,6,10,2,4,3,"Breach,Sova,Killjoy,Omen,Neon","Breach,Cypher,Omen,Jett,Gekko"
Haven,Da Gangalang,5STARS,6,13,4,8,5,2,"Breach,Sova,Killjoy,Omen,Jett","Breach,Cypher,Sova,Omen,Jett"
Bind,Sakura Breeze,Fellas in Paris,9,13,4,6,7,5,"Raze,Viper,Omen,Yoru,Fade","Raze,Viper,Brimstone,Skye,Gekko"
Lotus,REY eSports,Hidden Horizon EAST,13,9,5,5,4,8,"Raze,Killjoy,Viper,Omen,Fade","Breach,Cypher,Sova,Omen,Neon"
Icebox,SnuTek eSports,Glacial Guardians,7,13,3,9,4,4,"Breach,Sova,Killjoy,Viper,Jett","Killjoy,Viper,Jett,KAY/O,Gekko"
Sunset,E-WOLVES,Siko Esports,7,13,3,9,4,4,"Breach,Cypher,Sova,Omen,Neon","Breach,Cypher,Neon,Iso,Clove"
Sunset,Orkadia,Formulation Gaming,4,13,4,8,5,0,"Breach,Raze,Cypher,Omen,Gekko","Cypher,Sova,Omen,KAY/O,Neon"
Ascent,SNOOZE Esports,ApesOnTour,13,15,8,6,9,5,"Sova,Killjoy,Omen,Jett,KAY/O","Sova,Killjoy,Omen,Jett,KAY/O"
Ascent,CTRL x YARI Esports,Munich Esports,13,8,5,4,4,8,"Sova,Killjoy,Omen,Jett,KAY/O","Sova,Killjoy,Omen,Jett,KAY/O"
Bind,NEANLATIYONBOLM,Project SOS,13,2,10,2,0,3,"Raze,Viper,Brimstone,Yoru,Deadlock","Raze,Viper,Brimstone,Fade,Gekko"
Sunset,Kingslayers,Team Nice Shot,13,8,7,5,3,6,"Breach,Raze,Cypher,Sova,Omen","Cypher,Sova,Omen,KAY/O,Neon"
Haven,Sakura Breeze Academy,Hidden Horizon DACH,0,13,0,1,12,0,"Breach,Cypher,Omen,Jett,Fade","Sova,Killjoy,Omen,Yoru,Iso"
Abyss,Adimpleo Esports,Requiem,1,13,1,11,2,0,"Reyna,Jett,Chamber,Harbor,Gekko","Cypher,Sova,Omen,Jett,Harbor"
Bind,Bitfix Gaming,Coalesce,13,10,6,5,5,7,"Raze,Cypher,Brimstone,Skye,Deadlock","Raze,Viper,Brimstone,Fade,Gekko"
Ascent,Formulation Gaming GC,Colony Esports,3,13,2,10,3,1,"Sova,Killjoy,Omen,Jett,KAY/O","Cypher,Sova,Omen,Jett,KAY/O"
Sunset,Universae,trashcan,6,13,3,4,9,3,"Breach,Raze,Cypher,Omen,Gekko","Cypher,Sova,Omen,KAY/O,Neon"
Lotus,UNIWAY,NXS OGS,13,0,12,0,0,1,"Breach,Raze,Cypher,Omen,Fade","Breach,Raze,Killjoy,Omen,Gekko"
Haven,Adimpleo Esports,Requiem,0,13,0,12,1,0,"Breach,Cypher,Sova,Omen,Jett","Cypher,Sova,Omen,Yoru,Iso"
Icebox,Team Vortex,Jabba Enjoyers,3,13,2,2,11,1,"Killjoy,Yoru,Astra,Fade,Harbor","Sova,Killjoy,Viper,Jett,Deadlock"
Sunset,Atake Esports,Sentient Esports (Inactive),13,15,5,9,6,8,"Breach,Cypher,Sova,Omen,Neon","Raze,Cypher,Sova,Omen,Gekko"
Bind,Sakura Breeze Academy,Hidden Horizon DACH,1,13,1,11,2,0,"Raze,Cypher,Omen,Fade,Gekko","Raze,Cypher,Brimstone,Skye,Yoru"
Lotus,Sakura Breeze,Fellas in Paris,13,5,2,4,1,11,"Raze,Cypher,Omen,Fade,Deadlock","Breach,Raze,Cypher,Omen,Fade"
Ascent,REY ACADEMY,HUSK.GG Main,13,10,7,5,5,6,"Sova,Killjoy,Omen,Jett,KAY/O","Breach,Cypher,Sova,Omen,Jett"
Lotus,CTRL x YARI Esports,Munich Esports,13,5,5,1,4,8,"Breach,Cypher,Omen,Neon,Fade","Raze,Killjoy,Viper,Omen,Fade"
Lotus,Grow uP eSports,Purge eSports,13,5,3,3,2,10,"Raze,Viper,Omen,Chamber,Fade","Breach,Raze,Killjoy,Viper,Omen"
Bind,PUX Esports,Team Colt,7,13,5,7,6,2,"Raze,Cypher,Phoenix,Fade,Harbor","Raze,Viper,Omen,Skye,Iso"
Lotus,Siko Esports,Lootcifer,2,13,0,3,10,2,"Raze,Killjoy,Viper,Omen,Fade","Cypher,Viper,Omen,Neon,Fade"
Haven,OnlyFins,InTenZive,13,11,5,7,4,8,"Breach,Sova,Killjoy,Jett,Clove","Cypher,Sova,Omen,Yoru,Iso"
Ascent,Gladius,Team Nice Shot,13,8,5,7,1,8,"Cypher,Sova,Omen,Jett,KAY/O","Sova,Killjoy,Omen,Jett,KAY/O"
Haven,Universae,trashcan,6,13,5,2,11,1,"Breach,Sova,Killjoy,Omen,Jett","Breach,Sova,Killjoy,Omen,Jett"
Icebox,SNOOZE Esports,ApesOnTour,13,9,8,4,5,5,"Sova,Killjoy,Viper,Jett,Gekko","Sova,Killjoy,Viper,Reyna,Harbor"
Lotus,Kingslayers,REH Gaming,7,13,3,9,4,4,"Breach,Raze,Cypher,Omen,Gekko","Breach,Omen,Chamber,Neon,Fade"
Sunset,RYL | Royal Legion,Da Gangalang,13,8,6,3,5,7,"Breach,Cypher,Sova,Omen,Neon","Breach,Cypher,Omen,Neon,Iso"
Lotus,Ailurus eSports,Orkadia,7,13,0,8,5,7,"Raze,Cypher,Viper,Omen,Fade","Raze,Killjoy,Viper,Omen,Fade"
Sunset,Hidden Horizon EAST,STAKERS,13,11,4,8,3,9,"Breach,Cypher,Sova,Omen,Neon","Raze,Cypher,Sova,Omen,KAY/O"
Icebox,Bitfix Gaming,Coalesce,11,13,5,7,6,6,"Sova,Killjoy,Viper,Sage,Jett","Sova,Killjoy,Viper,Reyna,Jett"
Haven,Derve Esports,SnuTek eSports,12,14,6,7,7,6,"Breach,Sova,Killjoy,Omen,Jett","Breach,Cypher,Sova,Omen,Jett"
Bind,InTenZive,Hidden Horizon DACH,13,3,3,1,2,10,"Raze,Viper,Brimstone,Fade,Gekko","Raze,Viper,Brimstone,Skye,Fade"
Abyss,Atake Esports,Sentient Esports (Inactive),13,10,6,5,5,7,"Sova,Killjoy,Viper,Yoru,Astra","Breach,Sova,Jett,Astra,Harbor"
Haven,Kingslayers,REH Gaming,13,5,3,3,2,10,"Breach,Sova,Killjoy,Astra,Neon","Cypher,Sova,Phoenix,Omen,Jett"
Sunset,Siko Esports,Lootcifer,2,13,2,10,3,0,"Breach,Raze,Cypher,Sova,Omen","Raze,Cypher,Viper,Omen,Skye"
Lotus,Glacial Guardians,Lost Puppies,7,13,3,5,8,4,"Breach,Omen,Neon,Fade,Clove","Raze,Killjoy,Viper,Omen,Fade"
Bind,OOT Esports,REY eSports,12,14,5,8,6,7,"Raze,Viper,Brimstone,Fade,Gekko","Raze,Viper,Brimstone,Skye,Gekko"
Haven,UNIWAY,Adimpleo Esports,13,8,6,3,5,7,"Breach,Sova,Killjoy,Omen,Jett","Breach,Cypher,Sova,Omen,Jett"
Sunset,PUX Esports,Team Colt,13,5,7,5,0,6,"Raze,Cypher,Fade,Harbor,Iso","Breach,Cypher,Sova,Omen,Neon"
Lotus,5STARS,Apinaorkesteri,7,13,4,8,5,3,"Raze,Killjoy,Viper,Omen,Fade","Raze,Killjoy,Viper,Omen,Fade"
Sunset,NoTag,REY ACADEMY,13,7,7,1,6,6,"Raze,Cypher,Gekko,Iso,Clove","Raze,Cypher,Sova,Omen,KAY/O"
Haven,Hidden Horizon EAST,STAKERS,13,2,10,2,0,3,"Breach,Sova,Killjoy,Omen,Neon","Breach,Sova,Killjoy,Omen,Neon"
Bind,Hidden Horizon,Fellas in Paris,13,9,5,5,4,8,"Raze,Cypher,Viper,Brimstone,Skye","Raze,Viper,Brimstone,Skye,Gekko"
Bind,Project SOS,Colony Esports,17,15,10,6,9,7,"Raze,Viper,Brimstone,Fade,Gekko","Raze,Viper,Brimstone,Skye,Gekko"
Bind,Team Vortex,Grow uP eSports,13,6,5,2,4,8,"Raze,Viper,Brimstone,Fade,Deadlock","Raze,Brimstone,Fade,Gekko,Deadlock"
Lotus,trashcan,Munich Esports,13,0,12,0,0,1,"Raze,Killjoy,Viper,Omen,Fade","Raze,Killjoy,Viper,Omen,Fade"
Abyss,Akatsuki,E-WOLVES,13,5,9,3,2,4,"Cypher,Sova,Omen,Jett,Gekko","Breach,Sova,Viper,Jett,Astra"
Ascent,CTRL x YARI Esports,Universae,13,3,4,0,3,9,"Sova,Killjoy,Omen,Jett,KAY/O","Cypher,Sova,Omen,Jett,Deadlock"
Ascent,Asgard Esports,ApesOnTour,0,13,0,1,12,0,"Sova,Killjoy,Omen,Jett,KAY/O","Sova,Killjoy,Omen,Jett,KAY/O"
Bind,Formulation Gaming GC,NEANLATIYONBOLM,4,13,2,3,10,2,"Raze,Viper,Skye,Gekko,Clove","Raze,Viper,Brimstone,Yoru,Deadlock"
Haven,RYL | Royal Legion,Da Gangalang,13,10,7,4,6,6,"Breach,Cypher,Sova,Omen,Neon","Breach,Sova,Killjoy,Omen,Jett"
Sunset,Gladius,Team Nice Shot,15,13,4,10,3,11,"Cypher,Sova,Omen,KAY/O,Neon","Cypher,Sova,Omen,KAY/O,Neon"
Abyss,Purge eSports,Jabba Enjoyers,1,13,0,2,11,1,"Breach,Cypher,Sova,Jett,Astra","Sova,Killjoy,Viper,Yoru,Astra"
Ascent,SNOOZE Esports,Next In Line,10,13,7,4,9,3,"Sova,Killjoy,Omen,Jett,KAY/O","Sova,Killjoy,Omen,Jett,KAY/O"
Bind,Twisted Saints Esports,Banggai Cardinal,13,9,7,3,6,6,"Raze,Viper,Brimstone,Skye,Gekko","Raze,Viper,Brimstone,Fade,Gekko"
Lotus,Bitfix Gaming,Coalesce,16,14,9,6,8,7,"Breach,Raze,Cypher,Omen,Deadlock","Breach,Raze,Killjoy,Omen,Gekko"
Icebox,Derve Esports,SnuTek eSports,11,13,4,8,5,7,"Sova,Killjoy,Viper,Jett,Gekko","Breach,Sova,Killjoy,Viper,Jett"
Haven,Asgard Esports,ApesOnTour,3,13,1,11,2,2,"Breach,Cypher,Sova,Omen,Jett","Breach,Cypher,Sova,Omen,Neon"
Lotus,UNIWAY,Adimpleo Esports,13,1,11,1,0,2,"Breach,Raze,Cypher,Omen,Fade","Breach,Raze,Viper,Omen,Chamber"
Haven,PUX Esports,Team Colt,6,13,0,7,6,6,"Breach,Raze,Cypher,Harbor,Iso","Breach,Sova,Killjoy,Omen,Jett"
Haven,Project SOS,Colony Esports,13,6,6,1,5,7,"Sova,Killjoy,Viper,Omen,Yoru","Breach,Cypher,Sova,Omen,Neon"
Haven,Siko Esports,Lootcifer,14,12,9,4,8,5,"Breach,Cypher,Sova,Omen,Jett","Breach,Sova,Killjoy,Omen,Neon"
Lotus,OOT Esports,REY eSports,8,13,2,10,3,6,"Breach,Raze,Cypher,Omen,Fade","Raze,Killjoy,Viper,Omen,Fade"
Abyss,InTenZive,Hidden Horizon DACH,13,10,6,6,4,7,"Cypher,Sova,Jett,Astra,Gekko","Cypher,Sova,Omen,Jett,KAY/O"
Abyss,Kingslayers,REH Gaming,11,13,7,5,8,4,"Cypher,Sova,Jett,Yoru,Astra","Cypher,Sova,Jett,Yoru,Astra"
Ascent,Formulation Gaming,DSQ Esports,13,4,8,4,0,5,"Sova,Killjoy,Omen,Jett,KAY/O","Cypher,Sova,Omen,Jett,Deadlock"
Sunset,Glacial Guardians,Lost Puppies,11,13,3,9,4,8,"Cypher,Omen,KAY/O,Neon,Gekko","Breach,Cypher,Sova,Omen,Neon"
Sunset,SNOOZE Esports,Next In Line,4,13,3,9,4,1,"Breach,Raze,Cypher,Sova,Omen","Breach,Raze,Cypher,Omen,Gekko"
Haven,Gladius,Team Nice Shot,2,13,0,3,10,2,"Killjoy,Viper,Omen,Jett,Skye","Sova,Killjoy,Viper,Astra,Neon"
Bind,Purge eSports,Jabba Enjoyers,2,13,2,1,12,0,"Raze,Viper,Fade,Gekko,Clove","Raze,Viper,Brimstone,Fade,Gekko"
Bind,Ailurus eSports,Orkadia,8,13,7,5,8,1,"Raze,Viper,Brimstone,Skye,Gekko","Raze,Viper,Brimstone,Fade,Gekko"
Haven,Akatsuki,E-WOLVES,13,5,4,2,3,9,"Breach,Sova,Killjoy,Omen,Jett","Killjoy,Viper,Omen,Jett,Skye"
Lotus,Atake Esports,Sentient Esports (Inactive),10,13,5,6,7,5,"Raze,Killjoy,Viper,Omen,Fade","Breach,Raze,Cypher,Omen,Gekko"
Haven,CTRL x YARI Esports,Universae,13,6,5,2,4,8,"Breach,Sova,Killjoy,Omen,Neon","Breach,Sova,Killjoy,Omen,Jett"
Sunset,5STARS,Apinaorkesteri,7,13,7,5,8,0,"Breach,Raze,Cypher,Sova,Omen","Cypher,Sova,Omen,KAY/O,Neon"
Abyss,trashcan,Munich Esports,13,5,10,2,3,3,"Cypher,Sova,Omen,Jett,KAY/O","Cypher,Sova,Jett,Astra,Gekko"
Lotus,Hidden Horizon EAST,STAKERS,11,13,9,3,10,2,"Breach,Cypher,Sova,Omen,Neon","Breach,Killjoy,Omen,Neon,Fade"
Ascent,NoTag,REY ACADEMY,13,10,7,4,6,6,"Killjoy,Reyna,Omen,Jett,KAY/O","Sova,Killjoy,Omen,Jett,KAY/O"
Icebox,Formulation Gaming GC,NEANLATIYONBOLM,1,13,1,11,2,0,"Sova,Killjoy,Viper,Sage,Jett","Sova,Killjoy,Viper,Jett,Neon"
Sunset,Team Vortex,Grow uP eSports,13,6,9,3,3,4,"Breach,Raze,Cypher,Omen,Gekko","Breach,Raze,Cypher,Omen,Fade"
Haven,Hidden Horizon,Fellas in Paris,13,10,7,5,5,6,"Breach,Sova,Killjoy,Omen,Neon","Cypher,Sova,Omen,Yoru,Iso"
Abyss,RYL | Royal Legion,Da Gangalang,5,13,2,4,9,3,"Sova,Omen,Jett,Astra,KAY/O","Breach,Reyna,Omen,Neon,Deadlock"
Haven,Twisted Saints Esports,Banggai Cardinal,13,2,10,2,0,3,"Killjoy,Viper,Omen,Jett,Skye","Killjoy,Viper,Omen,Jett,Skye"
Sunset,Sakura Breeze Academy,OnlyFins,0,13,0,12,1,0,"Breach,Raze,Cypher,Omen,Gekko","Breach,Raze,Cypher,Sova,Omen"
Icebox,Haven Liberty,ESR Selection,13,9,5,5,4,8,"Sova,Killjoy,Reyna,Jett,Clove","Sova,Killjoy,Viper,Jett,KAY/O"
Sunset,Haven Liberty,ESR Selection,13,6,3,4,2,10,"Raze,Cypher,Sova,Deadlock,Clove","Breach,Raze,Cypher,Sova,Omen"
Ascent,Haven Liberty,ESR Selection,5,13,4,8,5,1,"Sova,Killjoy,Reyna,Omen,Jett","Sova,Killjoy,Omen,Jett,KAY/O"
Haven,Definite,ESR Selection,12,14,5,8,6,7,"Breach,Sova,Killjoy,Omen,Neon","Breach,Cypher,Sova,Astra,Neon"
Sunset,Definite,ESR Selection,6,13,2,5,8,4,"Breach,Raze,Cypher,Sova,Omen","Breach,Raze,Cypher,Sova,Omen"
Lotus,Definite,ESR Selection,13,11,9,3,8,4,"Killjoy,Viper,Omen,Neon,Fade","Raze,Killjoy,Viper,Omen,Fade"
Ascent,Haven Liberty,OEGHS A,13,2,11,1,1,2,"Raze,Sova,Killjoy,Omen,Iso","Sova,Killjoy,Omen,Jett,KAY/O"
Haven,Azzy White,Infiriumz Gaming GC,9,13,5,5,8,4,"Breach,Cypher,Sova,Omen,Neon","Breach,Sova,Killjoy,Omen,Neon"
Haven,Haven Liberty,OEGHS A,13,2,3,0,2,10,"Raze,Sova,Killjoy,Iso,Clove","Breach,Cypher,Sova,Omen,Jett"
Lotus,New Combat Line GC,No Sweat Blossom,13,10,5,7,3,8,"Raze,Killjoy,Viper,Omen,Fade","Breach,Raze,Killjoy,Omen,Gekko"
Ascent,Azzy White,Infiriumz Gaming GC,9,13,3,7,6,6,"Sova,Killjoy,Omen,Jett,KAY/O","Sova,Killjoy,Omen,Jett,KAY/O"
Ascent,New Combat Line GC,No Sweat Blossom,13,7,7,1,6,6,"Sova,Killjoy,Omen,Jett,KAY/O","Cypher,Sova,Omen,Yoru,Deadlock"
Bind,Azzy White,Infiriumz Gaming GC,13,9,7,5,4,6,"Raze,Viper,Brimstone,Skye,Deadlock","Raze,Viper,Brimstone,Yoru,Gekko"
Abyss,XSOUL GC,Deagle Ravagers,15,13,8,6,7,7,"Breach,Cypher,Sova,Astra,Neon","Cypher,Sova,Omen,Jett,KAY/O"
Bind,XSOUL GC,Deagle Ravagers,9,13,5,5,8,4,"Breach,Raze,Cypher,Brimstone,Yoru","Raze,Viper,Brimstone,Skye,Gekko"
Ascent,Dasein Club GC,Return of the Ashes,13,4,8,4,0,5,"Sova,Killjoy,Omen,Jett,KAY/O","Cypher,Sova,Omen,Jett,KAY/O"
Haven,XSOUL GC,Deagle Ravagers,13,11,6,6,5,7,"Breach,Cypher,Sova,Omen,Neon","Breach,Sova,Killjoy,Omen,Jett"
Haven,Dasein Club GC,Return of the Ashes,13,3,10,2,1,3,"Breach,Sova,Killjoy,Omen,Neon","Breach,Cypher,Sova,Omen,Neon"
Ascent,No Sweat Blossom,Infiriumz Gaming GC,13,11,9,3,8,4,"Cypher,Sova,Omen,Yoru,Deadlock","Sova,Killjoy,Omen,Jett,KAY/O"
Abyss,New Combat Line GC,Azzy White,13,1,11,1,0,2,"Breach,Cypher,Sova,Omen,Jett","Cypher,Sova,Omen,Jett,KAY/O"
Ascent,New Combat Line GC,Azzy White,13,5,4,2,3,9,"Raze,Sova,Killjoy,Omen,KAY/O","Cypher,Sova,Omen,Jett,KAY/O"
Sunset,No Sweat Blossom,Infiriumz Gaming GC,13,11,8,4,7,5,"Breach,Raze,Cypher,Omen,Gekko","Breach,Raze,Cypher,Omen,Gekko"
Ascent,Dasein Club GC,XSOUL GC,3,13,2,2,11,1,"Sova,Killjoy,Omen,Jett,KAY/O","Breach,Sova,Killjoy,Omen,Jett"
Haven,Deagle Ravagers,Return of the Ashes,13,9,7,5,4,6,"Breach,Sova,Killjoy,Omen,Jett","Breach,Cypher,Sova,Omen,Neon"
Ascent,Deagle Ravagers,Return of the Ashes,13,2,3,0,2,10,"Sova,Killjoy,Omen,Jett,KAY/O","Breach,Raze,Cypher,Sova,Omen"
Abyss,Dasein Club GC,XSOUL GC,5,13,3,9,4,2,"Cypher,Sova,Jett,Astra,Gekko","Breach,Cypher,Sova,Astra,Neon"
Sunset,Bon Bon Bum Contra GC,Akave Esports Black,6,13,0,7,6,6,"Breach,Sova,Sage,Omen,Gekko","Breach,Raze,Cypher,Omen,Gekko"
Haven,Bon Bon Bum Contra GC,Akave Esports Black,10,13,4,7,6,6,"Breach,Sova,Killjoy,Omen,Chamber","Breach,Cypher,Sova,Omen,Jett"
Haven,Leviatán GC,KRÜ BLAZE,15,13,9,5,8,6,"Breach,Cypher,Sova,Omen,Neon","Breach,Sova,Killjoy,Omen,Jett"
Icebox,Leviatán GC,KRÜ BLAZE,1,13,0,2,11,1,"Sova,Killjoy,Viper,Jett,KAY/O","Sova,Killjoy,Harbor,Iso,Clove"
Icebox,Leviatán GC,KRÜ BLAZE,1,13,0,2,11,1,"Sova,Killjoy,Viper,Jett,KAY/O","Sova,Killjoy,Harbor,Iso,Clove"
Ascent,K7 Esports GC,MYVRA GC,10,13,7,4,9,3,"Sova,Killjoy,Omen,Jett,KAY/O","Sova,Killjoy,Jett,KAY/O,Clove"
Abyss,K7 Esports GC,MYVRA GC,4,13,1,4,9,3,"Breach,Cypher,Sova,Omen,Jett","Breach,Raze,Cypher,Sova,Astra"
Sunset,Zen eSports GC,9z Team GC,10,13,4,8,5,6,"Breach,Cypher,Sova,Omen,Neon","Breach,Cypher,Omen,Neon,Gekko"
Abyss,Zen eSports GC,9z Team GC,5,13,3,3,10,2,"Breach,Cypher,Sova,Omen,Jett","Cypher,Sova,Omen,Jett,Harbor"
Ascent,KS Esports GC,FUSION X,5,13,5,7,6,0,"Cypher,Sova,Omen,Yoru,Deadlock","Raze,Sova,KAY/O,Iso,Clove"
Icebox,KS Esports GC,FUSION X,13,11,7,5,6,6,"Sova,Killjoy,Viper,Jett,Gekko","Killjoy,Jett,Astra,Gekko,Iso"
Abyss,KS Esports GC,FUSION X,5,13,4,8,5,1,"Sova,Omen,Yoru,Astra,Deadlock","Breach,Cypher,Jett,Astra,Gekko"
Haven,University War GC,FiRePOWER GC,11,13,7,5,8,4,"Breach,Cypher,Sova,Omen,Neon","Breach,Sova,Killjoy,Omen,Neon"
Abyss,University War GC,FiRePOWER GC,7,13,1,7,6,6,"Breach,Cypher,Sova,Omen,Jett","Cypher,Sova,Omen,Jett,KAY/O"
Ascent,University War GC,FiRePOWER GC,13,10,5,7,3,8,"Sova,Killjoy,Omen,Jett,KAY/O","Sova,Killjoy,Omen,Jett,KAY/O"
Sunset,Blinn Esports,SaD Esports,5,13,4,8,5,1,"Breach,Cypher,Omen,Neon,Gekko","Breach,Raze,Cypher,Sova,Omen"
Haven,Blinn Esports,SaD Esports,11,13,5,7,6,6,"Breach,Cypher,Sova,Omen,Neon","Sova,Jett,Astra,Deadlock,Iso"
Bind,kellogs cereal,Made in O'Block,13,7,7,5,2,6,"Raze,Cypher,Viper,Skye,Clove","Raze,Skye,Gekko,Deadlock,Clove"
Abyss,Freaky Furries,SaD Esports,3,13,0,4,9,3,"Cypher,Sova,Jett,Yoru,Astra","Cypher,Sova,Omen,Yoru,Harbor"
Ascent,Blinn Esports,ENVEE Esports,13,4,4,1,3,9,"Cypher,Sova,Omen,Yoru,Deadlock","Sova,Killjoy,Omen,Jett,KAY/O"
Sunset,kellogs cereal,Made in O'Block,13,9,6,6,3,7,"Breach,Raze,Cypher,Gekko,Clove","Breach,Raze,Cypher,Omen,Fade"
Bind,Freaky Furries,SaD Esports,13,8,7,5,3,6,"Raze,Viper,Brimstone,Skye,Deadlock","Raze,Cypher,Viper,Brimstone,Fade"
Sunset,Prime (NA),FAWZ Purple,13,3,11,1,2,2,"Breach,Raze,Cypher,Sova,Clove","Breach,Cypher,Sova,Omen,Neon"
Haven,Freaky Furries,SaD Esports,8,13,3,9,4,5,"Breach,Cypher,Sova,Omen,Jett","Sova,Jett,Astra,Deadlock,Iso"
Abyss,Blinn Esports,ENVEE Esports,13,11,6,6,5,7,"Cypher,Sova,Omen,Yoru,Harbor","Cypher,Viper,Omen,Yoru,Fade"
Haven,kellogs cereal,Made in O'Block,9,13,5,5,8,4,"Breach,Sova,Killjoy,Omen,Jett","Breach,Sova,Killjoy,Omen,Neon"
Bind,Prime (NA),FAWZ Purple,13,7,7,5,2,6,"Raze,Cypher,Sova,Brimstone,Clove","Raze,Viper,Brimstone,Fade,Gekko"
Abyss,EDward Gaming,Team Heretics,13,9,8,4,5,5,"Sova,Omen,Jett,Astra,KAY/O","Cypher,Sova,Jett,Astra,Gekko"
Bind,EDward Gaming,Team Heretics,11,13,6,6,7,5,"Raze,Viper,Brimstone,Fade,Gekko","Raze,Viper,Brimstone,Fade,Gekko"
Lotus,EDward Gaming,Team Heretics,13,9,7,3,6,6,"Breach,Omen,Neon,Fade,Clove","Raze,Killjoy,Viper,Omen,Fade"
Sunset,EDward Gaming,Team Heretics,13,4,11,1,3,2,"Cypher,Sova,Omen,KAY/O,Neon","Raze,Cypher,Sova,Omen,KAY/O"
Haven,EDward Gaming,Team Heretics,6,13,3,9,4,3,"Breach,Cypher,Sova,Omen,Neon","Breach,Cypher,Sova,Omen,Neon"
Sunset,FDR,Eternal Focus Crimson,6,13,1,6,7,5,"Breach,Raze,Cypher,Omen,Gekko","Breach,Cypher,Omen,Neon,Fade"
Abyss,FDR,Eternal Focus Crimson,13,6,5,2,4,8,"Cypher,Sova,Omen,Jett,Gekko","Cypher,Sova,Yoru,Astra,Gekko"
Sunset,West Virginia University,ENVEE Esports,5,13,2,4,9,3,"Breach,Cypher,Sova,Omen,Neon","Breach,Cypher,Sova,Omen,Neon"
Bind,FDR,Eternal Focus Crimson,8,13,3,6,7,5,"Raze,Viper,Brimstone,Fade,Gekko","Omen,Yoru,Fade,Harbor,Deadlock"
Haven, Unjustified,kellogs cereal,9,13,7,5,8,2,"Breach,Cypher,Sova,Omen,Jett","Breach,Sova,Killjoy,Omen,Jett"
Abyss,West Virginia University,ENVEE Esports,4,13,4,8,5,0,"Cypher,Sova,Omen,Jett,Harbor","Cypher,Viper,Omen,Yoru,Fade"
Bind,Una Ludio,FDR,6,13,4,8,5,2,"Raze,Cypher,Brimstone,Skye,Fade","Raze,Viper,Brimstone,Fade,Gekko"
Ascent,Mythos Wraiths,Eternal Focus Crimson,4,13,3,9,4,1,"Cypher,Sova,Omen,Jett,Deadlock","Raze,Sova,Killjoy,Omen,Deadlock"
Bind,Freaky Furries,Koufs Fun Club,13,11,5,7,4,8,"Raze,Viper,Brimstone,Skye,Deadlock","Raze,Brimstone,Yoru,Fade,Deadlock"
Ascent,Prime (NA),Gondal Enjoyers,13,5,3,3,2,10,"Sova,Killjoy,Omen,Jett,Fade","Cypher,Sova,Omen,Jett,Iso"
Ascent,Mongolia Car,SaD Esports,8,13,5,7,6,3,"Sova,Killjoy,Omen,Jett,KAY/O","Cypher,Sova,Omen,Jett,Deadlock"
Ascent, Unjustified,kellogs cereal,13,15,4,10,5,9,"Sova,Killjoy,Omen,Jett,KAY/O","Sova,Killjoy,Omen,Jett,KAY/O"
Ascent,Blinn Esports,1KRR and Racoone,13,3,10,2,1,3,"Cypher,Sova,Omen,Yoru,Deadlock","Cypher,Sova,Omen,Jett,Deadlock"
Sunset,Converse Purple,Eternal Focus Crimson,4,13,3,9,4,1,"Breach,Raze,Cypher,Sova,Omen","Breach,Cypher,Omen,Neon,Fade"
Sunset,SaD FROST,FDR,5,13,3,9,4,2,"Cypher,Omen,KAY/O,Neon,Gekko","Breach,Raze,Cypher,Omen,Gekko"
Ascent,West Virginia University,ENVEE Esports,17,15,10,6,9,7,"Sova,Killjoy,Omen,Jett,KAY/O","Sova,Killjoy,Omen,Jett,KAY/O"
Bind,UC CSU,Cumberland Phoenix,8,13,4,8,5,4,"Raze,Viper,Brimstone,Reyna,Skye","Breach,Neon,Fade,Iso,Clove"
Ascent,Low Budget,Una Ludio,8,13,2,7,6,6,"Sova,Killjoy,Omen,Jett,KAY/O","Sova,Killjoy,Omen,Jett,KAY/O"
Ascent,FAWZ Purple,lost cause,13,6,7,0,6,6,"Sova,Killjoy,Omen,Jett,KAY/O","Sova,Killjoy,Omen,Jett,KAY/O"
Haven,Freaky Furries,Koufs Fun Club,13,9,9,3,6,4,"Breach,Cypher,Sova,Omen,Jett","Sova,Killjoy,Omen,Jett,Iso"
Sunset,Mongolia Car,SaD Esports,5,13,3,9,4,2,"Breach,Cypher,Sova,Omen,Neon","Breach,Raze,Cypher,Sova,Omen"
Icebox,Forsaken Shadows,Mythos Wraiths,11,13,4,8,5,7,"Sova,Killjoy,Viper,Jett,Yoru","Sova,Killjoy,Viper,Jett,Harbor"
Haven,Prime (NA),Gondal Enjoyers,14,12,8,5,7,6,"Sova,Killjoy,Viper,Omen,Jett","Cypher,Sova,Yoru,Iso,Clove"
Haven,Blinn Esports,1KRR and Racoone,13,9,4,6,3,9,"Breach,Sova,Omen,Chamber,Neon","Breach,Cypher,Omen,Jett,Deadlock"
Ascent,Made in O'Block,Ivy League Dropouts,13,10,3,9,1,10,"Sova,Killjoy,Omen,Jett,KAY/O","Cypher,Sova,Omen,Yoru,Deadlock"
Abyss,Vovin, Unjustified,8,13,2,7,6,6,"Cypher,Sova,Jett,Yoru,Astra","Sova,Viper,Jett,Yoru,Astra"
Abyss,FAWZ Purple,lost cause,13,5,7,5,0,6,"Cypher,Sova,Jett,Astra,Gekko","Sova,Jett,Yoru,Astra,Deadlock"
Haven,Big Baller Brand,SaD FROST,7,13,3,9,4,4,"Breach,Cypher,Sova,Omen,Neon","Breach,Cypher,Sova,Omen,Neon"
Ascent,UC CSU,Cumberland Phoenix,5,13,1,5,8,4,"Cypher,Sova,Omen,Jett,KAY/O","Sova,Killjoy,Omen,Jett,KAY/O"
Haven,Converse Purple,Team Image,13,10,7,4,6,6,"Breach,Cypher,Sova,Omen,Jett","Breach,Sova,Killjoy,Omen,Neon"
Haven,Mongolia Car,SaD Esports,13,6,4,3,3,9,"Breach,Cypher,Sova,Omen,Neon","Sova,Jett,Astra,Deadlock,Iso"
Ascent,minions united GC,Una Ludio,10,13,5,6,7,5,"Sova,Killjoy,Omen,Jett,KAY/O","Sova,Killjoy,Omen,Jett,KAY/O"
Split,Berzerkers,West Virginia University,7,13,4,8,5,3,"Breach,Raze,Cypher,Omen,Yoru","Breach,Raze,Viper,Skye,Clove"
Sunset,Forsaken Shadows,Vibin Out Vex,13,5,3,3,2,10,"Raze,Cypher,Omen,Neon,Gekko","Breach,Cypher,Sova,Omen,Neon"
Ascent,Mythos Wraiths,Harmony Onyx,13,6,9,3,3,4,"Cypher,Sova,Omen,Jett,Deadlock","Sova,Killjoy,Omen,Jett,KAY/O"
Bind,goobers,FDR,1,13,1,11,2,0,"Cypher,Brimstone,Jett,Gekko,Deadlock","Raze,Viper,Brimstone,Fade,Gekko"
Bind,Made in O'Block,Ivy League Dropouts,13,10,6,6,4,7,"Raze,Viper,Skye,Gekko,Clove","Raze,Brimstone,Skye,Yoru,Gekko"
Bind,Prestige XOXO,Low Budget,1,13,0,2,11,1,"Raze,Viper,Skye,Harbor,Gekko","Raze,Viper,Brimstone,Skye,Gekko"
Bind,Freaky Furries,add3r's kittens,13,7,7,5,2,6,"Raze,Viper,Brimstone,Skye,Deadlock","Raze,Brimstone,Yoru,Fade,Gekko"
Sunset,Prime (NA),Gondal Enjoyers,10,13,1,10,3,9,"Breach,Raze,Cypher,Sova,Clove","Raze,Cypher,Fade,Iso,Clove"
Bind,Eternal Focus Crimson,Prestige Esports,13,11,5,7,4,8,"Omen,Yoru,Fade,Harbor,Deadlock","Raze,Viper,Brimstone,Skye,Gekko"
Bind,Vovin, Unjustified,5,13,3,9,4,2,"Raze,Viper,Fade,Gekko,Clove","Raze,Cypher,Viper,Brimstone,Skye"
Ascent,ENVEE Esports,Dexterity Gaming,13,6,10,2,4,3,"Sova,Killjoy,Omen,Jett,KAY/O","Cypher,Sova,Omen,Jett,KAY/O"
Split,Asura Onyx,FAWZ Purple,6,13,3,9,4,3,"Raze,Cypher,Viper,Omen,Skye","Raze,Cypher,Omen,Skye,Gekko"
Sunset,1KRR and Racoone,hunter505,13,10,7,4,6,6,"Breach,Cypher,Omen,Neon,Deadlock","Breach,Raze,Cypher,Omen,Gekko"
Ascent,Cumberland Phoenix,SEN SHAHZAM,13,7,6,6,1,7,"Sova,Killjoy,Omen,Jett,KAY/O","Sova,Killjoy,Omen,Jett,KAY/O"
Haven,Boomer Squad,Koufs Fun Club,10,13,2,9,4,8,"Cypher,Sova,Omen,Yoru,Deadlock","Sova,Killjoy,Omen,Jett,Iso"
Haven,Mongolia Car,Be Like Matt,13,6,8,4,2,5,"Breach,Cypher,Sova,Omen,Neon","Phoenix,Sage,Chamber,Gekko,Clove"
Abyss,Freaky Furries,add3r's kittens,13,2,3,0,2,10,"Cypher,Sova,Jett,Yoru,Astra","Sova,Killjoy,Jett,Yoru,Astra"
Sunset,minions united GC,Centic Junior,13,1,11,1,0,2,"Breach,Raze,Cypher,Omen,Gekko","Breach,Cypher,Neon,Fade,Clove"
Haven,SaD Esports,YDZ Esports,13,1,2,0,1,11,"Sova,Jett,Astra,Deadlock,Iso","Cypher,Sova,Omen,Yoru,Iso"
Haven,Skyline Dreamers GC,Team Image,4,13,1,4,9,3,"Breach,Killjoy,Omen,Jett,Gekko","Breach,Sova,Killjoy,Omen,Neon"
Ascent,UC CSU,Shrek's Ogres,13,6,7,5,1,6,"Cypher,Sova,Omen,Jett,KAY/O","Breach,Cypher,Yoru,Fade,Clove"
Haven,Forsaken Shadows,Natural Order,13,8,4,5,3,9,"Sova,Killjoy,Reyna,Omen,Jett","Breach,Cypher,Sova,Omen,Jett"
Bind,SaD FROST,Barely Acceptable,15,13,6,8,5,9,"Raze,Viper,Brimstone,Skye,Chamber","Raze,Viper,Brimstone,Omen,KAY/O"
Haven,Made in O'Block,Ivy League Dropouts,6,13,2,5,8,4,"Breach,Sova,Killjoy,Omen,Neon","Cypher,Sova,Omen,Jett,Iso"
Ascent,kaiju corp,Vibin Out Vex,10,13,7,5,8,3,"Cypher,Sova,Omen,Jett,KAY/O","Sova,Killjoy,Omen,Jett,KAY/O"
Haven,Venatus,goobers,8,13,4,5,8,4,"Breach,Sova,Killjoy,Omen,Jett","Cypher,Sova,Omen,Jett,KAY/O"
Ascent,Berzerkers,West Virginia University,14,16,7,8,8,7,"Cypher,Sova,Omen,Yoru,Deadlock","Sova,Killjoy,Omen,Jett,KAY/O"
Ascent,Empire Invictus,Una Ludio,4,13,1,4,9,3,"Cypher,Sova,Omen,Jett,KAY/O","Sova,Killjoy,Omen,Jett,KAY/O"
Sunset,Charmers GC,FDR,0,13,0,12,1,0,"Breach,Raze,Cypher,Omen,Gekko","Breach,Raze,Cypher,Omen,Gekko"
Ascent,Eternal Focus Crimson,Outcast Gaming,13,0,1,0,0,12,"Raze,Sova,Killjoy,Omen,Deadlock","Cypher,Sova,Omen,Jett,KAY/O"
Lotus,Harmony White,Mythos Wraiths,9,13,7,5,8,2,"Breach,Raze,Killjoy,Omen,Gekko","Raze,Cypher,Viper,Omen,Fade"
Haven,Gondal Enjoyers,OREGON CRACK,13,7,10,2,5,3,"Cypher,Sova,Phoenix,Neon,Clove","Cypher,Sova,Omen,Yoru,Iso"
Lotus,Mighty Meowers,Low Budget,7,13,1,7,6,6,"Breach,Raze,Cypher,Omen,Gekko","Raze,Killjoy,Viper,Omen,Fade"
Haven,Elite Dynasty,Prestige Esports,5,13,1,5,8,4,"Breach,Cypher,Sova,Omen,Neon","Breach,Cypher,Sova,Omen,Jett"
Lotus,Converse Purple,Freakazoids,13,6,5,2,4,8,"Breach,Raze,Killjoy,Omen,Fade","Breach,Raze,Cypher,Omen,Fade"
Ascent,SEN SHAHZAM,Kaizen (NA),13,0,12,0,0,1,"Sova,Killjoy,Omen,Jett,KAY/O","Cypher,Sova,Omen,Jett,KAY/O"
Split,Corvus Esports,lost cause,5,13,3,3,10,2,"Raze,Cypher,Omen,Jett,Skye","Raze,Omen,Skye,Chamber,Iso"
Haven,Vovin, Unjustified,13,7,4,4,3,9,"Breach,Cypher,Sova,Omen,Jett","Breach,Cypher,Sova,Omen,Jett"
Bind,Asura Onyx,FAWZ Purple,7,13,4,8,5,3,"Raze,Viper,Brimstone,Fade,Gekko","Raze,Viper,Brimstone,Skye,Gekko"
Pearl,Mongolia Car,Be Like Matt,13,6,9,3,3,4,"Sova,Killjoy,Jett,Astra,KAY/O","Killjoy,Viper,Jett,Skye,Harbor"
Sunset,Boomer Squad,Koufs Fun Club,7,13,4,8,5,3,"Raze,Cypher,Reyna,Astra,Gekko","Raze,Cypher,Omen,Neon,Fade"
Haven,1KRR and Racoone,hunter505,13,8,10,2,6,3,"Breach,Cypher,Omen,Neon,Deadlock","Breach,Sova,Killjoy,Omen,Neon"
Pearl,Blinn Esports,whats a pretzel,13,7,10,2,5,3,"Killjoy,Viper,Yoru,Astra,Fade","Sova,Killjoy,Viper,Yoru,Harbor"
Haven,Freaky Furries,add3r's kittens,10,13,6,5,8,4,"Breach,Cypher,Sova,Omen,Jett","Breach,Sova,Killjoy,Omen,Jett"
Haven,ENVEE Esports,Dexterity Gaming,13,5,4,2,3,9,"Breach,Cypher,Sova,Omen,Jett","Breach,Sova,Killjoy,Omen,Jett"
Pearl,ABG luvrs,Prime (NA),12,14,8,5,9,4,"Sova,Killjoy,Astra,Neon,Gekko","Cypher,Sova,Viper,Jett,Astra"
Ascent,SaD Esports,YDZ Esports,13,7,6,2,5,7,"Cypher,Sova,Omen,Jett,Deadlock","Sova,Killjoy,Omen,Jett,KAY/O"
Bind,Gondal Enjoyers,OREGON CRACK,13,7,7,5,2,6,"Raze,Yoru,Fade,Deadlock,Clove","Raze,Cypher,Brimstone,Reyna,Fade"
Ascent,threehunna,Ivy League Dropouts,3,13,1,11,2,2,"Sova,Killjoy,Omen,Jett,KAY/O","Cypher,Sova,Omen,Yoru,Deadlock"
Haven,Berzerkers,West Virginia University,13,8,7,2,6,6,"Cypher,Sova,Omen,Jett,Iso","Breach,Cypher,Sova,Omen,Neon"
Haven,Blinn Esports,whats a pretzel,13,2,11,1,1,2,"Breach,Sova,Omen,Chamber,Neon","Breach,Omen,Chamber,Neon,Fade"
Abyss,Corvus Esports,lost cause,10,13,8,4,9,2,"Breach,Cypher,Sova,Omen,Jett","Sova,Jett,Astra,Neon,Deadlock"
Split,BUGBLENDER,Made in O'Block,6,13,4,8,5,2,"Raze,Viper,Omen,Jett,Skye","Raze,Cypher,Jett,Skye,Astra"
Haven,CCG Esports,UC CSU,12,14,4,9,5,8,"Cypher,Sova,Omen,Yoru,Iso","Breach,Cypher,Sova,Omen,Jett"
Sunset,Una Ludio,Shrek's Ogres,6,13,3,9,4,3,"Breach,Cypher,Sova,Omen,Neon","Breach,Raze,Viper,Gekko,Clove"
Ascent,Cumberland Phoenix,Atlas Esports,13,6,5,2,4,8,"Sova,Killjoy,Omen,Jett,KAY/O","Sova,Killjoy,Omen,Jett,KAY/O"
Bind, Unjustified,Blackline,13,11,6,6,5,7,"Raze,Cypher,Viper,Brimstone,Skye","Raze,Viper,Brimstone,Skye,Fade"
Abyss,Asura Onyx,FAWZ Purple,14,12,6,7,5,8,"Cypher,Sova,Viper,Omen,Yoru","Cypher,Sova,Jett,Astra,Gekko"
Ascent,Goon that jawn,Boomer Squad,5,13,3,9,4,2,"Sova,Killjoy,Omen,Jett,Yoru","Cypher,Sova,Omen,Jett,Deadlock"
Ascent,YDZ Esports,Event Horizon,13,4,9,3,1,4,"Sova,Killjoy,Omen,Jett,KAY/O","Sova,Killjoy,Omen,Jett,KAY/O"
Haven,threehunna,Ivy League Dropouts,6,13,4,3,10,2,"Breach,Cypher,Sova,Omen,Jett","Cypher,Sova,Omen,Jett,Iso"
Split,Be Like Matt,Nearest Airport,13,9,3,7,2,10,"Raze,Cypher,Viper,Omen,Skye","Raze,Omen,Yoru,Astra,Fade"
Sunset,ABG luvrs,Prime (NA),10,13,6,6,7,4,"Breach,Cypher,Sova,Omen,Neon","Breach,Raze,Cypher,Sova,Clove"
Abyss,Harmony,OREGON CRACK,6,13,1,6,7,5,"Breach,Cypher,Sova,Omen,Jett","Cypher,Sova,Reyna,Jett,Astra"
Bind,Aspyre x Swarm,hunter505,8,13,6,6,7,2,"Raze,Viper,Brimstone,Fade,Gekko","Raze,Cypher,Reyna,Skye,Clove"
Bind,add3r's kittens,Good Career,13,8,8,4,4,5,"Raze,Brimstone,Yoru,Fade,Gekko","Raze,Viper,Brimstone,Skye,Gekko"
Haven,BUGBLENDER,Made in O'Block,4,13,0,5,8,4,"Breach,Cypher,Sova,Omen,Yoru","Breach,Sova,Killjoy,Omen,Neon"
Abyss,Kaizen (NA),Divine Valorant,14,12,8,5,7,6,"Cypher,Jett,Skye,Astra,Harbor","Sova,Viper,Jett,Yoru,Astra"
Bind,Xclusive,SEN SHAHZAM,5,13,4,2,11,1,"Raze,Cypher,Brimstone,Fade,Gekko","Raze,Viper,Brimstone,Reyna,Gekko"
Haven,les piments,Shrek's Ogres,1,13,1,11,2,0,"Breach,Cypher,Sova,Omen,Jett","Cypher,Sova,Omen,Jett,Yoru"
Haven,West Virginia University,Team Digital,13,5,6,0,5,7,"Breach,Cypher,Sova,Omen,Neon","Breach,Cypher,Sova,Omen,Jett"
Ascent, Unjustified,Blackline,13,5,7,5,0,6,"Sova,Killjoy,Omen,Jett,KAY/O","Sova,Killjoy,Omen,Jett,KAY/O"
Abyss,Koufs Fun Club,Spate Esports,13,6,8,4,2,5,"Cypher,Sova,Reyna,Omen,Jett","Cypher,Omen,Jett,Skye,Harbor"
Bind,Wet Napkins,Atlas Esports,9,13,3,7,6,6,"Raze,Viper,Brimstone,Skye,Iso","Raze,Viper,Brimstone,Skye,Gekko"
Pearl,Unckies,Dexterity Gaming,8,13,3,9,4,5,"Sova,Killjoy,Jett,Yoru,Astra","Killjoy,Viper,Jett,Harbor,Gekko"
Haven,Goon that jawn,Boomer Squad,13,7,4,4,3,9,"Breach,Cypher,Sova,Omen,Yoru","Cypher,Sova,Omen,Yoru,Deadlock"
Ascent,whats a pretzel,OC Eagles,13,11,5,7,4,8,"Cypher,Sova,Omen,Yoru,Deadlock","Sova,Killjoy,Omen,Jett,KAY/O"
Lotus,Bongo Cat,UC CSU,10,13,6,6,7,4,"Breach,Killjoy,Jett,Fade,Clove","Raze,Killjoy,Viper,Omen,Fade"
Bind,Acrylic eSports,Una Ludio,6,13,2,10,3,4,"Raze,Viper,Brimstone,Skye,Chamber","Raze,Cypher,Brimstone,Skye,Fade"
Sunset,Non-Verbal,1KRR and Racoone,4,13,4,8,5,0,"Breach,Cypher,Sova,Omen,Neon","Breach,Cypher,Omen,Neon,Deadlock"
Ascent,Paranoia Boys,CCG Esports,4,13,2,10,3,2,"Sova,Killjoy,Omen,Jett,KAY/O","Sova,Killjoy,Omen,Jett,KAY/O"
Bind,Harmony,OREGON CRACK,8,13,0,9,4,8,"Raze,Cypher,Brimstone,Skye,Deadlock","Raze,Cypher,Brimstone,Reyna,Fade"
Sunset,Aspyre x Swarm,hunter505,6,13,5,7,6,1,"Breach,Cypher,Omen,Neon,Fade","Breach,Raze,Cypher,Omen,Gekko"
Bind,YDZ Esports,Event Horizon,14,12,7,6,6,7,"Raze,Viper,Brimstone,Fade,Gekko","Raze,Viper,Brimstone,Fade,Gekko"
Ascent,NoPrac,Cumberland Phoenix,3,13,1,11,2,2,"Sova,Killjoy,Omen,Jett,KAY/O","Sova,Killjoy,Omen,Jett,KAY/O"
Ascent,Boise State University,FAWZ Purple,11,13,3,9,4,8,"Cypher,Sova,Omen,Jett,Deadlock","Sova,Killjoy,Omen,Jett,KAY/O"
Bind,Shane's Kittens,Ivy League Dropouts,2,13,2,10,3,0,"Raze,Cypher,Skye,Gekko,Clove","Raze,Brimstone,Skye,Yoru,Gekko"
Pearl,Be Like Matt,Nearest Airport,14,12,6,7,5,8,"Killjoy,Viper,Jett,Skye,Harbor","Killjoy,Jett,Astra,KAY/O,Fade"
Sunset,Prime (NA),BALLZ,13,8,7,5,3,6,"Breach,Raze,Cypher,Sova,Clove","Breach,Cypher,Sova,Omen,Neon"
Pearl,add3r's kittens,Good Career,13,11,3,9,2,10,"Sova,Killjoy,Jett,Yoru,Astra","Killjoy,Viper,Jett,Fade,Harbor"
Bind,Made in O'Block,Made in Brampton,13,4,8,4,0,5,"Raze,Viper,Skye,Gekko,Clove","Raze,Cypher,Brimstone,Sage,Chamber"
Pearl,The Bees Knees,lost cause,10,13,8,4,9,2,"Killjoy,Viper,Jett,Skye,Harbor","Killjoy,Phoenix,Jett,Skye,Astra"
Sunset,Goon that jawn,Boomer Squad,11,13,4,8,5,7,"Breach,Raze,Cypher,Sova,Omen","Raze,Cypher,Reyna,Astra,Gekko"
Haven,Unckies,Dexterity Gaming,11,13,5,7,6,6,"Breach,Sova,Killjoy,Omen,Jett","Breach,Sova,Killjoy,Omen,Jett"
Abyss,West Virginia University,Team Digital,14,12,9,4,8,5,"Cypher,Sova,Omen,Jett,Harbor","Cypher,Sova,Omen,Jett,KAY/O"
Bind,Be Like Matt,Nearest Airport,7,13,4,4,9,3,"Raze,Viper,Skye,Chamber,Clove","Raze,Cypher,Omen,Yoru,Deadlock"
Abyss,whats a pretzel,OC Eagles,13,8,9,3,5,4,"Sova,Omen,Jett,Harbor,Deadlock","Cypher,Sova,Omen,Yoru,KAY/O"
Haven,Non-Verbal,1KRR and Racoone,9,13,4,8,5,5,"Killjoy,Viper,Omen,Jett,Skye","Breach,Cypher,Omen,Neon,Deadlock"
Haven,Shane's Kittens,Ivy League Dropouts,8,13,6,6,7,2,"Breach,Sova,Killjoy,Omen,Jett","Cypher,Sova,Omen,Jett,Iso"
Sunset,Made in O'Block,Made in Brampton,13,3,9,3,0,4,"Breach,Raze,Cypher,Omen,Fade","Raze,Cypher,Sova,Omen,Gekko"
Haven,Koufs Fun Club,Spate Esports,15,13,8,6,7,7,"Sova,Killjoy,Omen,Jett,Iso","Breach,Cypher,Sova,Neon,Clove"
Abyss, Unjustified,Blackline,15,17,7,9,8,8,"Sova,Viper,Jett,Yoru,Astra","Cypher,Sova,Viper,Yoru,Astra"
Haven,YDZ Esports,Event Horizon,11,13,3,9,4,8,"Cypher,Sova,Omen,Yoru,Iso","Breach,Sova,Killjoy,Omen,Jett"
Haven,Aspyre x Swarm,hunter505,13,9,6,4,5,7,"Killjoy,Viper,Omen,Jett,Skye","Breach,Sova,Killjoy,Omen,Neon"
Sunset,Harmony,OREGON CRACK,13,10,9,2,8,4,"Breach,Cypher,Sova,Omen,Neon","Raze,Cypher,Gekko,Iso,Clove"
Ascent,The Bees Knees,lost cause,9,13,6,6,7,3,"Sova,Killjoy,Omen,Jett,KAY/O","Sova,Killjoy,Reyna,Omen,Jett"
Abyss,Boise State University,FAWZ Purple,9,13,7,5,8,2,"Cypher,Sova,Omen,Jett,Harbor","Cypher,Sova,Jett,Astra,Gekko"
Ascent,add3r's kittens,Good Career,10,13,2,9,4,8,"Sova,Killjoy,Omen,Jett,KAY/O","Sova,Killjoy,Omen,Jett,KAY/O"
Haven,Prime (NA),BALLZ,13,10,8,3,7,5,"Sova,Killjoy,Viper,Omen,Jett","Breach,Cypher,Sova,Omen,Neon"
Lotus,Leviatán,Team Heretics,3,13,2,2,11,1,"Breach,Raze,Cypher,Omen,Fade","Raze,Killjoy,Viper,Omen,Fade"
Abyss,Leviatán,Team Heretics,13,9,5,7,2,8,"Cypher,Sova,Omen,Jett,Harbor","Cypher,Sova,Jett,Astra,Gekko"
Sunset,Leviatán,Team Heretics,13,15,9,5,10,4,"Breach,Cypher,Sova,Omen,Neon","Raze,Cypher,Sova,Omen,KAY/O"
Icebox,Leviatán,Team Heretics,7,13,5,7,6,2,"Sova,Killjoy,Viper,Jett,Harbor","Sova,Killjoy,Viper,Neon,Gekko"
Ascent,Made in O'Block,OC Eagles,3,13,2,10,3,1,"Sova,Killjoy,Omen,Jett,KAY/O","Sova,Killjoy,Omen,Jett,KAY/O"
Split,Predator X Gaming,Spate Esports,13,15,5,9,6,8,"Breach,Raze,Cypher,Skye,Astra","Raze,Cypher,Omen,Jett,Skye"
Split,Bobo is Hobo,Boomer Squad,9,13,2,8,5,7,"Raze,Cypher,Viper,Skye,Astra","Raze,Cypher,Viper,Omen,Skye"
Split,whats a pretzel,kellogs cereal,13,5,8,4,1,5,"Raze,Cypher,Viper,Omen,Skye","Raze,Cypher,Viper,Omen,Skye"
Abyss,Be Like Matt,A Good Team,13,11,7,5,6,6,"Cypher,Sova,Omen,Yoru,Deadlock","Cypher,Sova,Jett,Astra,Gekko"
Ascent,Nearest Airport,OREGON CRACK,13,6,9,3,3,4,"Cypher,Sova,Omen,Yoru,Deadlock","Sova,Killjoy,Omen,Jett,Deadlock"
Split,hunter505,Ivy League Dropouts,16,14,4,11,3,12,"Raze,Cypher,Viper,Skye,Astra","Raze,Cypher,Viper,Omen,Skye"
Haven,Predator X Gaming,Spate Esports,11,13,7,5,8,4,"Breach,Cypher,Sova,Omen,Jett","Breach,Cypher,Sova,Neon,Clove"
Ascent,Bobo is Hobo,Boomer Squad,8,13,3,6,7,5,"Cypher,Sova,Omen,Jett,KAY/O","Sova,Killjoy,Omen,Jett,KAY/O"
Haven,Made in O'Block,OC Eagles,15,13,9,5,8,6,"Breach,Sova,Killjoy,Omen,Neon","Breach,Cypher,Sova,Omen,Neon"
Bind,ABG luvrs,Event Horizon,3,13,1,11,2,2,"Raze,Viper,Brimstone,Fade,Gekko","Raze,Viper,Brimstone,Fade,Gekko"
Bind,the gnomes,Dexterity Gaming,7,13,3,5,8,4,"Raze,Viper,Brimstone,Skye,Gekko","Raze,Cypher,Viper,Brimstone,Skye"
Ascent,add3r's kittens, Unjustified,14,12,10,3,9,4,"Raze,Killjoy,Sage,Fade,Clove","Sova,Killjoy,Omen,Jett,KAY/O"
Abyss,whats a pretzel,kellogs cereal,8,13,4,8,5,4,"Cypher,Sova,Omen,Jett,Harbor","Cypher,Sova,Reyna,Jett,Astra"
Pearl,1KRR and Racoone,Vovin,13,6,8,4,2,5,"Viper,Jett,Astra,Fade,Deadlock","Viper,Jett,Skye,Yoru,Harbor"
Bind,Nearest Airport,OREGON CRACK,13,6,10,2,4,3,"Raze,Cypher,Omen,Yoru,Deadlock","Raze,Cypher,Brimstone,Fade,Iso"
Pearl,Be Like Matt,A Good Team,11,13,5,7,6,6,"Killjoy,Viper,Jett,Skye,Harbor","Cypher,Sova,Jett,Astra,Gekko"
Sunset,Predator X Gaming,Spate Esports,13,5,9,3,2,4,"Breach,Raze,Cypher,Omen,Fade","Breach,Raze,Phoenix,Omen,Deadlock"
Haven,hunter505,Ivy League Dropouts,13,7,5,3,4,8,"Breach,Sova,Killjoy,Omen,Neon","Sova,Killjoy,Yoru,Iso,Clove"
Haven,ABG luvrs,Event Horizon,5,13,3,3,10,2,"Cypher,Sova,Omen,Yoru,Iso","Breach,Sova,Killjoy,Omen,Jett"
Haven,Bobo is Hobo,Boomer Squad,13,9,9,3,6,4,"Breach,Cypher,Sova,Jett,Astra","Cypher,Sova,Omen,Yoru,Deadlock"
Abyss,add3r's kittens, Unjustified,13,8,8,4,4,5,"Cypher,Sova,Jett,Iso,Clove","Sova,Viper,Jett,Yoru,Astra"
Haven,whats a pretzel,kellogs cereal,13,9,7,5,4,6,"Breach,Cypher,Sova,Omen,Jett","Breach,Sova,Killjoy,Omen,Jett"
Pearl,the gnomes,Dexterity Gaming,11,13,4,8,5,7,"Sova,Killjoy,Viper,Yoru,Harbor","Killjoy,Viper,Jett,Harbor,Gekko"
Abyss,Made in O'Block,OC Eagles,12,14,5,8,6,7,"Cypher,Sova,Yoru,Astra,KAY/O","Cypher,Sova,Omen,Yoru,KAY/O"
Ascent,Non-Verbal,Nearest Airport,13,10,7,5,5,6,"Cypher,Sova,Omen,Yoru,Deadlock","Cypher,Sova,Omen,Yoru,Deadlock"
Bind,1KRR and Racoone,Vovin,13,11,7,5,6,6,"Raze,Cypher,Skye,Deadlock,Clove","Raze,Viper,Fade,Gekko,Clove"
Sunset,Good Career,Gondal Enjoyers,13,9,9,1,8,4,"Breach,Raze,Cypher,Omen,Gekko","Raze,Cypher,Fade,Gekko,Clove"
Haven,Spate Esports,lost cause,13,7,6,2,5,7,"Breach,Cypher,Sova,Neon,Clove","Cypher,Sova,Omen,Yoru,Iso"
Sunset,Be Like Matt,A Good Team,15,13,3,11,2,12,"Breach,Raze,Cypher,Omen,Gekko","Raze,Cypher,Sova,Omen,KAY/O"
Split,BALLZ,Event Horizon,5,13,5,7,6,0,"Raze,Cypher,Omen,Skye,Neon","Raze,Cypher,Viper,Omen,Skye"
Pearl,Ivy League Dropouts,The Bees Knees,13,6,4,3,3,9,"Killjoy,Phoenix,Jett,Astra,Fade","Killjoy,Jett,Yoru,Astra,Fade"
Ascent,Bobo is Hobo,YDZ Esports,6,13,2,5,8,4,"Cypher,Sova,Omen,Jett,Deadlock","Sova,Killjoy,Omen,Jett,KAY/O"
Bind,Freaky Furries,hunter505,13,11,5,7,4,8,"Raze,Viper,Brimstone,Fade,Deadlock","Raze,Cypher,Skye,Deadlock,Clove"
Haven,Non-Verbal,Nearest Airport,13,3,3,1,2,10,"Killjoy,Viper,Omen,Jett,Skye","Breach,Sova,Killjoy,Omen,Jett"
Ascent,Unckies,whats a pretzel,13,4,3,2,2,10,"Cypher,Sova,Omen,Jett,Deadlock","Cypher,Sova,Omen,Jett,KAY/O"
Haven,Mongolia Car,Predator X Gaming,13,7,8,4,3,5,"Breach,Cypher,Sova,Omen,Neon","Breach,Cypher,Sova,Omen,Jett"
Sunset,ENVEE Esports,ABG luvrs,13,9,7,5,4,6,"Breach,Cypher,Sova,Omen,Neon","Breach,Cypher,Sova,Omen,Neon"
Haven,Goon that jawn,Team Digital,13,9,5,5,4,8,"Cypher,Sova,Omen,Jett,Yoru","Breach,Cypher,Sova,Omen,Jett"
Bind,FAWZ Purple,Vovin,4,13,1,4,9,3,"Raze,Viper,Brimstone,Fade,Gekko","Raze,Viper,Fade,Gekko,Clove"
Haven,Harmony,Dexterity Gaming,9,13,6,4,9,3,"Breach,Sova,Killjoy,Omen,Neon","Breach,Sova,Killjoy,Omen,Neon"
Pearl,add3r's kittens,Aspyre x Swarm,15,17,6,10,7,9,"Sova,Killjoy,Phoenix,Jett,Astra","Cypher,Sova,Jett,Astra,Gekko"
Split,Good Career,Gondal Enjoyers,13,11,7,5,6,6,"Raze,Cypher,Omen,Jett,Skye","Raze,Cypher,Viper,Skye,Clove"
Bind,Blackline,OREGON CRACK,10,13,5,6,7,5,"Raze,Cypher,Brimstone,Skye,Fade","Raze,Cypher,Brimstone,Fade,Iso"
Haven,Made in Brampton,Prime (NA),4,13,1,4,9,3,"Breach,Sova,Killjoy,Jett,Astra","Sova,Killjoy,Viper,Omen,Jett"
Sunset,SaD Esports,Made in O'Block,13,6,8,4,2,5,"Breach,Raze,Cypher,Sova,Omen","Breach,Raze,Cypher,Gekko,Clove"
Sunset,Corvus Esports,Boomer Squad,4,13,0,5,8,4,"Raze,Cypher,Jett,Gekko,Clove","Raze,Cypher,Reyna,Astra,Gekko"
Ascent,Berzerkers,the gnomes,13,4,9,3,1,4,"Cypher,Sova,Omen,Yoru,Deadlock","Sova,Killjoy,Omen,Jett,KAY/O"
Bind,Shane's Kittens,OC Eagles,9,13,1,9,4,8,"Raze,Cypher,Viper,Skye,Clove","Raze,Cypher,Viper,Brimstone,Skye"
Ascent,Spate Esports,lost cause,14,12,9,4,8,5,"Cypher,Sova,Omen,Jett,Deadlock","Sova,Killjoy,Reyna,Omen,Jett"
Sunset,Mongolia Car,Predator X Gaming,13,2,10,2,0,3,"Breach,Cypher,Sova,Omen,Neon","Breach,Raze,Cypher,Omen,Fade"
Haven,Freaky Furries,hunter505,13,6,7,5,1,6,"Breach,Cypher,Sova,Omen,Jett","Sova,Killjoy,Reyna,Omen,Neon"
Ascent,West Virginia University,Be Like Matt,13,8,6,6,2,7,"Sova,Killjoy,Omen,Jett,KAY/O","Cypher,Sova,Omen,Jett,Deadlock"
Sunset,Ivy League Dropouts,The Bees Knees,13,9,4,6,3,9,"Breach,Cypher,Sova,Omen,Neon","Breach,Raze,Cypher,Omen,Fade"
Pearl,Unckies,whats a pretzel,13,3,9,3,0,4,"Sova,Killjoy,Jett,Yoru,Astra","Sova,Yoru,Astra,Gekko,Deadlock"
Bind, Unjustified,Asura Onyx,13,5,5,1,4,8,"Raze,Cypher,Viper,Brimstone,Skye","Raze,Viper,Skye,Fade,Clove"
Ascent,ENVEE Esports,ABG luvrs,13,8,10,2,6,3,"Sova,Killjoy,Omen,Jett,KAY/O","Cypher,Sova,Omen,Jett,KAY/O"
Abyss,Goon that jawn,Team Digital,13,8,7,5,3,6,"Cypher,Sova,Omen,Yoru,Neon","Cypher,Sova,Omen,Jett,KAY/O"
Ascent,BALLZ,Event Horizon,12,14,4,9,5,8,"Sova,Killjoy,Reyna,Omen,Jett","Sova,Killjoy,Omen,Jett,KAY/O"
Pearl,Made in Brampton,Prime (NA),2,13,2,10,3,0,"Raze,Cypher,Phoenix,Chamber,Clove","Cypher,Sova,Viper,Reyna,Astra"
Bind,Non-Verbal,Nearest Airport,11,13,3,9,4,8,"Raze,Brimstone,Fade,Gekko,Deadlock","Raze,Cypher,Omen,Yoru,Deadlock"
Haven,Blackline,OREGON CRACK,3,13,0,4,9,3,"Breach,Cypher,Sova,Omen,Neon","Breach,Cypher,Sova,Omen,Jett"
Abyss,FAWZ Purple,Vovin,13,11,10,2,9,3,"Cypher,Sova,Jett,Astra,Gekko","Cypher,Sova,Jett,Yoru,Astra"
Bind,Bobo is Hobo,YDZ Esports,15,13,6,8,5,9,"Raze,Cypher,Sova,Viper,Brimstone","Raze,Viper,Brimstone,Fade,Gekko"
Pearl,Koufs Fun Club,Good Career,13,6,3,4,2,10,"Killjoy,Phoenix,Omen,Jett,Fade","Killjoy,Viper,Yoru,Astra,Fade"
Pearl,Corvus Esports,Boomer Squad,6,13,1,6,7,5,"Sova,Killjoy,Jett,Skye,Astra","Killjoy,Viper,Jett,Harbor,Gekko"
Haven,Blinn Esports,1KRR and Racoone,13,3,10,2,1,3,"Breach,Cypher,Sova,Omen,Neon","Cypher,Omen,Jett,Yoru,Neon"
Haven,SaD Esports,Made in O'Block,13,11,9,3,8,4,"Sova,Jett,Astra,Deadlock,Iso","Breach,Sova,Killjoy,Omen,Neon"
Sunset,Gondal Enjoyers,Boise State University,13,1,11,1,0,2,"Raze,Cypher,Fade,Gekko,Clove","Cypher,Sova,Omen,Yoru,Neon"
Haven,Berzerkers,the gnomes,13,8,5,4,4,8,"Cypher,Sova,Omen,Jett,Yoru","Breach,Sova,Killjoy,Omen,Jett"
Ascent,Shane's Kittens,OC Eagles,5,13,4,8,5,1,"Sova,Killjoy,Omen,Jett,KAY/O","Sova,Killjoy,Omen,Jett,KAY/O"
Bind,West Virginia University,Be Like Matt,4,13,2,10,3,2,"Raze,Viper,Brimstone,Skye,Gekko","Raze,Viper,Skye,Chamber,Clove"
Sunset,Harmony,Dexterity Gaming,13,15,8,6,9,5,"Breach,Cypher,Sova,Omen,Neon","Breach,Cypher,Sova,Omen,Neon"
Sunset,add3r's kittens,Aspyre x Swarm,14,16,9,6,10,5,"Breach,Raze,Cypher,Omen,Gekko","Breach,Cypher,Omen,Neon,Fade"
Ascent, Unjustified,Asura Onyx,13,3,9,3,0,4,"Sova,Killjoy,Omen,Jett,KAY/O","Sova,Killjoy,Omen,Jett,KAY/O"
Haven,A Good Team,threehunna,13,4,10,2,2,3,"Breach,Cypher,Sova,Omen,Neon","Breach,Sova,Killjoy,Omen,Jett"
Abyss,Freaky Furries,Ivy League Dropouts,13,7,7,5,2,6,"Cypher,Sova,Jett,Yoru,Astra","Breach,Cypher,Sova,Omen,Jett"
Haven,Koufs Fun Club,Good Career,13,2,11,1,1,2,"Sova,Killjoy,Omen,Jett,Iso","Breach,Cypher,Sova,Omen,Jett"
Pearl,ENVEE Esports,ABG luvrs,11,13,4,8,5,7,"Sova,Killjoy,Jett,Astra,KAY/O","Sova,Killjoy,Astra,Neon,Gekko"
Abyss,Unckies,whats a pretzel,7,13,2,6,7,5,"Cypher,Sova,Omen,Jett,Harbor","Sova,Omen,Jett,Harbor,Deadlock"
Haven,BALLZ,Event Horizon,13,8,5,7,1,8,"Breach,Cypher,Sova,Omen,Neon","Breach,Sova,Killjoy,Omen,Jett"
Pearl,Blinn Esports,1KRR and Racoone,13,4,9,3,1,4,"Killjoy,Viper,Jett,Skye,Harbor","Viper,Yoru,Astra,Fade,Iso"
Haven,FAWZ Purple,Vovin,5,13,3,9,4,2,"Breach,Sova,Killjoy,Omen,Jett","Breach,Cypher,Sova,Omen,Jett"
Ascent,Mongolia Car,Spate Esports,13,6,6,6,0,7,"Sova,Killjoy,Omen,Jett,KAY/O","Cypher,Sova,Omen,Jett,Deadlock"
Haven,Nearest Airport,OREGON CRACK,13,6,6,1,5,7,"Breach,Sova,Killjoy,Omen,Jett","Breach,Cypher,Sova,Omen,Jett"
Haven,Bobo is Hobo,YDZ Esports,8,13,2,7,6,6,"Breach,Cypher,Sova,Omen,Jett","Cypher,Sova,Omen,Yoru,Iso"
Haven,Gondal Enjoyers,Boise State University,13,4,10,2,2,3,"Cypher,Sova,Yoru,Iso,Clove","Sova,Jett,Astra,Deadlock,Iso"
Abyss,Corvus Esports,Boomer Squad,13,8,6,3,5,7,"Breach,Sova,Omen,Jett,Deadlock","Breach,Cypher,Sova,Jett,Astra"
Sunset,A Good Team,threehunna,13,3,2,2,1,11,"Raze,Cypher,Sova,Omen,KAY/O","Breach,Raze,Cypher,Omen,Gekko"
Split,West Virginia University,Be Like Matt,13,5,5,1,4,8,"Breach,Raze,Viper,Skye,Clove","Raze,Cypher,Viper,Omen,Skye"
Bind,Freaky Furries,Ivy League Dropouts,13,6,9,3,3,4,"Raze,Viper,Brimstone,Fade,Deadlock","Raze,Viper,Brimstone,Fade,Gekko"
Bind,SaD Esports,Shane's Kittens,13,6,4,3,3,9,"Raze,Viper,Brimstone,Yoru,Fade","Raze,Cypher,Viper,Skye,Clove"
Sunset,Unckies,kellogs cereal,13,6,4,3,3,9,"Breach,Raze,Cypher,Omen,Gekko","Raze,Omen,Gekko,Deadlock,Iso"
Split,Dexterity Gaming,the gnomes,7,13,4,8,5,3,"Raze,Cypher,Viper,Omen,Skye","Raze,Cypher,Omen,Jett,Skye"
Haven,Goon that jawn,Made in Brampton,13,6,4,3,3,9,"Raze,Astra,Chamber,Neon,Fade","Sova,Phoenix,Chamber,Neon,Clove"
Haven,Aspyre x Swarm,Asura Onyx,13,9,8,2,7,5,"Killjoy,Viper,Omen,Jett,Skye","Breach,Cypher,Sova,Omen,Jett"
Sunset,Mongolia Car,Spate Esports,13,7,7,5,2,6,"Breach,Cypher,Sova,Omen,Neon","Breach,Raze,Phoenix,Omen,Deadlock"
Haven,Made in O'Block,OC Eagles,13,10,7,4,6,6,"Breach,Sova,Killjoy,Omen,Neon","Breach,Cypher,Sova,Omen,Neon"
Sunset,Non-Verbal,Blackline,13,3,9,3,0,4,"Breach,Cypher,Sova,Omen,Neon","Breach,Raze,Cypher,Omen,Gekko"
Sunset,Nearest Airport,OREGON CRACK,10,13,4,7,6,6,"Breach,Raze,Cypher,Sova,Omen","Raze,Cypher,Gekko,Iso,Clove"
Haven,Berzerkers,Harmony,13,4,9,3,1,4,"Cypher,Sova,Omen,Jett,Yoru","Breach,Sova,Killjoy,Omen,Neon"
Haven,Good Career,Boise State University,13,7,6,6,1,7,"Breach,Cypher,Sova,Omen,Jett","Sova,Jett,Astra,Deadlock,Iso"
Sunset,ABG luvrs,Event Horizon,13,10,8,3,7,5,"Breach,Cypher,Sova,Omen,Neon","Raze,Cypher,Sova,Omen,KAY/O"
Haven,Bobo is Hobo,Corvus Esports,13,2,11,1,1,2,"Breach,Cypher,Sova,Omen,Jett","Cypher,Sova,Omen,Jett,Iso"
Haven,whats a pretzel,BUGBLENDER,13,11,8,4,7,5,"Breach,Cypher,Sova,Omen,Jett","Breach,Sova,Killjoy,Omen,Jett"
Haven,kellogs cereal,BUGBLENDER,13,11,8,4,7,5,"Breach,Cypher,Sova,Omen,Jett","Breach,Sova,Killjoy,Omen,Jett"
Haven,Vovin,1KRR and Racoone,6,13,4,8,5,2,"Breach,Cypher,Sova,Omen,Neon","Breach,Cypher,Omen,Neon,Deadlock"
Pearl,Koufs Fun Club,Gondal Enjoyers,13,4,5,0,4,8,"Killjoy,Phoenix,Omen,Jett,Fade","Cypher,Yoru,Astra,Fade,Deadlock"
Sunset,SaD Esports,Shane's Kittens,13,2,2,1,1,11,"Breach,Raze,Cypher,Sova,Omen","Raze,Cypher,Omen,Fade,Gekko"
Ascent,West Virginia University,A Good Team,13,7,6,6,1,7,"Sova,Killjoy,Omen,Jett,KAY/O","Cypher,Sova,Omen,Jett,Deadlock"
Abyss,Be Like Matt,threehunna,13,3,10,2,1,3,"Cypher,Sova,Omen,Yoru,Deadlock","Cypher,Sova,Jett,Astra,Gekko"
Haven,hunter505,The Bees Knees,13,5,3,3,2,10,"Sova,Killjoy,Omen,Neon,Iso","Breach,Sova,Killjoy,Omen,Jett"
Ascent,Blinn Esports,FAWZ Purple,13,6,10,2,4,3,"Cypher,Sova,Omen,Yoru,Deadlock","Sova,Killjoy,Omen,Jett,KAY/O"
Ascent,ENVEE Esports,BALLZ,13,7,7,5,2,6,"Sova,Killjoy,Omen,Jett,KAY/O","Sova,Killjoy,Reyna,Omen,Jett"
Pearl,Goon that jawn,Made in Brampton,13,6,4,3,3,9,"Cypher,Reyna,Yoru,Astra,Fade","Viper,Jett,Chamber,Harbor,Gekko"
Haven,add3r's kittens, Unjustified,13,8,7,2,6,6,"Breach,Sova,Killjoy,Omen,Neon","Breach,Cypher,Sova,Omen,Jett"
Pearl,lost cause,Predator X Gaming,9,13,3,9,4,6,"Cypher,Jett,Astra,Fade,Gekko","Killjoy,Viper,Jett,Skye,Harbor"
Bind,YDZ Esports,Boomer Squad,13,10,9,3,7,4,"Raze,Viper,Brimstone,Fade,Gekko","Raze,Viper,Gekko,Deadlock,Clove"
Haven,Freaky Furries,Ivy League Dropouts,11,13,8,4,9,3,"Breach,Cypher,Sova,Omen,Jett","Sova,Killjoy,Yoru,Iso,Clove"
Pearl,Vovin,1KRR and Racoone,6,13,2,10,3,4,"Breach,Killjoy,Astra,Neon,Gekko","Viper,Jett,Astra,Fade,Deadlock"
Pearl,Bobo is Hobo,Corvus Esports,13,7,5,7,0,8,"Sova,Killjoy,Jett,Astra,Gekko","Killjoy,Jett,Skye,Astra,Fade"
Haven,Dexterity Gaming,the gnomes,9,13,3,9,4,6,"Breach,Sova,Killjoy,Omen,Jett","Breach,Sova,Killjoy,Omen,Jett"
Abyss,Non-Verbal,Blackline,13,8,8,4,4,5,"Cypher,Sova,Omen,Jett,Harbor","Sova,Killjoy,Viper,Yoru,Astra"
Bind,Made in O'Block,OC Eagles,13,7,7,1,6,6,"Raze,Skye,Gekko,Deadlock,Clove","Raze,Cypher,Viper,Brimstone,Skye"
Sunset,ENVEE Esports,BALLZ,13,1,2,0,1,11,"Breach,Cypher,Sova,Omen,Neon","Breach,Cypher,Sova,Omen,Neon"
Haven,West Virginia University,A Good Team,13,2,10,2,0,3,"Breach,Cypher,Sova,Omen,Neon","Breach,Cypher,Sova,Omen,Jett"
Haven,Unckies,kellogs cereal,13,11,8,4,7,5,"Breach,Sova,Killjoy,Omen,Jett","Sova,Killjoy,Omen,Jett,Yoru"
Pearl,Aspyre x Swarm,Asura Onyx,13,8,5,7,1,8,"Cypher,Sova,Jett,Astra,Gekko","Killjoy,Viper,Jett,Skye,Astra"
Pearl,Be Like Matt,threehunna,13,4,9,3,1,4,"Killjoy,Viper,Jett,Skye,Harbor","Killjoy,Viper,Jett,Skye,Harbor"
Pearl,SaD Esports,Shane's Kittens,3,13,3,9,4,0,"Killjoy,Viper,Jett,Skye,Astra","Killjoy,Jett,Skye,Astra,Fade"
Abyss,Blinn Esports,FAWZ Purple,13,0,1,0,0,12,"Cypher,Sova,Omen,Jett,Deadlock","Cypher,Sova,Jett,Astra,Gekko"
Haven,Mongolia Car,Spate Esports,11,13,5,7,6,6,"Breach,Cypher,Sova,Omen,Jett","Breach,Cypher,Sova,Neon,Clove"
Bind,Nearest Airport,OREGON CRACK,13,10,9,2,8,4,"Raze,Cypher,Omen,Yoru,Deadlock","Raze,Cypher,Brimstone,Fade,Iso"
Bind,kellogs cereal,BUGBLENDER,13,6,7,5,1,6,"Raze,Brimstone,Fade,Gekko,Deadlock","Raze,Viper,Omen,Skye,Yoru"
Bind,whats a pretzel,BUGBLENDER,13,6,7,5,1,6,"Raze,Brimstone,Fade,Gekko,Deadlock","Raze,Viper,Omen,Skye,Yoru"
Sunset,Berzerkers,Harmony,13,9,8,2,7,5,"Breach,Raze,Cypher,Sova,Omen","Breach,Cypher,Sova,Omen,Neon"
Haven,Koufs Fun Club,Gondal Enjoyers,13,6,6,6,0,7,"Cypher,Sova,Omen,Jett,Iso","Breach,Sova,Killjoy,Astra,Neon"
Haven,ABG luvrs,Event Horizon,14,12,8,5,7,6,"Cypher,Sova,Omen,Yoru,Iso","Breach,Sova,Killjoy,Omen,Neon"
Sunset,lost cause,Predator X Gaming,4,13,3,9,4,1,"Breach,Cypher,Sova,Neon,Clove","Breach,Raze,Cypher,Omen,Fade"
Sunset,Good Career,Boise State University,13,10,6,5,5,7,"Breach,Raze,Cypher,Omen,Gekko","Cypher,Sova,Omen,Yoru,Neon"
Ascent,add3r's kittens, Unjustified,13,6,5,2,4,8,"Sova,Killjoy,Reyna,Omen,Jett","Sova,Killjoy,Omen,Jett,KAY/O"
Pearl,hunter505,The Bees Knees,13,7,7,5,2,6,"Killjoy,Skye,Astra,Neon,Harbor","Killjoy,Jett,Astra,KAY/O,Fade"
Icebox,SeanGares' Kittens,royexakim1,11,13,4,8,5,7,"Sova,Killjoy,Viper,Jett,Iso","Sova,Killjoy,Viper,Reyna,Jett"
Bind,SeanGares' Kittens,royexakim1,8,13,6,3,10,2,"Raze,Viper,Brimstone,Skye,Gekko","Raze,Viper,Brimstone,Skye,Yoru"
Abyss,Evil Genies,SeanGares' Kittens,9,13,5,7,6,4,"Cypher,Sova,Omen,Jett,Astra","Cypher,Sova,Jett,Astra,Iso"
Haven,Evil Genies,SeanGares' Kittens,5,13,4,8,5,1,"Breach,Cypher,Sova,Omen,Jett","Cypher,Sova,Omen,Jett,Iso"
Lotus,Evil Genies,SeanGares' Kittens,13,10,7,4,6,6,"Breach,Raze,Cypher,Omen,Gekko","Breach,Raze,Cypher,Omen,Gekko"
Lotus,royexakim1,asians n kehm,13,6,5,2,4,8,"Raze,Killjoy,Viper,Omen,Fade","Raze,Killjoy,Viper,Omen,Fade"
Sunset,royexakim1,asians n kehm,13,5,3,3,2,10,"Breach,Raze,Cypher,Sova,Omen","Breach,Cypher,Sova,Omen,Neon"
Abyss,Team Heretics,Sentinels,13,7,5,3,4,8,"Cypher,Sova,Jett,Astra,Gekko","Cypher,Sova,Omen,Jett,KAY/O"
Icebox,Team Heretics,Sentinels,13,9,5,7,2,8,"Sova,Killjoy,Viper,Neon,Gekko","Sova,Killjoy,Viper,Jett,KAY/O"
Haven,Team Heretics,Sentinels,8,13,5,7,6,3,"Raze,Killjoy,Sage,Omen,Gekko","Breach,Cypher,Sova,Omen,Neon"
Abyss,EDward Gaming,Leviatán,13,11,6,6,5,7,"Sova,Omen,Jett,Astra,KAY/O","Cypher,Sova,Omen,Jett,Harbor"
Lotus,EDward Gaming,Leviatán,13,4,8,4,0,5,"Breach,Omen,Neon,Fade,Clove","Breach,Raze,Cypher,Omen,Fade"
Icebox,EDward Gaming,Leviatán,14,16,3,12,4,11,"Sova,Killjoy,Viper,Jett,KAY/O","Sova,Killjoy,Viper,Jett,Harbor"
Haven,New Combat Line GC,NTH,10,13,6,5,8,4,"Breach,Sova,Killjoy,Omen,Jett","Raze,Sova,Killjoy,Reyna,Clove"
Icebox,New Combat Line GC,NTH,9,13,8,4,9,1,"Sova,Killjoy,Viper,Jett,Gekko","Sova,Viper,Jett,Chamber,Iso"
Ascent,Deagle Ravagers,Sphinx GC,11,13,3,9,4,8,"Sova,Killjoy,Omen,Jett,KAY/O","Sova,Killjoy,Omen,Jett,KAY/O"
Haven,Deagle Ravagers,Sphinx GC,11,13,3,9,4,8,"Breach,Sova,Killjoy,Omen,Jett","Breach,Sova,Killjoy,Omen,Neon"
Ascent,Bon Bon Bum Contra GC,MYVRA GC,13,6,6,1,5,7,"Sova,Killjoy,Phoenix,Omen,Jett","Sova,Killjoy,Omen,Jett,KAY/O"
Lotus,Bon Bon Bum Contra GC,MYVRA GC,10,13,6,5,8,4,"Breach,Raze,Cypher,Omen,Gekko","Breach,Raze,Cypher,Omen,Fade"
Sunset,Bon Bon Bum Contra GC,MYVRA GC,13,11,6,6,5,7,"Breach,Sova,Sage,Omen,Gekko","Breach,Raze,Cypher,Omen,Fade"
Icebox,9z Team GC,KRÜ BLAZE,5,13,2,4,9,3,"Killjoy,Viper,Jett,KAY/O,Gekko","Sova,Killjoy,Harbor,Iso,Clove"
Ascent,MIBR GC,LOUD GC,13,10,6,6,4,7,"Sova,Killjoy,Omen,Jett,KAY/O","Cypher,Sova,Omen,Neon,Deadlock"
Haven,9z Team GC,KRÜ BLAZE,7,13,2,6,7,5,"Breach,Cypher,Omen,Neon,Gekko","Breach,Sova,Killjoy,Omen,Jett"
Lotus,MIBR GC,LOUD GC,9,13,3,9,4,6,"Raze,Killjoy,Viper,Omen,Fade","Cypher,Omen,KAY/O,Neon,Fade"
Ascent,9z Team GC,KRÜ BLAZE,13,10,6,5,5,7,"Cypher,Sova,Omen,Jett,KAY/O","Sova,Killjoy,Omen,Jett,KAY/O"
Haven,MIBR GC,LOUD GC,14,12,8,5,7,6,"Breach,Cypher,Sova,Omen,Jett","Killjoy,Omen,Jett,Skye,Gekko"
Sunset,MIBR GC,LOUD GC,13,11,6,6,5,7,"Breach,Raze,Cypher,Omen,Gekko","Raze,Cypher,Omen,KAY/O,Gekko"
Bind,MIBR GC,LOUD GC,9,13,2,10,3,7,"Raze,Viper,Brimstone,Fade,Gekko","Raze,Cypher,Brimstone,Skye,Deadlock"
Icebox,Striders,esports team αD,13,8,8,4,4,5,"Sova,Killjoy,Viper,Jett,Harbor","Cypher,Sova,Omen,Jett,Harbor"
Sunset,BC SWELL,PARON,13,4,8,4,0,5,"Cypher,Sova,Omen,KAY/O,Neon","Raze,Sova,Killjoy,Omen,Astra"
Lotus,IGZIST,Delight,13,15,9,5,10,4,"Breach,Cypher,Sova,Omen,Neon","Breach,Raze,Cypher,Omen,Fade"
Sunset,Striders,esports team αD,5,13,0,6,7,5,"Cypher,Sova,Omen,KAY/O,Neon","Raze,Cypher,Sage,Omen,Fade"
Ascent,SCARZ,BABO,12,14,6,7,7,6,"Sova,Killjoy,Omen,Jett,KAY/O","Sova,Killjoy,Omen,Jett,KAY/O"
Abyss,BC SWELL,PARON,9,13,7,5,8,2,"Sova,Killjoy,Omen,Jett,Yoru","Sova,Omen,Chamber,Neon,Iso"
Haven,IGZIST,Delight,13,5,3,3,2,10,"Breach,Sova,Killjoy,Omen,Jett","Breach,Cypher,Sova,Omen,Neon"
Sunset,SCARZ,BABO,9,13,4,6,7,5,"Cypher,Sova,Omen,KAY/O,Neon","Breach,Cypher,Sova,Omen,Neon"
Bind,Striders,esports team αD,13,10,6,6,4,7,"Raze,Viper,Brimstone,Fade,Gekko","Raze,Cypher,Viper,Skye,Harbor"
Sunset,IGZIST,Delight,3,13,2,10,3,1,"Breach,Cypher,Sova,Omen,Neon","Cypher,Sova,Omen,KAY/O,Neon"
Ascent,BC SWELL,PARON,13,5,4,2,3,9,"Sova,Killjoy,Omen,Jett,KAY/O","Sova,Killjoy,Omen,Jett,KAY/O"
Abyss,K7 Esports GC,KS Esports GC,10,13,6,6,7,4,"Breach,Cypher,Sova,Omen,Jett","Sova,Omen,Yoru,Astra,Deadlock"
Ascent,K7 Esports GC,KS Esports GC,9,13,2,8,5,7,"Sova,Killjoy,Omen,Jett,KAY/O","Cypher,Sova,Omen,Yoru,Deadlock"
Abyss,Zen eSports GC,FiRePOWER GC,10,13,6,5,8,4,"Breach,Cypher,Sova,Omen,Jett","Cypher,Sova,Omen,Jett,KAY/O"
Icebox,Team Liquid Brazil,LOUD GC,8,13,1,8,5,7,"Killjoy,Viper,Omen,KAY/O,Gekko","Killjoy,Viper,Jett,KAY/O,Gekko"
Ascent,Zen eSports GC,FiRePOWER GC,11,13,7,5,8,4,"Sova,Killjoy,Omen,Jett,KAY/O","Sova,Killjoy,Omen,Jett,KAY/O"
Sunset,Team Liquid Brazil,LOUD GC,5,13,1,5,8,4,"Breach,Raze,Cypher,Sova,Omen","Raze,Cypher,Omen,KAY/O,Gekko"
Bind,Team Liquid Brazil,LOUD GC,12,14,6,7,7,6,"Raze,Cypher,Viper,Brimstone,Skye","Raze,Cypher,Brimstone,Skye,Deadlock"
Abyss,BLUE BEES.ESP,BC SWELL,13,11,6,6,5,7,"Breach,Sova,Omen,Yoru,Deadlock","Sova,Killjoy,Viper,Yoru,Astra"
Ascent,WICKED,PARON,11,13,3,9,4,8,"Sova,Killjoy,Omen,Jett,KAY/O","Sova,Killjoy,Omen,Jett,KAY/O"
Lotus,IGZIST,FAV gaming,2,13,1,2,11,1,"Breach,Cypher,Sova,Omen,Neon","Raze,Cypher,Viper,Omen,Fade"
Lotus,BLUE BEES.ESP,BC SWELL,11,13,7,5,8,4,"Breach,Omen,Neon,Fade,Clove","Raze,Killjoy,Viper,Omen,Fade"
Haven,TRIDENT,Delight,4,13,3,9,4,1,"Breach,Sova,Killjoy,Omen,Jett","Breach,Cypher,Sova,Omen,Neon"
Sunset,SCARZ,NOEZ FOXX,9,13,2,8,5,7,"Cypher,Sova,Omen,KAY/O,Neon","Cypher,Sova,Omen,KAY/O,Neon"
Sunset,Crest Gaming ZST,Striders,13,11,5,7,4,8,"Breach,Raze,Cypher,Omen,Jett","Cypher,Sova,Omen,KAY/O,Neon"
Icebox,NIX VISION,esports team αD,2,13,1,2,11,1,"Cypher,Viper,KAY/O,Gekko,Deadlock","Cypher,Sova,Omen,Jett,Harbor"
Sunset,IGZIST,FAV gaming,6,13,3,9,4,3,"Breach,Cypher,Sova,Omen,Neon","Breach,Raze,Cypher,Sova,Omen"
Icebox,BLUE BEES.ESP,BC SWELL,13,8,9,3,5,4,"Sova,Killjoy,Viper,Jett,Clove","Sova,Killjoy,Viper,Jett,Gekko"
Ascent,Crest Gaming ZST,Striders,13,5,4,2,3,9,"Sage,Omen,Jett,KAY/O,Fade","Cypher,Sova,Omen,Jett,Deadlock"
Ascent,SCARZ,NOEZ FOXX,10,13,3,9,4,7,"Sova,Killjoy,Omen,Jett,KAY/O","Sova,Killjoy,Omen,Jett,KAY/O"
Haven,WICKED,PARON,13,15,5,9,6,8,"Breach,Sova,Killjoy,Omen,Jett","Breach,Sova,Killjoy,Omen,Jett"
Bind,TRIDENT,Delight,9,13,7,5,8,2,"Raze,Viper,Brimstone,Fade,Gekko","Raze,Viper,Omen,Skye,Gekko"
Sunset,NIX VISION,esports team αD,4,13,1,4,9,3,"Breach,Raze,Cypher,Sova,Omen","Raze,Cypher,Sage,Omen,Fade"
Sunset,Akave Esports Black,FUSION X,8,13,6,6,7,2,"Breach,Raze,Cypher,Omen,Gekko","Breach,Raze,Cypher,Omen,Gekko"
Ascent,Akave Esports Black,FUSION X,2,13,0,3,10,2,"Cypher,Sova,Omen,Jett,KAY/O","Raze,Sova,KAY/O,Iso,Clove"
Ascent,University War GC,Leviatán GC,6,13,5,7,6,1,"Sova,Killjoy,Omen,Jett,KAY/O","Cypher,Sova,Omen,Jett,Deadlock"
Haven,Team Liquid Brazil,MIBR GC,6,13,2,5,8,4,"Cypher,Sova,Omen,Yoru,Iso","Breach,Cypher,Sova,Omen,Jett"
Haven,University War GC,Leviatán GC,0,13,0,1,12,0,"Breach,Cypher,Sova,Omen,Neon","Breach,Cypher,Sova,Omen,Neon"
Ascent,Team Liquid Brazil,MIBR GC,7,13,2,6,7,5,"Sova,Killjoy,Omen,Jett,KAY/O","Sova,Killjoy,Omen,Jett,KAY/O"
Sunset,University War GC,Leviatán GC,13,5,5,1,4,8,"Breach,Raze,Cypher,Omen,Fade","Breach,Cypher,Omen,Neon,Fade"
Icebox,LOUD GC,Team Leveling,13,10,8,4,6,5,"Killjoy,Viper,Jett,KAY/O,Gekko","Killjoy,Viper,KAY/O,Gekko,Iso"
Sunset,LOUD GC,Team Leveling,13,6,9,3,3,4,"Raze,Cypher,Omen,KAY/O,Gekko","Breach,Cypher,Sova,Omen,Neon"
Ascent,WICKED,BC SWELL,9,13,3,7,6,6,"Sova,Killjoy,Omen,Jett,KAY/O","Sova,Killjoy,Omen,Jett,KAY/O"
Ascent,TRIDENT,IGZIST,7,13,3,9,4,4,"Sova,Killjoy,Omen,Jett,KAY/O","Sova,Killjoy,Omen,Jett,KAY/O"
Bind,NOEZ FOXX,BABO,13,9,4,6,3,9,"Raze,Cypher,Brimstone,Skye,Deadlock","Raze,Cypher,Viper,Brimstone,Skye"
Icebox,WICKED,BC SWELL,6,13,6,6,7,0,"Sova,Killjoy,Viper,Jett,Iso","Sova,Killjoy,Viper,Jett,Gekko"
Bind,TRIDENT,IGZIST,13,8,9,0,8,4,"Raze,Viper,Brimstone,Fade,Gekko","Raze,Brimstone,Omen,Skye,Gekko"
Lotus,NOEZ FOXX,BABO,13,5,4,2,3,9,"Raze,Killjoy,Viper,Omen,Fade","Raze,Killjoy,Viper,Omen,Fade"
Ascent,Striders,esports team αD,13,5,5,1,4,8,"Cypher,Sova,Omen,Jett,Deadlock","Sova,Killjoy,Omen,Jett,KAY/O"
Lotus,Delight,FAV gaming,5,13,3,9,4,2,"Breach,Raze,Cypher,Omen,Fade","Raze,Killjoy,Viper,Omen,Fade"
Haven,PARON,BLUE BEES.ESP,6,13,2,10,3,4,"Breach,Sova,Killjoy,Omen,Jett","Sova,Killjoy,Omen,Yoru,Iso"
Bind,Crest Gaming ZST,NIX VISION,13,4,3,2,2,10,"Raze,Cypher,Brimstone,Jett,Skye","Raze,Brimstone,Reyna,Skye,Harbor"
Haven,WICKED,BC SWELL,13,8,8,4,4,5,"Breach,Sova,Killjoy,Omen,Jett","Cypher,Sova,Omen,Yoru,Clove"
Haven,TRIDENT,IGZIST,5,13,2,4,9,3,"Breach,Sova,Killjoy,Omen,Jett","Breach,Sova,Killjoy,Omen,Jett"
Haven,Delight,FAV gaming,3,13,2,10,3,1,"Breach,Cypher,Sova,Omen,Neon","Breach,Cypher,Sova,Omen,Jett"
Bind,Striders,esports team αD,13,5,8,4,1,5,"Raze,Viper,Brimstone,Fade,Gekko","Raze,Cypher,Viper,Skye,Harbor"
Icebox,Crest Gaming ZST,NIX VISION,13,3,10,2,1,3,"Killjoy,Viper,Jett,KAY/O,Clove","Cypher,Viper,KAY/O,Gekko,Deadlock"
Lotus,PARON,BLUE BEES.ESP,4,13,4,8,5,0,"Raze,Killjoy,Viper,Omen,Fade","Breach,Omen,Neon,Fade,Clove"
Ascent,NOEZ FOXX,BABO,12,14,6,7,7,6,"Sova,Killjoy,Omen,Jett,KAY/O","Sova,Killjoy,Omen,Jett,KAY/O"
Abyss,"Fenrir ""White"" E-Club",NTH,3,13,0,4,9,3,"Cypher,Sova,Omen,Jett,KAY/O","Cypher,Jett,KAY/O,Iso,Clove"
Haven,"Fenrir ""White"" E-Club",NTH,7,13,5,7,6,2,"Breach,Cypher,Sova,Omen,Jett","Raze,Sova,Killjoy,Reyna,Clove"
Ascent,Sphinx GC,Return of the Ashes,13,9,6,6,3,7,"Sova,Killjoy,Omen,Jett,KAY/O","Breach,Raze,Cypher,Sova,Omen"
Icebox,Kaoticcc and Friends,Blue Otter,8,13,1,8,5,7,"Sova,Killjoy,Viper,Reyna,Jett","Sova,Killjoy,Viper,Jett,Gekko"
Sunset,Kaoticcc and Friends,Blue Otter,2,13,0,3,10,2,"Breach,Raze,Cypher,Omen,Gekko","Breach,Cypher,Sova,Omen,Neon"
Icebox,Sphinx GC,Return of the Ashes,13,10,6,5,5,7,"Sova,Killjoy,Viper,Jett,Gekko","Sova,Killjoy,Viper,Jett,KAY/O"
Icebox,Be Like Matt,Blue Otter,1,13,0,2,11,1,"Sova,Killjoy,Viper,Reyna,Jett","Sova,Killjoy,Viper,Jett,Gekko"
Ascent,Cuddle Gang,Kaoticcc and Friends,8,13,4,8,5,4,"Sova,Killjoy,Omen,Jett,KAY/O","Sova,Killjoy,Omen,Jett,KAY/O"
Bind,Cuddle Gang,Kaoticcc and Friends,1,13,1,11,2,0,"Raze,Viper,Brimstone,Skye,Iso","Raze,Viper,Brimstone,Skye,Yoru"
Sunset,Be Like Matt,Blue Otter,10,13,6,6,7,4,"Breach,Raze,Cypher,Omen,Gekko","Breach,Cypher,Sova,Omen,Neon"
Icebox,Team Heretics,DRX,13,10,8,3,7,5,"Sova,Killjoy,Viper,Neon,Gekko","Sova,Killjoy,Viper,Jett,KAY/O"
Sunset,Team Heretics,DRX,13,5,6,0,5,7,"Raze,Cypher,Sova,Omen,KAY/O","Breach,Cypher,Sova,Omen,Neon"
Abyss,Team Heretics,DRX,5,13,0,6,7,5,"Cypher,Sova,Jett,Astra,Gekko","Cypher,Sova,Omen,Jett,KAY/O"
Lotus,Sentinels,FNATIC,13,6,8,4,2,5,"Raze,Killjoy,Viper,Omen,Fade","Raze,Killjoy,Viper,Omen,Fade"
Bind,Sentinels,FNATIC,9,13,7,5,8,2,"Raze,Viper,Brimstone,Fade,Gekko","Raze,Viper,Astra,Fade,Gekko"
Sunset,Sentinels,FNATIC,13,11,9,3,8,4,"Raze,Cypher,Omen,KAY/O,Gekko","Breach,Raze,Cypher,Sova,Astra"
Haven,Cuddle Gang,Fluffy Men,8,13,3,9,4,5,"Breach,Sova,Killjoy,Neon,Clove","Breach,Cypher,Sova,Omen,Jett"
Bind,No Sweat Blossom,NTH,9,13,5,5,8,4,"Raze,Cypher,Brimstone,Gekko,Deadlock","Raze,Cypher,Brimstone,Skye,Yoru"
Lotus,Georgia Tech Gold,Harmony,13,7,7,1,6,6,"Raze,Killjoy,Fade,Gekko,Clove","Breach,Killjoy,Omen,Neon,Fade"
Sunset,Blue Otter,Special Grade,13,7,7,5,2,6,"Breach,Cypher,Sova,Omen,Neon","Breach,Cypher,Sova,Omen,Neon"
Sunset,Cuddle Gang,Fluffy Men,13,10,5,7,3,8,"Raze,Cypher,KAY/O,Fade,Clove","Breach,Raze,Cypher,Omen,Fade"
Icebox,Be Like Matt,Dogo Fanclub,13,4,5,0,4,8,"Sova,Killjoy,Viper,Reyna,Jett","Sova,Killjoy,Viper,Reyna,Jett"
Sunset,Georgia Tech Gold,Harmony,13,3,9,3,0,4,"Raze,Cypher,Sova,Gekko,Clove","Breach,Cypher,Sova,Omen,Neon"
Haven,No Sweat Blossom,NTH,11,13,5,7,6,6,"Breach,Cypher,Omen,Neon,Iso","Raze,Sova,Killjoy,Reyna,Omen"
Haven,Blue Otter,Special Grade,13,3,2,2,1,11,"Breach,Cypher,Sova,Omen,Neon","Sova,Jett,Astra,Deadlock,Iso"
Haven,Kaoticcc and Friends,add3r's kittens,13,11,6,6,5,7,"Sova,Killjoy,Omen,Jett,Iso","Breach,Sova,Killjoy,Omen,Neon"
Sunset,Be Like Matt,Dogo Fanclub,13,7,5,3,4,8,"Breach,Raze,Cypher,Omen,Gekko","Breach,Raze,Cypher,Sova,Clove"
Bind,Kaoticcc and Friends,add3r's kittens,13,5,4,2,3,9,"Raze,Viper,Brimstone,Skye,Yoru","Raze,Brimstone,Yoru,Fade,Gekko"
Lotus,Georgia Tech Gold,les piments,13,9,6,6,3,7,"Raze,Killjoy,Fade,Gekko,Clove","Raze,Killjoy,Viper,Omen,Fade"
Lotus,Fluffy Men,4Gods1Bum,14,12,7,6,6,7,"Breach,Raze,Cypher,Omen,Fade","Raze,Killjoy,Viper,Omen,Fade"
Icebox,Special Grade,LoungeLizardWW,13,9,3,9,0,10,"Sova,Killjoy,Viper,Reyna,Jett","Sova,Killjoy,Viper,Reyna,Gekko"
Abyss,Return of the Ashes,XSOUL GC,13,8,6,3,5,7,"Breach,Cypher,Sova,Astra,Neon","Breach,Cypher,Sova,Jett,Astra"
Icebox,Dogo Fanclub,The GRID,13,10,8,4,6,5,"Sova,Killjoy,Viper,Reyna,Jett","Sova,Killjoy,Viper,Reyna,Jett"
Lotus,Harmony,slackers,13,7,8,4,3,5,"Breach,Killjoy,Omen,Neon,Fade","Breach,Raze,Omen,Gekko,Deadlock"
Haven,Fluffy Men,4Gods1Bum,13,3,3,1,2,10,"Breach,Cypher,Sova,Omen,Jett","Breach,Cypher,Sova,Omen,Jett"
Sunset,Blue Otter,whats a pretzel,13,10,10,2,8,3,"Breach,Cypher,Sova,Omen,Neon","Raze,Cypher,Yoru,Fade,Clove"
Bind,Akatsuki Aimers,Georgia Tech Gold,8,13,3,6,7,5,"Raze,Viper,Brimstone,Fade,Gekko","Raze,Cypher,Yoru,Gekko,Clove"
Ascent,Special Grade,LoungeLizardWW,13,8,3,6,2,10,"Cypher,Sova,Omen,Jett,Deadlock","Sova,Killjoy,Omen,Jett,KAY/O"
Icebox,Kaoticcc and Friends,Non Verbal,13,3,4,0,3,9,"Sova,Killjoy,Viper,Reyna,Jett","Sova,Killjoy,Viper,Jett,Gekko"
Abyss,SaD Esports,add3r's kittens,7,13,4,4,9,3,"Sova,Omen,Yoru,KAY/O,Harbor","Cypher,Jett,Yoru,Astra,Gekko"
Sunset,Dogo Fanclub,The GRID,13,7,8,4,3,5,"Breach,Raze,Cypher,Gekko,Clove","Breach,Raze,Cypher,Omen,Fade"
Ascent,ENVEE Esports,Be Like Matt,8,13,3,6,7,5,"Sova,Killjoy,Omen,Jett,KAY/O","Sova,Killjoy,Omen,Jett,KAY/O"
Haven,Blue Otter,whats a pretzel,13,5,2,4,1,11,"Breach,Cypher,Sova,Omen,Neon","Breach,Cypher,Sova,Omen,Jett"
Lotus,Cuddle Gang,SeanGares' Kittens,14,12,10,3,9,4,"Breach,Raze,Killjoy,Gekko,Clove","Breach,Cypher,Neon,Gekko,Clove"
Sunset,Kaoticcc and Friends,Non Verbal,13,10,4,7,3,9,"Breach,Raze,Cypher,Omen,Gekko","Breach,Cypher,Sova,Omen,Neon"
Sunset,Harmony,KU Esports,13,10,7,4,6,6,"Breach,Cypher,Sova,Omen,Neon","Breach,Cypher,Omen,KAY/O,Neon"
Icebox,ENVEE Esports,Be Like Matt,3,13,0,4,9,3,"Sova,Killjoy,Viper,Reyna,Jett","Sova,Killjoy,Viper,Reyna,Jett"
Abyss,4Gods1Bum,YDZ Esports,13,8,5,4,4,8,"Cypher,Sova,Omen,Jett,Yoru","Cypher,Sova,Omen,Yoru,KAY/O"
Haven,Akatsuki Aimers,School Project,13,8,6,6,2,7,"Sova,Jett,KAY/O,Chamber,Clove","Cypher,Sova,Omen,Jett,Skye"
Lotus,slackers,Eternal Focus Crimson,14,12,10,3,9,4,"Breach,Raze,Omen,Gekko,Deadlock","Raze,Cypher,Omen,Fade,Deadlock"
Lotus,Dogo Fanclub,The GRID,6,13,3,9,4,3,"Raze,Cypher,Omen,Neon,Fade","Raze,Cypher,Skye,Deadlock,Clove"
Haven,Return of the Ashes,XSOUL GC,21,19,8,12,7,13,"Breach,Cypher,Sova,Omen,Neon","Breach,Cypher,Sova,Omen,Jett"
Lotus,les piments,Omnipotence,13,10,7,5,5,6,"Raze,Killjoy,Viper,Omen,Fade","Raze,Cypher,Omen,Fade,Deadlock"
Haven,Cuddle Gang,SeanGares' Kittens,13,6,4,3,3,9,"Breach,Sova,Killjoy,Neon,Clove","Cypher,Yoru,Astra,Fade,Iso"
Sunset,No Sweat Blossom,Infiriumz Gaming GC,13,11,8,4,7,5,"Breach,Raze,Cypher,Omen,Iso","Breach,Raze,Cypher,Omen,Gekko"
Sunset,Nightblood Gaming,LoungeLizardWW,11,13,4,8,5,7,"Breach,Cypher,Sova,Omen,Neon","Breach,Raze,Cypher,Omen,Fade"
Abyss,Azzy White,NTH,7,13,1,7,6,6,"Cypher,Sova,Omen,Jett,KAY/O","Cypher,Jett,Astra,KAY/O,Iso"
Haven,whats a pretzel,Nearest Airport,13,5,6,0,5,7,"Breach,Cypher,Sova,Omen,Jett","Breach,Killjoy,Omen,Neon,Fade"
Ascent,TOS Gaming,slackers,4,13,2,10,3,2,"Sova,Killjoy,Omen,Jett,KAY/O","Cypher,Sova,Omen,Jett,KAY/O"
Icebox,Kitten Whiskers,Georgia Tech Gold,16,18,9,8,10,7,"Sova,Viper,Reyna,Jett,Gekko","Sova,Killjoy,Viper,Reyna,Jett"
Sunset,A Good Team,Non Verbal,4,13,2,3,10,2,"Raze,Cypher,Sova,Omen,Gekko","Breach,Cypher,Sova,Omen,Neon"
Haven,4Gods1Bum,YDZ Esports,13,6,7,5,1,6,"Breach,Cypher,Sova,Omen,Jett","Breach,Sova,Killjoy,Omen,Jett"
Haven,KU Esports,Radford University,13,9,5,5,4,8,"Breach,Sova,Killjoy,Omen,Jett","Breach,Sova,Killjoy,Omen,Jett"
Ascent,Omnipotence,Outcast Gaming,13,3,9,3,0,4,"Breach,Sova,Killjoy,Omen,KAY/O","Cypher,Sova,Omen,Jett,Deadlock"
Haven,Atlas Esports,Akatsuki Aimers,5,13,1,5,8,4,"Breach,Cypher,Sova,Omen,Jett","Sova,Jett,KAY/O,Chamber,Clove"
Lotus,Eternal Focus Crimson,Converse Purple,13,11,7,5,6,6,"Raze,Cypher,Omen,Fade,Deadlock","Breach,Raze,Killjoy,Omen,Gekko"
Sunset,Sho,Harmony,5,13,2,4,9,3,"Breach,Cypher,Omen,Neon,Fade","Breach,Cypher,Sova,Omen,Neon"
Ascent,les piments,The Worst Generation,13,5,8,4,1,5,"Sova,Killjoy,Omen,Jett,KAY/O","Sova,Killjoy,Omen,Jett,KAY/O"
Ascent,Nightblood Gaming,LoungeLizardWW,11,13,2,10,3,9,"Cypher,Sova,Omen,Yoru,Deadlock","Sova,Killjoy,Omen,Jett,KAY/O"
Icebox,Azzy White,NTH,5,13,3,3,10,2,"Sova,Viper,Jett,Harbor,Gekko","Sova,Viper,Jett,Chamber,Iso"
Lotus,No Sweat Blossom,Infiriumz Gaming GC,13,6,9,3,3,4,"Breach,Raze,Killjoy,Omen,Iso","Breach,Raze,Killjoy,Omen,Jett"
Ascent,add3r's kittens,random fricks,14,12,9,4,8,5,"Sova,Killjoy,Omen,Jett,KAY/O","Sova,Killjoy,Omen,Jett,Yoru"
Bind,Be Like Matt,Bosnian Bullets,13,7,8,4,3,5,"Raze,Cypher,Viper,Brimstone,Skye","Raze,Sova,Viper,Brimstone,Reyna"
Ascent,whats a pretzel,Nearest Airport,9,13,4,8,5,5,"Cypher,Sova,Omen,Yoru,Deadlock","Cypher,Sova,Omen,Yoru,Deadlock"
Haven,ABG luvrs,SeanGares' Kittens,6,13,2,5,8,4,"Cypher,Sova,Omen,Yoru,Deadlock","Cypher,Yoru,Fade,Iso,Clove"
Icebox,The GRID,Berzerkers,13,8,4,5,3,9,"Sova,Killjoy,Viper,Reyna,Jett","Sova,Killjoy,Viper,Reyna,Jett"
Abyss,XSOUL GC,raised,13,7,7,1,6,6,"Breach,Cypher,Sova,Jett,Astra","Breach,Omen,Jett,KAY/O,Neon"
Sunset,First Rounded,KU Esports,7,13,2,6,7,5,"Breach,Raze,Cypher,Sova,Omen","Breach,Cypher,Omen,KAY/O,Neon"
Haven,Outlast Gaming,Georgia Tech Gold,11,13,7,5,8,4,"Killjoy,Viper,Omen,Jett,Skye","Breach,Sova,Killjoy,Omen,Neon"
Bind,NME,School Project,8,13,3,6,7,5,"Raze,Viper,Brimstone,Fade,Gekko","Omen,Yoru,Fade,Deadlock,Clove"
Ascent,Big Baller Brand,slackers,10,13,3,9,4,7,"Sova,Killjoy,Omen,Jett,KAY/O","Cypher,Sova,Omen,Jett,Yoru"
Lotus,les piments,Divine GC,13,4,4,1,3,9,"Raze,Killjoy,Viper,Omen,Fade","Breach,Raze,Killjoy,Gekko,Clove"
Bind,4Gods1Bum,YDZ Esports,7,13,3,5,8,4,"Raze,Viper,Brimstone,Yoru,Gekko","Raze,Brimstone,Skye,Yoru,Deadlock"
Ascent,Be Like Matt,Bosnian Bullets,13,5,10,2,3,3,"Sova,Killjoy,Omen,Jett,KAY/O","Sova,Killjoy,Omen,Jett,KAY/O"
Lotus,add3r's kittens,random fricks,13,10,8,3,7,5,"Breach,Cypher,Omen,Neon,Gekko","Breach,Killjoy,Neon,Fade,Clove"
Lotus,Nightblood Gaming,LoungeLizardWW,13,8,7,2,6,6,"Breach,Cypher,Sova,Astra,Neon","Breach,Raze,Cypher,Omen,Fade"
Ascent,Giddions,Eternal Focus Crimson,2,13,1,11,2,1,"Cypher,Sova,Omen,Jett,KAY/O","Raze,Sova,Killjoy,Omen,Deadlock"
Haven,Converse Purple,Spearhead,13,10,9,2,8,4,"Cypher,Sova,Omen,Neon,Iso","Cypher,Sova,Reyna,Omen,Neon"
Sunset,Nine Lives Esports,Sho,5,13,3,9,4,2,"Breach,Raze,Cypher,Gekko,Clove","Breach,Cypher,Omen,Neon,Fade"
Lotus,Outcast Gaming,Vortex VTX,13,9,7,5,4,6,"Raze,Viper,Omen,Chamber,Fade","Breach,Cypher,Viper,Omen,Neon"
Ascent,Kitten Whiskers,DRIFT,13,4,5,0,4,8,"Sova,Jett,Yoru,Deadlock,Clove","Sova,Killjoy,Jett,KAY/O,Clove"
Bind,Radford University,SimonSaysFF,13,2,3,0,2,10,"Raze,Brimstone,Omen,Skye,Gekko","Raze,Killjoy,Neon,Gekko,Clove"
Haven,twobits money crew,The Worst Generation,8,13,6,6,7,2,"Killjoy,Viper,Omen,Jett,Skye","Breach,Sova,Killjoy,Omen,Neon"
Sunset,ABG luvrs,SeanGares' Kittens,5,13,3,3,10,2,"Breach,Raze,Cypher,Omen,Gekko","Breach,Cypher,Sova,Astra,Neon"
Ascent,Acrylic eSports,TOS Gaming,12,14,5,8,6,7,"Killjoy,Viper,Omen,Jett,Skye","Sova,Killjoy,Omen,Jett,KAY/O"
Haven,abandoned,Omnipotence,7,13,5,7,6,2,"Breach,Cypher,Sova,Omen,Jett","Cypher,Sova,Omen,Yoru,Neon"
Haven,A Good Team,Non Verbal,15,17,11,5,12,4,"Breach,Cypher,Sova,Omen,Jett","Killjoy,Viper,Omen,Jett,Skye"
Bind,whats a pretzel,Nearest Airport,13,7,5,3,4,8,"Viper,Brimstone,Skye,Yoru,Gekko","Raze,Cypher,Omen,Yoru,Deadlock"
Lotus,The GRID,Berzerkers,13,6,8,4,2,5,"Raze,Cypher,Skye,Deadlock,Clove","Raze,Cypher,Jett,Gekko,Clove"
Haven,XSOUL GC,raised,15,13,6,8,5,9,"Breach,Cypher,Sova,Omen,Jett","Cypher,Sova,Omen,Yoru,Iso"
Icebox,Return of the Ashes,Dasein Club GC,13,10,5,6,4,8,"Sova,Killjoy,Viper,Jett,KAY/O","Killjoy,Viper,Reyna,KAY/O,Gekko"
Ascent,XSOUL GC,raised,13,15,9,5,10,4,"Sova,Killjoy,Omen,Jett,KAY/O","Sova,Reyna,Omen,Jett,Deadlock"
Haven,Return of the Ashes,Dasein Club GC,13,9,4,6,3,9,"Breach,Cypher,Sova,Omen,Neon","Breach,Sova,Killjoy,Omen,Jett"
Lotus,Leviatán,Team Heretics,13,10,9,2,8,4,"Breach,Raze,Cypher,Omen,Fade","Raze,Killjoy,Viper,Omen,Fade"
Icebox,Leviatán,Team Heretics,15,13,8,6,7,7,"Sova,Killjoy,Viper,Jett,Harbor","Sova,Killjoy,Viper,Neon,Gekko"
Sunset,Sentinels,EDward Gaming,6,13,4,3,10,2,"Breach,Cypher,Omen,Neon,Fade","Cypher,Sova,Omen,KAY/O,Neon"
Lotus,Sentinels,EDward Gaming,9,13,3,7,6,6,"Raze,Killjoy,Viper,Omen,Fade","Breach,Omen,Neon,Fade,Clove"
Haven,Sentinels,EDward Gaming,13,9,8,4,5,5,"Breach,Cypher,Sova,Omen,Neon","Breach,Cypher,Sova,Omen,Neon"
Icebox,Bosnian Bullets,Furious Five,13,9,6,6,3,7,"Sova,Killjoy,Viper,Sage,Jett","Sova,Killjoy,Viper,Reyna,Jett"
Abyss,YDZ Esports,Event Horizon,13,7,7,5,2,6,"Cypher,Sova,Omen,Jett,KAY/O","Cypher,Sova,Omen,Jett,KAY/O"
Icebox,Goon that jawn,Berzerkers,11,13,6,6,7,5,"Raze,Sova,Killjoy,Viper,Reyna","Sova,Killjoy,Viper,Reyna,Jett"
Ascent,Bosnian Bullets,Furious Five,13,8,7,5,3,6,"Sova,Killjoy,Omen,Jett,KAY/O","Cypher,Sova,Omen,Jett,KAY/O"
Sunset,LazerrFreeks Mythic,random fricks,5,13,0,6,7,5,"Breach,Raze,Cypher,Omen,Fade","Cypher,Sova,Omen,Neon,Iso"
Haven,YDZ Esports,Event Horizon,12,14,5,8,6,7,"Cypher,Sova,Omen,Yoru,Iso","Breach,Sova,Killjoy,Omen,Jett"
Ascent,Goon that jawn,Berzerkers,8,13,6,6,7,2,"Raze,Sova,Killjoy,Omen,Iso","Sova,Killjoy,Reyna,Omen,Jett"
Haven,Bosnian Bullets,Furious Five,8,13,2,7,6,6,"Breach,Sova,Killjoy,Omen,Jett","Breach,Cypher,Sova,Omen,Jett"
Ascent,Paranoia Vortex,ABG luvrs,5,13,4,8,5,1,"Sova,Killjoy,Omen,Yoru,Deadlock","Sova,Killjoy,Omen,Jett,KAY/O"
Haven,LazerrFreeks Mythic,random fricks,6,13,1,6,7,5,"Killjoy,Viper,Omen,Jett,Skye","Cypher,Sova,Omen,Yoru,Iso"
Haven,Goon that jawn,Berzerkers,13,7,8,4,3,5,"Raze,Cypher,Sova,Reyna,Omen","Cypher,Sova,Jett,Iso,Clove"
Haven,SeanGares' Kittens,Rice Bowl,13,9,7,5,4,6,"Cypher,Omen,Jett,Gekko,Iso","Cypher,Killjoy,Sage,Omen,Deadlock"
Lotus,YDZ Esports,Event Horizon,13,7,7,1,6,6,"Raze,Killjoy,Viper,Omen,Fade","Breach,Raze,Cypher,Omen,Fade"
Lotus,AURA (Inactive),Akatsuki Aimers,9,13,4,6,7,5,"Breach,Raze,Killjoy,Omen,Gekko","Breach,Cypher,Omen,Neon,Fade"
Haven,Paranoia Vortex,ABG luvrs,13,11,6,6,5,7,"Sova,Killjoy,Reyna,Omen,Jett","Cypher,Sova,Omen,Yoru,Deadlock"
Sunset,Fluffy Men,Bosnian Bullets,13,7,6,2,5,7,"Breach,Raze,Cypher,Omen,Fade","Breach,Raze,Cypher,Sova,Omen"
Haven,Legion Nyx,Infiriumz Gaming GC,1,13,1,11,2,0,"Breach,Sova,Killjoy,Omen,Jett","Breach,Sova,Killjoy,Omen,Neon"
Lotus,Be Like Matt,Barely Acceptable,13,8,7,5,3,6,"Reyna,Chamber,Neon,Gekko,Clove","Breach,Raze,Killjoy,Omen,Gekko"
Lotus,Be Like Matt,Barely Acceptable,13,8,7,5,3,6,"Reyna,Chamber,Neon,Gekko,Clove","Breach,Raze,Killjoy,Omen,Gekko"
Bind,SeanGares' Kittens,Rice Bowl,13,5,10,2,3,3,"Raze,Viper,Brimstone,Yoru,Fade","Raze,Viper,Brimstone,Skye,Gekko"
Sunset,Non Verbal,BALLSOHARD UNIVERSITY,13,4,8,4,0,5,"Breach,Cypher,Sova,Omen,Neon","Breach,Cypher,Sova,Omen,Jett"
Icebox,Resonate,A Good Team,8,13,2,7,6,6,"Sova,Killjoy,Viper,Jett,Iso","Sova,Killjoy,Viper,Reyna,Jett"
Lotus,LazerrFreeks Mythic,random fricks,13,4,9,3,1,4,"Raze,Killjoy,Viper,Omen,Fade","Raze,Killjoy,Omen,Jett,Fade"
Ascent,LoungeLizardWW,Motion Men,13,6,8,4,2,5,"Sova,Killjoy,Omen,Jett,KAY/O","Cypher,Sova,Omen,Jett,Deadlock"
Bind,Nearest Airport,The blockade,13,0,1,0,0,12,"Raze,Cypher,Omen,Yoru,Deadlock","Raze,Viper,Jett,Skye,Clove"
Haven,Whiff Nation,Event Horizon,3,13,0,4,9,3,"Breach,Cypher,Sova,Omen,Jett","Breach,Sova,Killjoy,Omen,Jett"
Haven,Goon that jawn,Cuddle Gang,10,13,8,4,9,2,"Cypher,Sova,Omen,Yoru,Iso","Breach,Sova,Killjoy,Omen,Jett"
Ascent,Fluffy Men,Bosnian Bullets,13,5,3,3,2,10,"Sova,Killjoy,Omen,Jett,KAY/O","Sova,Killjoy,Omen,Jett,KAY/O"
Lotus,Paranoia Vortex,ABG luvrs,6,13,6,6,7,0,"Breach,Sova,Killjoy,Omen,Neon","Breach,Killjoy,Omen,Yoru,Gekko"
Icebox,New Combat Line GC,"Fenrir ""White"" E-Club",13,4,4,1,3,9,"Sova,Killjoy,Viper,Jett,Gekko","Reyna,Chamber,Gekko,Iso,Clove"
Icebox,Non Verbal,BALLSOHARD UNIVERSITY,13,4,8,4,0,5,"Sova,Killjoy,Viper,Jett,Gekko","Sova,Killjoy,Viper,Jett,Harbor"
Ascent,Legion Nyx,Infiriumz Gaming GC,12,14,8,5,9,4,"Breach,Sova,Killjoy,Omen,Jett","Sova,Killjoy,Omen,Jett,KAY/O"
Bind,AURA (Inactive),Akatsuki Aimers,7,13,5,7,6,2,"Raze,Viper,Brimstone,Fade,Gekko","Raze,Viper,Brimstone,Fade,Gekko"
Abyss,NTH,Stay K'O,13,8,8,4,4,5,"Cypher,Yoru,Neon,Iso,Clove","Sova,Omen,Yoru,KAY/O,Deadlock"
Ascent,whats a pretzel,Eternal Focus Crimson,13,5,5,1,4,8,"Cypher,Sova,Omen,Yoru,Deadlock","Sova,Killjoy,Omen,Deadlock,Iso"
Sunset,Furious Five,Astane Anarchy,13,11,9,3,8,4,"Breach,Cypher,Sova,Omen,Neon","Breach,Raze,Cypher,Omen,Fade"
Lotus,LoungeLizardWW,Motion Men,13,6,6,1,5,7,"Breach,Raze,Cypher,Omen,Fade","Breach,Killjoy,Omen,Neon,Fade"
Haven,Resonate,A Good Team,9,13,8,4,9,1,"Sova,Killjoy,Omen,Jett,Iso","Breach,Cypher,Sova,Omen,Jett"
Lotus,Dogo Fanclub,SeanGares' Kittens,13,11,7,5,6,6,"Raze,Cypher,Omen,Yoru,Gekko","Breach,Cypher,Neon,Gekko,Clove"
Lotus,random fricks,Lionheart eSports,13,7,6,6,1,7,"Raze,Killjoy,Omen,Jett,Fade","Breach,Cypher,Omen,Neon,Gekko"
Haven,Be Like Matt,4Gods1Bum,10,13,8,3,10,2,"Breach,Sova,Killjoy,Omen,Jett","Breach,Cypher,Sova,Omen,Jett"
Haven,Nearest Airport,The blockade,13,10,4,8,2,9,"Breach,Omen,Chamber,Neon,Fade","Cypher,Sova,Omen,Jett,Yoru"
Haven,CB,Berzerkers,9,13,5,5,8,4,"Breach,Sova,Killjoy,Omen,Jett","Cypher,Sova,Jett,Iso,Clove"
Haven,Fluffy Men,Bosnian Bullets,9,13,2,10,3,7,"Breach,Sova,Killjoy,Omen,Jett","Breach,Sova,Killjoy,Omen,Jett"
Bind,CHURCH OF CHAEWON KIM,ABG luvrs,7,13,4,4,9,3,"Raze,Viper,Brimstone,Skye,Deadlock","Raze,Viper,Brimstone,Fade,Gekko"
Haven,Blue Otter,LazerrFreeks Mythic,13,11,6,6,5,7,"Breach,Cypher,Sova,Omen,Neon","Killjoy,Viper,Omen,Jett,Skye"
Ascent,ENVEE Esports,YDZ Esports,13,7,7,5,2,6,"Sova,Killjoy,Omen,Jett,KAY/O","Sova,Killjoy,Omen,Jett,KAY/O"
Lotus,Whiff Nation,Event Horizon,13,9,5,7,2,8,"Raze,Killjoy,Viper,Omen,Fade","Breach,Raze,Cypher,Omen,Fade"
Ascent,Goon that jawn,Cuddle Gang,13,15,5,9,6,8,"Raze,Sova,Sage,Omen,KAY/O","Sova,Killjoy,Jett,KAY/O,Clove"
Lotus,whats a pretzel,Eternal Focus Crimson,13,6,9,3,3,4,"Raze,Viper,Fade,Deadlock,Clove","Breach,Raze,Cypher,Omen,Fade"
Ascent,New Combat Line GC,"Fenrir ""White"" E-Club",13,8,2,7,1,11,"Sova,Killjoy,Omen,Jett,Gekko","Breach,Sova,Killjoy,Omen,Jett"
Icebox,NTH,Stay K'O,13,3,10,2,1,3,"Sova,Viper,Jett,Chamber,Iso","Killjoy,Viper,Jett,KAY/O,Clove"
Bind,LoungeLizardWW,Motion Men,9,13,6,4,9,3,"Raze,Brimstone,Reyna,Fade,Gekko","Raze,Viper,Brimstone,Reyna,Skye"
Haven,Barely Acceptable,Dexterity Gaming,13,4,9,3,1,4,"Breach,Cypher,Sova,Omen,Jett","Killjoy,Viper,Jett,Skye,Harbor"
Haven,Furious Five,Astane Anarchy,13,10,8,4,6,5,"Breach,Cypher,Sova,Omen,Jett","Breach,Cypher,Sova,Omen,Jett"
Abyss,FDR,AURA (Inactive),5,13,1,5,8,4,"Cypher,Sova,Reyna,Omen,Jett","Cypher,Sova,Jett,Astra,KAY/O"
Sunset,Akatsuki Aimers,Poseidon Esports,13,11,7,5,6,6,"Breach,Raze,Sage,Omen,Gekko","Breach,Raze,Cypher,Sova,Omen"
Ascent,Dogo Fanclub,SeanGares' Kittens,13,5,2,4,1,11,"Sova,Killjoy,Omen,Jett,KAY/O","Cypher,Sova,Omen,Yoru,Deadlock"
Icebox,random fricks,Lionheart eSports,13,9,9,3,6,4,"Sova,Killjoy,Viper,Reyna,Jett","Sova,Killjoy,Viper,Jett,Gekko"
Lotus,roofcampers,Rice Bowl,12,14,6,7,7,6,"Breach,Raze,Killjoy,Omen,Fade","Raze,Killjoy,Viper,Omen,Fade"
Abyss,Be Like Matt,4Gods1Bum,11,13,6,6,7,5,"Sova,Viper,Omen,Yoru,Chamber","Cypher,Sova,Omen,Jett,Yoru"
Sunset,Blue Otter,LazerrFreeks Mythic,13,1,11,1,0,2,"Breach,Cypher,Sova,Omen,Neon","Breach,Raze,Cypher,Omen,Fade"
Bind,Resonate,The GRID,8,13,5,7,6,3,"Raze,Cypher,Viper,Brimstone,Skye","Raze,Brimstone,Skye,Deadlock,Clove"
Lotus,ENVEE Esports,YDZ Esports,13,5,8,4,1,5,"Raze,Killjoy,Viper,Omen,Fade","Raze,Killjoy,Viper,Omen,Fade"
Icebox,CB,Berzerkers,3,13,2,10,3,1,"Sova,Viper,Sage,Reyna,Chamber","Sova,Killjoy,Viper,Reyna,Jett"
Sunset,CHURCH OF CHAEWON KIM,ABG luvrs,9,13,6,4,9,3,"Breach,Raze,Cypher,Omen,Gekko","Breach,Raze,Cypher,Omen,Gekko"
Ascent,Whiff Nation,Event Horizon,6,13,4,8,5,2,"Sova,Killjoy,Omen,Jett,KAY/O","Sova,Killjoy,Omen,Jett,KAY/O"
Lotus,APX,The blockade,6,13,2,5,8,4,"Raze,Killjoy,Omen,Yoru,Fade","Raze,Killjoy,Viper,Fade,Clove"
Haven,Nightblood Gaming,Paranoia Vortex,13,2,3,0,2,10,"Breach,Cypher,Sova,Omen,Jett","Sova,Killjoy,Jett,Astra,Iso"
Haven,SaD Esports,Nearest Airport,13,5,9,3,2,4,"Sova,Jett,Astra,Deadlock,Iso","Breach,Omen,Chamber,Neon,Fade"
Haven,Eternal Focus Crimson,SaD FROST,13,10,5,7,3,8,"Breach,Cypher,Sova,Omen,Neon","Sova,Killjoy,Omen,Jett,Iso"
Haven,Eternal Focus Crimson,SaD FROST,13,10,5,7,3,8,"Breach,Cypher,Sova,Omen,Neon","Sova,Killjoy,Omen,Jett,Iso"
Haven,Special Grade,Non Verbal,13,10,7,4,6,6,"Breach,Cypher,Sova,Omen,Jett","Killjoy,Viper,Omen,Jett,Skye"
Haven,Kaoticcc and Friends,LoungeLizardWW,13,0,12,0,0,1,"Sova,Killjoy,Omen,Jett,Iso","Breach,Cypher,Sova,Omen,Jett"
Ascent,Motion Men,Kraken,13,5,5,1,4,8,"Cypher,Sova,Omen,Jett,Deadlock","Cypher,Sova,Omen,Jett,Deadlock"
Ascent,roofcampers,Rice Bowl,13,2,10,2,0,3,"Sova,Killjoy,Phoenix,Omen,Jett","Sova,Killjoy,Omen,Jett,KAY/O"
Ascent,Outlaw Empire,Akatsuki Aimers,4,13,4,8,5,0,"Cypher,Sova,Omen,Jett,Deadlock","Cypher,Sova,Omen,Jett,KAY/O"
Ascent,Bosnian Bullets,Astane Anarchy,13,8,6,6,2,7,"Sova,Killjoy,Omen,Jett,KAY/O","Breach,Killjoy,Omen,Jett,Fade"
Haven,lackers,FDR,9,13,4,6,7,5,"Breach,Cypher,Sova,Omen,Jett","Cypher,Sova,Reyna,Omen,Jett"
Lotus,AURA (Inactive),Elation Esports,13,6,6,1,5,7,"Breach,Raze,Killjoy,Omen,Gekko","Breach,Cypher,Omen,Yoru,KAY/O"
Lotus,Barely Acceptable,Dexterity Gaming,13,9,5,5,4,8,"Breach,Raze,Killjoy,Omen,Gekko","Raze,Killjoy,Viper,Omen,Fade"
Bind,Be Like Matt,4Gods1Bum,13,7,9,3,4,4,"Raze,Viper,Brimstone,Skye,Yoru","Raze,Viper,Brimstone,Skye,Gekko"
Bind,add3r's kittens,whats a pretzel,13,6,6,6,0,7,"Raze,Brimstone,Yoru,Fade,Gekko","Raze,Cypher,Brimstone,Skye,Deadlock"
Haven,Resonate,The GRID,13,9,7,5,4,6,"Sova,Killjoy,Omen,Jett,Iso","Cypher,Sova,Omen,Yoru,Iso"
Sunset,TT GC,Dasein Club GC,6,13,5,7,6,1,"Breach,Raze,Cypher,Omen,Gekko","Breach,Raze,Cypher,Sova,Omen"
Sunset,APX,The blockade,5,13,3,9,4,2,"Cypher,Sova,Omen,Yoru,Neon","Breach,Raze,Cypher,Omen,Deadlock"
Haven,Poseidon Esports,In My Prime,13,3,4,0,3,9,"Breach,Sova,Killjoy,Omen,Jett","Cypher,Sova,Omen,Yoru,Iso"
Ascent,Nightblood Gaming,Paranoia Vortex,13,5,10,2,3,3,"Cypher,Sova,Omen,Yoru,Deadlock","Sova,Killjoy,Omen,Jett,KAY/O"
Abyss,SaD Esports,Nearest Airport,13,3,11,1,2,2,"Sova,Omen,Yoru,KAY/O,Harbor","Cypher,Sova,Omen,Jett,Harbor"
Haven,Dogo Fanclub,SeanGares' Kittens,15,17,8,8,9,7,"Sova,Killjoy,Omen,Jett,Clove","Cypher,Yoru,Fade,Iso,Clove"
Lotus,Team Atlantis,A Good Team,2,13,0,3,10,2,"Breach,Raze,Cypher,Omen,Gekko","Raze,Killjoy,Omen,Yoru,Gekko"
Haven,CHURCH OF CHAEWON KIM,ABG luvrs,13,10,9,3,7,4,"Cypher,Sova,Omen,Yoru,Iso","Cypher,Sova,Omen,Yoru,Deadlock"
Sunset,Cuddle Gang,Berzerkers,13,10,8,4,6,5,"Raze,Cypher,KAY/O,Fade,Clove","Raze,Cypher,Sova,Omen,Jett"
Bind,LazerrFreeks Mythic,Lionheart eSports,13,11,7,5,6,6,"Raze,Viper,Brimstone,Fade,Gekko","Raze,Viper,Skye,Gekko,Clove"
Icebox,Special Grade,Non Verbal,13,2,3,0,2,10,"Sova,Killjoy,Viper,Jett,KAY/O","Sova,Killjoy,Viper,Jett,Clove"
Ascent,Event Horizon,YDZ Esports,6,13,3,9,4,3,"Sova,Killjoy,Omen,Jett,KAY/O","Sova,Killjoy,Omen,Jett,KAY/O"
Bind,Kaoticcc and Friends,LoungeLizardWW,13,5,6,0,5,7,"Raze,Viper,Brimstone,Skye,Yoru","Raze,Brimstone,Reyna,Skye,Gekko"
Lotus,Resonate,The GRID,3,13,3,9,4,0,"Raze,Killjoy,Omen,Neon,Gekko","Raze,Cypher,Skye,Deadlock,Clove"
Abyss,Motion Men,Kraken,13,6,5,2,4,8,"Breach,Cypher,Sova,Omen,Jett","Cypher,Sova,Omen,Yoru,Harbor"
Abyss,Eternal Focus Crimson,SaD FROST,13,9,9,3,6,4,"Cypher,Sova,Yoru,Astra,Gekko","Cypher,Sova,Jett,Astra,Gekko"
Abyss,Eternal Focus Crimson,SaD FROST,13,9,9,3,6,4,"Cypher,Sova,Yoru,Astra,Gekko","Cypher,Sova,Jett,Astra,Gekko"
Haven,roofcampers,Rice Bowl,8,13,4,8,5,4,"Cypher,Sova,Omen,Jett,Skye","Breach,Sova,Killjoy,Omen,Jett"
Haven,Sphinx GC,Deagle Ravagers,13,15,9,5,10,4,"Breach,Sova,Killjoy,Omen,Neon","Breach,Sova,Killjoy,Omen,Jett"
Haven,Team Atlantis,A Good Team,3,13,0,4,9,3,"Cypher,Sova,Omen,Yoru,Iso","Breach,Cypher,Sova,Omen,Jett"
Haven,add3r's kittens,whats a pretzel,13,8,6,3,5,7,"Breach,Sova,Killjoy,Omen,Neon","Breach,Cypher,Sova,Omen,Jett"
Ascent,Nine Lives Esports,Outlaw Empire,7,13,5,3,10,2,"Sova,Killjoy,Omen,Jett,KAY/O","Cypher,Sova,Omen,Jett,Deadlock"
Lotus,Day By Day,lackers,7,13,4,8,5,3,"Raze,Killjoy,Viper,Omen,Fade","Breach,Raze,Omen,Gekko,Deadlock"
Abyss,Goon that jawn,CB,13,9,8,2,7,5,"Raze,Sova,Killjoy,Omen,Neon","Cypher,Sova,Jett,Astra,Gekko"
Ascent,Fluffy Men,Furious Five,13,1,2,0,1,11,"Sova,Killjoy,Omen,Jett,KAY/O","Cypher,Sova,Omen,Yoru,Deadlock"
Icebox,TT GC,Dasein Club GC,6,13,3,9,4,3,"Sova,Killjoy,Viper,Reyna,Clove","Killjoy,Viper,Jett,KAY/O,Gekko"
Haven,Dexterity Gaming,4Gods1Bum,4,13,0,5,8,4,"Killjoy,Viper,Jett,Skye,Harbor","Cypher,Sova,Omen,Yoru,Iso"
Haven,Malecient Parasside,raised,1,13,0,2,11,1,"Breach,Killjoy,Omen,Jett,Skye","Cypher,Sova,Omen,Yoru,Iso"
Abyss,Nearest Airport,The blockade,13,7,8,4,3,5,"Cypher,Sova,Omen,Jett,Harbor","Cypher,Sova,Yoru,Astra,Iso"
Lotus,ENVEE Esports,Whiff Nation,13,1,11,1,0,2,"Killjoy,Viper,Omen,Jett,Fade","Raze,Killjoy,Viper,Omen,Fade"
Haven,Bosnian Bullets,Astane Anarchy,13,10,6,6,4,7,"Breach,Sova,Killjoy,Omen,Jett","Breach,Cypher,Sova,Omen,Neon"
Ascent,CLICK,In My Prime,11,13,2,10,3,9,"Sova,Killjoy,Reyna,Omen,Jett","Sova,Killjoy,Omen,Jett,KAY/O"
Sunset,Blue Otter,random fricks,13,8,5,4,4,8,"Breach,Cypher,Sova,Omen,Neon","Breach,Raze,Cypher,Omen,Gekko"
Lotus,Senchigami,Akatsuki Aimers,5,13,0,6,7,5,"Breach,Raze,Killjoy,Omen,Gekko","Breach,Cypher,Omen,Neon,Fade"
Lotus,Cuddle Gang,Berzerkers,13,9,5,5,4,8,"Breach,Raze,Killjoy,Gekko,Clove","Breach,Raze,Cypher,Omen,Gekko"
Lotus,Event Horizon,YDZ Esports,13,8,5,4,4,8,"Breach,Raze,Cypher,Omen,Fade","Raze,Omen,Fade,Deadlock,Clove"
Sunset,Non Verbal,BALLSOHARD UNIVERSITY,13,5,8,4,1,5,"Breach,Cypher,Sova,Omen,Neon","Breach,Raze,Cypher,Omen,Fade"
Lotus,Dogo Fanclub,roofcampers,13,4,10,2,2,3,"Raze,Cypher,Omen,Neon,Fade","Breach,Raze,Killjoy,Omen,Gekko"
Lotus,LoungeLizardWW,Kraken,13,3,4,0,3,9,"Breach,Raze,Cypher,Omen,Fade","Breach,Cypher,Omen,Neon,Fade"
Haven,Poseidon Esports,Atlas Esports,13,11,9,3,8,4,"Breach,Sova,Killjoy,Omen,Jett","Breach,Sova,Killjoy,Omen,Jett"
Lotus,LazerrFreeks Mythic,Lionheart eSports,9,13,5,5,8,4,"Raze,Killjoy,Viper,Omen,Fade","Breach,Cypher,Omen,Neon,Gekko"
Icebox,Special Grade,Natural Order,13,2,3,0,2,10,"Sova,Killjoy,Viper,Jett,KAY/O","Sova,Killjoy,Viper,Jett,Iso"
Sunset,Nightblood Gaming,CHURCH OF CHAEWON KIM,13,7,8,4,3,5,"Breach,Cypher,Sova,Omen,Neon","Breach,Raze,Cypher,Omen,Gekko"
Ascent,Paranoia Vortex,ABG luvrs,14,12,7,6,6,7,"Sova,Killjoy,Omen,Jett,KAY/O","Sova,Killjoy,Omen,Jett,KAY/O"
Icebox,Be Like Matt,Barely Acceptable,13,8,7,5,3,6,"Sova,Killjoy,Viper,Reyna,Jett","Sova,Killjoy,Viper,Jett,Gekko"
Lotus,Kaoticcc and Friends,Motion Men,13,6,5,2,4,8,"Breach,Raze,Killjoy,Omen,Fade","Breach,Cypher,Omen,Neon,Fade"
Sunset,Resonate,Team Atlantis,13,3,10,2,1,3,"Raze,Cypher,Omen,Gekko,Iso","Raze,Cypher,Omen,Neon,Gekko"
Lotus,add3r's kittens,Eternal Focus Crimson,13,10,7,5,5,6,"Sova,Sage,Yoru,KAY/O,Clove","Breach,Raze,Cypher,Omen,Fade"
Ascent,whats a pretzel,SaD FROST,13,2,2,1,1,11,"Cypher,Sova,Omen,Yoru,Deadlock","Sova,Killjoy,Omen,Jett,KAY/O"
Haven,SaD Esports,APX,13,2,3,0,2,10,"Sova,Jett,Astra,Deadlock,Iso","Breach,Sova,Killjoy,Omen,Jett"
Haven,SeanGares' Kittens,Rice Bowl,13,2,3,0,2,10,"Cypher,Yoru,Astra,Fade,Iso","Breach,Sova,Killjoy,Omen,Jett"
Ascent,The GRID,A Good Team,13,6,3,4,2,10,"Cypher,Sova,Reyna,Omen,Jett","Cypher,Sova,Omen,Yoru,Deadlock"
Icebox,Goon that jawn,CB,13,6,4,3,3,9,"Sova,Killjoy,Viper,Reyna,Jett","Sova,Viper,Sage,Reyna,Chamber"
Ascent,ENVEE Esports,Whiff Nation,13,2,1,2,0,12,"Sova,Killjoy,Omen,Jett,KAY/O","Cypher,Sova,Omen,Jett,Deadlock"
Haven,Kaizen (NA),FDR,7,13,2,6,7,5,"Breach,Sova,Killjoy,Omen,Jett","Cypher,Sova,Reyna,Omen,Jett"
Haven,Fluffy Men,Furious Five,13,9,6,4,5,7,"Breach,Cypher,Sova,Omen,Jett","Breach,Cypher,Sova,Omen,Jett"
Lotus,Dexterity Gaming,4Gods1Bum,6,13,4,3,10,2,"Raze,Killjoy,Viper,Omen,Fade","Raze,Killjoy,Viper,Omen,Fade"
Haven,Cuddle Gang,Berzerkers,10,13,3,8,5,7,"Breach,Sova,Killjoy,Omen,Jett","Cypher,Sova,Omen,Jett,Iso"
Sunset,Bosnian Bullets,Astane Anarchy,9,13,4,6,7,5,"Breach,Raze,Cypher,Sova,Omen","Breach,Raze,Cypher,Omen,Fade"
Haven,Non Verbal,BALLSOHARD UNIVERSITY,13,5,8,4,1,5,"Killjoy,Viper,Omen,Jett,Skye","Breach,Cypher,Sova,Omen,Jett"
Icebox,Blue Otter,random fricks,13,10,8,4,6,5,"Sova,Killjoy,Viper,Jett,Gekko","Sova,Killjoy,Viper,Reyna,Jett"
Bind,Dogo Fanclub,roofcampers,13,6,8,4,2,5,"Raze,Brimstone,Reyna,Yoru,Gekko","Raze,Cypher,Viper,Brimstone,Skye"
Bind,Vibin Out Vex,AURA (Inactive),5,13,5,7,6,0,"Raze,Cypher,Viper,Gekko,Clove","Raze,Viper,Brimstone,Fade,Gekko"
Lotus,Nightblood Gaming,CHURCH OF CHAEWON KIM,13,4,4,1,3,9,"Breach,Cypher,Sova,Astra,Neon","Raze,Killjoy,Viper,Omen,Fade"
Abyss,Malecient Parasside,raised,5,13,0,6,7,5,"Sova,Jett,Astra,Harbor,Gekko","Breach,Omen,Jett,KAY/O,Neon"
Icebox,Kaoticcc and Friends,Motion Men,13,2,3,0,2,10,"Sova,Killjoy,Viper,Reyna,Jett","Sova,Killjoy,Viper,Reyna,Gekko"
Abyss,Special Grade,Natural Order,13,4,4,1,3,9,"Cypher,Sova,Viper,Omen,Yoru","Sova,Killjoy,Viper,Jett,Astra"
Abyss,LazerrFreeks Mythic,Lionheart eSports,13,3,9,3,0,4,"Cypher,Sova,Viper,Omen,Yoru","Sova,Killjoy,Viper,Omen,Yoru"
Haven,whats a pretzel,SaD FROST,13,2,3,0,2,10,"Breach,Cypher,Sova,Omen,Jett","Breach,Sova,Killjoy,Omen,Jett"
Ascent,SeanGares' Kittens,Rice Bowl,13,1,2,0,1,11,"Cypher,Sova,Omen,Yoru,Deadlock","Sova,Killjoy,Omen,Jett,KAY/O"
Sunset,Be Like Matt,Barely Acceptable,13,2,10,2,0,3,"Breach,Raze,Cypher,Omen,Gekko","Breach,Cypher,Omen,Yoru,Neon"
Sunset,SaD Esports,APX,13,3,9,3,0,4,"Breach,Raze,Cypher,Sova,Omen","Cypher,Sova,Omen,Yoru,Neon"
Lotus,TT GC,Dasein Club GC,13,9,5,5,4,8,"Breach,Raze,Killjoy,Omen,Fade","Breach,Cypher,Omen,Neon,Fade"
Bind,Sphinx GC,Deagle Ravagers,10,13,5,7,6,5,"Viper,Skye,Yoru,Astra,Gekko","Breach,Raze,Viper,Brimstone,Gekko"
Ascent,LoungeLizardWW,Kraken,13,7,8,0,7,5,"Sova,Killjoy,Omen,Jett,KAY/O","Cypher,Sova,Omen,Jett,Deadlock"
Haven,add3r's kittens,Eternal Focus Crimson,13,7,10,2,5,3,"Cypher,Sova,Phoenix,Omen,Jett","Cypher,Sova,Omen,Skye,Neon"
Lotus,The GRID,A Good Team,13,3,4,0,3,9,"Raze,Cypher,Skye,Deadlock,Clove","Breach,Killjoy,Omen,Neon,Gekko"
Haven,Event Horizon,YDZ Esports,12,14,6,7,7,6,"Breach,Sova,Killjoy,Omen,Jett","Cypher,Sova,Omen,Yoru,Iso"
Haven,Paranoia Vortex,ABG luvrs,13,8,8,4,4,5,"Sova,Killjoy,Omen,Jett,Deadlock","Cypher,Sova,Phoenix,Omen,Jett"
Haven,Resonate,Team Atlantis,13,2,3,0,2,10,"Sova,Killjoy,Omen,Jett,Iso","Breach,Sova,Killjoy,Omen,Jett"
Bind,G2 Esports,FNATIC,11,13,7,5,8,4,"Raze,Viper,Brimstone,Skye,Gekko","Raze,Viper,Astra,Fade,Gekko"
Haven,G2 Esports,FNATIC,3,13,3,9,4,0,"Sova,Killjoy,Viper,Omen,Yoru","Cypher,Sova,Omen,Yoru,Iso"
Abyss,DRX,Trace Esports,13,5,4,2,3,9,"Cypher,Sova,Omen,Jett,KAY/O","Cypher,Sova,Jett,Astra,KAY/O"
Lotus,DRX,Trace Esports,13,3,10,2,1,3,"Raze,Viper,Omen,Chamber,Fade","Raze,Killjoy,Viper,Omen,Fade"
Sunset,Legiowon Puff,Stay K'O,7,13,4,8,5,3,"Breach,Raze,Cypher,Omen,Deadlock","Raze,Omen,Skye,Deadlock,Clove"
Haven,MOCHI,Legion Nyx,9,13,3,7,6,6,"Killjoy,Viper,Omen,Jett,Skye","Breach,Sova,Killjoy,Omen,Jett"
Icebox,MOCHI,Legion Nyx,11,13,5,7,6,6,"Sova,Killjoy,Viper,Jett,Gekko","Sova,Killjoy,Jett,Harbor,Gekko"
Ascent,Legiowon Puff,Stay K'O,17,15,6,10,5,11,"Sova,Killjoy,Omen,Jett,KAY/O","Breach,Sova,Omen,Jett,Deadlock"
Abyss,NTH,FEK ESPORTS GC,13,8,7,2,6,6,"Cypher,Jett,Chamber,Gekko,Clove","Sova,Viper,Jett,Harbor,Gekko"
Abyss,"Fenrir ""White"" E-Club",Azzy White,13,10,9,2,8,4,"Cypher,Sova,Omen,Jett,KAY/O","Cypher,Sova,Omen,Jett,KAY/O"
Sunset,ONE BULLET GAMING GC,Infiriumz Gaming GC,6,13,5,7,6,1,"Breach,Cypher,Omen,Neon,Gekko","Breach,Raze,Cypher,Omen,Gekko"
Lotus,New Combat Line GC,No Sweat Blossom,13,10,8,4,6,5,"Raze,Killjoy,Viper,Omen,Fade","Breach,Killjoy,Omen,Neon,Iso"
Bind,"Fenrir ""White"" E-Club",Azzy White,13,7,4,4,3,9,"Breach,Raze,Cypher,Brimstone,Deadlock","Raze,Brimstone,Skye,Yoru,Gekko"
Bind,MOCHI,Legion Nyx,13,6,10,2,4,3,"Raze,Viper,Brimstone,Fade,Gekko","Breach,Raze,Cypher,Brimstone,Skye"
Ascent,ONE BULLET GAMING GC,Infiriumz Gaming GC,5,13,4,2,11,1,"Breach,Sova,Killjoy,Omen,Jett","Sova,Killjoy,Omen,Jett,KAY/O"
Abyss,Legiowon Puff,Stay K'O,8,13,7,5,8,1,"Cypher,Sova,Omen,Jett,KAY/O","Sova,Omen,Yoru,KAY/O,Deadlock"
Haven,New Combat Line GC,No Sweat Blossom,13,6,4,3,3,9,"Breach,Sova,Killjoy,Omen,Neon","Breach,Cypher,Omen,Neon,Iso"
Sunset,Zen eSports GC,Leviatán GC,13,10,8,3,7,5,"Breach,Cypher,Sova,Omen,Neon","Breach,Cypher,Omen,Neon,Fade"
Lotus,Malecient Parasside,Krows Corax,13,10,7,5,5,6,"Killjoy,Omen,Skye,Neon,Gekko","Breach,Cypher,Omen,Neon,Gekko"
Bind,Sphinx GC,Return of the Ashes,13,7,7,5,2,6,"Viper,Skye,Yoru,Astra,Gekko","Breach,Raze,Cypher,Brimstone,Gekko"
Abyss,Malecient Parasside,Krows Corax,13,8,5,4,4,8,"Sova,Jett,Astra,Harbor,Gekko","Cypher,Sova,Jett,Astra,Gekko"
Abyss,Zen eSports GC,Leviatán GC,14,12,9,4,8,5,"Breach,Cypher,Sova,Omen,Jett","Cypher,Sova,Omen,Jett,Yoru"
Abyss,UC Esports,raised,5,13,3,3,10,2,"Cypher,Omen,Jett,Harbor,Gekko","Breach,Omen,Jett,KAY/O,Neon"
Abyss,XSOUL GC,Deagle Ravagers,5,13,2,4,9,3,"Breach,Cypher,Sova,Jett,Astra","Cypher,Sova,Omen,Jett,KAY/O"
Icebox,Dasein Club GC,B Site Nova,13,5,5,1,4,8,"Killjoy,Viper,Jett,KAY/O,Gekko","Sova,Killjoy,Viper,Jett,Gekko"
Lotus,Zen eSports GC,Leviatán GC,10,13,6,6,7,4,"Raze,Killjoy,Viper,Omen,Fade","Breach,Cypher,Omen,Neon,Iso"
Haven,Sphinx GC,Return of the Ashes,15,13,6,8,5,9,"Breach,Sova,Killjoy,Omen,Neon","Breach,Cypher,Sova,Omen,Neon"
Sunset,Malecient Parasside,Krows Corax,13,15,8,6,9,5,"Breach,Raze,Cypher,Omen,KAY/O","Breach,Cypher,Sova,Omen,Neon"
Icebox,UC Esports,raised,2,13,1,11,2,1,"Sova,Killjoy,Viper,Jett,KAY/O","Viper,Reyna,Jett,Harbor,Gekko"
Haven,XSOUL GC,Deagle Ravagers,3,13,3,9,4,0,"Breach,Cypher,Sova,Omen,Jett","Breach,Sova,Killjoy,Omen,Jett"
Sunset,Dasein Club GC,B Site Nova,13,4,10,2,2,3,"Breach,Raze,Cypher,Sova,Omen","Breach,Raze,Cypher,Omen,Gekko"
Abyss,Team Heretics,FNATIC,14,12,10,3,9,4,"Cypher,Sova,Jett,Astra,Gekko","Sova,Killjoy,Viper,Yoru,Astra"
Lotus,Team Heretics,FNATIC,13,3,4,0,3,9,"Raze,Killjoy,Viper,Omen,Fade","Raze,Killjoy,Viper,Omen,Fade"
Abyss,G2 Esports,Leviatán,5,13,4,8,5,1,"Sova,Killjoy,Viper,Yoru,Astra","Cypher,Sova,Omen,Jett,Harbor"
Icebox,G2 Esports,Leviatán,14,16,10,5,11,4,"Sova,Killjoy,Viper,Harbor,Gekko","Sova,Killjoy,Viper,Jett,Harbor"
Sunset,No Sweat Blossom,NTH,13,5,5,1,4,8,"Breach,Raze,Cypher,Omen,Iso","Raze,Cypher,Omen,Fade,Gekko"
Ascent,Stay K'O,FIXAM,13,11,10,2,9,3,"Breach,Sova,Omen,Jett,Deadlock","Sova,Killjoy,Omen,Jett,KAY/O"
Haven,No Sweat Blossom,NTH,8,13,2,7,6,6,"Breach,Raze,Cypher,Omen,Fade","Raze,Sova,Killjoy,Reyna,Omen"
Haven,MOCHI,Azzy White,5,13,4,8,5,1,"Killjoy,Viper,Omen,Jett,Skye","Breach,Omen,Neon,Fade,Iso"
Lotus,NovaCrew,Infiriumz Gaming GC,1,13,1,11,2,0,"Breach,Killjoy,Jett,Yoru,Astra","Breach,Raze,Killjoy,Omen,Jett"
Bind,ONE BULLET GAMING GC,"Fenrir ""White"" E-Club",4,13,2,10,3,2,"Raze,Viper,Skye,Gekko,Clove","Breach,Raze,Cypher,Brimstone,Deadlock"
Haven,New Combat Line GC,Legiowon Puff,13,7,6,2,5,7,"Breach,Sova,Killjoy,Omen,Jett","Breach,Killjoy,Omen,Jett,Gekko"
Abyss,Stay K'O,FIXAM,13,9,6,4,5,7,"Sova,Omen,Yoru,KAY/O,Deadlock","Cypher,Sova,Omen,Jett,KAY/O"
Ascent,No Sweat Blossom,NTH,13,9,7,5,4,6,"Cypher,Sova,Omen,Jett,Deadlock","Raze,Sova,Killjoy,Reyna,Omen"
Ascent,ONE BULLET GAMING GC,"Fenrir ""White"" E-Club",6,13,3,9,4,3,"Breach,Sova,Killjoy,Omen,Jett","Breach,Sova,Killjoy,Omen,Jett"
Ascent,NovaCrew,Infiriumz Gaming GC,5,13,3,9,4,2,"Sova,Killjoy,Jett,KAY/O,Clove","Sova,Killjoy,Omen,Jett,KAY/O"
Sunset,New Combat Line GC,Legiowon Puff,13,4,9,3,1,4,"Breach,Raze,Cypher,Omen,Clove","Breach,Raze,Cypher,Omen,Deadlock"
Haven,XSOUL GC,Dasein Club GC,13,5,8,4,1,5,"Breach,Cypher,Sova,Omen,Jett","Breach,Cypher,Sova,Omen,Neon"
Haven,Malecient Parasside,Return of the Ashes,7,13,5,3,10,2,"Breach,Killjoy,Omen,Skye,Neon","Breach,Cypher,Sova,Omen,Neon"
Sunset,Sphinx GC,UC Esports,13,8,8,4,4,5,"Breach,Cypher,Omen,Neon,Fade","Breach,Raze,Cypher,Omen,Fade"
Ascent,XSOUL GC,Dasein Club GC,13,9,3,9,0,10,"Sova,Killjoy,Omen,Jett,KAY/O","Sova,Killjoy,Omen,Jett,KAY/O"
Sunset,TT GC,Deagle Ravagers,4,13,2,10,3,2,"Breach,Raze,Cypher,Sova,Omen","Breach,Raze,Cypher,Omen,Gekko"
Ascent,Sphinx GC,UC Esports,13,2,3,0,2,10,"Sova,Killjoy,Omen,Jett,KAY/O","Sova,Killjoy,Omen,Jett,KAY/O"
Ascent,Malecient Parasside,Return of the Ashes,13,15,4,10,5,9,"Sova,Killjoy,Omen,Jett,KAY/O","Breach,Raze,Cypher,Sova,Omen"
Lotus,TT GC,Deagle Ravagers,2,13,2,10,3,0,"Breach,Raze,Killjoy,Omen,Fade","Raze,Killjoy,Viper,Omen,Fade"
Lotus,XSOUL GC,Dasein Club GC,6,13,1,6,7,5,"Breach,Raze,Cypher,Omen,Fade","Breach,Cypher,Omen,Neon,Fade"
Haven,Requiem,Siko Esports,13,10,5,6,4,8,"Cypher,Sova,Omen,Yoru,Iso","Breach,Cypher,Sova,Omen,Jett"
Sunset,Requiem,Siko Esports,8,13,3,6,7,5,"Raze,Cypher,Omen,KAY/O,Gekko","Breach,Raze,Cypher,Sova,Omen"
Lotus,Requiem,Siko Esports,13,7,6,2,5,7,"Raze,Cypher,Viper,Omen,Fade","Raze,Killjoy,Viper,Omen,Fade"
Icebox,Requiem,Siko Esports,13,3,9,3,0,4,"Killjoy,Viper,Jett,KAY/O,Gekko","Sova,Killjoy,Viper,KAY/O,Clove"
Sunset,Trace Esports,EDward Gaming,10,13,2,10,3,8,"Breach,Raze,Cypher,Sova,Omen","Cypher,Sova,Omen,KAY/O,Neon"
Bind,Trace Esports,EDward Gaming,7,13,5,3,10,2,"Raze,Cypher,Brimstone,Skye,Deadlock","Raze,Viper,Brimstone,Fade,Gekko"
Haven,DRX,Sentinels,8,13,2,7,6,6,"Breach,Cypher,Sova,Omen,Jett","Breach,Cypher,Sova,Omen,Neon"
Sunset,DRX,Sentinels,13,15,7,7,8,6,"Breach,Cypher,Sova,Omen,Neon","Breach,Cypher,Omen,Neon,Fade"
Haven,Bon Bon Bum Contra GC,KS Esports GC,13,9,7,3,6,6,"Breach,Sova,Killjoy,Omen,Chamber","Breach,Sova,Killjoy,Omen,Jett"
Icebox,Bon Bon Bum Contra GC,KS Esports GC,8,13,4,5,8,4,"Sova,Killjoy,Reyna,Jett,Harbor","Sova,Killjoy,Viper,Jett,Gekko"
Haven,9z Team GC,FiRePOWER GC,13,6,8,4,2,5,"Breach,Cypher,Omen,Neon,Gekko","Breach,Sova,Killjoy,Omen,Neon"
Icebox,9z Team GC,FiRePOWER GC,13,9,5,5,4,8,"Killjoy,Viper,Jett,KAY/O,Gekko","Killjoy,Viper,Omen,KAY/O,Gekko"
Abyss,K7 Esports GC,FUSION X,9,13,7,5,8,2,"Breach,Cypher,Sova,Omen,Jett","Breach,Cypher,Omen,Jett,Gekko"
Haven,minions united GC,SaD FROST,11,13,8,4,9,3,"Breach,Sova,Killjoy,Omen,Jett","Sova,Killjoy,Omen,Jett,Iso"
Haven,K7 Esports GC,FUSION X,6,13,5,7,6,1,"Breach,Cypher,Sova,Omen,Jett","Cypher,Sova,Astra,Gekko,Iso"
Ascent,minions united GC,SaD FROST,2,13,2,10,3,0,"Sova,Killjoy,Omen,Jett,KAY/O","Sova,Killjoy,Omen,Jett,KAY/O"
Lotus,University War GC,KRÜ BLAZE,5,13,2,4,9,3,"Breach,Raze,Killjoy,Omen,Fade","Raze,Killjoy,Viper,Omen,Fade"
Ascent,University War GC,KRÜ BLAZE,2,13,2,10,3,0,"Sova,Killjoy,Omen,Jett,KAY/O","Sova,Killjoy,Omen,Jett,KAY/O"
Haven,spaceW,NAPOLYON,5,13,4,8,5,1,"Breach,Sova,Killjoy,Omen,Jett","Killjoy,Viper,Omen,Jett,Skye"
Ascent,Legion Nyx,Legiowon Puff,4,13,3,9,4,1,"Breach,Sova,Killjoy,Omen,Jett","Sova,Killjoy,Omen,Jett,KAY/O"
Bind,"Fenrir ""White"" E-Club",FEK ESPORTS GC,13,4,9,3,1,4,"Breach,Raze,Cypher,Brimstone,Deadlock","Breach,Raze,Viper,Omen,Gekko"
Icebox,Stay K'O,MOCHI,1,13,0,2,11,1,"Killjoy,Viper,Jett,KAY/O,Clove","Sova,Killjoy,Viper,Jett,Gekko"
Abyss,FIXAM,Azzy White,3,13,0,4,9,3,"Breach,Jett,Astra,Chamber,Gekko","Cypher,Sova,Omen,Jett,KAY/O"
Lotus,No Sweat Blossom,NovaCrew,13,3,3,1,2,10,"Breach,Killjoy,Omen,Neon,Iso","Cypher,Skye,Astra,Chamber,Gekko"
Lotus,Infiriumz Gaming GC,NTH,16,18,9,8,10,7,"Breach,Raze,Killjoy,Omen,Jett","Killjoy,Jett,Gekko,Iso,Clove"
Abyss,"Fenrir ""White"" E-Club",FEK ESPORTS GC,13,6,6,1,5,7,"Cypher,Sova,Omen,Jett,KAY/O","Sova,Viper,Jett,KAY/O,Harbor"
Bind,Legion Nyx,Legiowon Puff,8,13,2,10,3,6,"Breach,Raze,Cypher,Brimstone,Skye","Raze,Cypher,Viper,Brimstone,Skye"
Ascent,FIXAM,Azzy White,6,13,5,7,6,1,"Sova,Killjoy,Omen,Jett,KAY/O","Cypher,Sova,Omen,Jett,KAY/O"
Ascent,No Sweat Blossom,NovaCrew,13,2,12,0,2,1,"Cypher,Sova,Omen,Jett,Deadlock","Sova,Killjoy,Jett,KAY/O,Clove"
Bind,Stay K'O,MOCHI,13,15,10,4,11,3,"Brimstone,Skye,Yoru,Gekko,Clove","Raze,Viper,Brimstone,Fade,Gekko"
Haven,Infiriumz Gaming GC,NTH,1,13,1,1,12,0,"Breach,Sova,Killjoy,Omen,Neon","Raze,Sova,Killjoy,Reyna,Omen"
Ascent,Goon that jawn,SaD Purple,12,14,6,7,7,6,"Sova,Killjoy,Omen,Jett,Yoru","Sova,Killjoy,Omen,Jett,KAY/O"
Lotus,Deagle Ravagers,raised,13,9,4,6,3,9,"Raze,Killjoy,Viper,Omen,Fade","Breach,Raze,Killjoy,Omen,Neon"
Lotus,Goon that jawn,SaD Purple,9,13,3,7,6,6,"Breach,Killjoy,Omen,Neon,Fade","Breach,Raze,Cypher,Omen,Fade"
Haven,Deagle Ravagers,raised,13,7,6,2,5,7,"Breach,Sova,Killjoy,Omen,Jett","Cypher,Sova,Omen,Yoru,Iso"
Icebox,Dasein Club GC,Krows Corax,13,4,10,2,2,3,"Killjoy,Viper,Jett,KAY/O,Gekko","Sova,Viper,Jett,Harbor,Gekko"
Haven,Return of the Ashes,B Site Nova,13,5,5,1,4,8,"Breach,Cypher,Sova,Omen,Neon","Breach,Sova,Killjoy,Omen,Jett"
Icebox,Goon that jawn,SaD Purple,13,5,2,4,1,11,"Sova,Killjoy,Viper,Reyna,Jett","Sova,Killjoy,Viper,Reyna,Jett"
Abyss,Dasein Club GC,Krows Corax,13,10,11,1,9,2,"Cypher,Sova,Omen,Jett,Iso","Cypher,Sova,Jett,Astra,Gekko"
Abyss,Deagle Ravagers,raised,9,13,6,6,7,3,"Cypher,Sova,Omen,Jett,KAY/O","Breach,Omen,Jett,KAY/O,Neon"
Sunset,Return of the Ashes,B Site Nova,13,7,6,2,5,7,"Breach,Cypher,Omen,Neon,Gekko","Breach,Raze,Cypher,Omen,Gekko"
Icebox,SaD Purple,Burger Boyz 2.0,17,15,9,7,8,8,"Sova,Killjoy,Viper,Reyna,Jett","Sova,Killjoy,Viper,Jett,Gekko"
Ascent,Goon that jawn,MORBIDLY OBESE,13,9,5,7,2,8,"Sova,Killjoy,Omen,Jett,Yoru","Sova,Killjoy,Omen,Jett,KAY/O"
Ascent,BB Esports,Amanakomeow,1,13,0,2,11,1,"Cypher,Sova,Omen,Jett,KAY/O","Cypher,Sova,Omen,Jett,Deadlock"
Lotus,Goon that jawn,MORBIDLY OBESE,11,13,4,8,5,7,"Breach,Cypher,Neon,Fade,Clove","Raze,Killjoy,Omen,Fade,Gekko"
Lotus,SaD Purple,Burger Boyz 2.0,13,6,5,2,4,8,"Breach,Raze,Cypher,Omen,Fade","Breach,Raze,Cypher,Omen,Gekko"
Bind,BB Esports,Amanakomeow,10,13,6,6,7,4,"Raze,Viper,Brimstone,Fade,Gekko","Raze,Cypher,Brimstone,Skye,Deadlock"
Icebox,InTenZive,SZK Esports,10,13,4,8,5,6,"Sova,Killjoy,Viper,Jett,KAY/O","Sova,Killjoy,Viper,Jett,Iso"
Haven,Goon that jawn,MORBIDLY OBESE,13,9,9,3,6,4,"Breach,Sova,Killjoy,Omen,Yoru","Breach,Cypher,Sova,Omen,Jett"
Ascent,Vila das Flores,REVOADA,10,13,6,6,7,4,"Cypher,Sova,Phoenix,Omen,Jett","Sova,Killjoy,Omen,Jett,KAY/O"
Bind,SaD Purple,Burger Boyz 2.0,7,13,1,7,6,6,"Raze,Viper,Brimstone,Skye,Deadlock","Raze,Brimstone,Skye,Gekko,Deadlock"
Ascent,Amanakomeow,Hidden Horizon,13,3,9,3,0,4,"Cypher,Sova,Omen,Jett,Deadlock","Sova,Killjoy,Omen,Jett,KAY/O"
Sunset,BB Esports,Cognizant,15,13,4,10,3,11,"Breach,Cypher,Sova,Omen,Neon","Breach,Cypher,Sova,Omen,Neon"
Sunset,InTenZive,SZK Esports,7,13,1,7,6,6,"Raze,Cypher,Sova,Omen,Gekko","Breach,Raze,Cypher,Omen,Gekko"
Lotus,Vila das Flores,REVOADA,4,13,3,9,4,1,"Breach,Cypher,Omen,Neon,Fade","Raze,Killjoy,Viper,Skye,Clove"
Haven,Next In Line,BB Esports,10,13,4,7,6,6,"Breach,Cypher,Sova,Omen,Neon","Cypher,Sova,Omen,Jett,Iso"
Bind,Cognizant,EXO Clan,13,8,10,2,6,3,"Breach,Cypher,Brimstone,Neon,Gekko","Raze,Viper,Brimstone,Fade,Gekko"
Bind,Amanakomeow,Phantom Fury,13,11,10,2,9,3,"Raze,Cypher,Brimstone,Skye,Deadlock","Cypher,Brimstone,KAY/O,Neon,Gekko"
Sunset,InTenZive,Nexum EC,13,10,8,3,7,5,"Raze,Cypher,Sova,Omen,Gekko","Cypher,Sova,Omen,Jett,KAY/O"
Lotus,SZK Esports,INCOGNITO,13,2,10,2,0,3,"Breach,Raze,Killjoy,Omen,Fade","Breach,Cypher,Omen,Neon,Gekko"
Abyss,Vila das Flores,REVOADA,13,8,3,6,2,10,"Cypher,Sova,Omen,Jett,Harbor","Cypher,Sova,Reyna,Omen,Jett"
Bind,Nexum EC,STAKERS,13,5,11,1,4,2,"Raze,Omen,Skye,KAY/O,Clove","Breach,Raze,Cypher,Brimstone,Skye"
Abyss,INCOGNITO,Solar Flare,13,7,6,2,5,7,"Breach,Cypher,Sova,Omen,Jett","Cypher,Sova,Omen,Jett,Deadlock"
Haven,SZK Esports,GMBLERS Esports,13,5,3,3,2,10,"Breach,Sova,Killjoy,Omen,Jett","Breach,Sova,Killjoy,Omen,Jett"
Sunset,InTenZive,IAPEsports,13,6,9,3,3,4,"Raze,Cypher,Sova,Omen,Gekko","Breach,Raze,Cypher,Omen,Yoru"
Lotus,spaceW,MAU Academy,13,5,8,4,1,5,"Breach,Raze,Killjoy,Omen,Gekko","Raze,Killjoy,Viper,Omen,Fade"
Bind,Vila das Flores,REVOADA,8,13,5,7,6,3,"Viper,Brimstone,Yoru,Neon,Fade","Raze,Viper,Brimstone,Jett,Skye"
Haven,X1 Esports,NAPOLYON,8,13,2,7,6,6,"Breach,Cypher,Sova,Omen,Jett","Killjoy,Viper,Omen,Jett,Skye"
Sunset,TFT Demons,MAU Academy,7,13,4,4,9,3,"Breach,Raze,Cypher,Sova,Omen","Cypher,Sova,Omen,KAY/O,Neon"
Ascent,NEANLATIYONBOLM,spaceW,10,13,6,5,8,4,"Sova,Killjoy,Omen,Jett,Yoru","Breach,Sova,Killjoy,Omen,Jett"
Haven,Rulers Of Fate,NAPOLYON,4,13,3,9,4,1,"Breach,Sova,Killjoy,Omen,Jett","Killjoy,Viper,Omen,Jett,Skye"
Ascent,X1 Esports,aynenkankaondan,13,2,3,0,2,10,"Cypher,Sova,Omen,Jett,KAY/O","Sova,Killjoy,Omen,Jett,KAY/O"
Haven,Vila das Flores,REVOADA,13,7,6,6,1,7,"Breach,Cypher,Sova,Omen,Neon","Breach,Sova,Killjoy,Omen,Neon"
Sunset,FAV gaming,IGZIST,13,11,8,4,7,5,"Breach,Raze,Cypher,Sova,Omen","Breach,Cypher,Sova,Omen,Neon"
Abyss,The MongolZ,BC SWELL,13,10,5,6,4,8,"Cypher,Viper,Skye,Yoru,Astra","Sova,Killjoy,Viper,Yoru,Astra"
Ascent,FAV gaming,IGZIST,13,10,9,2,8,4,"Sova,Killjoy,Omen,Jett,KAY/O","Sova,Killjoy,Omen,Jett,KAY/O"
Sunset,esports team αD,The MongolZ,10,13,5,6,7,5,"Raze,Cypher,Sage,Omen,Fade","Breach,Cypher,Omen,Neon,Gekko"
Ascent,BC SWELL,RIP root,13,6,6,1,5,7,"Sova,Killjoy,Omen,Jett,KAY/O","Sova,Killjoy,Omen,Jett,KAY/O"
Haven,IGZIST,Slovo Yakuta,13,7,5,3,4,8,"Breach,Sova,Killjoy,Omen,Jett","Breach,Sova,Killjoy,Omen,Jett"
Lotus,EDward Gaming,Paper Rex,13,4,9,3,1,4,"Breach,Omen,Neon,Fade,Clove","Raze,Cypher,Omen,Jett,Skye"
Ascent,FAV gaming,WICKED,13,4,4,1,3,9,"Sova,Killjoy,Omen,Jett,KAY/O","Sova,Killjoy,Omen,Jett,KAY/O"
Sunset,SilhouetteS,FAV gaming,1,13,1,11,2,0,"Cypher,Sova,Omen,Jett,KAY/O","Breach,Raze,Cypher,Sova,Omen"
Abyss,BC SWELL,ゆぴお戦隊ゴレンジャー,13,3,4,0,3,9,"Sova,Killjoy,Viper,Yoru,Astra","Omen,Jett,KAY/O,Gekko,Deadlock"
Ascent,TeamDuration,IGZIST,3,13,3,9,4,0,"Sova,Killjoy,Omen,Jett,KAY/O","Sova,Killjoy,Omen,Jett,KAY/O"
Lotus,TRIDENT,Slovo Yakuta,5,13,2,4,9,3,"Breach,Raze,Killjoy,Omen,Fade","Breach,Killjoy,Jett,Gekko,Clove"
Sunset,RIP root,Vtuber,13,8,9,0,8,4,"Breach,Cypher,Sova,Omen,Neon","Breach,Cypher,Sova,Omen,Neon"
Sunset,WICKED,toshio,13,0,12,0,0,1,"Breach,Cypher,Sova,Omen,Neon","Cypher,Sova,Phoenix,Omen,Clove"
Abyss,The MongolZ,NIX EAST,13,5,5,1,4,8,"Cypher,Viper,Skye,Yoru,Astra","Viper,Sage,Omen,Skye,KAY/O"
Sunset,esports team αD,DragonGaming,13,6,10,2,4,3,"Raze,Cypher,Sage,Omen,Fade","Raze,Cypher,Sova,Omen,Gekko"
Sunset,EDward Gaming,Paper Rex,13,8,6,6,2,7,"Cypher,Sova,Omen,KAY/O,Neon","Breach,Raze,Sage,Omen,Gekko"
Icebox,EDward Gaming,Paper Rex,3,13,0,4,9,3,"Sova,Killjoy,Viper,Jett,KAY/O","Sova,Killjoy,Viper,Sage,Jett"
Sunset,Leviatán,Team Vitality,13,4,3,2,2,10,"Breach,Cypher,Sova,Omen,Neon","Cypher,Sova,Omen,KAY/O,Neon"
Icebox,Leviatán,Team Vitality,14,12,6,7,5,8,"Sova,Killjoy,Viper,Jett,Harbor","Sova,Killjoy,Viper,Jett,Gekko"
Sunset,Special Grade,MORBIDLY OBESE,6,13,4,8,5,2,"Breach,Raze,Cypher,Omen,Gekko","Breach,Raze,Cypher,Sova,Clove"
Ascent,Goon that jawn,Maryville University,13,5,8,4,1,5,"Sova,Killjoy,Omen,Jett,Yoru","Sova,Killjoy,Omen,Jett,KAY/O"
Bind,Special Grade,MORBIDLY OBESE,13,9,5,7,2,8,"Raze,Brimstone,Fade,Gekko,Deadlock","Raze,Viper,Brimstone,Yoru,Fade"
Bind,SaD Purple,Nightblood Gaming,13,7,9,3,4,4,"Raze,Viper,Brimstone,Skye,Deadlock","Raze,Brimstone,Skye,Gekko,Deadlock"
Icebox,Burger Boyz 2.0,LazerrFreeks Mythic,13,7,7,1,6,6,"Sova,Killjoy,Viper,Jett,Gekko","Sova,Killjoy,Viper,Reyna,Jett"
Lotus,Crack Babies,les piments,4,13,3,9,4,1,"Raze,Killjoy,Viper,Omen,Fade","Breach,Cypher,Omen,Neon,Fade"
Icebox,Crack Babies,les piments,7,13,5,7,6,2,"Sova,Viper,Sage,Reyna,Chamber","Sova,Killjoy,Viper,Reyna,Jett"
Ascent,Special Grade,MORBIDLY OBESE,9,13,2,8,5,7,"Cypher,Sova,Omen,Yoru,Deadlock","Sova,Killjoy,Omen,Jett,KAY/O"
Haven,Burger Boyz 2.0,LazerrFreeks Mythic,15,13,11,3,10,4,"Breach,Sova,Killjoy,Omen,Neon","Killjoy,Viper,Omen,Jett,Skye"
Lotus,SaD Purple,Nightblood Gaming,10,13,7,5,8,3,"Breach,Raze,Cypher,Omen,Fade","Breach,Cypher,Sova,Astra,Neon"
Haven,Goon that jawn,Maryville University,14,12,6,7,5,8,"Breach,Sova,Killjoy,Omen,Yoru","Breach,Cypher,Sova,Omen,Jett"
Sunset,SaD FROST,VO Blossoms,13,1,2,0,1,11,"Breach,Cypher,Neon,Gekko,Clove","Raze,Cypher,KAY/O,Gekko,Clove"
Lotus,Burger Boyz 2.0,LazerrFreeks Mythic,3,13,3,9,4,0,"Breach,Raze,Cypher,Omen,Gekko","Raze,Killjoy,Viper,Omen,Fade"
Lotus,FAT Opps,MORBIDLY OBESE,8,13,8,4,9,0,"Raze,Killjoy,Viper,Omen,Fade","Raze,Killjoy,Omen,Fade,Gekko"
Sunset,yolo,Crack Babies,18,20,10,9,11,8,"Breach,Raze,Cypher,Omen,Gekko","Breach,Raze,Cypher,Omen,Gekko"
Abyss,Goon that jawn,Maryville University,6,13,2,5,8,4,"Cypher,Sova,Reyna,Omen,Yoru","Sova,Viper,Omen,Yoru,Iso"
Ascent,SaD Purple,Nightblood Gaming,13,11,7,5,6,6,"Sova,Killjoy,Omen,Jett,KAY/O","Cypher,Sova,Omen,Yoru,Deadlock"
Ascent,Omnipotence,les piments,3,13,3,9,4,0,"Breach,Sova,Killjoy,Omen,KAY/O","Cypher,Sova,Omen,Jett,KAY/O"
Haven,SaD FROST,VO Blossoms,14,12,11,2,10,3,"Breach,Sova,Killjoy,Jett,Clove","Breach,Sova,Killjoy,Omen,Jett"
Icebox,ROSE,LazerrFreeks Mythic,8,13,3,6,7,5,"Killjoy,Viper,Sage,Jett,Gekko","Sova,Killjoy,Viper,Reyna,Jett"
Lotus,yolo,Lotus 8 Purple,13,6,5,2,4,8,"Breach,Raze,Cypher,Omen,Gekko","Breach,Raze,Cypher,Omen,Gekko"
Ascent,FAT Opps,MORBIDLY OBESE,13,15,7,7,8,6,"Sova,Killjoy,Omen,Jett,KAY/O","Sova,Killjoy,Omen,Jett,KAY/O"
Haven,Goon that jawn,Deleta Esports,13,5,3,3,2,10,"Breach,Sova,Killjoy,Omen,Yoru","Sova,Killjoy,Reyna,Jett,Clove"
Haven,PR ESPORTS,Crack Babies,9,13,4,8,5,5,"Breach,Sova,Killjoy,Omen,Jett","Breach,Sova,Killjoy,Omen,Jett"
Bind,Fast Food Workers,Maryville University,10,13,4,8,5,6,"Raze,Cypher,Viper,Brimstone,Skye","Raze,Cypher,Viper,Brimstone,Skye"
Ascent,les piments,twobits money crew,13,8,7,2,6,6,"Sova,Killjoy,Reyna,Omen,Jett","Sova,Killjoy,Omen,Jett,KAY/O"
Abyss,Omnipotence,OutGoing Esports,13,7,6,2,5,7,"Breach,Sova,Killjoy,Omen,Jett","Breach,Cypher,Sova,Omen,Jett"
Haven,ROSE,LazerrFreeks Mythic,7,13,2,6,7,5,"Breach,Sova,Killjoy,Omen,Jett","Killjoy,Viper,Omen,Jett,Skye"
Icebox,Asians and Skuba,Nightblood Gaming,11,13,7,5,8,4,"Sova,Killjoy,Viper,Reyna,Jett","Sova,Killjoy,Viper,Omen,Iso"
Lotus,SaD Purple,Last Resistance,13,5,9,3,2,4,"Breach,Raze,Cypher,Omen,Fade","Breach,Cypher,Neon,Fade,Clove"
Sunset,Br0cken BOis,les piments,2,13,1,11,2,1,"Cypher,Sova,Omen,KAY/O,Neon","Raze,Cypher,Sova,Omen,Gekko"
Bind,Goon that jawn,Deleta Esports,13,10,5,6,4,8,"Raze,Viper,Yoru,Fade,Clove","Raze,Cypher,Brimstone,Skye,Gekko"
Bind,Clemson Esports,yolo,11,13,6,6,7,5,"Raze,Viper,Brimstone,Skye,Yoru","Raze,Cypher,Viper,Brimstone,Skye"
Ascent,The Outcasts,PR ESPORTS,2,13,0,3,10,2,"Cypher,Sova,Phoenix,Omen,Jett","Sova,Killjoy,Omen,Jett,KAY/O"
Ascent,Fast Food Workers,Maryville University,13,5,8,4,1,5,"Cypher,Sova,Omen,Jett,Deadlock","Sova,Killjoy,Omen,Jett,KAY/O"
Haven,washed players,Crack Babies,3,13,2,10,3,1,"Breach,Sova,Killjoy,Omen,Jett","Breach,Sova,Killjoy,Omen,Jett"
Haven,FAT Opps,MORBIDLY OBESE,13,11,9,3,8,4,"Killjoy,Viper,Omen,Jett,Skye","Breach,Cypher,Sova,Omen,Jett"
Haven,Burger Boyz 2.0,Nearest Airport,13,8,8,1,7,5,"Breach,Sova,Killjoy,Omen,Neon","Breach,Cypher,Sova,Omen,Neon"
Bind,REVOADA,Team Leveling,13,10,7,4,6,6,"Raze,Jett,Skye,Chamber,Clove","Raze,Viper,Brimstone,Skye,Gekko"
Icebox,Special Grade,LoungeLizardWW,13,8,6,6,2,7,"Sova,Killjoy,Viper,Jett,Gekko","Sova,Killjoy,Viper,Reyna,Jett"
Ascent,Nephillium BLACK,Omnipotence,6,13,1,6,7,5,"Sova,Killjoy,Omen,Jett,Fade","Breach,Sova,Killjoy,Omen,KAY/O"
Icebox,SaD Purple,Last Resistance,13,7,8,0,7,5,"Sova,Killjoy,Viper,Reyna,Jett","Sova,Viper,Reyna,Jett,Deadlock"
Ascent,Acrylic eSports,Lotus 8 Purple,6,13,2,10,3,4,"Killjoy,Viper,Omen,Jett,Skye","Sova,Killjoy,Omen,Jett,KAY/O"
Sunset,LazerrFreeks Mythic,Cuddle Gang,13,8,6,3,5,7,"Breach,Raze,Cypher,Omen,Fade","Breach,Raze,Cypher,Sova,Omen"
Sunset,Asians and Skuba,Nightblood Gaming,12,14,8,5,9,4,"Breach,Raze,Cypher,Sova,Omen","Breach,Cypher,Sova,Omen,Neon"
Sunset,Fast Food Workers,Maryville University,8,13,5,4,9,3,"Breach,Raze,Cypher,Omen,Gekko","Breach,Raze,Cypher,Sova,Omen"
Ascent,OutGoing Esports,The Side Homies,13,3,10,2,1,3,"Sova,Killjoy,Omen,Jett,KAY/O","Raze,Killjoy,Omen,Jett,Gekko"
Haven,twobits money crew,Bigsteppas,13,0,1,0,0,12,"Breach,Cypher,Sova,Omen,Jett","Cypher,Reyna,Omen,Neon,Gekko"
Abyss,Burger Boyz 2.0,Nearest Airport,13,8,6,3,5,7,"Breach,Cypher,Sova,Omen,Yoru","Cypher,Sova,Omen,Jett,Harbor"
Sunset,Special Grade,LoungeLizardWW,13,6,3,4,2,10,"Breach,Raze,Cypher,Omen,Gekko","Breach,Raze,Cypher,Omen,Gekko"
Icebox,Deleta Esports,Jawns IV,13,10,8,4,6,5,"Sova,Killjoy,Viper,Reyna,Jett","Sova,Killjoy,Viper,Gekko,Iso"
Abyss,REVOADA,Team Leveling,13,7,8,4,3,5,"Cypher,Sova,Reyna,Omen,Jett","Breach,Omen,KAY/O,Neon,Deadlock"
Lotus,FAT Opps,4star,13,9,6,6,3,7,"Raze,Killjoy,Viper,Omen,Fade","Raze,Cypher,Fade,Gekko,Clove"
Lotus,Goon that jawn,Raven Esports,13,6,10,2,4,3,"Breach,Cypher,Neon,Fade,Clove","Breach,Raze,Cypher,Omen,Fade"
Lotus,ENVEE YSL,Last Resistance,13,8,7,2,6,6,"Breach,Cypher,Neon,Fade,Clove","Raze,Omen,Fade,Deadlock,Clove"
Ascent,Fast Food Workers,English or Spanish,13,2,10,2,0,3,"Cypher,Sova,Omen,Jett,Deadlock","Sova,Killjoy,Omen,Jett,KAY/O"
Lotus,LazerrFreeks Mythic,Cuddle Gang,10,13,10,2,11,0,"Raze,Killjoy,Viper,Omen,Fade","Raze,Killjoy,Omen,Fade,Gekko"
Haven,ROSE,Team Digital,13,9,9,1,8,4,"Sova,Killjoy,Omen,Yoru,Neon","Breach,Sova,Killjoy,Omen,Jett"
Haven,Dexterity Gaming,Nearest Airport,5,13,1,5,8,4,"Breach,Sova,Killjoy,Omen,Jett","Breach,Sova,Omen,Chamber,Neon"
Haven,Asians and Skuba,Lionheart eSports,13,4,8,4,0,5,"Breach,Cypher,Sova,Omen,Jett","Sova,Killjoy,Viper,Omen,Yoru"
Lotus,Deleta Esports,Jawns IV,13,7,8,4,3,5,"Raze,Killjoy,Jett,Gekko,Clove","Raze,Killjoy,Viper,Omen,Fade"
Icebox,SaD Purple,Forsaken Shadows,14,12,7,6,6,7,"Sova,Killjoy,Viper,Jett,Iso","Sova,Killjoy,Viper,Reyna,Jett"
Lotus,LoungeLizardWW,Moon (NA),13,4,10,2,2,3,"Raze,Cypher,Omen,Fade,Gekko","Raze,Killjoy,Viper,Omen,Fade"
Ascent,MORBIDLY OBESE,Fargo North Dakota,13,11,4,8,3,9,"Sova,Killjoy,Omen,Jett,KAY/O","Cypher,Sova,Omen,Jett,Iso"
Abyss,Maryville University,Emma's Bakas,13,1,11,1,0,2,"Sova,Viper,Omen,Yoru,Iso","Breach,Raze,Cypher,Astra,Iso"
Lotus,Nightblood Gaming,Heavenly Sword Sect,13,8,3,6,2,10,"Breach,Cypher,Sova,Astra,Neon","Raze,Killjoy,Yoru,Gekko,Clove"
Bind,FAT Opps,4star,11,13,5,7,6,6,"Raze,Viper,Brimstone,Skye,Gekko","Raze,Viper,Brimstone,Fade,Gekko"
Bind,Special Grade,ABG luvrs,13,1,11,1,0,2,"Raze,Brimstone,Fade,Gekko,Deadlock","Raze,Viper,Brimstone,Reyna,Skye"
Haven,Goon that jawn,Raven Esports,13,7,7,5,2,6,"Breach,Sova,Killjoy,Omen,Yoru","Sova,Killjoy,Viper,Phoenix,Omen"
Bind,Burger Boyz 2.0,Harmony,13,6,10,2,4,3,"Raze,Brimstone,Skye,Gekko,Deadlock","Raze,Cypher,Brimstone,Skye,Deadlock"
Icebox,REVOADA,Team Leveling,11,13,9,3,10,2,"Sova,Killjoy,Viper,Jett,Gekko","Killjoy,Viper,KAY/O,Gekko,Iso"
Haven,Fast Food Workers,English or Spanish,14,12,10,3,9,4,"Breach,Sova,Killjoy,Omen,Jett","Breach,Cypher,Sova,Omen,Jett"
Lotus,Asians and Skuba,Lionheart eSports,13,8,8,4,4,5,"Breach,Cypher,Omen,Neon,Gekko","Raze,Killjoy,Viper,Omen,Fade"
Sunset,Maryville University,Emma's Bakas,13,3,4,0,3,9,"Breach,Raze,Cypher,Sova,Omen","Breach,Raze,Cypher,Deadlock,Clove"
Haven,Deleta Esports,Jawns IV,10,13,4,8,5,6,"Cypher,Sova,Phoenix,Omen,Jett","Breach,Sova,Killjoy,Omen,Jett"
Bind,Dexterity Gaming,Nearest Airport,8,13,7,5,8,1,"Raze,Brimstone,Skye,Yoru,Harbor","Raze,Cypher,Omen,Yoru,Deadlock"
Abyss,SaD Purple,Forsaken Shadows,13,8,7,5,3,6,"Cypher,Sova,Omen,Jett,Yoru","Cypher,Sova,Jett,Astra,Gekko"
Haven,LazerrFreeks Mythic,Cuddle Gang,13,11,6,6,5,7,"Killjoy,Viper,Omen,Jett,Skye","Breach,Sova,Killjoy,Omen,Jett"
Haven,MORBIDLY OBESE,Fargo North Dakota,13,8,8,1,7,5,"Breach,Cypher,Sova,Omen,Jett","Sova,Killjoy,Reyna,Omen,Jett"
Ascent,Nightblood Gaming,Heavenly Sword Sect,13,3,3,1,2,10,"Cypher,Sova,Omen,Yoru,Deadlock","Sova,Killjoy,Jett,KAY/O,Clove"
Abyss,ROSE,Team Digital,13,11,7,5,6,6,"Cypher,Sova,Jett,Astra,Deadlock","Cypher,Sova,Omen,Jett,KAY/O"
Haven,Special Grade,ABG luvrs,13,3,3,1,2,10,"Sova,Jett,Astra,Deadlock,Iso","Cypher,Sova,Phoenix,Omen,Jett"
Haven,ENVEE YSL,Last Resistance,18,16,7,10,6,11,"Killjoy,Viper,Omen,Jett,Skye","Cypher,Sova,Omen,Yoru,Iso"
Bind,LoungeLizardWW,Moon (NA),13,11,8,4,7,5,"Raze,Cypher,Brimstone,Yoru,Gekko","Raze,Viper,Brimstone,Fade,Gekko"
Haven,FAT Opps,4star,13,10,4,7,3,9,"Killjoy,Viper,Omen,Jett,Skye","Cypher,Sova,Reyna,Omen,Jett"
Haven,Burger Boyz 2.0,Harmony,13,2,10,2,0,3,"Breach,Sova,Killjoy,Omen,Neon","Breach,Sova,Killjoy,Omen,Neon"
Ascent,Nexum EC,SZK Esports,13,11,6,6,5,7,"Breach,Omen,Neon,Fade,Deadlock","Sova,Killjoy,Omen,Jett,KAY/O"
Ascent,bazinga esports,KHORE GAMING,13,7,5,3,4,8,"Sova,Killjoy,Omen,Jett,KAY/O","Sova,Killjoy,Omen,Jett,KAY/O"
Ascent,GMBLERS Esports,Solar Flare,4,13,1,4,9,3,"Sova,Killjoy,Omen,Jett,KAY/O","Sova,Killjoy,Omen,Jett,KAY/O"
Ascent,InTenZive,IAPEsports,7,13,2,10,3,5,"Sova,Killjoy,Omen,Jett,KAY/O","Cypher,Sova,Omen,Jett,Deadlock"
Ascent,INCOGNITO,Zeniths,13,6,6,1,5,7,"Cypher,Sova,Reyna,Omen,Jett","Sova,Killjoy,Omen,Jett,KAY/O"
Lotus,TBS GC,Vila das Flores,5,13,4,8,5,1,"Breach,Cypher,Omen,Neon,Fade","Breach,Cypher,Omen,Neon,Fade"
Bind,TBS GC,Vila das Flores,5,13,2,4,9,3,"Viper,Brimstone,Neon,Fade,Gekko","Viper,Brimstone,Yoru,Neon,Fade"
Lotus,FNATIC,KRÜ Esports,13,5,5,1,4,8,"Raze,Killjoy,Viper,Omen,Fade","Raze,Killjoy,Viper,Omen,Fade"
Haven,FNATIC,KRÜ Esports,13,9,7,3,6,6,"Cypher,Sova,Omen,Yoru,Iso","Breach,Cypher,Sova,Omen,Neon"
Sunset,FNATIC,KRÜ Esports,11,13,7,5,8,4,"Breach,Raze,Cypher,Sova,Astra","Breach,Cypher,Sova,Omen,Neon"
Icebox,Gen.G Esports,Sentinels,6,13,5,7,6,1,"Killjoy,Viper,Jett,KAY/O,Gekko","Sova,Killjoy,Viper,Jett,KAY/O"
Lotus,Gen.G Esports,Sentinels,9,13,4,6,7,5,"Raze,Killjoy,Viper,Omen,Fade","Raze,Killjoy,Viper,Omen,Fade"
Bind,Cuddle Gang,Bolton Esports,13,9,3,9,0,10,"Raze,Cypher,Brimstone,Skye,Fade","Raze,Cypher,Brimstone,Reyna,Gekko"
Icebox,English or Spanish,Ball Knowers,13,9,5,7,2,8,"Sova,Killjoy,Viper,Jett,KAY/O","Sova,Killjoy,Viper,Jett,Gekko"
Sunset,Lionheart eSports,Kraken,13,9,6,6,3,7,"Breach,Cypher,Sova,Omen,Neon","Breach,Raze,Cypher,Omen,Gekko"
Icebox,demeanorfps,Nearest Airport,11,13,5,7,6,6,"Sova,Killjoy,Viper,Jett,Clove","Sova,Killjoy,Viper,Reyna,Jett"
Ascent,Cuddle Gang,Bolton Esports,13,5,8,4,1,5,"Sova,Killjoy,Omen,Jett,Deadlock","Cypher,Sova,Omen,Jett,Deadlock"
Sunset,Heavenly Sword Sect,Astane Anarchy,13,11,6,6,5,7,"Raze,Cypher,Omen,KAY/O,Gekko","Breach,Raze,Cypher,Omen,Fade"
Haven,English or Spanish,Ball Knowers,13,2,10,2,0,3,"Breach,Cypher,Sova,Omen,Jett","Cypher,Sova,Reyna,Omen,Jett"
Abyss,Good Career,Moon (NA),6,13,3,4,9,3,"Cypher,Sova,Omen,Jett,KAY/O","Breach,Sova,Viper,Omen,Jett"
Haven,Team Digital,El Dorado,13,4,9,3,1,4,"Breach,Sova,Killjoy,Omen,Jett","Breach,Cypher,Sova,Omen,Neon"
Ascent,SeanGares' Kittens,Last Resistance,6,13,4,8,5,2,"Sova,Killjoy,Omen,Jett,KAY/O","Cypher,Sova,Omen,Yoru,Fade"
Ascent,Raven Esports,Prospects Hitmen,13,11,6,6,5,7,"Sova,Killjoy,Omen,Jett,KAY/O","Sova,Killjoy,Omen,Jett,KAY/O"
Bind,Emma's Bakas,Spate Esports,13,5,5,1,4,8,"Raze,Viper,Brimstone,Jett,Skye","Raze,Viper,Yoru,Gekko,Clove"
Bind,Event Horizon,Forsaken Shadows,6,13,2,5,8,4,"Raze,Viper,Brimstone,Fade,Gekko","Raze,Cypher,Brimstone,Yoru,Fade"
Icebox,Jawns IV,Fhouse,13,5,11,1,4,2,"Sova,Killjoy,Viper,Gekko,Iso","Sova,Killjoy,Viper,Reyna,Jett"
Abyss,Lionheart eSports,Kraken,13,9,6,4,5,7,"Cypher,Sova,Viper,Omen,Yoru","Cypher,Sova,Omen,Jett,Harbor"
Abyss,demeanorfps,Nearest Airport,11,13,6,6,7,5,"Breach,Cypher,Jett,Astra,Gekko","Cypher,Sova,Omen,Jett,Harbor"
Icebox,Heavenly Sword Sect,Astane Anarchy,13,8,6,3,5,7,"Sova,Killjoy,Viper,Jett,Iso","Sova,Killjoy,Viper,Sage,Reyna"
Ascent,Mickey Masters,Bedwars Lions,13,5,5,1,4,8,"Sova,Killjoy,Reyna,Omen,Jett","Sova,Killjoy,Omen,Jett,KAY/O"
Haven,MORBIDLY OBESE,Cuddle Gang,14,12,6,7,5,8,"Breach,Cypher,Sova,Omen,Jett","Breach,Sova,Killjoy,Omen,Jett"
Lotus,ABG luvrs,CCG Esports,13,2,10,2,0,3,"Breach,Killjoy,Omen,Yoru,Gekko","Breach,Cypher,Neon,Gekko,Clove"
Icebox,SeanGares' Kittens,Last Resistance,8,13,3,6,7,5,"Sova,Killjoy,Viper,Jett,KAY/O","Sova,Viper,Reyna,Jett,Deadlock"
Ascent,Team Digital,El Dorado,13,6,7,5,1,6,"Sova,Killjoy,Omen,Jett,KAY/O","Cypher,Sova,Omen,Jett,Deadlock"
Lotus,Fargo North Dakota,Asura Onyx,13,11,7,5,6,6,"Killjoy,Reyna,Omen,Neon,Fade","Reyna,Chamber,Fade,Iso,Clove"
Haven,Bolton Esports,Somali Pirates,13,10,3,9,1,10,"Breach,Cypher,Sova,Omen,Jett","Breach,Sova,Killjoy,Omen,Jett"
Bind,Good Career,Moon (NA),11,13,3,9,4,8,"Raze,Brimstone,Skye,Gekko,Deadlock","Raze,Viper,Brimstone,Fade,Gekko"
Icebox,Event Horizon,Forsaken Shadows,8,13,5,7,6,3,"Killjoy,Viper,Jett,KAY/O,Gekko","Sova,Killjoy,Viper,Reyna,Jett"
Haven,Jawns IV,Fhouse,13,6,7,5,1,6,"Breach,Sova,Killjoy,Omen,Jett","Breach,Cypher,Sova,Omen,Jett"
Sunset,Emma's Bakas,Spate Esports,13,9,7,5,4,6,"Breach,Raze,Cypher,Deadlock,Clove","Breach,Raze,Phoenix,Omen,Deadlock"
Haven,Raven Esports,Prospects Hitmen,13,15,9,5,10,4,"Sova,Killjoy,Viper,Yoru,Harbor","Killjoy,Viper,Omen,Jett,Skye"
Lotus,VO Blossoms,ColdHearts GC,13,5,3,3,2,10,"Raze,Killjoy,Omen,Fade,Gekko","Raze,Cypher,Omen,Skye,Deadlock"
Haven,Fargo North Dakota,Asura Onyx,13,4,9,3,1,4,"Sova,Killjoy,Reyna,Omen,Jett","Cypher,Sova,Omen,Yoru,Iso"
Ascent,Ball Knowers,Scarlet Knights Black,19,17,7,11,6,12,"Sova,Killjoy,Omen,Jett,KAY/O","Sova,Killjoy,Omen,Jett,KAY/O"
Ascent,MORBIDLY OBESE,Cuddle Gang,5,13,3,3,10,2,"Sova,Killjoy,Omen,Jett,KAY/O","Sova,Killjoy,Omen,Jett,Deadlock"
Ascent,Team Atlantis,Harmony,10,13,5,7,6,5,"Cypher,Sova,Omen,Jett,KAY/O","Cypher,Sova,Omen,Jett,Deadlock"
Haven,ABG luvrs,CCG Esports,13,6,7,5,1,6,"Cypher,Sova,Phoenix,Omen,Jett","Killjoy,Viper,Omen,Jett,Skye"
Sunset,Full Sail Armada,Kraken,7,13,3,5,8,4,"Cypher,Sova,Jett,Gekko,Clove","Breach,Raze,Cypher,Omen,Gekko"
Sunset,Maryville University,Heavenly Sword Sect,13,8,5,7,1,8,"Breach,Raze,Cypher,Sova,Omen","Raze,Cypher,Sova,Omen,KAY/O"
Ascent,demeanorfps,LoungeLizardWW,11,13,4,8,5,7,"Cypher,Sova,Omen,Jett,KAY/O","Cypher,Sova,Omen,Jett,KAY/O"
Lotus,Bolton Esports,Somali Pirates,3,13,3,9,4,0,"Breach,Killjoy,Omen,Neon,Gekko","Breach,Raze,Killjoy,Omen,Fade"
Haven,Mickey Masters,Bedwars Lions,11,13,6,6,7,5,"Breach,Sova,Killjoy,Omen,Jett","Killjoy,Viper,Omen,Jett,Skye"
Bind,SaD FROST,Charmers GC,13,6,8,4,2,5,"Raze,Cypher,Yoru,Fade,Clove","Raze,Viper,Brimstone,Skye,Gekko"
Bind,Raven Esports,Prospects Hitmen,13,4,3,2,2,10,"Raze,Cypher,Viper,Brimstone,Skye","Raze,Cypher,Brimstone,Skye,Gekko"
Lotus,4star,Whiff Nation,13,4,3,2,2,10,"Raze,Cypher,Fade,Gekko,Clove","Raze,Killjoy,Viper,Omen,Gekko"
Bind,Nightblood Gaming,Emma's Bakas,13,6,6,1,5,7,"Raze,Brimstone,Skye,Gekko,Deadlock","Raze,Viper,Skye,Deadlock,Clove"
Sunset,Event Horizon Red,Forsaken Shadows,7,13,3,5,8,4,"Breach,Raze,Cypher,Omen,Gekko","Raze,Cypher,Omen,Gekko,Iso"
Lotus,99 Stealers,Last Resistance,9,13,7,5,8,2,"Breach,Raze,Cypher,Omen,Fade","Breach,Cypher,Neon,Fade,Clove"
Ascent,El Dorado,The Bees Knees,14,12,4,9,3,10,"Cypher,Sova,Omen,Jett,Deadlock","Cypher,Sova,Reyna,Omen,Jett"
Bind,COPPER BLUE OVALS,Moon (NA),11,13,5,7,6,6,"Raze,Viper,Astra,Fade,Gekko","Raze,Viper,Brimstone,Fade,Gekko"
Icebox,SeanGares' Kittens,Deleta Esports,10,13,4,7,6,6,"Sova,Killjoy,Viper,Jett,KAY/O","Sova,Killjoy,Viper,Reyna,Jett"
Bind,CHURCH OF CHAEWON KIM,Nearest Airport,10,13,5,6,7,5,"Raze,Viper,Brimstone,Fade,Gekko","Raze,Cypher,Omen,Yoru,Deadlock"
Abyss,Mickey Masters,Bedwars Lions,13,2,3,0,2,10,"Raze,Cypher,Sova,Jett,Astra","Sova,Killjoy,Viper,Yoru,Astra"
Sunset,Team Atlantis,Harmony,3,13,0,4,9,3,"Raze,Cypher,Neon,Gekko,Clove","Breach,Cypher,Sova,Omen,Neon"
Haven,VO Blossoms,ColdHearts GC,13,9,7,3,6,6,"Breach,Sova,Killjoy,Omen,Jett","Breach,Sova,Omen,Jett,Chamber"
Sunset,Jawns IV,ENVEE YSL,10,13,5,6,7,5,"Breach,Raze,Sage,Omen,Gekko","Breach,Raze,Cypher,Omen,Fade"
Sunset,Fargo North Dakota,LazerrFreeks Mythic,7,13,5,7,6,2,"Breach,Raze,Cypher,Sova,Omen","Breach,Raze,Cypher,Omen,Fade"
Bind,Fast Food Workers,Lionheart eSports,13,6,4,3,3,9,"Raze,Cypher,Omen,Gekko,Deadlock","Raze,Reyna,Skye,Deadlock,Clove"
Icebox,SaD FROST,Charmers GC,13,1,11,1,0,2,"Sova,Killjoy,Viper,Reyna,Jett","Sova,Killjoy,Viper,Jett,Gekko"
Ascent,4star,Whiff Nation,13,2,3,0,2,10,"Cypher,Sova,Omen,Jett,Deadlock","Cypher,Sova,Omen,Jett,Deadlock"
Lotus,MORBIDLY OBESE,Cuddle Gang,13,6,5,2,4,8,"Raze,Cypher,Omen,Fade,Gekko","Breach,Raze,Killjoy,Omen,Fade"
Ascent,Bolton Esports,Somali Pirates,13,8,6,6,2,7,"Cypher,Sova,Omen,Jett,Deadlock","Sova,Killjoy,Omen,Jett,KAY/O"
Ascent,Full Sail Armada,Kraken,13,10,9,2,8,4,"Breach,Cypher,Sova,Jett,Clove","Cypher,Sova,Omen,Jett,Deadlock"
Haven,Dexterity Gaming,Good Career,13,8,8,4,4,5,"Breach,Sova,Killjoy,Omen,Jett","Breach,Sova,Killjoy,Omen,Jett"
Ascent,ABG luvrs,CCG Esports,9,13,5,5,8,4,"Cypher,Sova,Omen,Yoru,Deadlock","Sova,Killjoy,Omen,Jett,KAY/O"
Icebox,Ball Knowers,Scarlet Knights Black,13,11,7,5,6,6,"Sova,Killjoy,Viper,Jett,Gekko","Sova,Killjoy,Viper,Harbor,Deadlock"
Bind,Asians and Skuba,English or Spanish,13,7,9,3,4,4,"Raze,Viper,Brimstone,Fade,Gekko","Raze,Viper,Brimstone,Skye,Deadlock"
Bind,Malevolent Kitchen,Prospects Hitmen,7,13,2,6,7,5,"Raze,Cypher,Brimstone,Skye,Gekko","Raze,Cypher,Brimstone,Skye,Gekko"
Lotus,demeanorfps,LoungeLizardWW,9,13,7,5,8,2,"Breach,Raze,Cypher,Omen,Gekko","Raze,Cypher,Omen,Fade,Gekko"
Bind,Rice Bowl,Asura Onyx,7,13,3,5,8,4,"Raze,Viper,Brimstone,Skye,Gekko","Raze,Viper,Skye,Fade,Clove"
Sunset,Astane Anarchy,RECR,13,8,9,3,5,4,"Breach,Raze,Cypher,Omen,Fade","Raze,Cypher,Omen,KAY/O,Gekko"
Sunset,CHURCH OF CHAEWON KIM,Nearest Airport,4,13,1,4,9,3,"Breach,Raze,Cypher,Omen,Gekko","Breach,Raze,Cypher,Omen,Gekko"
Ascent,Special Grade,Harmony,13,1,11,1,0,2,"Cypher,Sova,Omen,Yoru,Deadlock","Cypher,Sova,Omen,Jett,Deadlock"
Haven,CB,Spate Esports,4,13,1,11,2,3,"Breach,Sova,Killjoy,Omen,Jett","Breach,Cypher,Sova,Neon,Clove"
Ascent,Jawns IV,ENVEE YSL,1,13,1,11,2,0,"Cypher,Sova,Omen,Yoru,Deadlock","Sova,Killjoy,Omen,Jett,KAY/O"
Haven,Maryville University,Heavenly Sword Sect,14,16,10,5,11,4,"Breach,Sova,Killjoy,Omen,Jett","Cypher,Sova,Omen,Yoru,Iso"
Haven,COPPER BLUE OVALS,Moon (NA),13,9,6,4,5,7,"Breach,Cypher,Sova,Omen,Jett","Breach,Sova,Killjoy,Omen,Jett"
Bind,Event Horizon Red,Forsaken Shadows,13,10,5,6,4,8,"Viper,Brimstone,Jett,Skye,Gekko","Raze,Cypher,Sova,Brimstone,Yoru"
Abyss,Fast Food Workers,Lionheart eSports,13,4,3,2,2,10,"Sova,Omen,Jett,Yoru,Chamber","Sova,Killjoy,Viper,Omen,Yoru"
Sunset,Nightblood Gaming,Emma's Bakas,14,16,3,12,4,11,"Breach,Cypher,Sova,Omen,Neon","Breach,Raze,Cypher,Deadlock,Clove"
Icebox,El Dorado,The Bees Knees,10,13,6,5,8,4,"Sova,Killjoy,Viper,Reyna,Jett","Raze,Sova,Killjoy,Viper,Reyna"
Haven,Full Sail Armada,Kraken,2,13,1,11,2,1,"Breach,Sova,Jett,Yoru,Astra","Killjoy,Viper,Omen,Jett,Skye"
Icebox,99 Stealers,Last Resistance,14,16,8,7,9,6,"Sova,Killjoy,Viper,Jett,Gekko","Sova,Viper,Reyna,Jett,Deadlock"
Lotus,SeanGares' Kittens,Deleta Esports,14,16,8,7,9,6,"Reyna,Astra,Harbor,Gekko,Clove","Raze,Killjoy,Jett,Gekko,Clove"
Icebox,Fargo North Dakota,LazerrFreeks Mythic,10,13,6,5,8,4,"Sova,Killjoy,Viper,Jett,KAY/O","Sova,Killjoy,Viper,Reyna,Jett"
Haven,Mickey Masters,Paranoia Boys,14,12,6,7,5,8,"Breach,Sova,Killjoy,Omen,Jett","Breach,Cypher,Sova,Omen,Jett"
Haven,Goon that jawn,Event Horizon,13,10,8,4,6,5,"Breach,Cypher,Sova,Omen,Yoru","Breach,Sova,Killjoy,Omen,Jett"
Lotus,SaD Purple,Raven Esports,13,11,8,4,7,5,"Raze,Viper,Omen,Fade,Deadlock","Breach,Raze,Cypher,Omen,Fade"
Haven,Team Atlantis,bricknodes,13,6,5,2,4,8,"Breach,Cypher,Omen,Jett,Deadlock","Breach,Sova,Killjoy,Omen,Jett"
Icebox,Fhouse,Lotus 8 Purple,13,6,4,3,3,9,"Sova,Killjoy,Viper,Reyna,Jett","Sova,Killjoy,Viper,Sage,Jett"
Ascent,FAT Opps,Team Digital,13,3,3,1,2,10,"Sova,Killjoy,Omen,Jett,KAY/O","Sova,Killjoy,Omen,Jett,KAY/O"
Haven,Endear Eclipse,Whiff Nation,10,13,5,6,7,5,"Breach,Cypher,Sova,Omen,Yoru","Breach,Cypher,Sova,Omen,Jett"
Haven,Asians and Skuba,English or Spanish,13,10,7,5,5,6,"Breach,Sova,Killjoy,Omen,Jett","Breach,Cypher,Sova,Omen,Jett"
Icebox,Dexterity Gaming,Good Career,8,13,5,7,6,3,"Sova,Killjoy,Viper,Jett,Gekko","Sova,Killjoy,Viper,Reyna,Jett"
Icebox,Clemson Esports,Bedwars Lions,5,13,3,3,10,2,"Sova,Killjoy,Viper,Jett,Harbor","Killjoy,Viper,Jett,KAY/O,Gekko"
Haven,Malevolent Kitchen,Prospects Hitmen,9,13,9,3,10,0,"Breach,Cypher,Sova,Omen,Jett","Killjoy,Viper,Omen,Jett,Skye"
Ascent,VO Blossoms,ColdHearts GC,7,13,4,8,5,3,"Sova,Killjoy,Jett,KAY/O,Clove","Sova,Killjoy,Phoenix,Omen,Jett"
Haven,Ball Knowers,Scarlet Knights Black,11,13,6,6,7,5,"Cypher,Sova,Reyna,Omen,Jett","Breach,Cypher,Sova,Omen,Jett"
Lotus,MORBIDLY OBESE,Bolton Esports,13,10,6,5,5,7,"Raze,Cypher,Omen,Fade,Gekko","Breach,Killjoy,Omen,Neon,Gekko"
Lotus,Rice Bowl,Asura Onyx,7,13,1,7,6,6,"Raze,Killjoy,Viper,Omen,Fade","Killjoy,Yoru,Fade,Iso,Clove"
Bind,ROSE,4star,13,11,7,5,6,6,"Raze,Brimstone,Skye,Gekko,Deadlock","Raze,Viper,Brimstone,Fade,Gekko"
Icebox,Charmers GC,Harmony Amethyst,13,4,4,1,3,9,"Sova,Killjoy,Viper,Jett,Gekko","Sova,Killjoy,Viper,Jett,Harbor"
Haven,Burger Boyz 2.0,ABG luvrs,16,14,6,9,5,10,"Breach,Sova,Killjoy,Omen,Neon","Cypher,Sova,Phoenix,Omen,Jett"
Sunset,Special Grade,Harmony,13,7,7,1,6,6,"Breach,Raze,Cypher,Omen,Gekko","Breach,Cypher,Sova,Omen,Neon"
Haven,CCG Esports,Scenario Cats,13,1,2,0,1,11,"Killjoy,Viper,Omen,Jett,Skye","Breach,Sova,Killjoy,Omen,Jett"
Haven,Jawns IV,ENVEE YSL,13,11,9,3,8,4,"Breach,Sova,Killjoy,Omen,Jett","Cypher,Sova,Omen,Yoru,Iso"
Haven,FAT Opps,Team Digital,13,2,3,0,2,10,"Killjoy,Viper,Omen,Jett,Skye","Breach,Sova,Killjoy,Omen,Jett"
Lotus,Astane Anarchy,RECR,13,10,3,9,1,10,"Breach,Raze,Killjoy,Omen,Fade","Breach,Cypher,Sova,Astra,Neon"
Sunset,CB,Spate Esports,8,13,7,5,8,1,"Breach,Raze,Cypher,Omen,Gekko","Raze,Cypher,Omen,Yoru,Gekko"
Abyss,Maryville University,Heavenly Sword Sect,13,10,7,5,5,6,"Sova,Viper,Omen,Yoru,Iso","Cypher,Sova,Omen,Jett,Iso"
Ascent,Paranoia Boys,Day By Day,13,2,10,2,0,3,"Sova,Killjoy,Omen,Jett,KAY/O","Sova,Killjoy,Omen,Jett,KAY/O"
Haven,SeanGares' Kittens,Deleta Esports,13,9,9,3,6,4,"Cypher,Sova,Omen,Jett,Iso","Raze,Sova,Omen,Jett,Gekko"
Haven,El Dorado,The Bees Knees,13,9,7,3,6,6,"Breach,Cypher,Sova,Omen,Neon","Cypher,Sova,Reyna,Omen,Jett"
Lotus,Goon that jawn,Event Horizon,13,5,3,3,2,10,"Breach,Cypher,Neon,Fade,Clove","Breach,Raze,Cypher,Omen,Fade"
Haven,SaD Purple,Raven Esports,13,7,3,5,2,10,"Cypher,Sova,Omen,Yoru,Iso","Sova,Killjoy,Viper,Yoru,Harbor"
Ascent,Nightblood Gaming,Emma's Bakas,13,8,8,4,4,5,"Cypher,Sova,Omen,Yoru,Deadlock","Cypher,Omen,Jett,KAY/O,Deadlock"
Haven,99 Stealers,Last Resistance,13,5,8,4,1,5,"Killjoy,Viper,Omen,Jett,Skye","Killjoy,Viper,Omen,Jett,Skye"
Haven,Fhouse,Lotus 8 Purple,13,2,3,0,2,10,"Breach,Cypher,Sova,Omen,Jett","Breach,Sova,Killjoy,Omen,Jett"
Haven,Event Horizon Red,Forsaken Shadows,12,14,8,5,9,4,"Breach,Sova,Killjoy,Omen,Jett","Breach,Sova,Killjoy,Omen,Jett"
Sunset,Team Atlantis,bricknodes,13,7,4,4,3,9,"Raze,Cypher,Neon,Gekko,Clove","Breach,Raze,Cypher,Omen,Gekko"
Ascent,Nearest Airport,LoungeLizardWW,12,14,5,8,6,7,"Cypher,Sova,Omen,Yoru,Deadlock","Cypher,Sova,Omen,Jett,KAY/O"
Ascent,COPPER BLUE OVALS,Moon (NA),8,13,5,7,6,3,"Sova,Phoenix,Sage,KAY/O,Clove","Cypher,Sova,Omen,Jett,Deadlock"
Haven,Fargo North Dakota,LazerrFreeks Mythic,13,8,7,2,6,6,"Sova,Killjoy,Reyna,Jett,Clove","Killjoy,Viper,Omen,Jett,Skye"
Icebox,demeanorfps,CHURCH OF CHAEWON KIM,13,8,9,3,5,4,"Sova,Killjoy,Viper,Jett,Clove","Sova,Killjoy,Viper,Jett,Gekko"
Ascent,CCG Esports,Scenario Cats,13,0,12,0,0,1,"Sova,Killjoy,Omen,Jett,KAY/O","Sova,Killjoy,Omen,Jett,KAY/O"
Ascent,Eagle Uncs,Clemson Esports,8,13,4,8,5,4,"Sova,Killjoy,Omen,Jett,KAY/O","Sova,Killjoy,Omen,Jett,KAY/O"
Ascent,Malevolent Kitchen,Prospects Hitmen,13,10,5,6,4,8,"Sova,Killjoy,Omen,Jett,KAY/O","Sova,Killjoy,Omen,Jett,KAY/O"
Ascent,Burger Boyz 2.0,ABG luvrs,13,3,9,3,0,4,"Sova,Killjoy,Omen,Jett,KAY/O","Cypher,Sova,Omen,Yoru,Deadlock"
Ascent,Rice Bowl,Asura Onyx,13,4,8,4,0,5,"Sova,Killjoy,Omen,Jett,KAY/O","Sova,Killjoy,Omen,Jett,KAY/O"
Haven,Lionheart eSports,Kraken,13,10,7,5,5,6,"Sova,Killjoy,Viper,Omen,Yoru","Killjoy,Viper,Omen,Jett,Skye"
Abyss,Mickey Masters,Dog Barkers,13,6,6,1,5,7,"Raze,Cypher,Sova,Reyna,Astra","Breach,Cypher,Sova,Jett,Astra"
Lotus,Dexterity Gaming,Good Career,13,9,10,2,7,3,"Raze,Killjoy,Viper,Omen,Fade","Raze,Omen,Chamber,Fade,Deadlock"
Ascent,Endear Eclipse,Whiff Nation,7,13,2,6,7,5,"Cypher,Sova,Omen,Jett,KAY/O","Cypher,Sova,Omen,Jett,Deadlock"
Abyss,ROSE,4star,13,9,7,3,6,6,"Cypher,Sova,Yoru,Astra,Deadlock","Cypher,Sova,Omen,Jett,Yoru"
Sunset,Bedwars Lions,Destined2Rise,13,9,8,4,5,5,"Breach,Raze,Cypher,Omen,Gekko","Raze,Cypher,Omen,KAY/O,Gekko"
Haven,Minas D'ouro,Vila das Flores,11,13,5,7,6,6,"Breach,Cypher,Sova,Omen,Neon","Breach,Cypher,Sova,Omen,Neon"
Lotus,Charmers GC,Harmony Amethyst,8,13,2,7,6,6,"Breach,Raze,Killjoy,Omen,Fade","Breach,Raze,Killjoy,Omen,Gekko"
Haven,MORBIDLY OBESE,Bolton Esports,13,11,5,7,4,8,"Breach,Cypher,Sova,Omen,Jett","Breach,Cypher,Sova,Omen,Jett"
Ascent,Jawns IV,Fhouse,13,2,10,2,0,3,"Cypher,Sova,Omen,Yoru,Deadlock","Sova,Killjoy,Omen,Jett,KAY/O"
Lotus,Waffle House,VO Blossoms,6,13,5,7,6,1,"Breach,Raze,Cypher,Omen,Gekko","Raze,Killjoy,Omen,Fade,Gekko"
Icebox,Alphaware Olympians,Paranoia Boys,6,13,3,9,4,3,"Sova,Killjoy,Viper,Jett,Gekko","Sova,Killjoy,Viper,Jett,Gekko"
Haven,Cuddle Gang,Somali Pirates,13,2,10,2,0,3,"Breach,Sova,Killjoy,Jett,Astra","Breach,Sova,Killjoy,Omen,Jett"
Lotus,Event Horizon,Forsaken Shadows,13,4,9,3,1,4,"Breach,Raze,Cypher,Omen,Fade","Raze,Cypher,Omen,Fade,Deadlock"
Haven,SaD FROST,Pixy Chixs,13,3,9,3,0,4,"Sova,Killjoy,Jett,Iso,Clove","Breach,Sova,Killjoy,Omen,Jett"
Lotus,Team Digital,The Bees Knees,13,6,10,2,4,3,"Breach,Raze,Killjoy,Omen,Fade","Raze,Killjoy,Viper,Omen,Fade"
Bind,TBS GC,Panela Antiaderente,13,6,8,4,2,5,"Viper,Brimstone,Neon,Fade,Gekko","Viper,Brimstone,Skye,Neon,Iso"
Icebox,English or Spanish,Scarlet Knights Black,13,11,6,6,5,7,"Sova,Killjoy,Viper,Chamber,Iso","Sova,Killjoy,Viper,Harbor,Deadlock"
Lotus,Nightblood Gaming,CB,13,5,5,1,4,8,"Breach,Cypher,Sova,Astra,Neon","Breach,Raze,Killjoy,Omen,Gekko"
Abyss,Raven Esports,Prospects Hitmen,13,3,3,1,2,10,"Cypher,Sova,Omen,Jett,KAY/O","Cypher,Sova,Omen,Jett,Harbor"
Lotus,Nearest Airport,LoungeLizardWW,10,13,5,6,7,5,"Raze,Viper,Omen,Chamber,Fade","Raze,Cypher,Omen,Fade,Gekko"
Lotus,REVOADA,TOTALE Talents,13,3,4,0,3,9,"Raze,Killjoy,Viper,Omen,Fade","Cypher,Omen,Neon,Fade,Gekko"
Ascent,Akatsuki Aimers,Day By Day,5,13,0,6,7,5,"Cypher,Sova,Omen,Jett,KAY/O","Sova,Killjoy,Omen,Jett,KAY/O"
Lotus,bricknodes,Harmony,9,13,7,3,10,2,"Breach,Raze,Killjoy,Omen,Gekko","Breach,Killjoy,Omen,Neon,Fade"
Icebox,AURA (Inactive),Bedwars Lions,1,13,0,2,11,1,"Sova,Killjoy,Sage,Jett,Harbor","Killjoy,Viper,Jett,KAY/O,Gekko"
Lotus,Emma's Bakas,Spate Esports,13,11,4,8,3,9,"Raze,Killjoy,Fade,Iso,Clove","Breach,Cypher,Omen,Neon,Fade"
Haven,ColdHearts GC,Prestige XOXO,13,6,4,3,3,9,"Sova,Omen,Jett,Chamber,Iso","Omen,Jett,Fade,Gekko,Deadlock"
Icebox,Team Leveling,sakki,13,1,2,0,1,11,"Killjoy,Viper,KAY/O,Gekko,Iso","Sova,Killjoy,Viper,Iso,Clove"
Abyss,Maryville University,Astane Anarchy,13,1,11,1,0,2,"Sova,Viper,Omen,Yoru,Iso","Cypher,Sova,Omen,Deadlock,Iso"
Lotus,Last Resistance,Deleta Esports,12,14,10,3,11,2,"Breach,Cypher,Neon,Fade,Clove","Raze,Killjoy,Jett,Gekko,Clove"
Bind,Lil Steppas,Mickey Masters,2,13,2,10,3,0,"Raze,Viper,Reyna,Omen,Gekko","Raze,Brimstone,Skye,Yoru,Iso"
Haven,Fargo North Dakota,Rice Bowl,13,5,3,3,2,10,"Cypher,Sova,Reyna,Omen,Yoru","Breach,Sova,Killjoy,Omen,Jett"
Icebox,ROSE,Endear Eclipse,13,3,3,1,2,10,"Killjoy,Viper,Sage,Jett,Gekko","Sova,Killjoy,Viper,Jett,Gekko"
Haven,Goon that jawn,Event Horizon Red,13,4,4,1,3,9,"Breach,Cypher,Sova,Omen,Yoru","Breach,Sova,Killjoy,Omen,Jett"
Haven,Fast Food Workers,Full Sail Armada,13,2,10,2,0,3,"Sova,Killjoy,Omen,Jett,Iso","Breach,Cypher,Omen,Jett,Deadlock"
Lotus,FAT Opps,El Dorado,13,2,10,2,0,3,"Raze,Killjoy,Viper,Omen,Fade","Breach,Raze,Killjoy,Omen,Gekko"
Haven,Burger Boyz 2.0,CCG Esports,13,9,10,2,7,3,"Breach,Sova,Killjoy,Omen,Neon","Breach,Cypher,Sova,Omen,Neon"
Ascent,Heavenly Sword Sect,RECR,13,7,9,3,4,4,"Sova,Killjoy,Omen,Jett,KAY/O","Sova,Killjoy,Omen,Jett,KAY/O"
Ascent,Omnipotence,Eagle Uncs,6,13,6,6,7,0,"Breach,Sova,Killjoy,Omen,KAY/O","Sova,Killjoy,Omen,Jett,KAY/O"
Lotus,Dexterity Gaming,COPPER BLUE OVALS,13,6,6,1,5,7,"Raze,Killjoy,Viper,Omen,Fade","Raze,Killjoy,Viper,Astra,Fade"
Haven,SeanGares' Kittens,99 Stealers,14,12,8,5,7,6,"Phoenix,Reyna,Omen,Chamber,Iso","Killjoy,Viper,Omen,Jett,Skye"
Lotus,SaD Purple,Malevolent Kitchen,13,1,12,0,1,1,"Raze,Omen,Chamber,Fade,Deadlock","Raze,Killjoy,Omen,Fade,Gekko"
Haven,demeanorfps,CHURCH OF CHAEWON KIM,9,13,6,6,7,3,"Cypher,Sova,Omen,Jett,Iso","Breach,Cypher,Sova,Omen,Neon"
Lotus,LazerrFreeks Mythic,Asura Onyx,13,7,3,5,2,10,"Raze,Killjoy,Viper,Omen,Fade","Raze,Killjoy,Yoru,Fade,Clove"
Haven,ENVEE YSL,Lotus 8 Purple,13,3,9,3,0,4,"Cypher,Sova,Omen,Yoru,Iso","Breach,Sova,Killjoy,Omen,Jett"
Icebox,Special Grade,Team Atlantis,13,6,10,2,4,3,"Sova,Killjoy,Viper,Jett,Gekko","Sova,Killjoy,Viper,Jett,Clove"
Haven,Asians and Skuba,Ball Knowers,13,7,9,3,4,4,"Omen,Yoru,Fade,Deadlock,Clove","Cypher,Sova,Reyna,Omen,Jett"
Lotus,Good Career,Moon (NA),13,4,4,1,3,9,"Raze,Omen,Chamber,Fade,Deadlock","Raze,Killjoy,Viper,Omen,Fade"
Lotus,Goon that jawn,Event Horizon Red,13,1,11,1,0,2,"Breach,Cypher,Neon,Fade,Clove","Raze,Killjoy,Viper,Omen,Fade"
Bind,SaD FROST,Pixy Chixs,13,7,12,0,7,1,"Raze,Viper,Skye,Chamber,Clove","Raze,Cypher,Viper,Brimstone,Skye"
Lotus,ABG luvrs,Scenario Cats,13,3,12,0,3,1,"Breach,Killjoy,Omen,Yoru,Gekko","Raze,Killjoy,Omen,Fade,Gekko"
Bind,4star,Whiff Nation,13,5,3,3,2,10,"Raze,Viper,Brimstone,Fade,Gekko","Raze,Cypher,Viper,Brimstone,Skye"
Ascent,Minas D'ouro,Vila das Flores,11,13,2,10,3,9,"Sova,Killjoy,Omen,Jett,KAY/O","Cypher,Sova,Phoenix,Omen,Jett"
Haven,Waffle House,VO Blossoms,8,13,7,5,8,1,"Breach,Cypher,Sova,Omen,Neon","Breach,Sova,Killjoy,Omen,Jett"
Icebox,ColdHearts GC,Prestige XOXO,13,2,10,2,0,3,"Sova,Killjoy,Viper,Reyna,Jett","Sova,Killjoy,Viper,Harbor,Iso"
Ascent,MORBIDLY OBESE,Bolton Esports,11,13,6,6,7,5,"Sova,Killjoy,Omen,Jett,KAY/O","Cypher,Sova,Omen,Jett,Deadlock"
Ascent,TBS GC,Panela Antiaderente,13,5,5,1,4,8,"Sova,Killjoy,Omen,Jett,KAY/O","Sova,Killjoy,Omen,Jett,KAY/O"
Ascent,Fast Food Workers,Full Sail Armada,13,1,11,1,0,2,"Cypher,Sova,Omen,Yoru,Deadlock","Breach,Cypher,Sova,Neon,Clove"
Ascent,Nightblood Gaming,CB,13,3,10,2,1,3,"Cypher,Sova,Omen,Yoru,Deadlock","Sova,Killjoy,Omen,Jett,KAY/O"
Haven,SaD Purple,Malevolent Kitchen,13,4,10,2,2,3,"Sova,Sage,Reyna,Jett,Clove","Breach,Cypher,Sova,Omen,Jett"
Lotus,Cuddle Gang,Somali Pirates,13,10,8,3,7,5,"Breach,Raze,Killjoy,Omen,Fade","Breach,Raze,Killjoy,Omen,Fade"
Ascent,Fargo North Dakota,Rice Bowl,13,4,4,1,3,9,"Sova,Killjoy,Phoenix,Omen,Jett","Sova,Killjoy,Omen,Jett,KAY/O"
Bind,Charmers GC,Harmony Amethyst,13,11,7,5,6,6,"Raze,Viper,Brimstone,Skye,Gekko","Breach,Raze,Viper,Brimstone,Skye"
Sunset,bricknodes,Harmony,6,13,3,9,4,3,"Breach,Raze,Cypher,Omen,Gekko","Breach,Cypher,Sova,Omen,Neon"
Abyss,Destined2Rise,Cosmic Scorpus,13,2,3,0,2,10,"Cypher,Sova,Jett,Astra,Harbor","Cypher,Sova,Omen,Jett,Gekko"
Ascent,Dog Barkers,Winner POV,13,2,10,2,0,3,"Sova,Killjoy,Omen,Jett,KAY/O","Sova,Killjoy,Omen,Jett,KAY/O"
Haven,REVOADA,TOTALE Talents,13,7,10,2,5,3,"Breach,Sova,Killjoy,Omen,Jett","Cypher,Sova,Omen,Yoru,Iso"
Ascent,LazerrFreeks Mythic,Asura Onyx,13,3,3,1,2,10,"Sova,Killjoy,Omen,Jett,KAY/O","Sova,Killjoy,Omen,Jett,KAY/O"
Bind,Team Leveling,sakki,13,3,9,3,0,4,"Raze,Viper,Brimstone,Skye,Gekko","Raze,Cypher,Brimstone,Skye,Deadlock"
Sunset,Emma's Bakas,Spate Esports,13,3,4,0,3,9,"Breach,Raze,Cypher,Deadlock,Clove","Raze,Cypher,Omen,Yoru,Gekko"
Ascent,ROSE,Endear Eclipse,13,6,5,2,4,8,"Cypher,Sova,Omen,Yoru,Deadlock","Cypher,Sova,Omen,Jett,KAY/O"
Sunset,Dexterity Gaming,COPPER BLUE OVALS,13,4,3,2,2,10,"Breach,Raze,Cypher,Omen,Gekko","Breach,Raze,Cypher,Omen,Gekko"
Haven,Maryville University,Astane Anarchy,13,4,3,2,2,10,"Breach,Sova,Killjoy,Omen,Jett","Breach,Cypher,Sova,Omen,Jett"
Bind,Nearest Airport,LoungeLizardWW,13,11,4,8,3,9,"Raze,Cypher,Omen,Yoru,Deadlock","Raze,Viper,Brimstone,Yoru,Fade"
Bind,Astral Vision Infinite,Clemson Esports,12,14,7,6,8,5,"Raze,Cypher,Brimstone,Yoru,Fade","Raze,Viper,Brimstone,Skye,Gekko"
Haven,English or Spanish,Scarlet Knights Black,13,10,6,5,5,7,"Breach,Cypher,Sova,Omen,Jett","Breach,Cypher,Sova,Omen,Jett"
Lotus,Jawns IV,Fhouse,14,12,9,4,8,5,"Raze,Killjoy,Viper,Omen,Fade","Breach,Raze,Cypher,Omen,Gekko"
Abyss,Lionheart eSports,Kraken,13,11,10,2,9,3,"Sova,Killjoy,Viper,Omen,Yoru","Cypher,Sova,Omen,Yoru,Harbor"
Ascent,Raven Esports,Prospects Hitmen,13,8,7,5,3,6,"Sova,Killjoy,Omen,Jett,KAY/O","Sova,Killjoy,Omen,Jett,KAY/O"
Haven,Event Horizon,Forsaken Shadows,13,11,6,6,5,7,"Breach,Sova,Killjoy,Omen,Jett","Breach,Sova,Killjoy,Omen,Jett"
Lotus,demeanorfps,CHURCH OF CHAEWON KIM,13,4,8,4,0,5,"Breach,Raze,Cypher,Omen,Gekko","Breach,Cypher,Omen,Neon,Fade"
Haven,FAT Opps,El Dorado,13,5,4,2,3,9,"Killjoy,Viper,Omen,Jett,Skye","Breach,Sova,Killjoy,Omen,Jett"
Bind,Last Resistance,Deleta Esports,9,13,3,7,6,6,"Raze,Viper,KAY/O,Fade,Clove","Raze,Cypher,Brimstone,Skye,Gekko"
Abyss,Team Digital,The Bees Knees,13,10,9,2,8,4,"Cypher,Sova,Omen,Jett,KAY/O","Cypher,Sova,Reyna,Jett,Astra"
Ascent,ENVEE YSL,Lotus 8 Purple,13,5,4,2,3,9,"Sova,Killjoy,Omen,Jett,KAY/O","Sova,Killjoy,Omen,Jett,KAY/O"
Ascent,Asians and Skuba,Ball Knowers,13,2,3,0,2,10,"Cypher,Sova,Omen,Yoru,Deadlock","Sova,Killjoy,Omen,Jett,KAY/O"
Sunset,SeanGares' Kittens,99 Stealers,13,8,6,3,5,7,"Cypher,Killjoy,Brimstone,Yoru,Deadlock","Breach,Raze,Cypher,Omen,Fade"
Sunset,Good Career,Moon (NA),13,2,3,0,2,10,"Breach,Raze,Cypher,Omen,Gekko","Cypher,Sova,Omen,KAY/O,Neon"
Lotus,Heavenly Sword Sect,RECR,13,7,7,5,2,6,"Raze,Killjoy,Viper,Omen,Fade","Breach,Cypher,Sova,Astra,Neon"
Haven,Special Grade,Team Atlantis,13,3,3,1,2,10,"Sova,Jett,Astra,Deadlock,Iso","Cypher,Sova,Omen,Yoru,Iso"
Haven,ABG luvrs,Scenario Cats,13,1,2,0,1,11,"Cypher,Sova,Phoenix,Omen,Jett","Breach,Sova,Killjoy,Omen,Jett"
Lotus,4star,Whiff Nation,13,1,12,0,1,1,"Raze,Cypher,Fade,Gekko,Clove","Breach,Raze,Cypher,Omen,Gekko"
Ascent,Burger Boyz 2.0,CCG Esports,13,10,7,5,5,6,"Sova,Killjoy,Omen,Jett,KAY/O","Sova,Killjoy,Omen,Jett,KAY/O"
Haven,Coalesce,NEANLATIYONBOLM,13,2,10,2,0,3,"Breach,Sova,Killjoy,Omen,Jett","Sova,Killjoy,Omen,Jett,Yoru"
Icebox,Coalesce,NEANLATIYONBOLM,13,10,6,6,4,7,"Sova,Killjoy,Viper,Reyna,Jett","Sova,Killjoy,Viper,Jett,Yoru"
Bind,FUT Esports,Paper Rex,6,13,3,9,4,3,"Raze,Viper,Brimstone,Fade,Gekko","Raze,Viper,Brimstone,Fade,Gekko"
Sunset,FUT Esports,Paper Rex,11,13,6,6,7,5,"Breach,Raze,Cypher,Omen,Gekko","Breach,Raze,Sage,Omen,Gekko"
Sunset,Talon Esports,Team Vitality,8,13,2,7,6,6,"Raze,Cypher,Omen,Fade,Deadlock","Cypher,Sova,Omen,KAY/O,Neon"
Lotus,Talon Esports,Team Vitality,6,13,4,3,10,2,"Raze,Omen,Fade,Deadlock,Clove","Breach,Raze,Cypher,Omen,Fade"
Bind,minions united GC,LazerrFreeks Ivy,13,4,9,3,1,4,"Raze,Viper,Brimstone,Skye,Gekko","Raze,Cypher,Skye,Yoru,Clove"
Bind,TOTALE Talents,Karasuno Crows,13,9,7,3,6,6,"Raze,Viper,Brimstone,Fade,Gekko","Raze,Viper,Brimstone,Fade,Gekko"
Bind,sakki,BLOOD Stars,13,11,7,5,6,6,"Raze,Viper,Brimstone,Sage,Skye","Raze,Cypher,Brimstone,Fade,Gekko"
Abyss,Vila das Flores,PROCURADAS,13,7,7,1,6,6,"Cypher,Sova,Omen,Jett,Harbor","Breach,Cypher,Omen,Jett,Gekko"
Bind,Panela Antiaderente,Athena's e-Sports,13,9,3,7,2,10,"Viper,Brimstone,Skye,Neon,Gekko","Raze,Cypher,Brimstone,Skye,Gekko"
Ascent,TOTALE Talents,Karasuno Crows,8,13,3,6,7,5,"Cypher,Sova,Omen,Jett,Deadlock","Sova,Killjoy,Omen,Jett,KAY/O"
Lotus,Minas D'ouro,Addictes GC,13,6,6,1,5,7,"Breach,Raze,Killjoy,Omen,Fade","Breach,Cypher,Omen,Neon,Fade"
Haven,TBS GC,As de copas,13,3,4,0,3,9,"Breach,Sova,Killjoy,Omen,Jett","Breach,Sova,Killjoy,Omen,Neon"
Bind,Team Leveling,BmE,13,5,5,1,4,8,"Brimstone,Skye,Neon,Gekko,Deadlock","Raze,Viper,Skye,Gekko,Clove"
Bind,REVOADA,Moranguinhas,13,2,3,0,2,10,"Brimstone,Skye,Chamber,Neon,Clove","Killjoy,Brimstone,Jett,Skye,Gekko"
Haven,Vila das Flores,PROCURADAS,13,3,9,3,0,4,"Breach,Cypher,Sova,Omen,Neon","Breach,Cypher,Sova,Omen,Jett"
Lotus,sakki,BLOOD Stars,13,7,8,4,3,5,"Breach,Killjoy,Omen,Neon,Fade","Raze,Killjoy,Viper,Omen,Gekko"
Bind,TBS GC,As de copas,13,1,11,1,0,2,"Viper,Brimstone,Neon,Fade,Gekko","Raze,Cypher,Brimstone,Skye,Gekko"
Icebox,Team Leveling,BmE,13,1,2,0,1,11,"Killjoy,Viper,KAY/O,Gekko,Iso","Sova,Killjoy,Viper,Sage,Gekko"
Ascent,Minas D'ouro,Addictes GC,13,4,10,2,2,3,"Sova,Killjoy,Omen,Jett,KAY/O","Sova,Killjoy,Omen,Jett,KAY/O"
Icebox,TOTALE Talents,Karasuno Crows,13,7,10,2,5,3,"Sova,Killjoy,Viper,Jett,Gekko","Sova,Killjoy,Viper,Sage,Jett"
Haven,Panela Antiaderente,Athena's e-Sports,13,9,8,4,5,5,"Breach,Sova,Killjoy,Omen,Neon","Breach,Killjoy,Omen,Neon,Gekko"
Icebox,REVOADA,Moranguinhas,13,3,10,2,1,3,"Sova,Killjoy,Viper,Jett,Iso","Sova,Killjoy,Viper,Jett,Gekko"
Icebox,Bilibili Gaming,KRÜ Esports,4,13,3,9,4,1,"Killjoy,Viper,Sage,Jett,KAY/O","Sova,Killjoy,Viper,Jett,Gekko"
Lotus,Bilibili Gaming,KRÜ Esports,9,13,7,5,8,2,"Breach,Viper,Omen,Neon,Fade","Raze,Killjoy,Viper,Omen,Fade"
Lotus,Sentinels,FunPlus Phoenix,13,5,4,2,3,9,"Raze,Killjoy,Viper,Omen,Fade","Breach,Viper,Omen,Chamber,Gekko"
Bind,Sentinels,FunPlus Phoenix,13,8,4,8,0,9,"Raze,Viper,Brimstone,Fade,Gekko","Viper,Omen,Yoru,Chamber,Fade"
Haven,SaD FROST,Envee Sapphire GC,13,3,11,1,2,2,"Breach,Sova,Killjoy,Jett,Clove","Cypher,Sova,Omen,Yoru,Iso"
Lotus,SaD FROST,LazerrFreeks Ivy,13,5,5,1,4,8,"Breach,Raze,Cypher,Gekko,Clove","Raze,Killjoy,Omen,Fade,Gekko"
Ascent,Tenax GC,Envee Sapphire GC,13,9,8,2,7,5,"Cypher,Sova,Omen,Jett,KAY/O","Sova,Killjoy,Omen,Jett,KAY/O"
Bind,EDward Gaming,G2 Esports,11,13,8,4,9,3,"Raze,Viper,Brimstone,Fade,Gekko","Raze,Viper,Brimstone,Skye,Gekko"
Haven,EDward Gaming,G2 Esports,11,13,5,7,6,6,"Breach,Cypher,Sova,Omen,Neon","Sova,Killjoy,Viper,Omen,Yoru"
Icebox,EDward Gaming,G2 Esports,13,8,9,3,5,4,"Sova,Killjoy,Viper,Jett,KAY/O","Sova,Killjoy,Viper,Harbor,Gekko"
Ascent,Leviatán,Trace Esports,5,13,2,10,3,3,"Cypher,Sova,Omen,Jett,Deadlock","Sova,Killjoy,Omen,Jett,KAY/O"
Sunset,Leviatán,Trace Esports,13,9,6,4,5,7,"Breach,Cypher,Sova,Omen,Neon","Breach,Raze,Cypher,Sova,Omen"
Bind,Leviatán,Trace Esports,10,13,5,6,7,5,"Raze,Viper,Brimstone,Skye,Gekko","Raze,Cypher,Brimstone,Skye,Deadlock"
Abyss,The blockade,Mickey Masters,5,13,1,5,8,4,"Breach,Raze,Cypher,Sova,Astra","Raze,Cypher,Sova,Astra,Gekko"
Haven,5 Retired Tier 2 Players,Mickey Masters,6,13,1,6,7,5,"Breach,Sova,Killjoy,Omen,Jett","Breach,Sova,Killjoy,Jett,Astra"
Haven,The blockade,Mickey Masters,6,13,1,6,7,5,"Breach,Sova,Killjoy,Omen,Jett","Breach,Sova,Killjoy,Jett,Astra"
Lotus,Spate Esports,The blockade,6,13,1,6,7,5,"Breach,Cypher,Omen,Neon,Fade","Raze,Killjoy,Viper,Fade,Clove"
Haven,Spate Esports,Weber State University,13,2,11,1,1,2,"Breach,Cypher,Sova,Neon,Clove","Breach,Cypher,Sova,Omen,Jett"
Haven,Mickey Masters,OutGoing Esports,13,2,11,1,1,2,"Breach,Sova,Killjoy,Jett,Astra","Breach,Sova,Killjoy,Omen,Jett"
Ascent,5 Retired Tier 2 Players,Death be Happen,13,2,10,2,0,3,"Sova,Killjoy,Omen,Jett,KAY/O","Sova,Killjoy,Omen,Jett,KAY/O"
Ascent,ST x WTP,The blockade,9,13,2,8,5,7,"Sova,Killjoy,Omen,Jett,KAY/O","Sova,Killjoy,Omen,Jett,KAY/O"
Haven,Weber State University,Poseidon Esports,13,3,4,0,3,9,"Breach,Cypher,Sova,Omen,Jett","Breach,Sova,Killjoy,Omen,Jett"
Sunset,Death be Happen,Team Fishy,13,3,9,3,0,4,"Breach,Raze,Cypher,Omen,Gekko","Raze,Cypher,Sova,Omen,Gekko"
Abyss,OutGoing Esports,Outline Esports,13,8,8,4,4,5,"Breach,Cypher,Sova,Omen,Jett","Raze,Cypher,Sova,Astra,Gekko"
Ascent,Legacy,SAGAZ,8,13,6,6,7,2,"Sova,Killjoy,Omen,Jett,KAY/O","Breach,Sova,Killjoy,Omen,Jett"
Icebox,Legacy,SAGAZ,10,13,8,4,9,2,"Sova,Killjoy,Viper,Reyna,Iso","Killjoy,Viper,KAY/O,Gekko,Iso"
Lotus,Legacy,SAGAZ,8,13,2,7,6,6,"Breach,Cypher,Omen,Neon,Iso","Breach,Cypher,Omen,Neon,Iso"
Abyss,Coalesce,Requiem,6,13,5,7,6,1,"Cypher,Sova,Omen,Jett,KAY/O","Cypher,Sova,Omen,Jett,KAY/O"
Haven,Coalesce,Requiem,14,12,7,6,6,7,"Breach,Sova,Killjoy,Omen,Jett","Cypher,Sova,Omen,Yoru,Iso"
Icebox,Coalesce,Requiem,10,13,5,7,6,5,"Sova,Killjoy,Viper,Reyna,Jett","Killjoy,Viper,Jett,KAY/O,Gekko"
Lotus,FNATIC,DRX,6,13,1,6,7,5,"Raze,Killjoy,Viper,Omen,Fade","Raze,Viper,Omen,Chamber,Fade"
Abyss,FNATIC,DRX,11,13,5,7,6,6,"Sova,Killjoy,Viper,Yoru,Astra","Cypher,Sova,Omen,Jett,KAY/O"
Bind,Gen.G Esports,Team Heretics,10,13,6,5,8,4,"Raze,Cypher,Viper,Brimstone,Skye","Viper,Skye,Yoru,Astra,Gekko"
Lotus,Gen.G Esports,Team Heretics,11,13,8,4,9,3,"Raze,Killjoy,Viper,Omen,Fade","Raze,Killjoy,Viper,Omen,Fade"
Abyss,Gen.G Esports,Team Heretics,13,11,7,5,6,6,"Sova,Viper,Jett,Yoru,Astra","Cypher,Sova,Jett,Astra,Gekko"
Ascent,Tenax GC,Charmers GC,13,2,2,1,1,11,"Cypher,Sova,Omen,Jett,KAY/O","Sova,Killjoy,Omen,Deadlock,Clove"
Sunset,Akave Esports Black,MYVRA GC,13,5,3,3,2,10,"Breach,Raze,Cypher,Omen,Gekko","Breach,Raze,Cypher,Omen,Fade"
Haven,Legacy,Agropesca Jacare,13,15,9,5,10,4,"Cypher,Sova,Phoenix,Omen,Iso","Cypher,Sova,Omen,Yoru,Iso"
Abyss,Akave Esports Black,MYVRA GC,11,13,5,7,6,6,"Sova,Omen,Jett,Gekko,Deadlock","Breach,Raze,Cypher,Sova,Astra"
Lotus,Legacy,Agropesca Jacare,11,13,4,8,5,7,"Breach,Cypher,Omen,Neon,Iso","Raze,Omen,Chamber,Fade,Clove"
Haven,Akave Esports Black,MYVRA GC,13,7,5,7,0,8,"Cypher,Sova,Omen,Jett,Skye","Breach,Raze,Killjoy,Astra,Fade"
Icebox,NIGERIA 96,SAGAZ,3,13,2,10,3,1,"Sova,Killjoy,Viper,Jett,Harbor","Killjoy,Viper,KAY/O,Gekko,Iso"
Ascent,NIGERIA 96,SAGAZ,11,13,6,6,7,5,"Cypher,Sova,Omen,Jett,Deadlock","Breach,Sova,Killjoy,Omen,Jett"
Sunset,NEANLATIYONBOLM,Siko Esports,7,13,6,6,7,1,"Killjoy,Yoru,Astra,Neon,Gekko","Breach,Raze,Cypher,Sova,Omen"
Sunset,NEANLATIYONBOLM,Osiris,13,7,7,1,6,6,"Breach,Raze,Cypher,Sova,Omen","Killjoy,Yoru,Astra,Neon,Gekko"
Bind,NEANLATIYONBOLM,Siko Esports,13,5,8,4,1,5,"Raze,Viper,Brimstone,Yoru,Deadlock","Raze,Viper,Brimstone,Skye,Gekko"
Bind,NEANLATIYONBOLM,Osiris,5,13,1,5,8,4,"Raze,Viper,Brimstone,Skye,Gekko","Raze,Viper,Brimstone,Yoru,Deadlock"
Haven,NEANLATIYONBOLM,Osiris,13,9,4,6,3,9,"Breach,Cypher,Sova,Omen,Jett","Sova,Killjoy,Omen,Jett,Yoru"
Haven,NEANLATIYONBOLM,Siko Esports,9,13,3,9,4,6,"Sova,Killjoy,Omen,Jett,Yoru","Breach,Cypher,Sova,Omen,Jett"
Abyss,Sad Green,Goon that jawn,9,13,4,8,5,5,"Cypher,Sova,Omen,Jett,Deadlock","Cypher,Sova,Omen,Yoru,Neon"
Bind,Sad Green,Goon that jawn,13,11,6,6,5,7,"Raze,Viper,Brimstone,Skye,Deadlock","Raze,Viper,Skye,Yoru,Clove"
Ascent,Burger Boyz 2.0,#flyaway,9,13,6,6,7,3,"Cypher,Sova,Omen,Jett,Deadlock","Sova,Killjoy,Omen,Jett,KAY/O"
Ascent,Sad Green,Goon that jawn,12,14,7,6,8,5,"Sova,Killjoy,Omen,Jett,KAY/O","Sova,Killjoy,Reyna,Omen,Yoru"
Bind,Burger Boyz 2.0,#flyaway,9,13,2,8,5,7,"Raze,Brimstone,Skye,Gekko,Deadlock","Raze,Brimstone,Reyna,Yoru,Gekko"
Icebox,SAGAZ,Agropesca Jacare,1,13,0,2,11,1,"Killjoy,Viper,KAY/O,Gekko,Iso","Sova,Killjoy,Viper,Iso,Clove"
Haven,SAGAZ,Agropesca Jacare,5,13,1,5,8,4,"Breach,Sova,Killjoy,Omen,Neon","Cypher,Sova,Omen,Yoru,Iso"
Ascent,Burger Boyz 2.0,Sad Green,2,13,2,10,3,0,"Cypher,Sova,Omen,Jett,Deadlock","Sova,Killjoy,Omen,Jett,KAY/O"
Icebox,Burger Boyz 2.0,Sad Green,4,13,2,3,10,2,"Sova,Killjoy,Viper,Jett,Gekko","Sova,Killjoy,Viper,Reyna,Jett"
Icebox,Legacy,NIGERIA 96,13,3,11,1,2,2,"Sova,Killjoy,Viper,Reyna,Iso","Sova,Killjoy,Viper,Jett,Harbor"
Bind,Burger Boyz 2.0,Sad Green,13,7,8,4,3,5,"Raze,Brimstone,Skye,Gekko,Deadlock","Raze,Viper,Brimstone,Skye,Deadlock"
Lotus,Legacy,NIGERIA 96,13,3,10,2,1,3,"Breach,Cypher,Omen,Neon,Iso","Breach,Cypher,Omen,Neon,Fade"
Haven,Goon that jawn,#flyaway,13,10,6,5,5,7,"Cypher,Sova,Omen,Jett,Yoru","Breach,Cypher,Sova,Omen,Jett"
Bind,Goon that jawn,#flyaway,13,6,6,1,5,7,"Raze,Viper,Brimstone,Yoru,Gekko","Raze,Brimstone,Reyna,Yoru,Gekko"
Abyss,Legacy,NIGERIA 96,11,13,7,5,8,4,"Cypher,Sova,Omen,Jett,KAY/O","Cypher,Sova,Yoru,Astra,Iso"
Abyss,EarnYourMedal,Sad Green,8,13,4,8,5,4,"Cypher,Sova,Reyna,Jett,Astra","Cypher,Sova,Jett,Astra,Deadlock"
Bind,Shake and Jake,Burger Boyz 2.0,5,13,1,5,8,4,"Raze,Viper,Brimstone,Skye,Deadlock","Raze,Brimstone,Skye,Gekko,Deadlock"
Icebox,EarnYourMedal,Sad Green,6,13,2,5,8,4,"Sova,Killjoy,Viper,Reyna,Jett","Sova,Killjoy,Viper,Reyna,Jett"
Ascent,Shake and Jake,Burger Boyz 2.0,10,13,7,5,8,3,"Sova,Killjoy,Omen,Jett,KAY/O","Cypher,Sova,Omen,Jett,Deadlock"
Abyss,#flyaway,ROSE,13,8,5,4,4,8,"Cypher,Sova,Jett,Astra,Deadlock","Cypher,Sova,Omen,Yoru,Deadlock"
Haven,Goon that jawn,Dolbaebi,14,12,8,5,7,6,"Breach,Cypher,Sova,Omen,Yoru","Breach,Cypher,Sova,Jett,Clove"
Bind,#flyaway,ROSE,13,2,10,2,0,3,"Raze,Brimstone,Reyna,Yoru,Gekko","Raze,Brimstone,Skye,Gekko,Deadlock"
Ascent,Goon that jawn,Dolbaebi,13,7,5,7,0,8,"Sova,Killjoy,Reyna,Omen,Yoru","Sova,Killjoy,Omen,Jett,KAY/O"
Icebox,Vixen Esports,PARABELLUM,1,13,0,2,11,1,"Viper,Reyna,Jett,Iso,Clove","Sova,Killjoy,Viper,Jett,KAY/O"
Haven,Shake and Jake,Burger Boyz 2.0,13,11,6,6,5,7,"Breach,Sova,Killjoy,Omen,Jett","Breach,Sova,Killjoy,Omen,Jett"
Icebox,EarnYourMedal,F5 Esports,14,12,8,5,7,6,"Sova,Killjoy,Viper,Reyna,Jett","Sova,Killjoy,Viper,Reyna,Jett"
Abyss,Vixen Esports,PARABELLUM,2,13,2,10,3,0,"Breach,Cypher,Sova,Omen,Jett","Breach,Cypher,Jett,Astra,Gekko"
Lotus,EarnYourMedal,F5 Esports,13,11,4,8,3,9,"Raze,Killjoy,Reyna,Omen,Skye","Breach,Raze,Cypher,Fade,Clove"
Haven,Reign Above,Dolbaebi,7,13,3,9,4,4,"Breach,Sova,Killjoy,Omen,Jett","Breach,Cypher,Sova,Jett,Clove"
Ascent,#flyaway,OverLoaded,13,11,9,3,8,4,"Sova,Killjoy,Omen,Jett,KAY/O","Cypher,Sova,Omen,Yoru,Fade"
Lotus,ARTHEA,STRIX,13,3,9,3,0,4,"Breach,Killjoy,Omen,Jett,Gekko","Breach,Raze,Cypher,Omen,Gekko"
Ascent,uhhhhh,Burger Boyz 2.0,7,13,3,5,8,4,"Sova,Killjoy,Reyna,Omen,Jett","Cypher,Sova,Omen,Jett,Deadlock"
Bind,Reign Above,Dolbaebi,7,13,3,9,4,4,"Raze,Viper,Brimstone,Skye,Chamber","Raze,Cypher,Brimstone,Skye,Gekko"
Bind,#flyaway,OverLoaded,13,5,7,5,0,6,"Raze,Brimstone,Reyna,Yoru,Gekko","Raze,Viper,KAY/O,Fade,Clove"
Haven,uhhhhh,Burger Boyz 2.0,3,13,0,4,9,3,"Breach,Sova,Killjoy,Omen,Jett","Breach,Sova,Killjoy,Omen,Jett"
Haven,ARTHEA,STRIX,13,8,7,2,6,6,"Breach,Sova,Killjoy,Omen,Jett","Breach,Cypher,Omen,Jett,Skye"
Bind,EDward Gaming,FUT Esports,13,10,8,4,6,5,"Raze,Viper,Brimstone,Fade,Gekko","Raze,Viper,Brimstone,Fade,Gekko"
Lotus,EDward Gaming,FUT Esports,13,9,8,4,5,5,"Breach,Omen,Neon,Fade,Clove","Breach,Cypher,Viper,Omen,Jett"
Lotus,G2 Esports,Paper Rex,13,9,4,6,3,9,"Raze,Killjoy,Viper,Omen,Fade","Omen,Jett,KAY/O,Neon,Fade"
Icebox,G2 Esports,Paper Rex,13,8,8,4,4,5,"Sova,Killjoy,Viper,Harbor,Gekko","Sova,Killjoy,Viper,Sage,Jett"
Icebox,the gnomes,F5 Esports,11,13,7,5,8,4,"Sova,Killjoy,Viper,Jett,Gekko","Sova,Killjoy,Viper,Reyna,Jett"
Haven,the gnomes,F5 Esports,13,10,10,1,9,3,"Breach,Sova,Killjoy,Omen,Jett","Breach,Sova,Killjoy,Jett,Astra"
Lotus,the gnomes,F5 Esports,14,16,6,9,7,8,"Breach,Cypher,Omen,Neon,Gekko","Breach,Raze,Cypher,Fade,Clove"
Lotus,F5 Esports,The Villans,13,5,10,2,3,3,"Breach,Raze,Cypher,Fade,Clove","Raze,Killjoy,Viper,Omen,Skye"
Abyss,OverLoaded,Reign Above,13,9,7,5,4,6,"Cypher,Sova,Omen,Jett,Harbor","Cypher,Sova,Omen,Jett,Yoru"
Lotus,the gnomes,Event Horizon,13,8,7,5,3,6,"Breach,Cypher,Omen,Neon,Gekko","Breach,Raze,Cypher,Omen,Fade"
Lotus,Team Liquid Brazil,NIGERIA 96,11,13,5,7,6,6,"Raze,Killjoy,Viper,Omen,Fade","Breach,Cypher,Omen,Neon,Fade"
Bind,Agropesca Jacare,NoOrg9,13,1,2,0,1,11,"Raze,Cypher,Viper,Brimstone,Skye","Raze,Viper,Brimstone,Skye,Gekko"
Abyss,The Villans,Raiders of the Knight,13,11,9,3,8,4,"Cypher,Jett,Astra,Gekko,Iso","Raze,Cypher,Omen,Gekko,Iso"
Haven,F5 Esports,OverLoaded,11,13,5,7,6,6,"Breach,Sova,Killjoy,Jett,Astra","Killjoy,Viper,Omen,Jett,Skye"
Ascent,the gnomes,Reign Above,13,15,5,9,6,8,"Sova,Killjoy,Omen,Jett,KAY/O","Sova,Killjoy,Omen,Jett,KAY/O"
Lotus,FIU Varsity,Event Horizon,5,13,3,9,4,2,"Raze,Omen,Skye,Chamber,Gekko","Breach,Raze,Cypher,Omen,Fade"
Haven,Agropesca Jacare,NoOrg9,13,5,4,2,3,9,"Cypher,Sova,Omen,Yoru,Iso","Breach,Cypher,Sova,Omen,Jett"
Ascent,Team Liquid Brazil,NIGERIA 96,11,13,4,8,5,7,"Sova,Killjoy,Omen,Jett,KAY/O","Cypher,Sova,Omen,Jett,Deadlock"
Ascent,Event Horizon,OverLoaded,8,13,6,3,10,2,"Sova,Killjoy,Omen,Jett,KAY/O","Cypher,Sova,Omen,Yoru,Fade"
Bind,Raiders of the Knight,Reign Above,8,13,6,6,7,2,"Raze,Reyna,Astra,Chamber,Iso","Raze,Viper,Brimstone,Skye,Chamber"
Abyss,IAPEsports,Grow uP eSports,13,9,7,3,6,6,"Breach,Phoenix,Omen,Yoru,KAY/O","Cypher,Phoenix,Astra,Neon,Gekko"
Abyss,GMBLERS Esports,bazinga esports,13,8,8,1,7,5,"Sova,Omen,Jett,Gekko,Deadlock","Cypher,Sova,Omen,Jett,Harbor"
Abyss,INCOGNITO,InTenZive,9,13,5,5,8,4,"Breach,Cypher,Jett,Astra,Gekko","Sova,Jett,Astra,Gekko,Deadlock"
Abyss,Nexum EC,Solar Flare,8,13,4,5,8,4,"Omen,Jett,KAY/O,Fade,Deadlock","Sova,Omen,Jett,Gekko,Deadlock"
Abyss,STAKERS,Zeniths,7,13,3,5,8,4,"Breach,Cypher,Sova,Jett,Astra","Breach,Omen,Jett,Gekko,Deadlock"
Haven,The Villans,the gnomes,10,13,6,5,8,4,"Killjoy,Viper,Jett,Skye,Clove","Breach,Sova,Killjoy,Omen,Jett"
Sunset,#flyaway,uhhhhh,13,6,3,4,2,10,"Breach,Raze,Cypher,Omen,Gekko","Breach,Raze,Cypher,Omen,Fade"
Lotus,F5 Esports,FIU Varsity,13,11,8,4,7,5,"Breach,Cypher,Neon,Fade,Clove","Raze,Omen,Skye,Chamber,Gekko"
Ascent,#flyaway,uhhhhh,11,13,5,7,6,6,"Sova,Killjoy,Omen,Neon,Iso","Sova,Killjoy,Reyna,Omen,Jett"
Lotus,Goon that jawn,The Villans,13,10,9,3,7,4,"Viper,Reyna,Astra,Chamber,Deadlock","Raze,Cypher,Reyna,Gekko,Clove"
Bind,#flyaway,uhhhhh,13,6,9,3,3,4,"Raze,Brimstone,Reyna,Yoru,Gekko","Raze,Skye,Deadlock,Iso,Clove"
Bind,PARABELLUM,STRIX,13,3,4,0,3,9,"Breach,Viper,Brimstone,Jett,Skye","Breach,Raze,Cypher,Omen,Skye"
Abyss,GMBLERS Esports,Nexum EC,3,13,3,9,4,0,"Cypher,Sova,Omen,Harbor,Iso","Omen,Jett,KAY/O,Fade,Deadlock"
Abyss,STAKERS,KHORE GAMING,13,10,9,2,8,4,"Breach,Cypher,Sova,Jett,Astra","Breach,Sova,Killjoy,Omen,Jett"
Abyss,bazinga esports,IAPEsports,11,13,6,6,7,5,"Cypher,Sova,Omen,Jett,Harbor","Breach,Phoenix,Omen,Yoru,KAY/O"
Abyss,InTenZive,Solar Flare,13,3,2,2,1,11,"Sova,Jett,Astra,Gekko,Deadlock","Cypher,Sova,Omen,Jett,KAY/O"
Abyss,INCOGNITO,Grow uP eSports,13,3,4,0,3,9,"Breach,Cypher,Jett,Astra,Gekko","Cypher,Phoenix,Astra,Neon,Gekko"
Ascent,Goon that jawn,The Villans,13,5,8,4,1,5,"Sova,Killjoy,Omen,Jett,Iso","Cypher,Sova,Omen,Jett,Deadlock"
Ascent,PARABELLUM,STRIX,13,5,6,0,5,7,"Sova,Killjoy,Omen,Jett,KAY/O","Breach,Cypher,Sova,Omen,Jett"
Ascent,ARTHEA,Vixen Esports,10,13,6,5,8,4,"Sova,Killjoy,Omen,Jett,KAY/O","Sova,Killjoy,Sage,Omen,Jett"
Haven,ARTHEA,Vixen Esports,7,13,6,6,7,1,"Breach,Sova,Killjoy,Omen,Jett","Breach,Sova,Killjoy,Omen,Jett"
Bind,Team Vitality,Trace Esports,7,13,6,6,7,1,"Raze,Viper,Omen,Fade,Gekko","Raze,Cypher,Brimstone,Skye,Deadlock"
Sunset,Team Vitality,Trace Esports,13,7,5,3,4,8,"Cypher,Sova,Omen,KAY/O,Neon","Breach,Raze,Cypher,Sova,Omen"
Ascent,Team Vitality,Trace Esports,13,15,7,7,8,6,"Sova,Killjoy,Omen,Jett,KAY/O","Sova,Killjoy,Omen,Jett,KAY/O"
Ascent,Leviatán,Talon Esports,13,8,5,4,4,8,"Cypher,Sova,Omen,Jett,Deadlock","Sova,Phoenix,Sage,KAY/O,Clove"
Bind,Leviatán,Talon Esports,13,11,6,6,5,7,"Raze,Viper,Brimstone,Skye,Gekko","Viper,Omen,Skye,Yoru,Neon"
Icebox,Sad Green,OverLoaded,6,13,3,4,9,3,"Sova,Killjoy,Viper,Reyna,Jett","Sova,Viper,Reyna,Jett,Deadlock"
Bind,Sad Green,OverLoaded,13,7,7,5,2,6,"Raze,Viper,Brimstone,Skye,Deadlock","Raze,Viper,KAY/O,Fade,Clove"
Ascent,Sad Green,OverLoaded,9,13,1,9,4,8,"Sova,Killjoy,Omen,Jett,KAY/O","Cypher,Sova,Omen,Yoru,Fade"
Sunset,EarnYourMedal,Raiders of the Knight,13,10,7,5,5,6,"Cypher,Reyna,Omen,Jett,Gekko","Raze,Cypher,Omen,Gekko,Iso"
Haven,Shake and Jake,FIU Varsity,13,2,10,2,0,3,"Sova,Phoenix,Jett,Iso,Clove","Sova,Reyna,Omen,Chamber,Neon"
Haven,EarnYourMedal,Raiders of the Knight,13,4,5,0,4,8,"Cypher,Sova,Reyna,Jett,Astra","Sova,Killjoy,Omen,Jett,Iso"
Haven,OverLoaded,the gnomes,11,13,6,6,7,5,"Killjoy,Viper,Omen,Jett,Skye","Breach,Sova,Killjoy,Omen,Jett"
Lotus,Shake and Jake,FIU Varsity,13,3,9,3,0,4,"Breach,Raze,Cypher,Fade,Clove","Raze,Omen,Skye,Chamber,Gekko"
Icebox,Bedwars Lions,Akatsuki Aimers,13,3,9,3,0,4,"Killjoy,Viper,Jett,KAY/O,Gekko","Sova,Killjoy,Viper,Jett,Gekko"
Bind,Sad Green,Dolbaebi,6,13,3,4,9,3,"Raze,Cypher,Brimstone,Skye,Deadlock","Raze,Viper,Brimstone,Skye,Deadlock"
Bind,FIU Varsity,Raiders of the Knight,3,13,1,3,10,2,"Raze,Brimstone,Skye,Yoru,Chamber","Raze,Skye,Astra,Chamber,Iso"
Ascent,OverLoaded,the gnomes,13,9,5,7,2,8,"Cypher,Sova,Omen,Yoru,Fade","Sova,Killjoy,Omen,Jett,KAY/O"
Ascent,Shake and Jake,EarnYourMedal,13,10,7,5,5,6,"Sova,Killjoy,Omen,Jett,KAY/O","Sova,Killjoy,Omen,Jett,KAY/O"
Haven,Bedwars Lions,Akatsuki Aimers,13,8,4,5,3,9,"Killjoy,Viper,Omen,Jett,Skye","Breach,Sova,Killjoy,Omen,Jett"
Sunset,FIU Varsity,Raiders of the Knight,5,13,4,8,5,1,"Breach,Raze,Cypher,Omen,Gekko","Raze,Cypher,Omen,Gekko,Iso"
Lotus,Sad Green,Dolbaebi,11,13,5,7,6,6,"Breach,Raze,Cypher,Sova,Clove","Raze,Killjoy,Viper,Omen,Fade"
Lotus,Bedwars Lions,Akatsuki Aimers,8,13,6,3,10,2,"Breach,Raze,Cypher,Omen,Fade","Breach,Cypher,Omen,Neon,Fade"
Lotus,OverLoaded,the gnomes,11,13,8,4,9,3,"Breach,Cypher,Neon,Fade,Clove","Breach,Cypher,Omen,Neon,Gekko"
Sunset,Shake and Jake,EarnYourMedal,13,8,8,4,4,5,"Breach,Raze,Cypher,Omen,Gekko","Cypher,Reyna,KAY/O,Gekko,Clove"
Icebox,NIGERIA 96,LRNJ,13,8,7,5,3,6,"Sova,Killjoy,Viper,Jett,Harbor","Sova,Killjoy,Viper,Jett,Harbor"
Haven,MIBR GC,Team Liquid Brazil,13,15,9,5,10,4,"Breach,Sova,Killjoy,Omen,Jett","Cypher,Sova,Omen,Yoru,Iso"
Icebox,Sad Green,the gnomes,13,1,2,0,1,11,"Sova,Killjoy,Viper,Reyna,Jett","Sova,Killjoy,Viper,Harbor,Gekko"
Icebox,Dolbaebi,the gnomes,13,1,2,0,1,11,"Sova,Killjoy,Viper,Reyna,Jett","Sova,Killjoy,Viper,Harbor,Gekko"
Haven,Purpose Gaming,Akatsuki Aimers,8,13,4,8,5,4,"Breach,Cypher,Sova,Omen,Neon","Sova,Reyna,Jett,Chamber,Clove"
Haven,Bedwars Lions,wadadaa,13,11,7,5,6,6,"Killjoy,Viper,Omen,Jett,Skye","Cypher,Reyna,Omen,Jett,Neon"
Sunset,FIU Varsity,EarnYourMedal,8,13,6,6,7,2,"Cypher,Sova,Omen,Neon,Gekko","Cypher,Reyna,KAY/O,Gekko,Clove"
Sunset,NIGERIA 96,LRNJ,9,13,4,6,7,5,"Viper,Sage,Omen,KAY/O,Gekko","Cypher,Sova,Omen,KAY/O,Neon"
Ascent,RD E-SPORTS,NoOrg9,1,13,0,2,11,1,"Sova,Killjoy,Omen,Jett,KAY/O","Sova,Killjoy,Omen,Jett,KAY/O"
Haven,Agropesca Jacare,Team YOSO,14,12,7,6,6,7,"Cypher,Sova,Omen,Yoru,Iso","Breach,Cypher,Sova,Omen,Neon"
Bind,MIBR GC,Team Liquid Brazil,16,18,8,9,9,8,"Raze,Viper,Brimstone,Fade,Gekko","Raze,Cypher,Viper,Brimstone,Skye"
Abyss,Machine Esports,Purpose Gaming,12,14,9,4,10,3,"Cypher,Sova,Omen,Jett,Iso","Sova,Killjoy,Viper,Yoru,Astra"
Haven,Dolbaebi,the gnomes,11,13,8,4,9,3,"Breach,Sova,Killjoy,Omen,Jett","Breach,Sova,Killjoy,Omen,Jett"
Haven,Sad Green,the gnomes,11,13,8,4,9,3,"Breach,Sova,Killjoy,Omen,Jett","Breach,Sova,Killjoy,Omen,Jett"
Lotus,Omnipotence,Akatsuki Aimers,7,13,5,3,10,2,"Raze,Cypher,Omen,Fade,Deadlock","Breach,Cypher,Omen,Neon,Fade"
Lotus,FIU Varsity,EarnYourMedal,13,11,6,6,5,7,"Raze,Omen,Skye,Chamber,Gekko","Breach,Killjoy,Reyna,Omen,Skye"
Lotus,RD E-SPORTS,NoOrg9,13,6,5,2,4,8,"Raze,Killjoy,Viper,Omen,Skye","Raze,Killjoy,Viper,Omen,Fade"
Sunset,Agropesca Jacare,Team YOSO,13,6,4,3,3,9,"Breach,Raze,Cypher,Sova,Astra","Breach,Cypher,Sova,Omen,Neon"
Sunset,Shake and Jake,Raiders of the Knight,14,12,5,8,4,9,"Breach,Raze,Cypher,Omen,Gekko","Raze,Omen,Chamber,Gekko,Iso"
Lotus,Weber State University,wadadaa,17,19,13,5,14,4,"Breach,Raze,Killjoy,Omen,Gekko","Raze,Cypher,Omen,Skye,Deadlock"
Icebox,Death be Happen,Bedwars Lions,6,13,0,0,7,3,"Sova,Killjoy,Viper,Jett,Gekko","Killjoy,Viper,Jett,KAY/O,Gekko"
Sunset,Event Horizon,The Villans,13,8,6,3,5,7,"Raze,Cypher,Sova,Omen,Neon","Breach,Cypher,Sova,Omen,Neon"
Lotus,NIGERIA 96,LRNJ,17,15,8,8,7,9,"Breach,Cypher,Omen,Neon,Fade","Breach,Raze,Cypher,Omen,Fade"
Ascent,Dolbaebi,OverLoaded,13,6,4,3,3,9,"Sova,Killjoy,Omen,Jett,KAY/O","Cypher,Sova,Omen,Yoru,Fade"
Abyss,Machine Esports,Yucky Aim,13,7,5,3,4,8,"Cypher,Sova,Omen,Jett,Iso","Breach,Cypher,Jett,Astra,Gekko"
Haven,blend,Akatsuki Aimers,7,13,4,4,9,3,"Breach,Cypher,Sova,Omen,Jett","Sova,Reyna,Jett,Chamber,Clove"
Bind,Dolbaebi,the gnomes,13,6,8,4,2,5,"Raze,Viper,Brimstone,Skye,Deadlock","Raze,Viper,Brimstone,Skye,Gekko"
Bind,Sad Green,the gnomes,13,6,8,4,2,5,"Raze,Viper,Brimstone,Skye,Deadlock","Raze,Viper,Brimstone,Skye,Gekko"
Lotus,MIBR GC,Team Liquid Brazil,13,5,7,5,0,6,"Raze,Killjoy,Viper,Omen,Fade","Raze,Killjoy,Viper,Omen,Fade"
Icebox,Death be Happen,AKIMBO,13,1,11,1,0,2,"Sova,Killjoy,Viper,Jett,Gekko","Sova,Killjoy,Viper,Jett,Gekko"
Icebox,FIU Varsity,EarnYourMedal,8,13,3,6,7,5,"Sova,Killjoy,Viper,Jett,Chamber","Sova,Killjoy,Viper,Jett,KAY/O"
Haven,Senchigami,wadadaa,5,13,2,4,9,3,"Breach,Sova,Killjoy,Omen,Jett","Cypher,Reyna,Omen,Jett,Neon"
Ascent,Shake and Jake,Raiders of the Knight,13,2,10,2,0,3,"Sova,Killjoy,Omen,Jett,KAY/O","Sova,Killjoy,Omen,Jett,KAY/O"
Haven,Purpose Gaming,patty flippers,13,4,10,2,2,3,"Breach,Cypher,Sova,Omen,Neon","Cypher,Sova,Reyna,Omen,Jett"
Lotus,Vortex VTX,Omnipotence,0,13,0,12,1,0,"Breach,Cypher,Viper,Omen,Neon","Raze,Cypher,Omen,Fade,Deadlock"
Lotus,Event Horizon,The Villans,13,2,10,2,0,3,"Breach,Raze,Cypher,Omen,Fade","Breach,Raze,Cypher,Omen,Gekko"
Haven,Bedwars Lions,Event Horizon Red,13,8,6,6,2,7,"Killjoy,Viper,Omen,Jett,Skye","Sova,Killjoy,Omen,Jett,Neon"
Haven,Dolbaebi,OverLoaded,13,4,4,1,3,9,"Breach,Cypher,Sova,Jett,Clove","Killjoy,Viper,Omen,Jett,Skye"
Bind,Goon that jawn,#flyaway,13,8,3,6,2,10,"Breach,Raze,Skye,Deadlock,Clove","Raze,Brimstone,Reyna,Yoru,Gekko"
Haven,RD E-SPORTS,NoOrg9,15,17,11,5,12,4,"Breach,Sova,Killjoy,Omen,Jett","Breach,Cypher,Sova,Omen,Jett"
Lotus,SSJ de Óculos,Agropesca Jacare,6,13,2,5,8,4,"Raze,Killjoy,Viper,Omen,Fade","Raze,Omen,Chamber,Fade,Clove"
Haven,SYN,Weber State University,2,13,2,10,3,0,"Killjoy,Viper,Omen,Jett,Skye","Breach,Cypher,Sova,Omen,Jett"
Haven,Azure Bears,LRNJ,4,13,1,4,9,3,"Breach,Sova,Killjoy,Omen,Neon","Breach,Cypher,Sova,Omen,Jett"
Lotus,Akatsuki Aimers,Yumi Tanuki,13,1,2,0,1,11,"Breach,Cypher,Omen,Neon,Fade","Breach,Raze,Killjoy,Omen,Fade"
Haven,Ibreon Esports Amethyst,Event Horizon Red,4,13,0,5,8,4,"Breach,Sova,Killjoy,Omen,Jett","Sova,Killjoy,Omen,Jett,Neon"
Ascent,Cardboard Dragons,AKIMBO,7,13,2,10,3,5,"Sova,Killjoy,Omen,Jett,KAY/O","Sova,Killjoy,Omen,Jett,KAY/O"
Abyss,Omnipotence,Guardian Esports,13,4,10,2,2,3,"Breach,Sova,Killjoy,Omen,Jett","Cypher,Sova,Omen,Jett,KAY/O"
Haven,Bedwars Lions,OutGoing Esports,13,4,5,0,4,8,"Killjoy,Viper,Omen,Jett,Skye","Breach,Sova,Killjoy,Omen,Jett"
Lotus,Paranoia Boys,Yucky Aim,12,14,6,7,7,6,"Breach,Raze,Cypher,Omen,Gekko","Killjoy,Viper,Omen,Jett,Gekko"
Ascent,Purpose Gaming,JabootyModeGaming,13,3,4,0,3,9,"Sova,Killjoy,Omen,Jett,KAY/O","Sova,Killjoy,Brimstone,Jett,Skye"
Haven,ColdFront Esports,blend,4,13,1,11,2,3,"Breach,Sova,Killjoy,Omen,Jett","Breach,Cypher,Sova,Omen,Jett"
Abyss,wadadaa,Raven Esports,13,4,8,4,0,5,"Cypher,Reyna,Omen,Jett,Neon","Sova,Omen,Jett,Harbor,Deadlock"
Ascent,Team YOSO,lanchonete do gerso,13,8,7,2,6,6,"Sova,Killjoy,Omen,Jett,KAY/O","Sova,Killjoy,Omen,Jett,KAY/O"
Sunset,DRACC,NIGERIA 96,3,13,2,10,3,1,"Breach,Cypher,Omen,Neon,Deadlock","Viper,Sage,Omen,KAY/O,Gekko"
Haven,Goon that jawn,#flyaway,13,11,6,6,5,7,"Cypher,Sova,Omen,Yoru,Iso","Breach,Sova,Killjoy,Omen,Jett"
Haven,SAIDEIRA ESPORTS,Team Liquid Brazil,10,13,5,6,7,5,"Breach,Sova,Killjoy,Omen,Jett","Cypher,Sova,Omen,Yoru,Iso"
Lotus,NoOrg9,Vex Dragons,13,6,5,2,4,8,"Raze,Killjoy,Viper,Omen,Fade","Raze,Killjoy,Omen,Fade,Deadlock"
Lotus,RD E-SPORTS,Os Bate Laje,13,9,8,2,7,5,"Raze,Killjoy,Viper,Omen,Skye","Breach,Killjoy,Omen,Jett,Gekko"
Haven,Event Horizon,uhhhhh,7,13,3,9,4,4,"Breach,Sova,Killjoy,Omen,Jett","Breach,Sova,Killjoy,Omen,Jett"
Icebox,Azure Bears,LRNJ,14,12,8,5,7,6,"Omen,KAY/O,Harbor,Gekko,Clove","Sova,Killjoy,Viper,Jett,Harbor"
Bind,SSJ de Óculos,Agropesca Jacare,13,9,8,4,5,5,"Raze,Viper,Skye,Gekko,Clove","Raze,Cypher,Viper,Brimstone,Skye"
Lotus,SAIDEIRA ESPORTS,Team Liquid Brazil,5,13,2,4,9,3,"Raze,Killjoy,Viper,Omen,Fade","Raze,Killjoy,Viper,Omen,Fade"
Bind,DRACC,NIGERIA 96,14,12,8,5,7,6,"Cypher,Brimstone,Skye,Neon,Deadlock","Raze,Viper,Omen,Skye,Harbor"
Haven,MIBR GC,Valoriza,13,6,3,4,2,10,"Breach,Sova,Killjoy,Omen,Jett","Breach,Cypher,Omen,Neon,Fade"
Haven,RD E-SPORTS,Os Bate Laje,13,4,8,4,0,5,"Breach,Sova,Killjoy,Omen,Jett","Breach,Sova,Killjoy,Omen,Jett"
Haven,Team YOSO,lanchonete do gerso,15,17,10,6,11,5,"Breach,Cypher,Sova,Omen,Neon","Breach,Omen,Jett,Chamber,Fade"
Lotus,Event Horizon,uhhhhh,13,11,6,6,5,7,"Breach,Raze,Cypher,Omen,Fade","Raze,Cypher,Omen,Gekko,Iso"
Lotus,#flyaway,The Villans,13,5,8,4,1,5,"Cypher,Neon,Deadlock,Iso,Clove","Raze,Cypher,Omen,Fade,Iso"
Haven,Burger Boyz 2.0,F5 Esports,13,11,9,3,8,4,"Breach,Sova,Killjoy,Omen,Neon","Breach,Sova,Killjoy,Jett,Astra"
Lotus,Azure Bears,LRNJ,8,13,6,3,10,2,"Breach,Cypher,Omen,Neon,Fade","Breach,Raze,Cypher,Omen,Fade"
Abyss,ROSE,Reign Above,13,5,5,1,4,8,"Cypher,Sova,Omen,Yoru,Deadlock","Cypher,Sova,Omen,Jett,Yoru"
Bind,NoOrg9,Vex Dragons,13,8,8,1,7,5,"Raze,Viper,Brimstone,Skye,Gekko","Raze,Cypher,Brimstone,Skye,Deadlock"
Lotus,MIBR GC,Valoriza,13,0,12,0,0,1,"Raze,Killjoy,Viper,Omen,Fade","Raze,Cypher,Omen,Fade,Deadlock"
Sunset,SSJ de Óculos,Agropesca Jacare,11,13,5,7,6,6,"Breach,Cypher,Sova,Omen,Neon","Breach,Raze,Cypher,Sova,Astra"
Bind,SAIDEIRA ESPORTS,Team Liquid Brazil,13,8,3,6,2,10,"Raze,Viper,Brimstone,Fade,Gekko","Raze,Cypher,Viper,Brimstone,Skye"
Lotus,DRACC,NIGERIA 96,3,13,3,9,4,0,"Breach,Killjoy,Omen,Neon,Deadlock","Breach,Cypher,Omen,Neon,Fade"
Sunset,Team YOSO,lanchonete do gerso,13,3,10,2,1,3,"Breach,Cypher,Sova,Omen,Neon","Raze,Cypher,Omen,Gekko,Deadlock"
Ascent,Event Horizon,uhhhhh,8,13,1,8,5,7,"Sova,Killjoy,Omen,Jett,KAY/O","Sova,Killjoy,Reyna,Omen,Jett"
Lotus,ROSE,Reign Above,13,1,2,0,1,11,"Raze,Killjoy,Viper,Omen,Fade","Breach,Killjoy,Omen,Neon,Fade"
Icebox,#flyaway,The Villans,13,5,5,1,4,8,"Sova,Viper,Sage,Jett,Chamber","Killjoy,Viper,Omen,KAY/O,Gekko"
Lotus,Burger Boyz 2.0,F5 Esports,13,8,8,4,4,5,"Breach,Raze,Cypher,Gekko,Clove","Breach,Cypher,Neon,Fade,Clove"
Bind,ROSE,Burger Boyz 2.0,13,4,3,2,2,10,"Raze,Brimstone,Skye,Gekko,Deadlock","Raze,Cypher,Viper,Brimstone,Skye"
Bind,uhhhhh,The Villans,13,8,3,6,2,10,"Raze,Skye,Deadlock,Iso,Clove","Raze,Viper,Astra,Fade,Gekko"
Haven,Neira Esports,STRIX,11,13,6,6,7,5,"Breach,Cypher,Sova,Brimstone,Jett","Breach,Cypher,Omen,Jett,Skye"
Lotus,F5 Esports,Reign Above,13,4,11,1,3,2,"Breach,Cypher,Neon,Fade,Clove","Breach,Killjoy,Omen,Neon,Fade"
Icebox,ROSE,Burger Boyz 2.0,13,6,4,3,3,9,"Killjoy,Viper,Sage,Jett,Gekko","Sova,Killjoy,Viper,Jett,Gekko"
Lotus,Goon that jawn,Event Horizon,13,5,3,3,2,10,"Breach,Cypher,Neon,Fade,Clove","Breach,Raze,Cypher,Omen,Fade"
Icebox,FBU ESPORTS,PARABELLUM,2,13,0,3,10,2,"Sova,Viper,Sage,Jett,Gekko","Sova,Killjoy,Viper,Jett,KAY/O"
Lotus,uhhhhh,The Villans,10,13,4,8,5,6,"Breach,Raze,Killjoy,Omen,Gekko","Breach,Raze,Cypher,Omen,Gekko"
Haven,Goon that jawn,Event Horizon,13,6,3,4,2,10,"Cypher,Sova,Omen,Yoru,Iso","Breach,Sova,Killjoy,Omen,Jett"
Ascent,F5 Esports,Reign Above,13,5,4,2,3,9,"Sova,Killjoy,Omen,Jett,KAY/O","Sova,Killjoy,Omen,Jett,KAY/O"
Haven,ROSE,Burger Boyz 2.0,8,13,2,7,6,6,"Sova,Killjoy,Yoru,Astra,Neon","Breach,Sova,Killjoy,Omen,Neon"
Ascent,uhhhhh,The Villans,13,7,9,3,4,4,"Sova,Killjoy,Reyna,Omen,Jett","Cypher,Sova,Omen,Jett,Deadlock"
Haven,Vixen Esports,Bilgi Esports,14,12,5,8,4,9,"Breach,Sova,Killjoy,Omen,Jett","Breach,Sova,Killjoy,Omen,Jett"
Haven,Burger Boyz 2.0,Reign Above,13,3,3,1,2,10,"Breach,Sova,Killjoy,Omen,Neon","Breach,Sova,Killjoy,Omen,Jett"
Lotus,F5 Esports,ROSE,11,13,8,4,9,3,"Breach,Cypher,Neon,Fade,Clove","Raze,Killjoy,Viper,Omen,Fade"
Bind,#flyaway,Event Horizon,13,5,10,2,3,3,"Raze,Brimstone,Reyna,Yoru,Gekko","Raze,Viper,Brimstone,Fade,Gekko"
Haven,ARTHEA,SNIPE Esports,13,4,4,1,3,9,"Breach,Sova,Killjoy,Omen,Jett","Breach,Cypher,Sova,Omen,Jett"
Abyss,Burger Boyz 2.0,Reign Above,13,11,6,6,5,7,"Breach,Cypher,Sova,Omen,Jett","Cypher,Sova,Omen,Jett,Yoru"
Ascent,Goon that jawn,uhhhhh,13,9,6,6,3,7,"Sova,Killjoy,Omen,Yoru,Iso","Sova,Killjoy,Omen,Jett,KAY/O"
Haven,F5 Esports,ROSE,11,13,6,6,7,5,"Breach,Sova,Killjoy,Jett,Astra","Sova,Killjoy,Yoru,Astra,Neon"
Ascent,Burger Boyz 2.0,Reign Above,11,13,5,7,6,6,"Cypher,Sova,Omen,Jett,Deadlock","Sova,Killjoy,Omen,Jett,KAY/O"
Lotus,#flyaway,Event Horizon,13,9,8,2,7,5,"Raze,Cypher,Gekko,Deadlock,Clove","Breach,Raze,Cypher,Omen,Fade"
Lotus,FNATIC,Bilibili Gaming,13,4,3,2,2,10,"Raze,Killjoy,Viper,Omen,Fade","Breach,Cypher,Omen,Neon,Fade"
Bind,FNATIC,Bilibili Gaming,13,9,6,4,5,7,"Raze,Viper,Astra,Fade,Gekko","Raze,Cypher,Viper,Brimstone,Skye"
Bind,DRX,KRÜ Esports,13,6,4,3,3,9,"Raze,Viper,Brimstone,Fade,Gekko","Raze,Viper,Brimstone,Fade,Gekko"
Abyss,DRX,KRÜ Esports,13,6,5,2,4,8,"Cypher,Sova,Omen,Jett,KAY/O","Cypher,Sova,Omen,KAY/O,Harbor"
Haven,DRX,KRÜ Esports,2,13,2,10,3,0,"Breach,Cypher,Sova,Omen,Jett","Breach,Cypher,Sova,Omen,Neon"
Ascent,LazerrFreeks Ivy,Envee Sapphire GC,13,6,8,4,2,5,"Sova,Killjoy,Omen,Jett,KAY/O","Sova,Killjoy,Omen,Jett,KAY/O"
Lotus,SaD FROST,minions united GC,13,10,6,5,5,7,"Breach,Cypher,Neon,Gekko,Clove","Breach,Raze,Killjoy,Omen,Fade"
Sunset,SaD FROST,Charmers GC,13,6,8,4,2,5,"Breach,Raze,Cypher,Fade,Clove","Breach,Raze,Cypher,Omen,Fade"
Ascent,Coalesce,Hidden Horizon,13,8,5,7,1,8,"Cypher,Sova,Phoenix,Omen,Jett","Sova,Killjoy,Omen,Jett,KAY/O"
Icebox,Coalesce,Hidden Horizon,13,5,4,2,3,9,"Sova,Killjoy,Viper,Reyna,Jett","Sova,Killjoy,Viper,Jett,Gekko"
Lotus,Requiem,Jabba Enjoyers,13,9,8,2,7,5,"Cypher,Viper,Omen,Neon,Fade","Breach,Raze,Killjoy,Omen,Fade"
Icebox,Requiem,Jabba Enjoyers,13,8,6,3,5,7,"Killjoy,Viper,Jett,KAY/O,Gekko","Sova,Killjoy,Viper,Jett,Deadlock"
Lotus,FunPlus Phoenix,Team Heretics,13,15,6,8,7,7,"Raze,Viper,Omen,Astra,Gekko","Raze,Killjoy,Viper,Omen,Fade"
Bind,FunPlus Phoenix,Team Heretics,13,9,5,5,4,8,"Viper,Omen,Yoru,Chamber,Fade","Raze,Viper,Brimstone,Fade,Gekko"
Abyss,FunPlus Phoenix,Team Heretics,12,14,8,5,9,4,"Cypher,Viper,Omen,Yoru,Fade","Cypher,Sova,Jett,Astra,Gekko"
Ascent,Gen.G Esports,Sentinels,13,7,8,4,3,5,"Sova,Killjoy,Omen,Jett,KAY/O","Cypher,Sova,Omen,Jett,Deadlock"
Haven,Gen.G Esports,Sentinels,13,8,6,3,5,7,"Killjoy,Viper,Omen,Jett,Skye","Breach,Cypher,Sova,Omen,Jett"
Sunset,minions united GC,Tenax GC,13,6,9,3,3,4,"Breach,Raze,Cypher,Omen,Gekko","Cypher,Omen,KAY/O,Neon,Fade"
Sunset,LazerrFreeks Ivy,Tenax GC,14,12,5,8,4,9,"Raze,Cypher,Fade,Gekko,Clove","Cypher,Omen,KAY/O,Neon,Fade"
